time,subj_course_id,sec_code,sec_id,prof,available,waitlist,total,enrolled_ct
1748417678123,AAPI 87,A00,911745,Solomon; Amanda Lee Albaniel,20,0,20,0
1748417679159,AAS 10R,A01,912566,Butler; Elizabeth Annette,16,0,34,18
1748417679159,AAS 10R,A02,912567,Butler; Elizabeth Annette,21,0,34,13
1748417680187,AAS 170R,A00,912568,Butler; Elizabeth Annette,29,0,32,3
1748417681214,ANAR 104,A01,911408,Shtienberg; Gilad,11,0,20,9
1748417682239,ANAR 120,A00,911411,Staff,22,0,30,8
1748417683267,ANAR 166,A00,911412,Jimenez Cano; Nayeli Guada,21,0,30,9
1748417684293,ANAR 167,A01,911414,Dunseth; Zachary Clark,0,0,10,10
1748417685327,ANBI 100,A00,911416,Marchetto; Maria Carolina,36,0,40,4
1748417685327,ANBI 100,B00,961136,Staff,66,0,80,14
1748417686355,ANBI 112,A00,911417,Marchetto; Maria Carolina,0,0,20,20
1748417687381,ANBI 117,A01,961211,Fox; Patrick Keolu Ozer,33,0,40,7
1748417688413,ANBI 135,A01,911419,Non; Amy L,4,0,15,11
1748417689446,ANBI 141,A00,911420,Gagneux; Pascal,170,0,196,26
1748417690478,ANSC 108,A00,911460,Pedersen; David,38,0,40,2
1748417691506,ANSC 121,A00,911472,Sloane; Julia Kathryn,53,0,60,7
1748417692540,ANSC 124,A00,911473,Bialecki; Jon Anthony,32,0,40,8
1748417693566,ANSC 142,A00,911474,Stone; Annika Britt,32,0,40,8
1748417694597,ANSC 148,A00,911475,Walkover; Lillian B,46,0,46,0
1748417695626,ANSC 149,A00,911476,Varma; Saiba,56,0,60,4
1748417696655,ANSC 152,A00,961212,Staff,40,0,40,0
1748417697683,ANSC 190,A00,911479,Jassal; Aftab,41,0,50,9
1748417698715,ANTH 1,A00,910717,Jassal; Aftab,146,0,150,4
1748417699742,ANTH 2,A01,910719,Wilder; Linnea Lorene,31,0,36,5
1748417699742,ANTH 2,A02,910720,Wilder; Linnea Lorene,36,0,36,0
1748417699742,ANTH 2,A03,910722,Wilder; Linnea Lorene,32,0,36,4
1748417699742,ANTH 2,A04,910723,Wilder; Linnea Lorene,35,0,36,1
1748417699742,ANTH 2,A05,910724,Wilder; Linnea Lorene,35,0,36,1
1748417699742,ANTH 2,A06,910725,Wilder; Linnea Lorene,35,0,36,1
1748417699742,ANTH 2,A07,910726,Wilder; Linnea Lorene,33,0,34,1
1748417700775,ANTH 10,A00,910727,Stewart; Alexander B,147,0,175,28
1748417701803,ANTH 21,A01,910730,Stone; Annika Britt,35,0,36,1
1748417701803,ANTH 21,A02,910731,Stone; Annika Britt,34,0,36,2
1748417701803,ANTH 21,A03,910732,Stone; Annika Britt,34,0,36,2
1748417701803,ANTH 21,A04,910733,Stone; Annika Britt,30,0,36,6
1748417701803,ANTH 21,A05,910734,Stone; Annika Britt,35,0,36,1
1748417701803,ANTH 21,A06,910735,Stone; Annika Britt,30,0,36,6
1748417701803,ANTH 21,A07,910736,Stone; Annika Britt,24,0,34,10
1748417701803,ANTH 21,B01,910738,Kang; Byung Chu,36,0,36,0
1748417701803,ANTH 21,B02,910740,Kang; Byung Chu,36,0,36,0
1748417701803,ANTH 21,B03,910781,Kang; Byung Chu,34,0,36,2
1748417701803,ANTH 21,B04,910782,Kang; Byung Chu,34,0,36,2
1748417701803,ANTH 21,B05,910821,Kang; Byung Chu,36,0,36,0
1748417701803,ANTH 21,B06,910826,Kang; Byung Chu,34,0,36,2
1748417701803,ANTH 21,B07,910834,Kang; Byung Chu,34,0,34,0
1748417702837,ANTH 23,A01,910896,Stewart; Alexander B,25,0,25,0
1748417702837,ANTH 23,A02,910916,Stewart; Alexander B,25,0,25,0
1748417702837,ANTH 23,A03,910932,Stewart; Alexander B,25,0,25,0
1748417702837,ANTH 23,A04,910933,Stewart; Alexander B,24,0,25,1
1748417702837,ANTH 23,A05,910938,Stewart; Alexander B,25,0,25,0
1748417702837,ANTH 23,A06,911043,Stewart; Alexander B,25,0,25,0
1748417702837,ANTH 23,A07,911141,Stewart; Alexander B,24,0,25,1
1748417703873,ANTH 87,A00,911153,Jordan; David K.,20,0,20,0
1748417703873,ANTH 87,B00,911392,Jordan; David K.,20,0,20,0
1748417703873,ANTH 87,C00,911404,Varma; Saiba,20,0,20,0
1748417704903,ANTH 101,A01,911481,Staff,27,0,30,3
1748417704903,ANTH 101,A02,911482,Staff,15,0,30,15
1748417704903,ANTH 101,A03,911483,Staff,24,0,30,6
1748417704903,ANTH 101,A04,911484,Staff,17,0,30,13
1748417705932,ANTH 105,A00,911486,Staff,69,0,80,11
1748417706959,ANTH 108,A00,911487,Sloane; Julia Kathryn,32,0,35,3
1748417707986,ANTH 196A,A00,911488,Staff,14,0,15,1
1748417709015,ANTH 200,A00,911489,Non; Amy L,12,0,15,3
1748417710048,ANTH 203,A00,911490,Gagneux; Pascal,20,0,20,0
1748417711074,ANTH 208,A00,911491,Kang; Byung Chu,8,0,12,4
1748417712101,ANTH 268,A00,911492,McKenzie; Kerry V.,10,0,10,0
1748417713128,ANTH 273,A00,911493,McKenzie; Kerry V.,10,0,10,0
1748417714154,ANTH 281A,A00,911494,Pedersen; David,10,0,10,0
1748417715180,ANTH 285,A00,911495,Algaze; Guillermo,7,0,10,3
1748417716207,ASTR 1,A01,911506,Wright; Shelley Adams,282,0,300,18
1748417717236,ASTR 18,A01,911508,Arnold; Kam S,35,0,37,2
1748417718263,ASTR 20A,A01,911510,Theissen; Christopher Alexander,48,0,56,8
1748417719297,ASTR 65,A01,911512,Trumbo; Samantha Kathleen,49,0,50,1
1748417720337,ASTR 101,A01,911514,Burgasser; Adam Jonathan,25,0,32,7
1748417721364,ASTR 104,A01,911516,Lee; Eve Jihyun,29,0,32,3
1748417722395,ASTR 120,A01,911518,Tytler; David Robert,29,0,37,8
1748417723426,ASTR 124,A01,911520,Konopacky; Quinn Morgan,33,0,37,4
1748417724462,ASTR 150,A01,911522,Hosseinzadeh; Griffin Alex,34,0,40,6
1748417725487,ASTR 200,A00,911523,Sandstrom; Karin Marie,29,0,30,1
1748417726517,ASTR 201,A00,911524,Broekgaarden; Floor Suzan,30,0,30,0
1748417727550,ASTR 213,A00,911525,Keres; Dusan,28,0,30,2
1748417728582,ASTR 250,A00,911526,Theissen; Christopher Alexander & Hosseinzadeh; Griffin Alex,27,0,30,3
1748417729608,ASTR 251,A00,911527,Theissen; Christopher Alexander & Hosseinzadeh; Griffin Alex,27,0,30,3
1748417730675,AWP 3,001,910489,Staff,12,0,12,0
1748417730675,AWP 3,002,910490,Staff,12,0,12,0
1748417730675,AWP 3,003,910491,Staff,12,0,12,0
1748417730675,AWP 3,004,910492,Staff,12,0,12,0
1748417730675,AWP 3,005,910493,Staff,12,0,12,0
1748417730675,AWP 3,006,910495,Staff,12,0,12,0
1748417730675,AWP 3,007,910498,Staff,12,0,12,0
1748417730675,AWP 3,008,910509,Staff,12,0,12,0
1748417730675,AWP 3,009,910516,Staff,12,0,12,0
1748417730675,AWP 3,010,910525,Staff,12,0,12,0
1748417730675,AWP 3,011,910531,Staff,12,0,12,0
1748417730675,AWP 3,012,910532,Staff,12,0,12,0
1748417730675,AWP 3,013,910533,Staff,12,0,12,0
1748417730675,AWP 3,014,910534,Staff,12,0,12,0
1748417730675,AWP 3,015,910535,Staff,12,0,12,0
1748417730675,AWP 3,016,910536,Staff,12,0,12,0
1748417730675,AWP 3,017,910537,Staff,12,0,12,0
1748417730675,AWP 3,018,910538,Staff,12,0,12,0
1748417730675,AWP 3,019,910539,Staff,0,0,0,0
1748417730675,AWP 3,020,910540,Staff,0,0,0,0
1748417730675,AWP 3,021,910541,Staff,12,0,12,0
1748417730675,AWP 3,022,910542,Staff,0,0,0,0
1748417730675,AWP 3,023,910543,Staff,12,0,12,0
1748417730675,AWP 3,024,910545,Staff,12,0,12,0
1748417730675,AWP 3,025,910546,Staff,12,0,12,0
1748417730675,AWP 3,026,910547,Staff,12,0,12,0
1748417730675,AWP 3,027,910548,Staff,12,0,12,0
1748417730675,AWP 3,028,910549,Staff,12,0,12,0
1748417730675,AWP 3,029,910550,Staff,0,0,0,0
1748417730675,AWP 3,030,910551,Staff,0,0,0,0
1748417730675,AWP 3,031,910552,Staff,12,0,12,0
1748417730675,AWP 3,032,910553,Staff,12,0,12,0
1748417730675,AWP 3,033,910554,Staff,12,0,12,0
1748417730675,AWP 3,034,910555,Staff,12,0,12,0
1748417730675,AWP 3,035,910557,Staff,12,0,12,0
1748417730675,AWP 3,036,910558,Staff,12,0,12,0
1748417730675,AWP 3,037,910559,Staff,12,0,12,0
1748417730675,AWP 3,038,910560,Staff,12,0,12,0
1748417730675,AWP 3,039,910561,Staff,12,0,12,0
1748417730675,AWP 3,040,910562,Staff,12,0,12,0
1748417730675,AWP 3,041,910563,Staff,12,0,12,0
1748417730675,AWP 3,042,910564,Staff,12,0,12,0
1748417730675,AWP 3,043,910565,Staff,12,0,12,0
1748417730675,AWP 3,044,910566,Staff,12,0,12,0
1748417730675,AWP 3,045,910567,Staff,12,0,12,0
1748417730675,AWP 3,046,910568,Staff,12,0,12,0
1748417730675,AWP 3,047,910569,Staff,12,0,12,0
1748417730675,AWP 3,048,910570,Staff,12,0,12,0
1748417730675,AWP 3,049,910571,Staff,12,0,12,0
1748417730675,AWP 3,050,910576,Staff,12,0,12,0
1748417730675,AWP 3,051,910629,Staff,12,0,12,0
1748417730675,AWP 3,052,910630,Staff,12,0,12,0
1748417730675,AWP 3,053,910632,Staff,12,0,12,0
1748417730675,AWP 3,054,910633,Staff,12,0,12,0
1748417730675,AWP 3,055,910635,Staff,12,0,12,0
1748417730675,AWP 3,056,910636,Staff,12,0,12,0
1748417730675,AWP 3,057,910638,Staff,12,0,12,0
1748417730675,AWP 3,058,910640,Staff,0,0,0,0
1748417730675,AWP 3,059,910641,Staff,12,0,12,0
1748417730675,AWP 3,060,910645,Staff,12,0,12,0
1748417730675,AWP 3,061,910646,Staff,12,0,12,0
1748417730675,AWP 3,062,910648,Staff,12,0,12,0
1748417730675,AWP 3,063,910649,Staff,12,0,12,0
1748417730675,AWP 3,064,910653,Staff,12,0,12,0
1748417730675,AWP 3,065,910654,Staff,12,0,12,0
1748417730675,AWP 3,066,910656,Staff,12,0,12,0
1748417730675,AWP 3,067,910657,Staff,12,0,12,0
1748417730675,AWP 3,068,910659,Staff,15,0,15,0
1748417730675,AWP 3,069,910660,Staff,0,0,0,0
1748417730675,AWP 3,070,910662,Staff,12,0,12,0
1748417730675,AWP 3,071,910665,Staff,0,0,0,0
1748417730675,AWP 3,072,910667,Staff,12,0,12,0
1748417730675,AWP 3,073,970938,Staff,12,0,12,0
1748417730675,AWP 3,074,970939,Staff,12,0,12,0
1748417730675,AWP 3,075,970940,Staff,0,0,0,0
1748417730675,AWP 3,076,970941,Staff,12,0,12,0
1748417730675,AWP 3,077,970942,Staff,12,0,12,0
1748417730675,AWP 3,078,970943,Staff,0,0,0,0
1748417730675,AWP 3,079,970944,Staff,12,0,12,0
1748417730675,AWP 3,080,970945,Staff,0,0,0,0
1748417730675,AWP 3,081,971140,Staff,0,0,0,0
1748417730675,AWP 3,082,971141,Staff,0,0,0,0
1748417730675,AWP 3,083,971142,Staff,0,0,0,0
1748417730675,AWP 3,084,971152,Staff,0,0,0,0
1748417730675,AWP 3,085,971315,Staff,0,0,0,0
1748417731705,AWP 4B,B00,910682,Staff,0,0,0,0
1748417731705,AWP 4B,C00,910701,Staff,0,0,0,1
1748417732734,BENG 1,A01,911565,Khojah; Reem I,26,0,30,4
1748417732734,BENG 1,A02,911567,Khojah; Reem I,30,0,30,0
1748417732734,BENG 1,A03,911568,Khojah; Reem I,29,0,30,1
1748417733760,BENG 2,A00,911569,Khojah; Reem I,28,0,30,2
1748417734786,BENG 98,001,969809,Sah; Robert Lie-Yuan,9999,0,9999,0
1748417735812,BENG 99,001,969810,Sah; Robert Lie-Yuan,9999,0,9999,0
1748417736843,BENG 100,A01,911579,Taylor Amos; Alyssa C,35,0,50,15
1748417737871,BENG 110,A01,911582,Mc Culloch; Andrew Douglas,5,0,30,25
1748417737871,BENG 110,A02,911584,Mc Culloch; Andrew Douglas,17,0,30,13
1748417738897,BENG 122A,A01,958030,Cauwenberghs; Gert,54,0,70,16
1748417739926,BENG 133,A01,911589,Mali; Prashant Gulab Ram,33,0,40,7
1748417740961,BENG 135,A01,911653,Staff,32,0,40,8
1748417741987,BENG 141,A01,911674,Staff,29,0,40,11
1748417743014,BENG 161A,A01,911676,Fraley; Stephanie I.,16,0,35,19
1748417743014,BENG 161A,A02,957945,Fraley; Stephanie I.,29,0,35,6
1748417744044,BENG 162,A01,911682,Mali; Prashant Gulab Ram,0,0,30,30
1748417744044,BENG 162,A02,911683,Mali; Prashant Gulab Ram,25,0,30,5
1748417745075,BENG 166A,A02,911685,Sah; Robert Lie-Yuan,11,0,35,24
1748417746103,BENG 183,A01,911688,Zhong; Sheng,35,0,120,85
1748417747128,BENG 187B,A00,911689,Taylor Amos; Alyssa C,52,0,120,68
1748417748158,BENG 188A,A01,911691,Taylor Amos; Alyssa C,131,0,170,39
1748417749202,BENG 196,A00,911692,Cabrales; Pedro,5,0,5,0
1748417750229,BENG 197,A00,911693,Cabrales; Pedro,9999,0,9999,0
1748417751258,BENG 198,001,969812,Sah; Robert Lie-Yuan,9999,0,9999,0
1748417752294,BENG 211,A00,911720,Smarr; Benjamin,2,0,30,28
1748417753322,BENG 216,A01,911722,Cauwenberghs; Gert,1,0,40,39
1748417754378,BENG 219,A00,911723,Schoeneberg; Johannes,0,0,0,0
1748417755404,BENG 221,A00,911724,Valdez-Jasso; Daniela,28,0,70,42
1748417756429,BENG 226,A01,911727,Schmid-Schoenbein; Geert W,54,0,120,66
1748417757458,BENG 230A,A00,911728,Huang; Xiaohua,59,0,120,61
1748417758484,BENG 241A,A01,911730,Cyphert; Erika Leah,0,0,50,50
1748417759510,BENG 242,A00,911731,Cai; Shengqiang,15,0,40,25
1748417760542,BENG 247A,A00,911732,Shi; Lingyan,31,0,55,24
1748417761572,BENG 247B,A00,911733,Aran; Kiana,0,0,30,30
1748417762601,BENG 254,A01,911735,Hasty; Jeff M,0,0,20,20
1748417763626,BENG 260,A01,911737,Silva; Gabriel,15,0,45,30
1748417764658,BENG 280A,A00,911738,Liu; Thomas Tao-Ming & McVeigh; Elliot R.,34,0,70,36
1748417765684,BENG 281,A00,911739,Zhong; Sheng,6,0,90,84
1748417766780,BENG 282,A00,911740,Cabrales; Pedro,19,0,100,81
1748417767812,BENG 292,A01,911742,Ross; Camille,20,0,20,0
1748417768843,BENG 294A,A00,911743,King; Kevin R,25,0,50,25
1748417769867,BENG 295,A00,911744,Watson; John Thomas,9999,0,9999,0
1748417770892,BGGN 202,A00,943331,Kadonaga; James T,52,0,60,8
1748417771922,BGGN 204,A00,943332,Shurin; Jonathan,11,0,20,9
1748417772951,BGGN 206A,A00,943343,Bennett; Eric J,50,0,50,0
1748417773976,BGGN 208,A00,943344,Meyer; Justin Raymond & Bennett; Eric J,50,0,50,0
1748417775005,BGGN 213,A00,943349,Grant; Barry J,48,0,48,0
1748417776031,BGGN 214,A00,943351,Suel; Gurol Mehmet,23,0,50,27
1748417777057,BGGN 220,A00,943352,Dickinson; Alexandra Jazz & Pruneda-Paz; Jose L.,23,0,50,27
1748417778082,BGGN 227,A00,943372,Huffaker; Alisa,44,0,50,6
1748417779109,BGGN 249A,A01,969612,Bloodgood; Brenda Laurie,0,0,0,0
1748417779109,BGGN 249A,A02,969639,Bloodgood; Brenda Laurie,0,0,0,0
1748417780136,BGGN 260,A01,946423,Silva; Gabriel,15,0,15,0
1748417781400,BGGN 271,001,967097,Akbari; Omar Sultan,9999,0,9999,0
1748417781400,BGGN 271,002,967098,Allen; Nicola J,9999,0,9999,0
1748417781400,BGGN 271,003,967099,Alperin; Mariann,9999,0,9999,0
1748417781400,BGGN 271,004,967238,Antal; Corina Elena,9998,0,9999,1
1748417781400,BGGN 271,005,967365,Banghart; Matthew Ryan,9999,0,9999,0
1748417781400,BGGN 271,006,967368,Bier; Ethan,9999,0,9999,0
1748417781400,BGGN 271,007,967371,Boss; Gerard R.,9999,0,9999,0
1748417781400,BGGN 271,008,967375,Bouvet; Michael,9999,0,9999,0
1748417781400,BGGN 271,009,967376,Breen; Ellen C.,9999,0,9999,0
1748417781400,BGGN 271,010,967382,Bui; Jack D,9999,0,9999,0
1748417781400,BGGN 271,011,967391,Burnett; Lindsey,9998,0,9999,1
1748417781400,BGGN 271,012,967407,Caffrey; Conor,9999,0,9999,0
1748417781400,BGGN 271,013,967429,Castle; Michael James,9999,0,9999,0
1748417781400,BGGN 271,014,967431,Chang; John Tzu-yu,9999,0,9999,0
1748417781400,BGGN 271,015,967448,Chen; Xu,9999,0,9999,0
1748417781400,BGGN 271,016,967449,Cheng; Christine Shiang-Ling,9999,0,9999,0
1748417781400,BGGN 271,017,967464,Cheresh; David A.,9999,0,9999,0
1748417781400,BGGN 271,018,967496,Cherqui; Stephanie,9999,0,9999,0
1748417781400,BGGN 271,019,967500,Chu; Hiutung,9999,0,9999,0
1748417781400,BGGN 271,020,967559,Church; Kellie Breen,9999,0,9999,0
1748417781400,BGGN 271,021,967560,Cleland; Elsa Eleanor,9999,0,9999,0
1748417781400,BGGN 271,022,967561,Cohen; Shiran,9999,0,9999,0
1748417781400,BGGN 271,023,967562,Coufal; Nicole Gabriele,9999,0,9999,0
1748417781400,BGGN 271,024,967563,Croker; Ben Adam,9999,0,9999,0
1748417781400,BGGN 271,025,967564,Crotty Alexander; Laura E,9999,0,9999,0
1748417781400,BGGN 271,026,967565,Daugherty; Matthew Dorton,9998,0,9999,1
1748417781400,BGGN 271,027,967566,De Silva; Shermin,9999,0,9999,0
1748417781400,BGGN 271,028,967567,Dhar; Debanjan,9999,0,9999,0
1748417781400,BGGN 271,029,967568,Dixon; Jesse,9999,0,9999,0
1748417781400,BGGN 271,030,967569,Doherty; Taylor Alan,9998,0,9999,1
1748417781400,BGGN 271,031,967570,Dore; Kim Bohemie,9999,0,9999,0
1748417781400,BGGN 271,032,967571,Dorrestein; Pieter,9999,0,9999,0
1748417781400,BGGN 271,033,967572,Dulawa; Stephanie Carole,9999,0,9999,0
1748417781400,BGGN 271,034,967573,Fang; Xi,9999,0,9999,0
1748417781400,BGGN 271,035,967575,Farley; Emma Kristen,9998,0,9999,1
1748417781400,BGGN 271,036,967576,Ferguson; Cole John,9999,0,9999,0
1748417781400,BGGN 271,037,967578,Fisch; Kathleen Marie,9999,0,9999,0
1748417781400,BGGN 271,038,967579,George; Olivier,9999,0,9999,0
1748417781400,BGGN 271,039,967580,Ghosh; Pradipta,9998,0,9999,1
1748417781400,BGGN 271,040,967581,Glasgow; Stacey Marie,9999,0,9999,0
1748417781400,BGGN 271,041,967582,Golden; James W,9999,0,9999,0
1748417781400,BGGN 271,042,967583,Gonzalez Gamboa; Ivonne,9999,0,9999,0
1748417781400,BGGN 271,043,967584,Goren; Alon M,9999,0,9999,0
1748417781400,BGGN 271,044,967650,Guatelli; John C,9999,0,9999,0
1748417781400,BGGN 271,045,967651,Guma; Monica,9998,0,9999,1
1748417781400,BGGN 271,046,967652,Gustafsson; Asa Birgitta,9999,0,9999,0
1748417781400,BGGN 271,047,967655,Hamdoun; Amr,9999,0,9999,0
1748417781400,BGGN 271,048,967657,Hao; Nan,9999,0,9999,0
1748417781400,BGGN 271,049,967658,Hasty; Jeff M,9999,0,9999,0
1748417781400,BGGN 271,050,967660,Jiang; Qingfei,9998,0,9999,1
1748417781400,BGGN 271,051,967661,Jin; Chunyu,9999,0,9999,0
1748417781400,BGGN 271,052,967662,Jin; Yishi,9999,0,9999,0
1748417781400,BGGN 271,053,967663,Joshi; Shweta,9998,0,9999,1
1748417781400,BGGN 271,054,967664,Ju; Won-Kyu,9998,0,9999,1
1748417781400,BGGN 271,055,967665,Jun; Suckjoon,9999,0,9999,0
1748417781400,BGGN 271,056,967666,Kaech; Susan Michelle,9999,0,9999,0
1748417781400,BGGN 271,057,967668,Kauffman; Alexander,9998,0,9999,1
1748417781400,BGGN 271,058,967670,Kiger; Amy,9999,0,9999,0
1748417781400,BGGN 271,059,967720,Koloski; Miranda Jane,9998,0,9999,1
1748417781400,BGGN 271,060,967864,Komiyama; Takaki,9999,0,9999,0
1748417781400,BGGN 271,061,967865,Kronenberg; Mitchell E.,9998,0,9999,1
1748417781400,BGGN 271,062,967866,Kufareva; Irina,9999,0,9999,0
1748417781400,BGGN 271,063,967867,Lee; Yun Sok,9999,0,9999,0
1748417781400,BGGN 271,064,967869,Leutgeb; Stefan,9999,0,9999,0
1748417781400,BGGN 271,065,967870,Lewis; Warren G.,9999,0,9999,0
1748417781400,BGGN 271,066,967871,Li; Willis Xiaowei,9998,0,9999,1
1748417781400,BGGN 271,067,967872,Lim; Byungkook,9999,0,9999,0
1748417781400,BGGN 271,068,967873,Lo; Stanley M.,9998,0,9999,1
1748417781400,BGGN 271,069,967874,Lopez Ramirez; Miguel Alej,9999,0,9999,0
1748417781400,BGGN 271,070,967875,Lu; Li-Fan,9998,0,9999,1
1748417781400,BGGN 271,071,967877,Lu; Pengzhe,9999,0,9999,0
1748417781400,BGGN 271,072,967878,Lyons; Deirdre Colleen,9999,0,9999,0
1748417781400,BGGN 271,073,967879,Lyumkis; Dmitry Evgenievich,9999,0,9999,0
1748417781400,BGGN 271,074,967880,Mandyam; Chitra,9999,0,9999,0
1748417781400,BGGN 271,075,967881,McConville; Patrick James,9999,0,9999,0
1748417781400,BGGN 271,076,967882,Mertens; Jerome Stefan,9999,0,9999,0
1748417781400,BGGN 271,077,967884,Morris; Gerald P,9999,0,9999,0
1748417781400,BGGN 271,078,967885,Muroyama; Andrew David,9999,0,9999,0
1748417781400,BGGN 271,079,967886,Murre; Cornelis,9999,0,9999,0
1748417781400,BGGN 271,080,967887,Neal; Sonya E,9999,0,9999,0
1748417781400,BGGN 271,081,967889,Newton; Alexandra C.,9999,0,9999,0
1748417781400,BGGN 271,082,967890,Nieh; James Charles,9999,0,9999,0
1748417781400,BGGN 271,083,967893,Niwa; Maho,9999,0,9999,0
1748417781400,BGGN 271,084,967894,Pantham; Priyadarshini,9999,0,9999,0
1748417781400,BGGN 271,085,967895,Parast; Mana,9999,0,9999,0
1748417781400,BGGN 271,086,967899,Perry; Michael William,9999,0,9999,0
1748417781400,BGGN 271,087,967900,Pillus; Lorraine,9998,0,9999,1
1748417781400,BGGN 271,088,967902,Pogliano; Joseph,9999,0,9999,0
1748417781400,BGGN 271,089,967903,Pruneda-Paz; Jose L.,9999,0,9999,0
1748417781400,BGGN 271,090,967904,Raffatellu; Manuela,9999,0,9999,0
1748417781400,BGGN 271,091,967906,Rana; Tariq,9999,0,9999,0
1748417781400,BGGN 271,092,967907,Rao; Anjana,9998,0,9999,1
1748417781400,BGGN 271,093,967908,Raz; Eyal,9998,0,9999,1
1748417781400,BGGN 271,094,967909,Gaulton; Kyle J,9999,0,9999,0
1748417781400,BGGN 271,095,967910,Rifkin; Scott,9998,0,9999,1
1748417781400,BGGN 271,096,967912,Risbrough; Victoria Blythe,9999,0,9999,0
1748417781400,BGGN 271,097,967916,Rose; Noah Hartmann,9999,0,9999,0
1748417781400,BGGN 271,098,967917,Rouse; Gregory W.,9999,0,9999,0
1748417781400,BGGN 271,099,967918,Saier; Milton H.,9999,0,9999,0
1748417781400,BGGN 271,100,967919,Saltiel; Alan,9998,0,9999,1
1748417781400,BGGN 271,101,967920,Sanchez-Lopez; Elsa,9999,0,9999,0
1748417781400,BGGN 271,102,967921,Schenk; Simon,9999,0,9999,0
1748417781400,BGGN 271,103,967922,Schroeder; Julian I,9998,0,9999,1
1748417781400,BGGN 271,104,967923,Sebat; Lilia Mikhailovna,9999,0,9999,0
1748417781400,BGGN 271,105,967925,Sen; George L,9999,0,9999,0
1748417781400,BGGN 271,106,967926,Shaner; Nathan C.,9999,0,9999,0
1748417781400,BGGN 271,107,967927,Shao; Jianhua,9999,0,9999,0
1748417781400,BGGN 271,108,967928,Shurin; Jonathan,9999,0,9999,0
1748417781400,BGGN 271,109,967929,Sicklick; Jason Keith,9999,0,9999,0
1748417781400,BGGN 271,110,967931,Signer; Robert,9999,0,9999,0
1748417781400,BGGN 271,111,967932,Sigurdson; Christina,9999,0,9999,0
1748417781400,BGGN 271,112,967934,Simonson; Tatum Sasha Summ,9999,0,9999,0
1748417781400,BGGN 271,113,967935,Spitzer; Nicholas,9999,0,9999,0
1748417781400,BGGN 271,114,967936,Steinmetz; Nicole F,9999,0,9999,0
1748417781400,BGGN 271,115,967938,Su; Chih-Ying,9999,0,9999,0
1748417781400,BGGN 271,116,967939,Telese; Francesca,9999,0,9999,0
1748417781400,BGGN 271,117,967942,Towers; Christina Garlingt,9999,0,9999,0
1748417781400,BGGN 271,118,967943,Tye; Kay M,9999,0,9999,0
1748417781400,BGGN 271,119,967945,Wahlin; Karl Jonas,9997,0,9999,2
1748417781400,BGGN 271,120,967947,Wang; Shizhen,9999,0,9999,0
1748417781400,BGGN 271,121,967949,Wang; Jean Yin Jen,9999,0,9999,0
1748417781400,BGGN 271,122,967952,Webster; Nicholas J G,9999,0,9999,0
1748417781400,BGGN 271,123,967953,Weiskopf; Daniela,9998,0,9999,1
1748417781400,BGGN 271,124,967954,Welsbie; Derek,9999,0,9999,0
1748417781400,BGGN 271,125,967956,Wildonger; Jill Cathleen,9999,0,9999,0
1748417781400,BGGN 271,126,967957,Yelon; Deborah,9999,0,9999,0
1748417781400,BGGN 271,127,967958,Yeo; Eugene Wei-Ming,9998,0,9999,1
1748417781400,BGGN 271,128,967959,Ying; Wei,9998,0,9999,1
1748417781400,BGGN 271,129,967960,Young; Jared W.,9999,0,9999,0
1748417781400,BGGN 271,130,967961,Zage; Peter,9999,0,9999,0
1748417781400,BGGN 271,131,967962,Zengler; Karsten B,9999,0,9999,0
1748417781400,BGGN 271,132,967963,Zhang; Jin,9999,0,9999,0
1748417781400,BGGN 271,133,967964,Zhao; Yunde,9999,0,9999,0
1748417781400,BGGN 271,134,967965,Zheng; Ye,9998,0,9999,1
1748417781400,BGGN 271,135,967966,Zhou; Huilin,9998,0,9999,1
1748417781400,BGGN 271,136,967970,Zou; Yimin,9998,0,9999,1
1748417782434,BGGN 272,A00,943373,Lo; Stanley M.,14,0,15,1
1748417783462,BGGN 275,A00,943374,Pogliano; Joseph,0,0,0,0
1748417784492,BGGN 276,A00,943378,Pogliano; Joseph,0,0,0,0
1748417785526,BGJC 204,A00,943407,Lu; Li-Fan & Chang; John Tzu-yu,9998,0,9999,1
1748417786552,BGJC 215,A00,943417,Tour; Ella,9,0,10,1
1748417787738,BGRD 200,001,965406,Akbari; Omar Sultan,9999,0,9999,0
1748417787738,BGRD 200,002,965407,Allen; Eric,9999,0,9999,0
1748417787738,BGRD 200,003,965408,Allen; Nicola J,9998,0,9999,1
1748417787738,BGRD 200,004,965427,Alperin; Mariann,9999,0,9999,0
1748417787738,BGRD 200,005,965428,Amaro; Rommie E,9998,0,9999,1
1748417787738,BGRD 200,006,965429,Antal; Corina Elena,9998,0,9999,1
1748417787738,BGRD 200,007,965731,Asahina; Kenta,9999,0,9999,0
1748417787738,BGRD 200,008,965732,Augustine; Vineet,9999,0,9999,0
1748417787738,BGRD 200,009,965733,Ayres; Janelle Samantha,9998,0,9999,1
1748417787738,BGRD 200,010,965734,Banghart; Matthew Ryan,9999,0,9999,0
1748417787738,BGRD 200,011,965735,Barton; Andrew David,9999,0,9999,0
1748417787738,BGRD 200,012,965736,Bayless; Daniel Wilson,9999,0,9999,0
1748417787738,BGRD 200,013,965737,Benna; Marcus K,9999,0,9999,0
1748417787738,BGRD 200,014,965738,Bennett; Eric J,9999,0,9999,0
1748417787738,BGRD 200,015,965739,Bier; Ethan,9999,0,9999,0
1748417787738,BGRD 200,016,965740,Bloodgood; Brenda Laurie,9999,0,9999,0
1748417787738,BGRD 200,017,965741,Boss; Gerard R.,9999,0,9999,0
1748417787738,BGRD 200,018,966029,Bouvet; Michael,9999,0,9999,0
1748417787738,BGRD 200,019,966054,Breen; Ellen C.,9999,0,9999,0
1748417787738,BGRD 200,020,966072,Bui; Jack D,9999,0,9999,0
1748417787738,BGRD 200,021,966073,Burnett; Lindsey,9998,0,9999,1
1748417787738,BGRD 200,022,966080,Caffrey; Conor,9999,0,9999,0
1748417787738,BGRD 200,023,966082,Callaway; Edward M,9999,0,9999,0
1748417787738,BGRD 200,024,966087,Castle; Michael James,9999,0,9999,0
1748417787738,BGRD 200,025,966089,Chaim; Isaac,9999,0,9999,0
1748417787738,BGRD 200,026,966092,Chang; John Tzu-yu,9999,0,9999,0
1748417787738,BGRD 200,027,966094,Chen; Xu,9999,0,9999,0
1748417787738,BGRD 200,028,966095,Cheng; Christine Shiang-Ling,9999,0,9999,0
1748417787738,BGRD 200,029,966099,Cheresh; David A.,9999,0,9999,0
1748417787738,BGRD 200,030,966103,Cherqui; Stephanie,9999,0,9999,0
1748417787738,BGRD 200,031,966104,Chu; Hiutung,9999,0,9999,0
1748417787738,BGRD 200,032,966107,Church; Kellie Breen,9999,0,9999,0
1748417787738,BGRD 200,033,966108,Cleland; Elsa Eleanor,9997,0,9999,2
1748417787738,BGRD 200,034,966111,Cohen; Shiran,9999,0,9999,0
1748417787738,BGRD 200,035,966112,Cooper; Kimberly Lynn,9999,0,9999,0
1748417787738,BGRD 200,036,966114,Coufal; Nicole Gabriele,9999,0,9999,0
1748417787738,BGRD 200,037,966115,Croker; Ben Adam,9999,0,9999,0
1748417787738,BGRD 200,038,966116,Crotty Alexander; Laura E,9999,0,9999,0
1748417787738,BGRD 200,039,966117,Daugherty; Matthew Dorton,9997,0,9999,2
1748417787738,BGRD 200,040,966118,De Silva; Shermin,9998,0,9999,1
1748417787738,BGRD 200,041,966119,Desai; Arshad,9999,0,9999,0
1748417787738,BGRD 200,042,966120,Dhar; Debanjan,9999,0,9999,0
1748417787738,BGRD 200,043,966121,Dickinson; Alexandra Jazz,9999,0,9999,0
1748417787738,BGRD 200,044,966123,Dixon; Jesse,9999,0,9999,0
1748417787738,BGRD 200,045,966125,Doherty; Taylor Alan,9998,0,9999,1
1748417787738,BGRD 200,046,966128,Dore; Kim Bohemie,9999,0,9999,0
1748417787738,BGRD 200,047,966129,Dorrestein; Pieter,9999,0,9999,0
1748417787738,BGRD 200,048,966130,Dulawa; Stephanie Carole,9999,0,9999,0
1748417787738,BGRD 200,049,966131,Ecker; Joseph R,9999,0,9999,0
1748417787738,BGRD 200,050,966174,Engle; Dannielle D,9998,0,9999,1
1748417787738,BGRD 200,051,966179,Ernst; Andreas,9999,0,9999,0
1748417787738,BGRD 200,052,966182,Esko; Jeffrey D.,9999,0,9999,0
1748417787738,BGRD 200,053,966183,Fang; Xi,9999,0,9999,0
1748417787738,BGRD 200,054,966184,Farley; Emma Kristen,9998,0,9999,1
1748417787738,BGRD 200,055,966187,Ferguson; Cole John,9999,0,9999,0
1748417787738,BGRD 200,056,966190,Fisch; Kathleen Marie,9999,0,9999,0
1748417787738,BGRD 200,057,966193,Gage; Fred H,9999,0,9999,0
1748417787738,BGRD 200,058,966194,George; Monique Leana,9998,0,9999,1
1748417787738,BGRD 200,059,966196,George; Olivier,9999,0,9999,0
1748417787738,BGRD 200,060,966202,Ghosh; Pradipta,9998,0,9999,1
1748417787738,BGRD 200,061,966203,Glasgow; Stacey Marie,9999,0,9999,0
1748417787738,BGRD 200,062,966204,Glass; Christopher,9999,0,9999,0
1748417787738,BGRD 200,063,966226,Golden; James W,9999,0,9999,0
1748417787738,BGRD 200,064,966231,Goldrath; Ananda,9999,0,9999,0
1748417787738,BGRD 200,065,966232,Gonzalez Gamboa; Ivonne,9999,0,9999,0
1748417787738,BGRD 200,066,966233,Goren; Alon M,9999,0,9999,0
1748417787738,BGRD 200,067,966245,Guatelli; John C,9999,0,9999,0
1748417787738,BGRD 200,068,966247,Guma; Monica,9998,0,9999,1
1748417787738,BGRD 200,069,966253,Gustafsson; Asa Birgitta,9999,0,9999,0
1748417787738,BGRD 200,070,966255,Gutkind; Jorge Silvio,9998,0,9999,1
1748417787738,BGRD 200,071,966260,Hamdoun; Amr,9999,0,9999,0
1748417787738,BGRD 200,072,966262,Hampton; Randolph Y.,9998,0,9999,1
1748417787738,BGRD 200,073,966263,Hao; Nan,9999,0,9999,0
1748417787738,BGRD 200,074,966265,Hargreaves; Diana Clare,9997,0,9999,2
1748417787738,BGRD 200,075,966268,Hasty; Jeff M,9999,0,9999,0
1748417787738,BGRD 200,076,966270,Hollern; Daniel Patrick,9999,0,9999,0
1748417787738,BGRD 200,077,966271,Holway; David A.,9998,0,9999,1
1748417787738,BGRD 200,078,966272,Huffaker; Alisa,9999,0,9999,0
1748417787738,BGRD 200,079,966273,Hui; Enfu,9999,0,9999,0
1748417787738,BGRD 200,080,966275,Hwa; Terence T.,9999,0,9999,0
1748417787738,BGRD 200,081,966276,Jackrel; Sara,9998,0,9999,1
1748417787738,BGRD 200,082,966277,Jiang; Qingfei,9998,0,9999,1
1748417787738,BGRD 200,083,966281,Jin; Chunyu,9999,0,9999,0
1748417787738,BGRD 200,084,966283,Jin; Yishi,9999,0,9999,0
1748417787738,BGRD 200,085,966287,Joshi; Shweta,9999,0,9999,0
1748417787738,BGRD 200,086,966290,Ju; Won-Kyu,9998,0,9999,1
1748417787738,BGRD 200,087,966291,Jun; Suckjoon,9999,0,9999,0
1748417787738,BGRD 200,088,966292,Kadonaga; James T,9999,0,9999,0
1748417787738,BGRD 200,089,966293,Kaech; Susan Michelle,9999,0,9999,0
1748417787738,BGRD 200,090,966295,Kauffman; Alexander,9998,0,9999,1
1748417787738,BGRD 200,091,966301,Kendrick; Agnieszka Anasta,9999,0,9999,0
1748417787738,BGRD 200,092,966302,Kiger; Amy,9999,0,9999,0
1748417787738,BGRD 200,093,966314,Knight; Robin,9999,0,9999,0
1748417787738,BGRD 200,094,966315,Koloski; Miranda Jane,9998,0,9999,1
1748417787738,BGRD 200,095,966339,Komiyama; Takaki,9998,0,9999,1
1748417787738,BGRD 200,096,966351,Kosuri; Pallav,9999,0,9999,0
1748417787738,BGRD 200,097,966361,Kronenberg; Mitchell E.,9999,0,9999,0
1748417787738,BGRD 200,098,966374,Kryazhimskiy; Sergey A,9999,0,9999,0
1748417787738,BGRD 200,099,966377,Kufareva; Irina,9999,0,9999,0
1748417787738,BGRD 200,100,966380,Lee; Christopher Tingkuang,9999,0,9999,0
1748417787738,BGRD 200,101,966383,Lee; Kuo Fen,9999,0,9999,0
1748417787738,BGRD 200,102,966387,Lee; Yun Sok,9999,0,9999,0
1748417787738,BGRD 200,103,966397,Leutgeb; Jill K.,9999,0,9999,0
1748417787738,BGRD 200,104,966446,Leutgeb; Stefan,9998,0,9999,1
1748417787738,BGRD 200,105,966478,Lewis; Warren G.,9999,0,9999,0
1748417787738,BGRD 200,106,966490,Li; Willis Xiaowei,9998,0,9999,1
1748417787738,BGRD 200,107,966491,Lim; Byungkook,9998,0,9999,1
1748417787738,BGRD 200,108,966494,Lo; Stanley M.,9998,0,9999,1
1748417787738,BGRD 200,109,966499,Looger; Loren Lee,9998,0,9999,1
1748417787738,BGRD 200,110,966500,Lopez Ramirez; Miguel Alej,9999,0,9999,0
1748417787738,BGRD 200,111,966510,Lovett-Barron; Matthew Rod,9998,0,9999,1
1748417787738,BGRD 200,112,966513,Lu; Li-Fan,9998,0,9999,1
1748417787738,BGRD 200,113,966515,Lu; Pengzhe,9999,0,9999,0
1748417787738,BGRD 200,114,966522,Lykke-Andersen; Jens,9999,0,9999,0
1748417787738,BGRD 200,115,966526,Lyons; Deirdre Colleen,9999,0,9999,0
1748417787738,BGRD 200,116,966528,Lyumkis; Dmitry Evgenievich,9999,0,9999,0
1748417787738,BGRD 200,117,966531,Mandyam; Chitra,9999,0,9999,0
1748417787738,BGRD 200,118,966537,Manor; Uri,9999,0,9999,0
1748417787738,BGRD 200,119,966538,Mayfield; Stephen P.,9998,0,9999,1
1748417787738,BGRD 200,120,966539,McConville; Patrick James,9999,0,9999,0
1748417787738,BGRD 200,121,966546,Mertens; Jerome Stefan,9999,0,9999,0
1748417787738,BGRD 200,122,966586,Meyer; Justin Raymond,9999,0,9999,0
1748417787738,BGRD 200,123,966587,Morris; Gerald P,9999,0,9999,0
1748417787738,BGRD 200,124,966588,Mueller; Lena,9998,0,9999,1
1748417787738,BGRD 200,125,966590,Muroyama; Andrew David,9999,0,9999,0
1748417787738,BGRD 200,126,966591,Murre; Cornelis,9999,0,9999,0
1748417787738,BGRD 200,127,966593,Neal; Sonya E,9998,0,9999,1
1748417787738,BGRD 200,128,966594,Newton; Alexandra C.,9999,0,9999,0
1748417787738,BGRD 200,129,966596,Nieh; James Charles,9999,0,9999,0
1748417787738,BGRD 200,130,966597,Niwa; Maho,9999,0,9999,0
1748417787738,BGRD 200,131,966605,Nizet; Victor F.,9999,0,9999,0
1748417787738,BGRD 200,132,966606,Oegema; Karen,9999,0,9999,0
1748417787738,BGRD 200,133,966608,Panda; Satchidananda,9998,0,9999,1
1748417787738,BGRD 200,134,966610,Pantham; Priyadarshini,9999,0,9999,0
1748417787738,BGRD 200,135,966612,Parast; Mana,9999,0,9999,0
1748417787738,BGRD 200,136,966613,Pasquinelli; Amy,9999,0,9999,0
1748417787738,BGRD 200,137,966615,Pekkurnaz Banghart; Gulcin,9999,0,9999,0
1748417787738,BGRD 200,138,966639,Perry; Michael William,9998,0,9999,1
1748417787738,BGRD 200,139,966640,Pillus; Lorraine,9998,0,9999,1
1748417787738,BGRD 200,140,966654,Pogliano; Joseph,9999,0,9999,0
1748417787738,BGRD 200,141,966700,Pogliano; Kit J.,9999,0,9999,0
1748417787738,BGRD 200,142,966701,Pruneda-Paz; Jose L.,9999,0,9999,0
1748417787738,BGRD 200,143,966744,Raffatellu; Manuela,9999,0,9999,0
1748417787738,BGRD 200,144,966745,Ramanan; Deepshika,9998,0,9999,1
1748417787738,BGRD 200,145,966746,Rana; Tariq,9999,0,9999,0
1748417787738,BGRD 200,146,966747,Rao; Anjana,9999,0,9999,0
1748417787738,BGRD 200,147,966811,Raz; Eyal,9998,0,9999,1
1748417787738,BGRD 200,149,966817,Gaulton; Kyle J,9999,0,9999,0
1748417787738,BGRD 200,150,966824,Rennison; Diana,9999,0,9999,0
1748417787738,BGRD 200,151,966828,Reyes De Barboza; Nabora S,9999,0,9999,0
1748417787738,BGRD 200,152,966837,Rifkin; Scott,9998,0,9999,1
1748417787738,BGRD 200,153,966839,Risbrough; Victoria Blythe,9999,0,9999,0
1748417787738,BGRD 200,154,966846,Rivera; Fabian Chavez,9999,0,9999,0
1748417787738,BGRD 200,155,966851,Rohner; Patrick Thomas,9999,0,9999,0
1748417787738,BGRD 200,156,966859,Rose; Noah Hartmann,9999,0,9999,0
1748417787738,BGRD 200,157,966874,Rosenfeld; Michael G,9999,0,9999,0
1748417787738,BGRD 200,158,966882,Rouse; Gregory W.,9999,0,9999,0
1748417787738,BGRD 200,159,966885,Saier; Milton H.,9999,0,9999,0
1748417787738,BGRD 200,160,966923,Saltiel; Alan,9998,0,9999,1
1748417787738,BGRD 200,161,966926,Sanchez-Lopez; Elsa,9999,0,9999,0
1748417787738,BGRD 200,162,966927,Saphire; Erica Ollmann,9999,0,9999,0
1748417787738,BGRD 200,163,966931,Schenk; Simon,9999,0,9999,0
1748417787738,BGRD 200,164,966938,Schroeder; Julian I,9999,0,9999,0
1748417787738,BGRD 200,165,966966,Sebat; Lilia Mikhailovna,9999,0,9999,0
1748417787738,BGRD 200,166,966978,Sen; George L,9999,0,9999,0
1748417787738,BGRD 200,167,966981,Shah; Sameer B,9999,0,9999,0
1748417787738,BGRD 200,168,966982,Shaner; Nathan C.,9999,0,9999,0
1748417787738,BGRD 200,169,966983,Shao; Jianhua,9999,0,9999,0
1748417787738,BGRD 200,170,966984,Sharpee; Tatyana,9999,0,9999,0
1748417787738,BGRD 200,171,966985,Shaw; Reuben,9999,0,9999,0
1748417787738,BGRD 200,172,966986,Shurin; Jonathan,9998,0,9999,1
1748417787738,BGRD 200,173,966987,Sicklick; Jason Keith,9999,0,9999,0
1748417787738,BGRD 200,174,966988,Signer; Robert,9999,0,9999,0
1748417787738,BGRD 200,175,966989,Sigurdson; Christina,9999,0,9999,0
1748417787738,BGRD 200,176,966991,Simonson; Tatum Sasha Summ,9999,0,9999,0
1748417787738,BGRD 200,177,966992,Soncin; Francesca,9999,0,9999,0
1748417787738,BGRD 200,178,966993,Spitzer; Nicholas,9999,0,9999,0
1748417787738,BGRD 200,179,966994,Steinmetz; Nicole F,9999,0,9999,0
1748417787738,BGRD 200,180,966995,Su; Chih-Ying,9999,0,9999,0
1748417787738,BGRD 200,181,966996,Suel; Gurol Mehmet,9998,0,9999,1
1748417787738,BGRD 200,182,966997,Sun; Xin,9998,0,9999,1
1748417787738,BGRD 200,183,966998,Telese; Francesca,9998,0,9999,1
1748417787738,BGRD 200,184,966999,Towers; Christina Garlingt,9999,0,9999,0
1748417787738,BGRD 200,185,967000,Traver; David,9999,0,9999,0
1748417787738,BGRD 200,186,967001,Troemel; Emily Ruth,9998,0,9999,1
1748417787738,BGRD 200,187,967002,Tye; Kay M,9999,0,9999,0
1748417787738,BGRD 200,188,967003,Vijayanand; Pandurangan,9999,0,9999,0
1748417787738,BGRD 200,189,967004,Villa Rodriguez; Elizabeth,9999,0,9999,0
1748417787738,BGRD 200,190,967005,Wahlin; Karl Jonas,9997,0,9999,2
1748417787738,BGRD 200,191,967009,Wang; Shizhen,9999,0,9999,0
1748417787738,BGRD 200,192,967010,Wang; Jean Yin Jen,9999,0,9999,0
1748417787738,BGRD 200,193,967011,Webster; Nicholas J G,9999,0,9999,0
1748417787738,BGRD 200,194,967016,Weiskopf; Daniela,9998,0,9999,1
1748417787738,BGRD 200,195,967020,Welsbie; Derek,9999,0,9999,0
1748417787738,BGRD 200,196,967022,Wildonger; Jill Cathleen,9998,0,9999,1
1748417787738,BGRD 200,197,967027,Winzeler; Elizabeth A,9998,0,9999,1
1748417787738,BGRD 200,198,967029,Wodarz; Dominik Franz Xave,9999,0,9999,0
1748417787738,BGRD 200,199,967033,Yelon; Deborah,9998,0,9999,1
1748417787738,BGRD 200,200,967034,Yeo; Eugene Wei-Ming,9998,0,9999,1
1748417787738,BGRD 200,201,967040,Ying; Wei,9998,0,9999,1
1748417787738,BGRD 200,202,967052,Young; Jared W.,9999,0,9999,0
1748417787738,BGRD 200,203,967057,Zage; Peter,9999,0,9999,0
1748417787738,BGRD 200,204,967070,Zengler; Karsten B,9998,0,9999,1
1748417787738,BGRD 200,206,967081,Zhang; Jin,9999,0,9999,0
1748417787738,BGRD 200,207,967083,Zhao; Yunde,9999,0,9999,0
1748417787738,BGRD 200,208,967086,Zheng; Binhai,9999,0,9999,0
1748417787738,BGRD 200,209,967091,Zheng; Ye,9999,0,9999,0
1748417787738,BGRD 200,210,967093,Zhou; Huilin,9999,0,9999,0
1748417787738,BGRD 200,211,967095,Zou; Yimin,9998,0,9999,1
1748417787738,BGRD 200,212,967096,Zuniga; Elina I,9999,0,9999,0
1748417787738,BGRD 200,213,967978,Biering; Scott,9999,0,9999,0
1748417788765,BGSE 200,A00,943418,Tour; Ella & Petrie; Katherine Lynn,9999,0,9999,0
1748417789794,BGSE 205,A00,943419,Muroyama; Andrew David,46,0,50,4
1748417789794,BGSE 205,C00,943420,Russell; Alistair B,44,0,50,6
1748417789794,BGSE 205,D00,943421,Villa Rodriguez; Elizabeth,41,0,50,9
1748417789794,BGSE 205,E00,960271,Lim; Byungkook,45,0,50,5
1748417790823,BIBC 100,A01,959758,Flagg; Matthew Paul,0,0,38,38
1748417790823,BIBC 100,A02,959759,Flagg; Matthew Paul,0,0,38,38
1748417790823,BIBC 100,A03,959760,Flagg; Matthew Paul,0,0,38,38
1748417790823,BIBC 100,A04,959761,Flagg; Matthew Paul,0,0,36,36
1748417791861,BIBC 102,A01,959209,Pekkurnaz Banghart; Gulcin,0,0,34,34
1748417791861,BIBC 102,A02,959258,Pekkurnaz Banghart; Gulcin,0,0,34,34
1748417791861,BIBC 102,A03,959300,Pekkurnaz Banghart; Gulcin,0,0,35,35
1748417791861,BIBC 102,A04,959302,Pekkurnaz Banghart; Gulcin,0,0,34,34
1748417791861,BIBC 102,B01,959307,Pekkurnaz Banghart; Gulcin,0,0,34,34
1748417791861,BIBC 102,B02,959309,Pekkurnaz Banghart; Gulcin,0,0,34,34
1748417791861,BIBC 102,B03,959310,Pekkurnaz Banghart; Gulcin,0,0,33,33
1748417791861,BIBC 102,B04,959311,Pekkurnaz Banghart; Gulcin,0,0,34,34
1748417792895,BIBC 103,A01,942080,Grossman; Emily N,0,0,24,24
1748417792895,BIBC 103,A02,942081,Grossman; Emily N,0,0,24,24
1748417792895,BIBC 103,B01,942083,Grossman; Emily N,0,0,24,24
1748417792895,BIBC 103,B02,942129,Grossman; Emily N,0,0,24,24
1748417792895,BIBC 103,C01,942131,Burg; Michael,0,0,24,24
1748417792895,BIBC 103,C02,942152,Burg; Michael,0,0,24,24
1748417792895,BIBC 103,D01,942169,Burg; Michael,0,0,24,24
1748417792895,BIBC 103,D02,942170,Burg; Michael,0,0,24,24
1748417793928,BICD 100,A01,959831,Day; Christopher D,53,0,61,8
1748417793928,BICD 100,A02,959832,Day; Christopher D,49,0,61,12
1748417793928,BICD 100,A03,959833,Day; Christopher D,43,0,61,18
1748417793928,BICD 100,A04,959834,Day; Christopher D,58,0,61,3
1748417793928,BICD 100,B01,959749,McDonnell; Lisa Marie,0,0,61,61
1748417793928,BICD 100,B02,959750,McDonnell; Lisa Marie,0,0,61,61
1748417793928,BICD 100,B03,959751,McDonnell; Lisa Marie,0,0,61,61
1748417793928,BICD 100,B04,959752,McDonnell; Lisa Marie,37,0,61,24
1748417793928,BICD 100,C01,959835,Yelon; Deborah,0,0,61,61
1748417793928,BICD 100,C02,959836,Yelon; Deborah,54,0,61,7
1748417793928,BICD 100,C03,959837,Yelon; Deborah,61,0,61,0
1748417793928,BICD 100,C04,959838,Yelon; Deborah,57,0,61,4
1748417794952,BICD 110,A01,959312,Kiger; Amy,60,0,123,63
1748417794952,BICD 110,A02,959315,Kiger; Amy,94,0,122,28
1748417795982,BICD 130,A01,942207,Perry; Michael William,0,0,48,48
1748417795982,BICD 130,A02,942208,Perry; Michael William,37,0,48,11
1748417795982,BICD 130,A03,942209,Perry; Michael William,29,0,48,19
1748417795982,BICD 130,A04,942236,Perry; Michael William,19,0,48,29
1748417797012,BICD 140,A01,942372,Zuniga; Elina I,42,0,49,7
1748417797012,BICD 140,A02,942492,Zuniga; Elina I,45,0,49,4
1748417797012,BICD 140,A03,942493,Zuniga; Elina I,48,0,49,1
1748417797012,BICD 140,A04,942494,Zuniga; Elina I,46,0,49,3
1748417798038,BIEB 102,A01,942496,Butler; Shannon Rhey,182,0,248,66
1748417799066,BIEB 121,A00,942497,Holway; David A.,0,0,32,32
1748417799066,BIEB 121,B00,942498,Butler; Shannon Rhey,0,0,32,32
1748417800094,BIEB 141,A01,942500,Kryazhimskiy; Sergey A,23,0,40,17
1748417801124,BIEB 146,A01,942502,Petrie; Katherine Lynn,41,0,89,48
1748417801124,BIEB 146,A02,942503,Petrie; Katherine Lynn,0,0,88,88
1748417801124,BIEB 146,A03,942504,Petrie; Katherine Lynn,4,0,88,84
1748417801124,BIEB 146,A04,942505,Petrie; Katherine Lynn,21,0,89,68
1748417802151,BIEB 150,A01,942507,Rennison; Diana,28,0,41,13
1748417802151,BIEB 150,A02,942508,Rennison; Diana,32,0,41,9
1748417802151,BIEB 150,A03,942509,Rennison; Diana,36,0,41,5
1748417802151,BIEB 150,A04,942510,Rennison; Diana,6,0,40,34
1748417803183,BIEB 174,A01,942512,Cleland; Elsa Eleanor & Barton; Andrew David,9,0,41,32
1748417803183,BIEB 174,A02,942513,Cleland; Elsa Eleanor & Barton; Andrew David,37,0,41,4
1748417803183,BIEB 174,A03,942514,Cleland; Elsa Eleanor & Barton; Andrew David,35,0,41,6
1748417803183,BIEB 174,A04,942515,Cleland; Elsa Eleanor & Barton; Andrew David,30,0,40,10
1748417804212,BILD 1,A01,959729,Ochoa Mikrut; Stacy Daniel,50,0,60,10
1748417804212,BILD 1,A02,959730,Ochoa Mikrut; Stacy Daniel,48,0,59,11
1748417804212,BILD 1,A03,959731,Ochoa Mikrut; Stacy Daniel,48,0,59,11
1748417804212,BILD 1,A04,959732,Ochoa Mikrut; Stacy Daniel,50,0,59,9
1748417804212,BILD 1,B01,959733,Cooper; Andrew Michael,46,0,60,14
1748417804212,BILD 1,B02,959734,Cooper; Andrew Michael,58,0,59,1
1748417804212,BILD 1,B03,959735,Cooper; Andrew Michael,54,0,59,5
1748417804212,BILD 1,B04,959736,Cooper; Andrew Michael,50,0,59,9
1748417804212,BILD 1,C01,959737,Rusert; Jessica Marie,58,0,60,2
1748417804212,BILD 1,C02,959738,Rusert; Jessica Marie,59,0,59,0
1748417804212,BILD 1,C03,959739,Rusert; Jessica Marie,49,0,59,10
1748417804212,BILD 1,C04,959740,Rusert; Jessica Marie,55,0,59,4
1748417805239,BILD 2,A01,959013,Reyes Gonzalez; Catalina,28,0,57,29
1748417805239,BILD 2,A02,959016,Reyes Gonzalez; Catalina,52,0,57,5
1748417805239,BILD 2,A03,959017,Reyes Gonzalez; Catalina,46,0,56,10
1748417805239,BILD 2,A04,959018,Reyes Gonzalez; Catalina,51,0,55,4
1748417805239,BILD 2,B01,959078,Reyes Gonzalez; Catalina,42,0,57,15
1748417805239,BILD 2,B02,959095,Reyes Gonzalez; Catalina,50,0,57,7
1748417805239,BILD 2,B03,959165,Reyes Gonzalez; Catalina,55,0,56,1
1748417805239,BILD 2,B04,959169,Reyes Gonzalez; Catalina,54,0,55,1
1748417806268,BILD 3,A01,959741,Stockwell; Sarah R,56,0,60,4
1748417806268,BILD 3,A02,959742,Stockwell; Sarah R,57,0,59,2
1748417806268,BILD 3,A03,959743,Stockwell; Sarah R,59,0,59,0
1748417806268,BILD 3,A04,959744,Stockwell; Sarah R,55,0,59,4
1748417806268,BILD 3,B01,959745,Stockwell; Sarah R,55,0,60,5
1748417806268,BILD 3,B02,959746,Stockwell; Sarah R,59,0,59,0
1748417806268,BILD 3,B03,959747,Stockwell; Sarah R,56,0,59,3
1748417806268,BILD 3,B04,959748,Stockwell; Sarah R,58,0,59,1
1748417806268,BILD 3,C01,959823,Hammond; LaTisha Marie,47,0,60,13
1748417806268,BILD 3,C02,959824,Hammond; LaTisha Marie,48,0,59,11
1748417806268,BILD 3,C03,959825,Hammond; LaTisha Marie,56,0,59,3
1748417806268,BILD 3,C04,959826,Hammond; LaTisha Marie,58,0,59,1
1748417806268,BILD 3,D01,959827,Hammond; LaTisha Marie,43,0,60,17
1748417806268,BILD 3,D02,959828,Hammond; LaTisha Marie,49,0,59,10
1748417806268,BILD 3,D03,959829,Hammond; LaTisha Marie,52,0,59,7
1748417806268,BILD 3,D04,959830,Hammond; LaTisha Marie,56,0,59,3
1748417807302,BILD 4,A01,940749,Gonzalez Gamboa; Ivonne,0,0,0,0
1748417807302,BILD 4,A02,940750,Gonzalez Gamboa; Ivonne,0,0,0,0
1748417807302,BILD 4,A03,940909,Gonzalez Gamboa; Ivonne,0,0,0,0
1748417807302,BILD 4,A04,940922,Gonzalez Gamboa; Ivonne,0,0,0,0
1748417807302,BILD 4,A05,940925,Gonzalez Gamboa; Ivonne,0,0,0,0
1748417807302,BILD 4,A06,941008,Gonzalez Gamboa; Ivonne,0,0,0,0
1748417807302,BILD 4,A07,941009,Gonzalez Gamboa; Ivonne,0,0,0,0
1748417807302,BILD 4,A08,941114,Gonzalez Gamboa; Ivonne,0,0,0,0
1748417807302,BILD 4,B01,941116,Reuther; Keefe,0,0,0,0
1748417807302,BILD 4,B02,941119,Reuther; Keefe,0,0,0,0
1748417807302,BILD 4,B03,941120,Reuther; Keefe,0,0,0,0
1748417807302,BILD 4,B04,941143,Reuther; Keefe,0,0,0,0
1748417807302,BILD 4,B05,941182,Reuther; Keefe,0,0,0,0
1748417807302,BILD 4,B06,941183,Reuther; Keefe,0,0,0,0
1748417807302,BILD 4,B07,941184,Reuther; Keefe,0,0,0,0
1748417807302,BILD 4,B08,941202,Reuther; Keefe,0,0,0,0
1748417807302,BILD 4,C01,941209,Lo; Stanley M.,0,0,0,0
1748417807302,BILD 4,C02,941226,Lo; Stanley M.,0,0,0,0
1748417807302,BILD 4,C03,941228,Lo; Stanley M.,0,0,0,0
1748417807302,BILD 4,C04,941284,Lo; Stanley M.,0,0,0,0
1748417807302,BILD 4,C05,941394,Lo; Stanley M.,0,0,0,0
1748417807302,BILD 4,C06,941473,Lo; Stanley M.,0,0,0,0
1748417807302,BILD 4,C07,941905,Lo; Stanley M.,0,0,0,0
1748417807302,BILD 4,C08,941906,Lo; Stanley M.,0,0,0,0
1748417807302,BILD 4,D01,941908,Lo; Stanley M.,0,0,0,0
1748417807302,BILD 4,D02,941925,Lo; Stanley M.,0,0,0,0
1748417807302,BILD 4,D03,941926,Lo; Stanley M.,0,0,0,0
1748417807302,BILD 4,D04,941927,Lo; Stanley M.,0,0,0,0
1748417807302,BILD 4,D05,941928,Lo; Stanley M.,0,0,0,0
1748417807302,BILD 4,D06,941943,Lo; Stanley M.,0,0,0,0
1748417807302,BILD 4,D07,941944,Lo; Stanley M.,0,0,0,0
1748417807302,BILD 4,D08,941973,Lo; Stanley M.,0,0,0,0
1748417808337,BILD 5,A01,959177,Mueller; Liam O'Connor,0,0,0,0
1748417808337,BILD 5,A02,959178,Mueller; Liam O'Connor,0,0,0,0
1748417808337,BILD 5,A03,959179,Mueller; Liam O'Connor,0,0,0,0
1748417808337,BILD 5,A04,959181,Mueller; Liam O'Connor,0,0,0,0
1748417808337,BILD 5,B01,959183,Mueller; Liam O'Connor,0,0,0,0
1748417808337,BILD 5,B02,959184,Mueller; Liam O'Connor,0,0,0,0
1748417808337,BILD 5,B03,959188,Mueller; Liam O'Connor,0,0,0,0
1748417808337,BILD 5,B04,959189,Mueller; Liam O'Connor,0,0,0,0
1748417808337,BILD 5,C01,959190,Reuther; Keefe,0,0,0,0
1748417808337,BILD 5,C02,959191,Reuther; Keefe,0,0,0,0
1748417808337,BILD 5,C03,959196,Reuther; Keefe,0,0,0,0
1748417808337,BILD 5,C04,959199,Reuther; Keefe,0,0,0,0
1748417809363,BILD 10,A01,942020,Ochoa Mikrut; Stacy Daniel,40,0,40,0
1748417809363,BILD 10,A02,942033,Ochoa Mikrut; Stacy Daniel,35,0,39,4
1748417809363,BILD 10,A03,942045,Ochoa Mikrut; Stacy Daniel,32,0,39,7
1748417809363,BILD 10,A04,942046,Ochoa Mikrut; Stacy Daniel,30,0,39,9
1748417810392,BILD 87,A00,942047,Saier; Milton H.,20,0,20,0
1748417810392,BILD 87,B00,942060,Saier; Milton H.,20,0,20,0
1748417811422,BIMM 100,A01,959797,Lykke-Andersen; Jens,37,0,50,13
1748417811422,BIMM 100,A02,959798,Lykke-Andersen; Jens,5,0,50,45
1748417811422,BIMM 100,A03,959799,Lykke-Andersen; Jens,0,0,50,50
1748417811422,BIMM 100,A04,959800,Lykke-Andersen; Jens,3,0,50,47
1748417811422,BIMM 100,B01,959807,Pruneda-Paz; Jose L.,1,0,50,49
1748417811422,BIMM 100,B02,959808,Pruneda-Paz; Jose L.,0,0,50,50
1748417811422,BIMM 100,B03,959809,Pruneda-Paz; Jose L.,8,0,50,42
1748417811422,BIMM 100,B04,959810,Pruneda-Paz; Jose L.,37,0,50,13
1748417811422,BIMM 100,C01,959762,Pasquinelli; Amy,0,0,54,54
1748417811422,BIMM 100,C02,959763,Pasquinelli; Amy,20,0,54,34
1748417811422,BIMM 100,C03,959764,Pasquinelli; Amy,31,0,54,23
1748417811422,BIMM 100,C04,959765,Pasquinelli; Amy,47,0,54,7
1748417812459,BIMM 101,A01,942520,Meaders; Clara Leigh,0,0,24,24
1748417812459,BIMM 101,A02,942521,Meaders; Clara Leigh,0,0,24,24
1748417812459,BIMM 101,B01,942523,Meaders; Clara Leigh,0,0,24,24
1748417812459,BIMM 101,B02,942524,Meaders; Clara Leigh,0,0,24,24
1748417812459,BIMM 101,C01,942690,McDonnell; Lisa Marie,0,0,24,24
1748417812459,BIMM 101,C02,942755,McDonnell; Lisa Marie,0,0,24,24
1748417812459,BIMM 101,D01,942757,Day; Christopher D,0,0,24,24
1748417812459,BIMM 101,D02,942758,Day; Christopher D,12,0,24,12
1748417812459,BIMM 101,E01,942760,Cooper; Andrew Michael,0,0,24,24
1748417812459,BIMM 101,E02,942761,Cooper; Andrew Michael,0,0,24,24
1748417812459,BIMM 101,F01,942763,Rusert; Jessica Marie,14,0,24,10
1748417812459,BIMM 101,F02,942764,Rusert; Jessica Marie,19,0,24,5
1748417813485,BIMM 120,A01,942766,Saier; Milton H.,40,0,48,8
1748417813485,BIMM 120,A02,942767,Saier; Milton H.,40,0,48,8
1748417813485,BIMM 120,A03,942768,Saier; Milton H.,15,0,48,33
1748417813485,BIMM 120,A04,942769,Saier; Milton H.,0,0,48,48
1748417814524,BIMM 121,A01,942771,Gustafson-Brown; Cindy,0,0,24,24
1748417814524,BIMM 121,A02,942772,Gustafson-Brown; Cindy,0,0,24,24
1748417814524,BIMM 121,B01,942774,Gustafson-Brown; Cindy,1,0,24,23
1748417814524,BIMM 121,B02,942775,Gustafson-Brown; Cindy,5,0,24,19
1748417814524,BIMM 121,C01,942777,Pirino; Giorgia,0,0,24,24
1748417814524,BIMM 121,C02,942778,Pirino; Giorgia,0,0,24,24
1748417814524,BIMM 121,D01,942780,Pirino; Giorgia,0,0,24,24
1748417814524,BIMM 121,D02,942781,Pirino; Giorgia,0,0,24,24
1748417815552,BIMM 122,A01,942783,Russell; Alistair B,19,0,44,25
1748417815552,BIMM 122,A02,942784,Russell; Alistair B,29,0,44,15
1748417815552,BIMM 122,A03,942785,Russell; Alistair B,35,0,44,9
1748417815552,BIMM 122,A04,942786,Russell; Alistair B,30,0,44,14
1748417816579,BIMM 128,A01,942788,Hao; Nan,0,0,30,30
1748417816579,BIMM 128,A02,942789,Hao; Nan,0,0,31,31
1748417816579,BIMM 128,A03,942790,Hao; Nan,0,0,31,31
1748417816579,BIMM 128,A04,942791,Hao; Nan,0,0,31,31
1748417817605,BIMM 143,A01,942793,Grant; Barry J,13,0,40,27
1748417817605,BIMM 143,B01,942795,Bozinovic; Goran,21,0,40,19
1748417818633,BIMM 143R,A01,942797,Bozinovic; Goran,0,0,40,40
1748417819670,BIMM 194,A00,942798,Golden; Susan S.,5,0,32,27
1748417819670,BIMM 194,B00,942799,Golden; James W,21,0,32,11
1748417819670,BIMM 194,C00,942800,Karlseder; Jan & Saghatelian; Alan,0,0,32,32
1748417820699,BIOM 200A,A00,911746,Gordts; Philip,30,0,30,0
1748417821725,BIOM 200B,A00,911747,Gordts; Philip,35,0,35,0
1748417822752,BIOM 201,A00,911749,Daneman; Richard,35,0,35,0
1748417823785,BIOM 202,A01,911753,Corbett; Kevin Daniel,35,0,35,0
1748417824810,BIOM 203A,A00,911755,Corbett; Kevin Daniel,35,0,35,0
1748417825836,BIOM 218,A00,911756,Gagneux; Pascal,11,0,12,1
1748417826862,BIOM 219,A00,911757,Ross; Camille,20,0,20,0
1748417827889,BIOM 242,A00,911758,Hamilton; Bruce Alan,19,0,20,1
1748417828919,BIOM 293,A00,911759,Gustafsson; Asa Birgitta,35,0,35,0
1748417829945,BIOM 295,A00,911760,Joiner; William J.,0,0,0,0
1748417830974,BIOM 296,A00,911761,Yaksh; Tony L.,35,0,35,0
1748417832003,BIPN 100,A01,959801,Leutgeb; Stefan,0,0,36,36
1748417832003,BIPN 100,A02,959802,Leutgeb; Stefan,0,0,36,36
1748417832003,BIPN 100,A03,959803,Leutgeb; Stefan,3,0,36,33
1748417832003,BIPN 100,A04,959804,Leutgeb; Stefan,0,0,36,36
1748417832003,BIPN 100,B01,959766,Cooke; James Edward,33,0,41,8
1748417832003,BIPN 100,B02,959767,Cooke; James Edward,39,0,41,2
1748417832003,BIPN 100,B03,959768,Cooke; James Edward,37,0,40,3
1748417832003,BIPN 100,B04,959769,Cooke; James Edward,37,0,40,3
1748417832003,BIPN 100,C01,959770,Cooke; James Edward,35,0,41,6
1748417832003,BIPN 100,C02,959771,Cooke; James Edward,40,0,41,1
1748417832003,BIPN 100,C03,959772,Cooke; James Edward,37,0,40,3
1748417832003,BIPN 100,C04,959773,Cooke; James Edward,38,0,40,2
1748417832003,BIPN 100,D01,959811,Yang; Mingyu,0,0,41,41
1748417832003,BIPN 100,D02,959812,Yang; Mingyu,0,0,41,41
1748417832003,BIPN 100,D03,959813,Yang; Mingyu,0,0,40,40
1748417832003,BIPN 100,D04,959814,Yang; Mingyu,0,0,40,40
1748417833029,BIPN 103,A01,942981,Yang; Mingyu,0,0,48,48
1748417834062,BIPN 105,A01,942983,Armour; Jon Christopher,0,0,21,21
1748417834062,BIPN 105,A02,942984,Armour; Jon Christopher,0,0,21,21
1748417834062,BIPN 105,B01,942989,Armour; Jon Christopher,0,0,21,21
1748417834062,BIPN 105,B02,942990,Armour; Jon Christopher,0,0,21,21
1748417835088,BIPN 118,A01,960886,Banghart; Matthew Ryan,23,0,30,7
1748417835088,BIPN 118,A02,960889,Banghart; Matthew Ryan,24,0,30,6
1748417835088,BIPN 118,A03,960891,Banghart; Matthew Ryan,23,0,30,7
1748417835088,BIPN 118,A04,960892,Banghart; Matthew Ryan,27,0,30,3
1748417836120,BIPN 140,A01,942992,Owens; Melinda Tsao-Ying,9,0,32,23
1748417836120,BIPN 140,A02,942994,Owens; Melinda Tsao-Ying,0,0,32,32
1748417836120,BIPN 140,A03,942995,Owens; Melinda Tsao-Ying,0,0,32,32
1748417836120,BIPN 140,A04,942996,Owens; Melinda Tsao-Ying,9,0,30,21
1748417836120,BIPN 140,B01,942998,Owens; Melinda Tsao-Ying,4,0,32,28
1748417836120,BIPN 140,B02,942999,Owens; Melinda Tsao-Ying,3,0,32,29
1748417836120,BIPN 140,B03,943000,Owens; Melinda Tsao-Ying,18,0,32,14
1748417836120,BIPN 140,B04,943001,Owens; Melinda Tsao-Ying,23,0,30,7
1748417837149,BIPN 145,A01,943083,Maita; Isabella Vincenza,0,0,42,42
1748417837149,BIPN 145,B01,943085,Marino; Marc J,13,0,42,29
1748417837149,BIPN 145,C01,943108,Marino; Marc J,0,0,42,42
1748417838175,BIPN 148,A01,943119,Leutgeb; Jill K.,15,0,39,24
1748417838175,BIPN 148,A02,943120,Leutgeb; Jill K.,16,0,39,23
1748417838175,BIPN 148,A03,943121,Leutgeb; Jill K.,33,0,39,6
1748417838175,BIPN 148,A04,943201,Leutgeb; Jill K.,27,0,39,12
1748417839201,BIPN 189,A00,943247,Gentner; Tim,0,0,25,25
1748417840228,BISP 182,A00,943255,Pogliano; Joseph,9999,0,9999,0
1748417841259,BISP 194,A00,943261,Wertheim; Joel Okrent,0,0,32,32
1748417842286,BNFO 281,A00,961454,Gaasterland; Theresa,13,0,40,27
1748417843312,BNFO 283,A00,961457,Benner; Christopher William,69,0,100,31
1748417844341,BNFO 294,A01,961499,Ross; Camille,39,0,50,11
1748417845376,CAT 1,A01,915666,Bronstein; Phoebe Malan,13,0,16,3
1748417845376,CAT 1,A02,915673,Bronstein; Phoebe Malan,15,0,16,1
1748417845376,CAT 1,A03,915727,Bronstein; Phoebe Malan,16,0,16,0
1748417845376,CAT 1,A04,915728,Bronstein; Phoebe Malan,16,0,16,0
1748417845376,CAT 1,A05,915729,Bronstein; Phoebe Malan,16,0,16,0
1748417845376,CAT 1,A06,915730,Bronstein; Phoebe Malan,13,0,16,3
1748417845376,CAT 1,A07,915731,Bronstein; Phoebe Malan,16,0,16,0
1748417845376,CAT 1,A08,915732,Bronstein; Phoebe Malan,16,0,16,0
1748417845376,CAT 1,A09,915733,Bronstein; Phoebe Malan,14,0,16,2
1748417845376,CAT 1,A10,915734,Bronstein; Phoebe Malan,16,0,16,0
1748417845376,CAT 1,A11,915751,Bronstein; Phoebe Malan,16,0,16,0
1748417845376,CAT 1,A12,915752,Bronstein; Phoebe Malan,15,0,16,1
1748417845376,CAT 1,A13,915753,Bronstein; Phoebe Malan,15,0,16,1
1748417845376,CAT 1,A14,915754,Bronstein; Phoebe Malan,16,0,16,0
1748417845376,CAT 1,A15,915755,Bronstein; Phoebe Malan,16,0,16,0
1748417845376,CAT 1,A16,915756,Bronstein; Phoebe Malan,16,0,16,0
1748417845376,CAT 1,B01,915763,Bronstein; Phoebe Malan,15,0,16,1
1748417845376,CAT 1,B02,915764,Bronstein; Phoebe Malan,15,0,16,1
1748417845376,CAT 1,B03,915765,Bronstein; Phoebe Malan,14,0,16,2
1748417845376,CAT 1,B04,915766,Bronstein; Phoebe Malan,16,0,16,0
1748417845376,CAT 1,B05,915767,Bronstein; Phoebe Malan,12,0,16,4
1748417845376,CAT 1,B06,915768,Bronstein; Phoebe Malan,16,0,16,0
1748417845376,CAT 1,B07,915769,Bronstein; Phoebe Malan,16,0,16,0
1748417845376,CAT 1,B08,915770,Bronstein; Phoebe Malan,16,0,16,0
1748417845376,CAT 1,B09,915771,Bronstein; Phoebe Malan,16,0,16,0
1748417845376,CAT 1,B10,915772,Bronstein; Phoebe Malan,16,0,16,0
1748417845376,CAT 1,B11,915773,Bronstein; Phoebe Malan,16,0,16,0
1748417845376,CAT 1,B12,915774,Bronstein; Phoebe Malan,15,0,16,1
1748417845376,CAT 1,B13,915775,Bronstein; Phoebe Malan,16,0,16,0
1748417845376,CAT 1,B14,915776,Bronstein; Phoebe Malan,15,0,16,1
1748417845376,CAT 1,B15,915777,Bronstein; Phoebe Malan,14,0,16,2
1748417845376,CAT 1,B16,915778,Bronstein; Phoebe Malan,16,0,16,0
1748417845376,CAT 1,C01,915780,Algaze; Guillermo,11,0,16,5
1748417845376,CAT 1,C02,915781,Algaze; Guillermo,16,0,16,0
1748417845376,CAT 1,C03,915782,Algaze; Guillermo,15,0,16,1
1748417845376,CAT 1,C04,915783,Algaze; Guillermo,16,0,16,0
1748417845376,CAT 1,C05,915784,Algaze; Guillermo,16,0,16,0
1748417845376,CAT 1,C06,915785,Algaze; Guillermo,16,0,16,0
1748417845376,CAT 1,C07,915786,Algaze; Guillermo,16,0,16,0
1748417845376,CAT 1,C08,915787,Algaze; Guillermo,15,0,16,1
1748417845376,CAT 1,C09,915788,Algaze; Guillermo,16,0,16,0
1748417845376,CAT 1,C10,915790,Algaze; Guillermo,16,0,16,0
1748417845376,CAT 1,C11,915791,Algaze; Guillermo,16,0,16,0
1748417845376,CAT 1,C12,915792,Algaze; Guillermo,16,0,16,0
1748417845376,CAT 1,C13,915793,Algaze; Guillermo,16,0,16,0
1748417845376,CAT 1,C14,915794,Algaze; Guillermo,16,0,16,0
1748417845376,CAT 1,D01,915796,Marchisotto; Jennifer Anne,16,0,16,0
1748417845376,CAT 1,D02,915797,Marchisotto; Jennifer Anne,15,0,16,1
1748417845376,CAT 1,D03,915798,Marchisotto; Jennifer Anne,16,0,16,0
1748417845376,CAT 1,D04,915799,Marchisotto; Jennifer Anne,12,0,16,4
1748417845376,CAT 1,D05,915800,Marchisotto; Jennifer Anne,16,0,16,0
1748417845376,CAT 1,D06,915801,Marchisotto; Jennifer Anne,16,0,16,0
1748417845376,CAT 1,D07,915802,Marchisotto; Jennifer Anne,15,0,16,1
1748417845376,CAT 1,D08,915803,Marchisotto; Jennifer Anne,16,0,16,0
1748417845376,CAT 1,D09,915804,Marchisotto; Jennifer Anne,16,0,16,0
1748417845376,CAT 1,D10,915805,Marchisotto; Jennifer Anne,16,0,16,0
1748417845376,CAT 1,D11,915806,Marchisotto; Jennifer Anne,15,0,16,1
1748417845376,CAT 1,D12,915807,Marchisotto; Jennifer Anne,16,0,16,0
1748417845376,CAT 1,D13,915808,Marchisotto; Jennifer Anne,15,0,16,1
1748417845376,CAT 1,D14,915809,Marchisotto; Jennifer Anne,15,0,16,1
1748417846401,CAT 88,A00,969796,Popko; Elizabeth Ashley,0,0,0,0
1748417847432,CAT 90,A00,915812,Geibel; William,7,0,15,8
1748417848461,CAT 124,A01,915814,Rose; Becca Rae,0,0,20,20
1748417848461,CAT 124,B01,961453,Geibel; William,14,0,20,6
1748417849492,CAT 125,001,915815,Delaville; Romain,18,0,20,2
1748417849492,CAT 125,003,915817,Bigham; David Joseph,12,0,20,8
1748417849492,CAT 125,004,915818,Bigham; David Joseph,3,0,20,17
1748417849492,CAT 125,005,915819,Marchisotto; Jennifer Anne,11,0,20,9
1748417849492,CAT 125,006,915820,Marchisotto; Jennifer Anne,0,0,20,20
1748417849492,CAT 125,007,915821,Morales; Celeste Georgianna,12,0,20,8
1748417849492,CAT 125,008,915822,Morales; Celeste Georgianna,15,0,20,5
1748417849492,CAT 125,009,915823,Morales; Celeste Georgianna,18,0,20,2
1748417849492,CAT 125,010,915824,Irwin; Matthew Joseph,18,0,20,2
1748417849492,CAT 125,011,915825,Irwin; Matthew Joseph,15,0,20,5
1748417849492,CAT 125,012,915826,Irwin; Matthew Joseph,15,0,20,5
1748417849492,CAT 125,013,915827,Vanderschuit; Maya Alysia,16,0,20,4
1748417849492,CAT 125,014,915828,Vanderschuit; Maya Alysia,18,0,20,2
1748417849492,CAT 125,015,915829,Vanderschuit; Maya Alysia,15,0,20,5
1748417849492,CAT 125,016,915830,Rose; Becca Rae,5,0,20,15
1748417849492,CAT 125,017,915831,Rose; Becca Rae,4,0,20,16
1748417849492,CAT 125,018,915832,Hyland; Tina Mae,13,0,20,7
1748417849492,CAT 125,019,915833,Hyland; Tina Mae,17,0,20,3
1748417850522,CAT 125R,A00,915834,Hyland; Tina Mae,0,0,20,20
1748417850522,CAT 125R,B00,915835,Hyland; Tina Mae,0,0,20,20
1748417850522,CAT 125R,C00,915836,Hyland; Tina Mae,0,0,20,20
1748417850522,CAT 125R,D00,915837,Tosun; Adriana,0,0,20,20
1748417850522,CAT 125R,E00,915838,Smith; Lauryn Alissa,0,0,20,20
1748417850522,CAT 125R,F00,915839,Smith; Lauryn Alissa,0,0,20,20
1748417850522,CAT 125R,G00,915840,Smith; Lauryn Alissa,0,0,20,20
1748417851590,CAT 200,A00,915841,Popko; Elizabeth Ashley,17,0,20,3
1748417852620,CCE 1,A00,915063,Bigley; Michele Heather,30,0,40,10
1748417852620,CCE 1,B00,915064,Bigley; Michele Heather,36,0,40,4
1748417853651,CCE 2,001,915067,Santos; Vabianna Daria,0,0,20,20
1748417853651,CCE 2,002,915068,Santos; Vabianna Daria,0,0,20,20
1748417853651,CCE 2,003,915069,Santos; Vabianna Daria,18,0,20,2
1748417853651,CCE 2,004,915070,Staff,17,0,20,3
1748417853651,CCE 2,005,915071,Staff,15,0,20,5
1748417853651,CCE 2,006,915072,Staff,8,0,20,12
1748417853651,CCE 2,007,915073,Staff,11,0,20,9
1748417853651,CCE 2,008,915074,Staff,0,0,20,20
1748417853651,CCE 2,009,915090,Staff,5,0,20,15
1748417853651,CCE 2,010,915104,Merryman; Ashley,0,0,20,20
1748417853651,CCE 2,011,915114,Merryman; Ashley,0,0,20,20
1748417853651,CCE 2,012,915136,Merryman; Ashley,0,0,20,20
1748417853651,CCE 2,013,915176,Staff,13,0,20,7
1748417853651,CCE 2,014,915177,Staff,20,0,20,0
1748417853651,CCE 2,015,915178,Staff,17,0,20,3
1748417853651,CCE 2,016,915179,Staff,16,0,20,4
1748417854688,CCE 3,001,915194,Labat Ii; Michael Luis,13,0,20,7
1748417854688,CCE 3,002,915195,Labat Ii; Michael Luis,17,0,20,3
1748417854688,CCE 3,003,915196,Labat Ii; Michael Luis,17,0,20,3
1748417854688,CCE 3,004,915197,Lee; Kassandra,16,0,20,4
1748417854688,CCE 3,005,915198,Lee; Kassandra,6,0,20,14
1748417854688,CCE 3,006,915199,Lee; Kassandra,10,0,20,10
1748417854688,CCE 3,007,915200,Garcia; Kathryn Mary,0,0,20,20
1748417854688,CCE 3,008,915201,Garcia; Kathryn Mary,2,0,20,18
1748417855728,CCE 120,A01,915203,Quijada; David,26,0,30,4
1748417855728,CCE 120,B01,915205,Quijada; David,17,0,30,13
1748417855728,CCE 120,C01,915207,Williams; Danielle,21,0,30,9
1748417855728,CCE 120,D01,915275,Crawford; James,26,0,30,4
1748417855728,CCE 120,E01,915323,Kenley; Nicole,0,0,30,30
1748417855728,CCE 120,F01,915325,Kenley; Nicole,5,0,30,25
1748417856758,CENG 4,A01,913054,Li; Yanran,35,0,36,1
1748417856758,CENG 4,A02,913055,Li; Yanran,36,0,36,0
1748417856758,CENG 4,A03,913058,Li; Yanran,36,0,36,0
1748417856758,CENG 4,A04,913060,Li; Yanran,36,0,36,0
1748417857789,CENG 15,A01,913087,Lubarda; Vlado,69,0,70,1
1748417858816,CENG 100,A00,913088,Powell; Alyssa,108,0,120,12
1748417859849,CENG 101A,A00,913089,Opatkiewicz; Justin Paul,107,0,146,39
1748417860875,CENG 110,A01,913091,Powell; Alyssa,15,0,24,9
1748417861905,CENG 120,A00,913092,Opatkiewicz; Justin Paul,96,0,146,50
1748417862932,CENG 122,A00,913093,Li; Wan-Lu,120,0,140,20
1748417863961,CENG 170,A01,913196,Drews; Aaron,7,0,25,18
1748417863961,CENG 170,A02,913202,Drews; Aaron,4,0,25,21
1748417863961,CENG 170,A03,913204,Drews; Aaron,5,0,30,25
1748417864988,CENG 175,A00,913205,Steinmetz; Nicole F,14,0,35,21
1748417866021,CENG 205,A00,913207,Jahed Motlagh; Zeinab,54,0,70,16
1748417867068,CENG 210A,A00,913209,Shah; Nisarg,50,0,50,0
1748417868093,CENG 211,A00,913211,Sirbuly; Donald,23,0,25,2
1748417869120,CENG 213,A00,913213,Fenning; David,25,0,25,0
1748417870147,CENG 221A,A00,913214,Liu; Ping,38,0,50,12
1748417871247,CENG 252,A00,913215,Chen; Zheng,42,0,50,8
1748417872278,CGS 2A,A01,915347,Martin Sandino; Amanda Maria Yoland,11,0,15,4
1748417872278,CGS 2A,A02,915348,Martin Sandino; Amanda Maria Yoland,12,0,15,3
1748417872278,CGS 2A,A03,915375,Martin Sandino; Amanda Maria Yoland,11,0,15,4
1748417872278,CGS 2A,A04,915376,Martin Sandino; Amanda Maria Yoland,15,0,15,0
1748417873307,CGS 100A,A00,915379,Perez; Roy,16,0,31,15
1748417874334,CGS 109,A00,915458,Cuong; Marisol,36,0,40,4
1748417875364,CGS 110,A00,915463,Cuong; Marisol,27,0,30,3
1748417876389,CGS 113,A00,915465,Martin Sandino; Amanda Maria Yoland,8,0,16,8
1748417877415,CGS 134,A00,915498,Chatti; Deepti,17,0,32,15
1748417878443,CGS 150,A00,915508,Taylor-Garcia; Daphne,13,0,16,3
1748417879471,CGS 187,A00,915515,Martin Sandino; Amanda Maria Yoland,13,0,16,3
1748417880500,CGS 190,A00,915516,Taylor-Garcia; Daphne,7,0,7,0
1748417881529,CGS 208,A00,915517,Kang; Byung Chu,1,0,1,0
1748417882560,CHEM 4,A01,958051,Brydges; Stacey,39,0,40,1
1748417882560,CHEM 4,A02,958052,Brydges; Stacey,38,0,40,2
1748417882560,CHEM 4,A03,958053,Brydges; Stacey,37,0,40,3
1748417882560,CHEM 4,A04,958054,Brydges; Stacey,39,0,40,1
1748417882560,CHEM 4,A05,958055,Brydges; Stacey,40,0,40,0
1748417882560,CHEM 4,A06,958056,Brydges; Stacey,38,0,40,2
1748417882560,CHEM 4,A07,958057,Brydges; Stacey,40,0,40,0
1748417882560,CHEM 4,A08,958058,Brydges; Stacey,40,0,40,0
1748417882560,CHEM 4,B01,958059,Brydges; Stacey,40,0,40,0
1748417882560,CHEM 4,B02,958060,Brydges; Stacey,40,0,40,0
1748417882560,CHEM 4,B03,958061,Brydges; Stacey,40,0,40,0
1748417882560,CHEM 4,B04,958062,Brydges; Stacey,36,0,40,4
1748417882560,CHEM 4,B05,958063,Brydges; Stacey,38,0,40,2
1748417882560,CHEM 4,B06,958064,Brydges; Stacey,39,0,40,1
1748417882560,CHEM 4,B07,958065,Brydges; Stacey,40,0,40,0
1748417882560,CHEM 4,B08,958066,Brydges; Stacey,40,0,40,0
1748417883605,CHEM 6A,A01,958094,Stallings; Dontarie M,5,0,8,3
1748417883605,CHEM 6A,A02,958095,Stallings; Dontarie M,4,0,8,4
1748417883605,CHEM 6A,A03,958096,Stallings; Dontarie M,7,0,8,1
1748417883605,CHEM 6A,A04,958097,Stallings; Dontarie M,8,0,8,0
1748417883605,CHEM 6A,A05,958098,Stallings; Dontarie M,8,0,8,0
1748417883605,CHEM 6A,A06,958099,Stallings; Dontarie M,8,0,8,0
1748417883605,CHEM 6A,A07,958100,Stallings; Dontarie M,8,0,8,0
1748417883605,CHEM 6A,A08,958101,Stallings; Dontarie M,8,0,8,0
1748417883605,CHEM 6A,A09,958102,Stallings; Dontarie M,0,0,0,0
1748417883605,CHEM 6A,B01,958136,Stallings; Dontarie M,0,0,8,8
1748417883605,CHEM 6A,B02,958137,Stallings; Dontarie M,5,0,8,3
1748417883605,CHEM 6A,B03,958138,Stallings; Dontarie M,8,0,8,0
1748417883605,CHEM 6A,B04,958139,Stallings; Dontarie M,7,0,8,1
1748417883605,CHEM 6A,B05,958140,Stallings; Dontarie M,0,0,8,8
1748417883605,CHEM 6A,B06,958141,Stallings; Dontarie M,3,0,8,5
1748417883605,CHEM 6A,B07,958143,Stallings; Dontarie M,2,0,8,6
1748417883605,CHEM 6A,B08,958144,Stallings; Dontarie M,8,0,8,0
1748417883605,CHEM 6A,B09,958145,Stallings; Dontarie M,0,0,0,0
1748417883605,CHEM 6A,C01,958146,Schurmeier; Kimberly,6,0,8,2
1748417883605,CHEM 6A,C02,958147,Schurmeier; Kimberly,7,0,8,1
1748417883605,CHEM 6A,C03,958148,Schurmeier; Kimberly,8,0,8,0
1748417883605,CHEM 6A,C04,958149,Schurmeier; Kimberly,8,0,8,0
1748417883605,CHEM 6A,C05,958150,Schurmeier; Kimberly,8,0,8,0
1748417883605,CHEM 6A,C06,958151,Schurmeier; Kimberly,6,0,8,2
1748417883605,CHEM 6A,C07,958152,Schurmeier; Kimberly,8,0,8,0
1748417883605,CHEM 6A,C08,958153,Schurmeier; Kimberly,7,0,8,1
1748417883605,CHEM 6A,C09,958154,Schurmeier; Kimberly,0,0,0,0
1748417883605,CHEM 6A,D01,958155,Schurmeier; Kimberly,3,0,8,5
1748417883605,CHEM 6A,D02,958156,Schurmeier; Kimberly,3,0,8,5
1748417883605,CHEM 6A,D03,958157,Schurmeier; Kimberly,4,0,8,4
1748417883605,CHEM 6A,D04,958158,Schurmeier; Kimberly,6,0,8,2
1748417883605,CHEM 6A,D05,958159,Schurmeier; Kimberly,7,0,8,1
1748417883605,CHEM 6A,D06,958160,Schurmeier; Kimberly,7,0,8,1
1748417883605,CHEM 6A,D07,958161,Schurmeier; Kimberly,8,0,8,0
1748417883605,CHEM 6A,D08,958162,Schurmeier; Kimberly,8,0,8,0
1748417883605,CHEM 6A,D09,958195,Schurmeier; Kimberly,0,0,0,0
1748417883605,CHEM 6A,E01,958203,Zid; Brian M,0,0,8,8
1748417883605,CHEM 6A,E02,958206,Zid; Brian M,6,0,8,2
1748417883605,CHEM 6A,E03,958207,Zid; Brian M,7,0,8,1
1748417883605,CHEM 6A,E04,958350,Zid; Brian M,8,0,8,0
1748417883605,CHEM 6A,E05,958361,Zid; Brian M,7,0,8,1
1748417883605,CHEM 6A,E06,958373,Zid; Brian M,2,0,8,6
1748417883605,CHEM 6A,E07,958394,Zid; Brian M,7,0,8,1
1748417883605,CHEM 6A,E08,958395,Zid; Brian M,1,0,8,7
1748417883605,CHEM 6A,E09,958396,Zid; Brian M,0,0,0,0
1748417883605,CHEM 6A,F01,958397,Ortony; Julia Helen,8,0,8,0
1748417883605,CHEM 6A,F02,958407,Ortony; Julia Helen,0,0,8,8
1748417883605,CHEM 6A,F03,958409,Ortony; Julia Helen,2,0,8,6
1748417883605,CHEM 6A,F04,958417,Ortony; Julia Helen,6,0,8,2
1748417883605,CHEM 6A,F05,958422,Ortony; Julia Helen,8,0,8,0
1748417883605,CHEM 6A,F06,958425,Ortony; Julia Helen,8,0,8,0
1748417883605,CHEM 6A,F07,958428,Ortony; Julia Helen,7,0,8,1
1748417883605,CHEM 6A,F08,958442,Ortony; Julia Helen,8,0,8,0
1748417883605,CHEM 6A,F09,958488,Ortony; Julia Helen,0,0,0,0
1748417883605,CHEM 6A,G01,958489,Ortony; Julia Helen,7,0,8,1
1748417883605,CHEM 6A,G02,958490,Ortony; Julia Helen,8,0,8,0
1748417883605,CHEM 6A,G03,958491,Ortony; Julia Helen,3,0,8,5
1748417883605,CHEM 6A,G04,958499,Ortony; Julia Helen,2,0,8,6
1748417883605,CHEM 6A,G05,958500,Ortony; Julia Helen,4,0,8,4
1748417883605,CHEM 6A,G06,958501,Ortony; Julia Helen,8,0,8,0
1748417883605,CHEM 6A,G07,958502,Ortony; Julia Helen,8,0,8,0
1748417883605,CHEM 6A,G08,958636,Ortony; Julia Helen,8,0,8,0
1748417883605,CHEM 6A,G09,958637,Ortony; Julia Helen,0,0,0,0
1748417884637,CHEM 6B,A01,958638,Bussey; Thomas J,15,0,22,7
1748417884637,CHEM 6B,A02,958641,Bussey; Thomas J,0,0,22,22
1748417884637,CHEM 6B,A03,958646,Bussey; Thomas J,0,0,22,22
1748417884637,CHEM 6B,A04,958648,Bussey; Thomas J,10,0,22,12
1748417884637,CHEM 6B,A05,958650,Bussey; Thomas J,8,0,22,14
1748417884637,CHEM 6B,A06,958652,Bussey; Thomas J,18,0,22,4
1748417884637,CHEM 6B,A07,958653,Bussey; Thomas J,20,0,22,2
1748417884637,CHEM 6B,A08,958654,Bussey; Thomas J,19,0,22,3
1748417884637,CHEM 6B,A09,958710,Bussey; Thomas J,21,0,22,1
1748417884637,CHEM 6B,A10,958713,Bussey; Thomas J,21,0,22,1
1748417885664,CHEM 6C,A01,958743,Yuen Zhou; Joel,24,0,38,14
1748417885664,CHEM 6C,A02,958744,Yuen Zhou; Joel,20,0,38,18
1748417885664,CHEM 6C,A03,958745,Yuen Zhou; Joel,28,0,38,10
1748417885664,CHEM 6C,A04,958746,Yuen Zhou; Joel,30,0,38,8
1748417885664,CHEM 6C,A05,958747,Yuen Zhou; Joel,36,0,38,2
1748417885664,CHEM 6C,A06,958748,Yuen Zhou; Joel,23,0,38,15
1748417885664,CHEM 6C,A07,958749,Yuen Zhou; Joel,22,0,38,16
1748417885664,CHEM 6C,A08,958750,Yuen Zhou; Joel,12,0,38,26
1748417885664,CHEM 6C,A09,958751,Yuen Zhou; Joel,28,0,38,10
1748417886694,CHEM 7L,A01,912668,Leigh; Brian,0,0,24,24
1748417886694,CHEM 7L,A02,912669,Leigh; Brian,0,0,24,24
1748417886694,CHEM 7L,A03,912670,Leigh; Brian,0,0,24,24
1748417886694,CHEM 7L,A04,912671,Leigh; Brian,0,0,24,24
1748417886694,CHEM 7L,A05,912672,Leigh; Brian,0,0,24,24
1748417886694,CHEM 7L,A06,912673,Leigh; Brian,0,0,20,20
1748417886694,CHEM 7L,A07,912674,Leigh; Brian,0,0,24,24
1748417886694,CHEM 7L,A08,912675,Leigh; Brian,0,0,24,24
1748417886694,CHEM 7L,A09,912676,Leigh; Brian,0,0,24,24
1748417886694,CHEM 7L,A10,912677,Leigh; Brian,0,0,24,24
1748417886694,CHEM 7L,B01,912680,Leigh; Brian,0,0,24,24
1748417886694,CHEM 7L,B02,912681,Leigh; Brian,0,0,24,24
1748417886694,CHEM 7L,B03,912682,Leigh; Brian,0,0,24,24
1748417886694,CHEM 7L,B04,912683,Leigh; Brian,0,0,24,24
1748417886694,CHEM 7L,B05,912684,Leigh; Brian,0,0,24,24
1748417886694,CHEM 7L,B06,912685,Leigh; Brian,0,0,24,24
1748417886694,CHEM 7L,B07,912686,Leigh; Brian,0,0,24,24
1748417886694,CHEM 7L,B08,912687,Leigh; Brian,0,0,24,24
1748417886694,CHEM 7L,B09,912688,Leigh; Brian,0,0,24,24
1748417886694,CHEM 7L,B10,912689,Leigh; Brian,0,0,24,24
1748417887729,CHEM 40A,A01,958809,Bertrand; Guy,0,0,34,34
1748417887729,CHEM 40A,A02,958811,Bertrand; Guy,0,0,29,29
1748417887729,CHEM 40A,A03,958812,Bertrand; Guy,0,0,34,34
1748417887729,CHEM 40A,A04,958813,Bertrand; Guy,0,0,34,34
1748417887729,CHEM 40A,A05,958814,Bertrand; Guy,0,0,34,34
1748417887729,CHEM 40A,A06,958816,Bertrand; Guy,0,0,34,34
1748417887729,CHEM 40A,A07,958822,Bertrand; Guy,0,0,34,34
1748417887729,CHEM 40A,A08,958824,Bertrand; Guy,0,0,34,34
1748417887729,CHEM 40A,B01,958825,Bertrand; Guy,0,0,34,34
1748417887729,CHEM 40A,B02,958826,Bertrand; Guy,0,0,34,34
1748417887729,CHEM 40A,B03,958828,Bertrand; Guy,0,0,34,34
1748417887729,CHEM 40A,B04,958829,Bertrand; Guy,0,0,34,34
1748417887729,CHEM 40A,B05,958898,Bertrand; Guy,0,0,34,34
1748417887729,CHEM 40A,B06,958899,Bertrand; Guy,0,0,34,34
1748417887729,CHEM 40A,B07,958900,Bertrand; Guy,0,0,34,34
1748417887729,CHEM 40A,B08,958901,Bertrand; Guy,0,0,34,34
1748417887729,CHEM 40A,C01,958086,Yang; Jerry,30,0,34,4
1748417887729,CHEM 40A,C02,958087,Yang; Jerry,32,0,34,2
1748417887729,CHEM 40A,C03,958088,Yang; Jerry,31,0,34,3
1748417887729,CHEM 40A,C04,958089,Yang; Jerry,34,0,34,0
1748417887729,CHEM 40A,C05,958090,Yang; Jerry,34,0,34,0
1748417887729,CHEM 40A,C06,958091,Yang; Jerry,27,0,34,7
1748417887729,CHEM 40A,C07,958092,Yang; Jerry,29,0,34,5
1748417887729,CHEM 40A,C08,958093,Yang; Jerry,27,0,34,7
1748417887729,CHEM 40A,D01,958113,Albizati; Kim F.,0,0,34,34
1748417887729,CHEM 40A,D02,958114,Albizati; Kim F.,0,0,34,34
1748417887729,CHEM 40A,D03,958115,Albizati; Kim F.,0,0,34,34
1748417887729,CHEM 40A,D04,958116,Albizati; Kim F.,0,0,34,34
1748417887729,CHEM 40A,D05,958117,Albizati; Kim F.,0,0,34,34
1748417887729,CHEM 40A,D06,958118,Albizati; Kim F.,0,0,34,34
1748417887729,CHEM 40A,D07,958119,Albizati; Kim F.,0,0,34,34
1748417887729,CHEM 40A,D08,958120,Albizati; Kim F.,0,0,34,34
1748417888755,CHEM 40B,A01,958752,Molinski; Tadeusz,0,0,31,31
1748417888755,CHEM 40B,A02,958754,Molinski; Tadeusz,0,0,32,32
1748417888755,CHEM 40B,A03,958755,Molinski; Tadeusz,0,0,32,32
1748417888755,CHEM 40B,A04,958756,Molinski; Tadeusz,0,0,32,32
1748417888755,CHEM 40B,A05,958757,Molinski; Tadeusz,0,0,32,32
1748417888755,CHEM 40B,A06,958758,Molinski; Tadeusz,0,0,32,32
1748417888755,CHEM 40B,A07,958759,Molinski; Tadeusz,0,0,32,32
1748417888755,CHEM 40B,A08,958760,Molinski; Tadeusz,2,0,32,30
1748417888755,CHEM 40B,A09,958761,Molinski; Tadeusz,32,0,32,0
1748417889795,CHEM 41A,A01,958071,Klosterman; Jeremy K,0,0,22,22
1748417889795,CHEM 41A,A02,958072,Klosterman; Jeremy K,1,0,36,35
1748417889795,CHEM 41A,A03,958073,Klosterman; Jeremy K,16,0,36,20
1748417889795,CHEM 41A,A04,958074,Klosterman; Jeremy K,32,0,36,4
1748417889795,CHEM 41A,A05,958075,Klosterman; Jeremy K,0,0,0,0
1748417889795,CHEM 41A,A06,958076,Klosterman; Jeremy K,24,0,36,12
1748417889795,CHEM 41A,A07,958077,Klosterman; Jeremy K,3,0,36,33
1748417889795,CHEM 41A,A08,958078,Klosterman; Jeremy K,0,0,36,36
1748417889795,CHEM 41A,A09,958079,Klosterman; Jeremy K,36,0,36,0
1748417890826,CHEM 41C,A01,958105,Tor; Yitzhak,0,0,38,38
1748417890826,CHEM 41C,A02,958106,Tor; Yitzhak,0,0,40,40
1748417891858,CHEM 43A,A01,912711,Lam; Tin Yiu,0,0,24,24
1748417891858,CHEM 43A,A02,912712,Lam; Tin Yiu,0,0,24,24
1748417891858,CHEM 43A,A03,912713,Lam; Tin Yiu,0,0,24,24
1748417891858,CHEM 43A,A04,912714,Lam; Tin Yiu,0,0,24,24
1748417891858,CHEM 43A,A05,912715,Lam; Tin Yiu,0,0,24,24
1748417891858,CHEM 43A,A06,912716,Lam; Tin Yiu,0,0,24,24
1748417891858,CHEM 43A,A07,912717,Lam; Tin Yiu,0,0,24,24
1748417891858,CHEM 43A,A08,912718,Lam; Tin Yiu,0,0,24,24
1748417891858,CHEM 43A,A09,912719,Lam; Tin Yiu,0,0,24,24
1748417891858,CHEM 43A,A10,912720,Lam; Tin Yiu,0,0,24,24
1748417891858,CHEM 43A,B01,912722,Lam; Tin Yiu,0,0,24,24
1748417891858,CHEM 43A,B02,912723,Lam; Tin Yiu,0,0,24,24
1748417891858,CHEM 43A,B03,912724,Lam; Tin Yiu,0,0,19,19
1748417891858,CHEM 43A,B04,912725,Lam; Tin Yiu,0,0,24,24
1748417891858,CHEM 43A,B05,912726,Lam; Tin Yiu,0,0,24,24
1748417891858,CHEM 43A,B06,912727,Lam; Tin Yiu,0,0,24,24
1748417891858,CHEM 43A,B07,912728,Lam; Tin Yiu,0,0,24,24
1748417891858,CHEM 43A,B08,912729,Lam; Tin Yiu,0,0,24,24
1748417891858,CHEM 43A,B09,912730,Lam; Tin Yiu,0,0,24,24
1748417891858,CHEM 43A,B10,912731,Lam; Tin Yiu,0,0,24,24
1748417892885,CHEM 96,A00,960251,Bussey; Thomas J,15,0,20,5
1748417893918,CHEM 100A,A01,912734,Leigh; Brian,0,0,24,24
1748417893918,CHEM 100A,A02,912735,Leigh; Brian,0,0,24,24
1748417893918,CHEM 100A,A03,912736,Leigh; Brian,0,0,24,24
1748417893918,CHEM 100A,A04,912737,Leigh; Brian,0,0,24,24
1748417893918,CHEM 100A,A05,912738,Leigh; Brian,0,0,24,24
1748417893918,CHEM 100A,A06,912739,Leigh; Brian,0,0,24,24
1748417894951,CHEM 108,A01,912741,Ghosh; Gourisankar,0,0,24,24
1748417894951,CHEM 108,A02,912742,Ghosh; Gourisankar,0,0,24,24
1748417894951,CHEM 108,A03,912743,Ghosh; Gourisankar,13,0,24,11
1748417894951,CHEM 108,A04,912744,Ghosh; Gourisankar,23,0,24,1
1748417895978,CHEM 109,A01,912746,Muller; Ulrich K.,0,0,24,24
1748417895978,CHEM 109,A02,912747,Muller; Ulrich K.,0,0,24,24
1748417895978,CHEM 109,A03,912748,Muller; Ulrich K.,0,0,24,24
1748417895978,CHEM 109,A04,912749,Muller; Ulrich K.,15,0,24,9
1748417897007,CHEM 114A,A01,958067,Toor; Navtej,23,0,30,7
1748417897007,CHEM 114A,A02,958068,Toor; Navtej,18,0,30,12
1748417897007,CHEM 114A,A03,958069,Toor; Navtej,15,0,30,15
1748417897007,CHEM 114A,A04,958070,Toor; Navtej,0,0,30,30
1748417897007,CHEM 114A,B01,958080,Guseman; Alex,0,0,30,30
1748417897007,CHEM 114A,B02,958081,Guseman; Alex,0,0,30,30
1748417897007,CHEM 114A,B03,958082,Guseman; Alex,20,0,30,10
1748417897007,CHEM 114A,B04,958083,Guseman; Alex,24,0,30,6
1748417898033,CHEM 114D,A00,912752,Ghosh; Gourisankar,11,0,20,9
1748417899060,CHEM 116,A01,958121,Godula; Kamil,35,0,50,15
1748417899060,CHEM 116,A02,958122,Godula; Kamil,29,0,50,21
1748417900085,CHEM 117,A00,912754,Jones; Lisa Michelle,89,0,100,11
1748417901113,CHEM 126A,A01,958126,Schoeneberg; Johannes,14,0,35,21
1748417901113,CHEM 126A,A02,958127,Schoeneberg; Johannes,4,0,35,31
1748417901113,CHEM 126A,A03,958128,Schoeneberg; Johannes,0,0,35,35
1748417901113,CHEM 126A,A04,958129,Schoeneberg; Johannes,1,0,35,34
1748417901113,CHEM 126A,A05,958130,Schoeneberg; Johannes,34,0,35,1
1748417901113,CHEM 126A,A06,958131,Schoeneberg; Johannes,25,0,35,10
1748417902139,CHEM 130,A01,958084,Sinha; Amitabha,6,0,35,29
1748417902139,CHEM 130,A02,958085,Sinha; Amitabha,21,0,35,14
1748417903164,CHEM 142,A00,912758,Godula; Kamil,112,0,135,23
1748417904192,CHEM 143C,A01,912760,Klosterman; Jeremy K,8,0,24,16
1748417904192,CHEM 143C,A02,912761,Klosterman; Jeremy K,11,0,24,13
1748417905217,CHEM 152,A00,912762,Schmidt; Valerie A,18,0,30,12
1748417906241,CHEM 163,A00,912763,Jones; Lisa Michelle,1,0,10,9
1748417907271,CHEM 171,A01,958103,Slade; Jonathan,30,0,40,10
1748417907271,CHEM 171,A02,958104,Slade; Jonathan,36,0,40,4
1748417908298,CHEM 204,A00,912765,Ghosh; Partho,29,0,30,1
1748417909323,CHEM 209,A00,912766,Toor; Navtej,36,0,40,4
1748417910350,CHEM 213A,A00,912767,Guseman; Alex,46,0,50,4
1748417911380,CHEM 214,A00,912768,Ghosh; Gourisankar,18,0,20,2
1748417912407,CHEM 216,A00,912769,Godula; Kamil,28,0,30,2
1748417913433,CHEM 219A,A00,912770,Zid; Brian M,43,0,45,2
1748417914465,CHEM 222,A00,912771,Graeve; Olivia A,4,0,5,1
1748417915495,CHEM 224,A00,912772,Rinehart; Jeffrey Dennis,19,0,20,1
1748417916525,CHEM 227,A00,912773,Schimpf; Alina M,28,0,30,2
1748417918584,CHEM 231,A00,912775,Yong; Haiwang,20,0,20,0
1748417919614,CHEM 232A,A00,963071,Yuen Zhou; Joel,15,0,15,0
1748417920641,CHEM 234,A00,912776,Pun; Andrew Brian,39,0,40,1
1748417921671,CHEM 242,A00,912777,Godula; Kamil,22,0,25,3
1748417922698,CHEM 252,A00,912778,Schmidt; Valerie A,27,0,30,3
1748417923729,CHEM 263,A00,912779,Jones; Lisa Michelle,28,0,30,2
1748417924759,CHEM 291,A00,912780,Staff,20,0,20,0
1748417925784,CHEM 294,A00,912781,Staff,49,0,50,1
1748417926813,CHIN 10AD,A01,913381,Liu; Mingming,10,0,12,2
1748417926813,CHIN 10AD,A02,913382,Liu; Mingming,10,0,12,2
1748417927844,CHIN 10AM,A01,913384,Chen; Pei-Chia,9,0,12,3
1748417927844,CHIN 10AM,A02,913385,Chen; Pei-Chia,10,0,12,2
1748417928885,CHIN 10AN,A01,913387,Xu; Li,10,0,10,0
1748417928885,CHIN 10AN,A02,913388,Xu; Li,10,0,10,0
1748417928885,CHIN 10AN,B01,913390,Xu; Li,9,0,10,1
1748417928885,CHIN 10AN,B02,913391,Xu; Li,8,0,10,2
1748417928885,CHIN 10AN,C01,913393,Xu; Li,12,0,12,0
1748417928885,CHIN 10AN,C02,913394,Xu; Li,11,0,12,1
1748417929913,CHIN 20AD,A01,913396,Liu; Mingming,12,0,14,2
1748417929913,CHIN 20AD,A02,913397,Liu; Mingming,13,0,14,1
1748417930946,CHIN 20AM,A01,913399,Wang; Xiao,11,0,12,1
1748417930946,CHIN 20AM,A02,913400,Wang; Xiao,9,0,12,3
1748417930946,CHIN 20AM,B01,913402,Wang; Xiao,12,0,12,0
1748417930946,CHIN 20AM,B02,913403,Wang; Xiao,12,0,12,0
1748417931978,CHIN 20AN,A01,913405,Anderson; Qin-Hong,8,0,12,4
1748417931978,CHIN 20AN,A02,913406,Anderson; Qin-Hong,7,0,12,5
1748417931978,CHIN 20AN,B01,913408,Anderson; Qin-Hong,6,0,12,6
1748417931978,CHIN 20AN,B02,913409,Anderson; Qin-Hong,9,0,12,3
1748417931978,CHIN 20AN,C01,913411,Anderson; Qin-Hong,11,0,12,1
1748417933004,CHIN 100AM,A00,913412,Wang; Xiao,12,0,15,3
1748417934034,CHIN 100AN,A00,913413,Chen; Pei-Chia,8,0,15,7
1748417935064,CHIN 185A,A00,913414,Liu; Mingming,15,0,15,0
1748417936091,CLIN 294A,A00,914822,Weingarten; Amanda Gooding,10,0,10,0
1748417937139,CLIN 296,A00,914825,Moore; David Joseph,100,0,100,0
1748417937139,CLIN 296,B00,914826,Brookman; Lauren Irene,5,0,5,0
1748417938174,CLIN 297,A00,914827,Wall; Tamara Lynn,100,0,100,0
1748417939200,CLRE 254,A00,914830,Vaida; Florin,9997,0,9999,2
1748417940227,CLRE 255,A01,914832,Cuomo; Raphael Eduardo,9997,0,9999,2
1748417941255,CLRE 256,A01,914835,Morris; Sheldon,9996,0,9999,3
1748417942282,CLRE 257,A00,914836,Mehta; Ravindra L.,9997,0,9999,2
1748417943310,CLRE 258,A00,914839,Mehta; Ravindra L.,9997,0,9999,2
1748417944340,CLRE 260,A00,914840,Cuomo; Raphael Eduardo,9999,0,9999,0
1748417945364,CLRE 295A,A00,914845,Cuomo; Raphael Eduardo,9999,0,9999,0
1748417946391,CLRE 297,001,914847,Cuomo; Raphael Eduardo,9999,0,9999,0
1748417947418,CLX 87,A00,913379,Castro; Robert Jess,20,0,20,0
1748417948444,COGR 200A,A00,914800,Dewaard; Andrew Michael,5,0,5,0
1748417949471,COGR 200C,A00,914801,Irani; Lilly C,5,0,5,0
1748417950500,COGR 225A,A00,914803,McKenzie; Kerry V.,10,0,10,0
1748417951530,COGR 225C,A00,914804,McKenzie; Kerry V.,9,0,10,1
1748417952557,COGR 275,A00,914805,Jack; Caroline Sarah,9,0,10,1
1748417952557,COGR 275,B00,914807,Zilberg; Elana,9,0,10,1
1748417952557,COGR 275,C00,914809,Goldfarb; Brian,7,0,10,3
1748417953586,COGS 1,A01,913420,Beatty-Martinez; Anne,47,0,56,9
1748417953586,COGS 1,A02,913421,Beatty-Martinez; Anne,39,0,56,17
1748417953586,COGS 1,A03,913422,Beatty-Martinez; Anne,51,0,55,4
1748417953586,COGS 1,A04,913423,Beatty-Martinez; Anne,46,0,50,4
1748417953586,COGS 1,A05,913424,Beatty-Martinez; Anne,41,0,50,9
1748417953586,COGS 1,A06,913425,Beatty-Martinez; Anne,44,0,50,6
1748417953586,COGS 1,A07,913426,Beatty-Martinez; Anne,48,0,50,2
1748417953586,COGS 1,A08,913427,Beatty-Martinez; Anne,45,0,50,5
1748417954611,COGS 2,A01,913429,Boyle; Mary E. T.,49,0,50,1
1748417954611,COGS 2,A02,913430,Boyle; Mary E. T.,47,0,50,3
1748417954611,COGS 2,A03,913431,Boyle; Mary E. T.,46,0,50,4
1748417954611,COGS 2,A04,913432,Boyle; Mary E. T.,49,0,50,1
1748417954611,COGS 2,A05,913433,Boyle; Mary E. T.,47,0,50,3
1748417955638,COGS 3,A01,913435,Boyle; Mary E. T.,48,0,60,12
1748417955638,COGS 3,A02,913436,Boyle; Mary E. T.,52,0,60,8
1748417956666,COGS 9,A01,913439,Khosla; Meenakshi,48,0,50,2
1748417956666,COGS 9,A02,913440,Khosla; Meenakshi,49,0,50,1
1748417956666,COGS 9,A03,913441,Khosla; Meenakshi,48,0,50,2
1748417956666,COGS 9,A04,913442,Khosla; Meenakshi,46,0,50,4
1748417956666,COGS 9,A05,913443,Khosla; Meenakshi,44,0,50,6
1748417956666,COGS 9,A06,913444,Khosla; Meenakshi,46,0,50,4
1748417957697,COGS 10,A01,913446,Staff,42,0,50,8
1748417957697,COGS 10,A02,913447,Staff,46,0,50,4
1748417957697,COGS 10,A03,913448,Staff,47,0,50,3
1748417957697,COGS 10,A04,913449,Staff,47,0,50,3
1748417957697,COGS 10,A05,913450,Staff,50,0,50,0
1748417957697,COGS 10,A06,913451,Staff,45,0,50,5
1748417958722,COGS 11,A01,913453,Boroditsky; Lera,142,0,149,7
1748417959749,COGS 14A,A01,913455,Creel; Sarah,29,0,50,21
1748417959749,COGS 14A,A02,913456,Creel; Sarah,37,0,50,13
1748417959749,COGS 14A,A03,913457,Creel; Sarah,42,0,50,8
1748417959749,COGS 14A,A04,913458,Creel; Sarah,45,0,50,5
1748417959749,COGS 14A,A05,913459,Creel; Sarah,47,0,50,3
1748417959749,COGS 14A,A06,913460,Creel; Sarah,48,0,50,2
1748417959749,COGS 14A,A07,913461,Creel; Sarah,46,0,50,4
1748417960777,COGS 14B,A01,913463,Barrera; Steven James,32,0,50,18
1748417960777,COGS 14B,A02,913464,Barrera; Steven James,45,0,50,5
1748417960777,COGS 14B,A03,913465,Barrera; Steven James,40,0,50,10
1748417960777,COGS 14B,A04,913466,Barrera; Steven James,46,0,50,4
1748417960777,COGS 14B,A05,913467,Barrera; Steven James,40,0,50,10
1748417961803,COGS 15,A01,913469,Bergen; Benjamin,57,0,60,3
1748417961803,COGS 15,A02,913470,Bergen; Benjamin,57,0,60,3
1748417962829,COGS 17,A01,913472,Johnson; Christine M.,38,0,50,12
1748417962829,COGS 17,A02,913473,Johnson; Christine M.,47,0,50,3
1748417962829,COGS 17,A03,913474,Johnson; Christine M.,40,0,50,10
1748417962829,COGS 17,A04,913475,Johnson; Christine M.,42,0,50,8
1748417962829,COGS 17,A05,913476,Johnson; Christine M.,48,0,50,2
1748417962829,COGS 17,A06,913477,Johnson; Christine M.,48,0,50,2
1748417962829,COGS 17,A07,913478,Johnson; Christine M.,50,0,54,4
1748417962829,COGS 17,A08,913479,Johnson; Christine M.,43,0,56,13
1748417963870,COGS 18,A01,913481,Morgan; Eric,27,0,35,8
1748417963870,COGS 18,A02,913482,Morgan; Eric,30,0,35,5
1748417963870,COGS 18,A03,913483,Morgan; Eric,29,0,35,6
1748417963870,COGS 18,A04,913484,Morgan; Eric,32,0,35,3
1748417963870,COGS 18,A05,913485,Morgan; Eric,31,0,35,4
1748417963870,COGS 18,A06,913486,Morgan; Eric,31,0,35,4
1748417963870,COGS 18,A07,913487,Morgan; Eric,30,0,35,5
1748417963870,COGS 18,A08,913488,Morgan; Eric,31,0,35,4
1748417963870,COGS 18,A09,913520,Morgan; Eric,29,0,35,6
1748417963870,COGS 18,B01,968089,Morgan; Eric,34,0,35,1
1748417963870,COGS 18,B02,968090,Morgan; Eric,35,0,35,0
1748417963870,COGS 18,B03,968091,Morgan; Eric,35,0,35,0
1748417963870,COGS 18,B04,968092,Morgan; Eric,35,0,35,0
1748417963870,COGS 18,B05,968093,Morgan; Eric,35,0,35,0
1748417963870,COGS 18,B06,968094,Morgan; Eric,35,0,35,0
1748417963870,COGS 18,B07,968095,Morgan; Eric,35,0,35,0
1748417963870,COGS 18,B08,968096,Morgan; Eric,34,0,35,1
1748417963870,COGS 18,B09,968097,Morgan; Eric,34,0,35,1
1748417964910,COGS 100,A01,913580,Staff,58,0,60,2
1748417964910,COGS 100,A02,913581,Staff,55,0,60,5
1748417964910,COGS 100,A03,913621,Staff,55,0,60,5
1748417964910,COGS 100,A04,913622,Staff,55,0,60,5
1748417964910,COGS 100,A05,913663,Staff,54,0,60,6
1748417965937,COGS 101A,A01,913705,Barrera; Steven James,37,0,50,13
1748417965937,COGS 101A,A02,913709,Barrera; Steven James,35,0,50,15
1748417965937,COGS 101A,A03,913713,Barrera; Steven James,18,0,50,32
1748417965937,COGS 101A,A04,913715,Barrera; Steven James,26,0,50,24
1748417965937,COGS 101A,A05,913718,Barrera; Steven James,44,0,50,6
1748417965937,COGS 101A,A06,913721,Barrera; Steven James,37,0,50,13
1748417965937,COGS 101A,A07,913722,Barrera; Steven James,41,0,50,9
1748417966964,COGS 101B,A01,913725,Hoffman; Drew Ellen,26,0,50,24
1748417966964,COGS 101B,A02,913726,Hoffman; Drew Ellen,44,0,50,6
1748417966964,COGS 101B,A03,913727,Hoffman; Drew Ellen,47,0,50,3
1748417966964,COGS 101B,A04,913730,Hoffman; Drew Ellen,50,0,50,0
1748417968000,COGS 102A,A01,968009,Staff,41,0,48,7
1748417968000,COGS 102A,A02,968010,Staff,36,0,48,12
1748417968000,COGS 102A,A03,968011,Staff,47,0,50,3
1748417969033,COGS 107A,A01,913748,Rangel; Lara M,43,0,56,13
1748417969033,COGS 107A,A02,913750,Rangel; Lara M,43,0,54,11
1748417969033,COGS 107A,A03,913751,Rangel; Lara M,31,0,50,19
1748417969033,COGS 107A,A04,913754,Rangel; Lara M,22,0,50,28
1748417969033,COGS 107A,A05,913755,Rangel; Lara M,27,0,50,23
1748417969033,COGS 107A,A06,913756,Rangel; Lara M,0,0,50,50
1748417970062,COGS 107B,A01,968098,Staff,0,0,50,50
1748417970062,COGS 107B,A02,968099,Staff,7,0,50,43
1748417970062,COGS 107B,A03,968102,Staff,37,0,49,12
1748417971089,COGS 108,A01,913846,Fleischer; Jason G,0,0,56,56
1748417971089,COGS 108,A02,913847,Fleischer; Jason G,18,0,56,38
1748417971089,COGS 108,A03,913858,Fleischer; Jason G,20,0,50,30
1748417971089,COGS 108,A04,913899,Fleischer; Jason G,44,0,55,11
1748417971089,COGS 108,A05,913984,Fleischer; Jason G,29,0,50,21
1748417971089,COGS 108,A06,914035,Fleischer; Jason G,31,0,50,19
1748417971089,COGS 108,A07,914036,Fleischer; Jason G,36,0,50,14
1748417971089,COGS 108,A08,914037,Fleischer; Jason G,44,0,50,6
1748417971089,COGS 108,B01,914039,Fleischer; Jason G,38,0,50,12
1748417971089,COGS 108,B02,914040,Fleischer; Jason G,48,0,50,2
1748417971089,COGS 108,B03,914172,Fleischer; Jason G,32,0,50,18
1748417971089,COGS 108,B04,914182,Fleischer; Jason G,36,0,50,14
1748417971089,COGS 108,B05,914185,Fleischer; Jason G,28,0,50,22
1748417971089,COGS 108,B06,914188,Fleischer; Jason G,20,0,50,30
1748417971089,COGS 108,B07,914209,Fleischer; Jason G,39,0,54,15
1748417971089,COGS 108,B08,914210,Fleischer; Jason G,49,0,56,7
1748417972120,COGS 109,A01,968106,Mukamel; Eran A,30,0,48,18
1748417972120,COGS 109,A02,968107,Mukamel; Eran A,39,0,49,10
1748417972120,COGS 109,A03,968108,Mukamel; Eran A,47,0,49,2
1748417973146,COGS 111,A01,914261,Hoffman; Drew Ellen,34,0,50,16
1748417973146,COGS 111,A02,914262,Hoffman; Drew Ellen,49,0,50,1
1748417973146,COGS 111,A03,914263,Hoffman; Drew Ellen,46,0,50,4
1748417973146,COGS 111,A04,914264,Hoffman; Drew Ellen,28,0,50,22
1748417974177,COGS 115,A01,914266,Deak; Gedeon O.,35,0,70,35
1748417975255,COGS 116,A01,914268,Greene; Deanna Jacquelyn,49,0,70,21
1748417976283,COGS 118A,A01,914270,Tu; Zhuowen,30,0,50,20
1748417976283,COGS 118A,A02,914271,Tu; Zhuowen,31,0,50,19
1748417976283,COGS 118A,A03,914272,Tu; Zhuowen,7,0,50,43
1748417976283,COGS 118A,A04,914273,Tu; Zhuowen,6,0,50,44
1748417977314,COGS 118B,A01,969817,De Sa; Virginia,32,0,49,17
1748417977314,COGS 118B,A02,969818,De Sa; Virginia,34,0,49,15
1748417977314,COGS 118B,A03,969819,De Sa; Virginia,31,0,49,18
1748417977314,COGS 118B,A04,969822,De Sa; Virginia,43,0,49,6
1748417978341,COGS 125,A00,968043,Klemmer; Scott R,48,0,50,2
1748417979370,COGS 128,A01,914278,Staff,16,0,50,34
1748417979370,COGS 128,A02,914279,Staff,0,0,50,50
1748417980400,COGS 143,A01,914284,Johnson; Christine M.,16,0,40,24
1748417981427,COGS 150,A01,968112,Staff,36,0,50,14
1748417981427,COGS 150,A02,968113,Staff,44,0,49,5
1748417981427,COGS 150,A03,968114,Staff,43,0,48,5
1748417982452,COGS 151,A00,968044,Coulson; Seana M,48,0,50,2
1748417983480,COGS 160,A00,914286,Kirsh; David Joel,25,0,25,0
1748417984511,COGS 165,A01,914291,Kiyonaga; Anastasia,0,0,50,50
1748417985540,COGS 187A,A01,914293,Kirsh; David Joel,0,0,50,50
1748417985540,COGS 187A,A02,914294,Kirsh; David Joel,0,0,50,50
1748417985540,COGS 187A,A03,914295,Kirsh; David Joel,16,0,49,33
1748417986567,COGS 189,A00,914296,De Sa; Virginia,119,0,200,81
1748417987593,COGS 190A,A00,914297,Staff,9999,0,9999,0
1748417988619,COGS 194,A00,914298,Hill; Seth J,9999,0,9999,0
1748417989660,COGS 203,A00,914326,Zettersten; Martin,11,0,20,9
1748417990696,COGS 210A,001,914327,Kirsh; David Joel,9999,0,9999,0
1748417990696,COGS 210A,002,914328,Greene; Deanna Jacquelyn,9998,0,9999,1
1748417990696,COGS 210A,003,914329,Xia; Haijun,9998,0,9999,1
1748417990696,COGS 210A,004,914330,Nitz; Douglas A.,9999,0,9999,0
1748417990696,COGS 210A,005,914331,Hollan; James D.,9999,0,9999,0
1748417990696,COGS 210A,006,914332,De Sa; Virginia,9998,0,9999,1
1748417990696,COGS 210A,007,914333,Rossano; Federico,9999,0,9999,0
1748417990696,COGS 210A,008,914334,Kiyonaga; Anastasia,9999,0,9999,0
1748417990696,COGS 210A,009,914335,Coulson; Seana M,9998,0,9999,1
1748417991726,COGS 211A,A00,914336,Boroditsky; Lera,9995,0,9999,4
1748417992755,COGS 230,A00,914337,Munyaka; Imani N. S.,3,0,15,12
1748417993783,COGS 234,A00,970720,Xia; Haijun,4,0,20,16
1748417994813,COGS 260,A00,914340,Voytek; Bradley Thomas,9994,0,9999,5
1748417995850,COMM 10,A01,914366,Whitworth-Smith; Andrew C,6,0,10,4
1748417995850,COMM 10,A02,914367,Whitworth-Smith; Andrew C,7,0,10,3
1748417995850,COMM 10,A03,914368,Whitworth-Smith; Andrew C,9,0,10,1
1748417995850,COMM 10,A04,914369,Whitworth-Smith; Andrew C,6,0,10,4
1748417995850,COMM 10,A05,914370,Whitworth-Smith; Andrew C,10,0,10,0
1748417995850,COMM 10,A06,914371,Whitworth-Smith; Andrew C,9,0,10,1
1748417995850,COMM 10,A07,914372,Whitworth-Smith; Andrew C,9,0,10,1
1748417995850,COMM 10,A08,914373,Whitworth-Smith; Andrew C,7,0,10,3
1748417995850,COMM 10,A09,914374,Whitworth-Smith; Andrew C,9,0,10,1
1748417995850,COMM 10,A10,914375,Whitworth-Smith; Andrew C,10,0,10,0
1748417995850,COMM 10,A11,914376,Whitworth-Smith; Andrew C,6,0,10,4
1748417995850,COMM 10,A12,914377,Whitworth-Smith; Andrew C,10,0,10,0
1748417996876,COMM 20,A01,914385,Hill; Erin Truesdell,75,0,75,0
1748417997903,COMM 40,A00,914386,Jack; Caroline Sarah,61,0,75,14
1748417998929,COMM 50,A00,914387,Staff,21,0,25,4
1748417999955,COMM 80,A01,914389,Staff,77,0,80,3
1748418000991,COMM 100A,A01,914391,Harb; Anthony Joseph,1,0,10,9
1748418000991,COMM 100A,A02,914392,Harb; Anthony Joseph,0,0,10,10
1748418000991,COMM 100A,A03,914393,Harb; Anthony Joseph,0,0,10,10
1748418000991,COMM 100A,A04,914394,Harb; Anthony Joseph,0,0,10,10
1748418000991,COMM 100A,A05,914395,Harb; Anthony Joseph,0,0,10,10
1748418000991,COMM 100A,A06,914396,Harb; Anthony Joseph,0,0,10,10
1748418000991,COMM 100A,A07,914397,Harb; Anthony Joseph,1,0,10,9
1748418000991,COMM 100A,A08,914398,Harb; Anthony Joseph,6,0,10,4
1748418000991,COMM 100A,A09,914399,Harb; Anthony Joseph,7,0,10,3
1748418000991,COMM 100A,A10,914400,Harb; Anthony Joseph,7,0,10,3
1748418002027,COMM 101,A01,914404,Martinico; Daniel J,8,0,15,7
1748418002027,COMM 101,A02,914405,Martinico; Daniel J,2,0,15,13
1748418002027,COMM 101,A03,914406,Martinico; Daniel J,1,0,15,14
1748418002027,COMM 101,A04,914407,Martinico; Daniel J,13,0,15,2
1748418003052,COMM 101K,A00,914408,Staff,0,0,0,0
1748418004083,COMM 101M,A00,914409,Halm; Gavin Patrick,10,0,18,8
1748418005112,COMM 101N,A00,914410,Martinico; Daniel J,4,0,16,12
1748418006142,COMM 101T,A00,914411,Davis; Zeinabu I.,12,0,18,6
1748418007171,COMM 102C,A01,914417,Campion; Camille E,0,0,6,6
1748418007171,COMM 102C,A02,914423,Campion; Camille E,0,0,6,6
1748418007171,COMM 102C,A03,914432,Campion; Camille E,0,0,6,6
1748418008202,COMM 106,A00,914439,Kidman; Shawna F,54,0,70,16
1748418009228,COMM 106F,A00,914442,Hill; Erin Truesdell,23,0,42,19
1748418010261,COMM 106N,A00,914480,Hallin; Daniel C,46,0,70,24
1748418011292,COMM 108D,A00,914491,Goldfarb; Brian,45,0,46,1
1748418012322,COMM 113T,A00,914493,Dominguez Rubio; Fernando,43,0,46,3
1748418013348,COMM 114E,A00,914767,Pavon Aramburu; Maria Laur,41,0,44,3
1748418014375,COMM 114I,A00,914768,Rojo Solis; Juan Jose,39,0,44,5
1748418015406,COMM 115,A00,914769,Alac; Morana,35,0,46,11
1748418016433,COMM 119,A01,914771,Staff,50,0,50,0
1748418017463,COMM 120M,A00,914773,Abuelhiga; Soraya Jill,37,0,44,7
1748418018491,COMM 127,A00,914774,Abuelhiga; Soraya Jill,33,0,44,11
1748418019517,COMM 133,A00,914775,Dewey; Matthew D,35,0,44,9
1748418020546,COMM 134,A00,914777,Kidman; Shawna F,31,0,44,13
1748418021574,COMM 135,A00,914778,Davis; Zeinabu I.,44,0,46,2
1748418022605,COMM 142,A00,914779,McKenna; Denise,22,0,44,22
1748418023636,COMM 146,A00,914780,Halm; Gavin Patrick,34,0,44,10
1748418023636,COMM 146,B00,968068,Ybarra; Megan,41,0,44,3
1748418024662,COMM 148,A00,914785,Staff,0,0,0,0
1748418025689,COMM 164,A00,914786,Dominguez Rubio; Fernando,9,0,25,16
1748418026719,COMM 173,A00,914787,Alac; Morana,4,0,25,21
1748418027748,COMM 177,A00,914788,Rojo Solis; Juan Jose,2,0,25,23
1748418028779,COMM 185,A00,914792,Boateng; Boatema,21,0,25,4
1748418029806,COMM 190,B00,914793,Staff,0,0,23,23
1748418029806,COMM 190,C00,914794,Staff,10,0,23,13
1748418029806,COMM 190,D00,914795,Hassanpour; Anvar,4,0,23,19
1748418030834,COMM 194,A00,954115,Hill; Seth J,9999,0,9999,0
1748418031866,COMM 196A,A00,914796,Dewaard; Andrew Michael,0,0,0,1
1748418032904,CSE 3,A50,914849,Alvarado; Christine J.,49,0,50,1
1748418032904,CSE 3,A51,914850,Alvarado; Christine J.,49,0,50,1
1748418032904,CSE 3,A52,914852,Alvarado; Christine J.,46,0,46,0
1748418033939,CSE 6R,A01,914856,Soosai Raj; Adalbert Geral,238,0,250,12
1748418034969,CSE 8A,A50,914860,Soosai Raj; Adalbert Geral,2,0,3,1
1748418034969,CSE 8A,A51,914868,Soosai Raj; Adalbert Geral,1,0,3,2
1748418034969,CSE 8A,A52,914870,Soosai Raj; Adalbert Geral,1,0,3,2
1748418034969,CSE 8A,A53,914871,Soosai Raj; Adalbert Geral,1,0,3,2
1748418034969,CSE 8A,A54,914872,Soosai Raj; Adalbert Geral,2,0,3,1
1748418034969,CSE 8A,A55,914873,Soosai Raj; Adalbert Geral,2,0,3,1
1748418034969,CSE 8A,A56,914875,Soosai Raj; Adalbert Geral,3,0,3,0
1748418034969,CSE 8A,A57,914876,Soosai Raj; Adalbert Geral,1,0,3,2
1748418036003,CSE 11,A01,958990,Cao; Yingjun,0,0,50,50
1748418036003,CSE 11,B01,959775,Ochoa; Benjamin Lawrence,103,0,115,12
1748418037029,CSE 12,A01,958991,Cao; Yingjun,0,0,100,100
1748418038062,CSE 20,A01,959784,Jones; Miles E,0,0,25,25
1748418038062,CSE 20,A02,968053,Jones; Miles E,1,0,25,24
1748418039095,CSE 21,A01,959776,Jones; Miles E,0,0,30,30
1748418039095,CSE 21,A02,968059,Jones; Miles E,3,0,30,27
1748418040124,CSE 29,A50,914888,Politz; Joseph Gibbs,0,0,10,10
1748418040124,CSE 29,A51,914889,Politz; Joseph Gibbs,0,0,10,10
1748418040124,CSE 29,A52,914891,Politz; Joseph Gibbs,0,0,10,10
1748418040124,CSE 29,A53,914892,Politz; Joseph Gibbs,0,0,10,10
1748418040124,CSE 29,B50,914897,Shalev; Aaron D,0,0,10,10
1748418040124,CSE 29,B51,914898,Shalev; Aaron D,0,0,10,10
1748418040124,CSE 29,B52,914900,Shalev; Aaron D,0,0,10,10
1748418040124,CSE 29,B53,914901,Shalev; Aaron D,0,0,10,10
1748418041159,CSE 30,A01,959778,Eldon; John,0,0,15,15
1748418042200,CSE 87,A00,914904,Moshiri; Niema,20,0,20,0
1748418043228,CSE 89,A00,914906,Minnes Kemp; Mor Mia,100,0,100,0
1748418043228,CSE 89,B00,969276,Minnes Kemp; Mor Mia,100,0,100,0
1748418044274,CSE 95,A00,914907,Cao; Yingjun,100,0,100,0
1748418045301,CSE 100,A01,959787,Moshiri; Niema,0,0,75,75
1748418046328,CSE 100R,A01,914911,Moshiri; Niema,0,0,125,125
1748418047357,CSE 101,A01,958995,Impagliazzo; Russell,0,0,30,30
1748418047357,CSE 101,A02,958998,Impagliazzo; Russell,0,0,30,30
1748418047357,CSE 101,A03,959000,Impagliazzo; Russell,0,0,30,30
1748418047357,CSE 101,B01,959777,Liu; Qipeng,94,0,175,81
1748418048384,CSE 103,A01,959001,Freund; Yoav,69,0,96,27
1748418049420,CSE 105,A01,959785,Lovett; Shachar,0,0,45,45
1748418050451,CSE 107,A01,959002,Bellare; Mihir,81,0,96,15
1748418051489,CSE 110,A50,914923,Coblenz; Michael J,10,0,50,40
1748418051489,CSE 110,A51,914925,Coblenz; Michael J,18,0,50,32
1748418051489,CSE 110,A52,914926,Coblenz; Michael J,44,0,50,6
1748418051489,CSE 110,A53,914928,Coblenz; Michael J,33,0,50,17
1748418051489,CSE 110,A54,914930,Coblenz; Michael J,42,0,50,8
1748418051489,CSE 110,A55,914931,Coblenz; Michael J,36,0,45,9
1748418052520,CSE 118,A50,914934,Weibel; Nadir,16,0,25,9
1748418053549,CSE 120,A01,959780,Voelker; Geoffrey M.,130,0,295,165
1748418054580,CSE 127,A01,959795,Savage; Stefan,88,0,192,104
1748418055607,CSE 130,A01,959003,Polikarpova; Nadezhda,118,0,145,27
1748418056633,CSE 131,A01,914941,Politz; Joseph Gibbs,33,0,50,17
1748418057664,CSE 132A,A01,959790,Gupta; Amarnath,141,0,196,55
1748418058689,CSE 134B,A01,959005,Powell; Thomas Allan,115,0,146,31
1748418059716,CSE 140,A01,914947,Orailoglu; Alex,124,0,146,22
1748418060742,CSE 140L,A01,914949,Orailoglu; Alex,112,0,146,34
1748418061769,CSE 141,A01,959006,Pannuto; Patrick William,79,0,146,67
1748418062798,CSE 141L,A01,961134,Eldon; John,75,0,146,71
1748418063826,CSE 142,A01,959781,Swanson; Steven James,250,0,295,45
1748418064853,CSE 150A,A01,959774,Bonjour; Trevor,101,0,225,124
1748418065881,CSE 150B,A01,959791,Solares; Edwin A,187,0,196,9
1748418066909,CSE 151A,A01,959782,Dasgupta; Sanjoy,187,0,250,63
1748418066909,CSE 151A,B01,959783,Dasgupta; Sanjoy,226,0,250,24
1748418067939,CSE 152A,A01,959792,Su; Hao,0,0,0,0
1748418068969,CSE 158,A01,959793,McAuley; Julian John,100,0,196,96
1748418069996,CSE 158R,A01,914961,McAuley; Julian John,449,0,550,101
1748418069996,CSE 158R,B01,968064,McAuley; Julian John,100,0,100,0
1748418071028,CSE 167,A01,959796,Li; Tzumao,110,0,192,82
1748418072068,CSE 170,A01,914965,Vaccaro; Kristen Marie,13,0,20,7
1748418072068,CSE 170,A02,914967,Vaccaro; Kristen Marie,0,0,20,20
1748418072068,CSE 170,A03,914968,Vaccaro; Kristen Marie,17,0,20,3
1748418072068,CSE 170,A04,914969,Vaccaro; Kristen Marie,15,0,20,5
1748418072068,CSE 170,A05,914970,Vaccaro; Kristen Marie,17,0,20,3
1748418072068,CSE 170,A06,914971,Vaccaro; Kristen Marie,18,0,20,2
1748418072068,CSE 170,A07,914972,Vaccaro; Kristen Marie,16,0,19,3
1748418072068,CSE 170,A08,914973,Vaccaro; Kristen Marie,1,0,19,18
1748418072068,CSE 170,A09,914974,Vaccaro; Kristen Marie,8,0,19,11
1748418072068,CSE 170,A10,969577,Vaccaro; Kristen Marie,18,0,19,1
1748418073099,CSE 190,A00,914975,Vaccaro; Kristen Marie,146,0,146,0
1748418074127,CSE 191,A00,914976,Minnes Kemp; Mor Mia,9999,0,9999,0
1748418075158,CSE 193,A01,959007,Bonjour; Trevor,50,0,50,0
1748418076191,CSE 194,A01,959009,Munyaka; Imani N. S.,6,0,60,54
1748418077217,CSE 197,001,914980,Minnes Kemp; Mor Mia,9999,0,9999,0
1748418078244,CSE 202,A00,914981,Liu; Qipeng,0,0,0,0
1748418079325,CSE 206A,A00,914982,Micciancio; Daniele,0,0,0,0
1748418080351,CSE 207B,A00,914983,Heninger; Nadia A,0,0,0,0
1748418081378,CSE 209A,A00,914984,Impagliazzo; Russell,0,0,0,0
1748418082413,CSE 209B,A00,914985,Bellare; Mihir,0,0,0,0
1748418083440,CSE 210,A00,914986,Powell; Thomas Allan,0,0,0,0
1748418084473,CSE 216,A00,914987,Munyaka; Imani N. S.,0,0,0,0
1748418085503,CSE 221,A00,914988,Ousterhout; Amy,0,0,0,0
1748418086531,CSE 227,A00,914989,Fernandes; Earlence T,0,0,0,0
1748418087562,CSE 229A,A00,914990,Snoeren; Alex C.,0,0,0,0
1748418088592,CSE 229C,A00,914993,Fernandes; Earlence T,0,0,0,0
1748418089619,CSE 237C,A00,914994,Kastner; Ryan Charles,0,0,0,0
1748418090646,CSE 239B,A00,914996,D'Antoni; Loris,0,0,0,0
1748418091679,CSE 240A,A00,914997,Tullsen; Dean Michael,0,0,0,0
1748418092705,CSE 249E,A00,914998,Pannuto; Patrick William,0,0,0,0
1748418093738,CSE 250A,A00,914999,Bonjour; Trevor,0,0,0,0
1748418094765,CSE 252A,A00,915000,Ochoa; Benjamin Lawrence,0,0,0,0
1748418095799,CSE 258,A01,959794,McAuley; Julian John,0,0,0,0
1748418096833,CSE 258R,A01,915004,McAuley; Julian John,0,0,0,0
1748418097865,CSE 259,A00,915005,Prithviraj; Ammanabrolu,0,0,0,0
1748418098897,CSE 260,A01,959011,Chin; Bryan W.,0,0,0,0
1748418099924,CSE 270,A01,959012,Chern; Albert Ren-Haur,0,0,0,0
1748418100951,CSE 276A,A00,915009,Christensen; Henrik I,0,0,0,0
1748418101990,CSE 290,A00,915013,Bafna; Vineet,0,0,0,0
1748418101990,CSE 290,B00,915014,Nakashole; Ndapandula,0,0,0,0
1748418101990,CSE 290,C00,915015,Ramamoorthi; Ravi,0,0,0,0
1748418101990,CSE 290,D00,915017,Tullsen; Dean Michael,0,0,0,0
1748418101990,CSE 290,F00,915020,Vaccaro; Kristen Marie,0,0,0,0
1748418103022,CSE 291A,A00,915021,Yu; Qi,0,0,0,0
1748418103022,CSE 291A,B00,915022,Weibel; Nadir,0,0,0,0
1748418103022,CSE 291A,C00,915049,Munyaka; Imani N. S.,0,0,0,0
1748418103022,CSE 291A,D00,968730,Zhang; Yiying,0,0,0,0
1748418104051,CSE 291P,A00,915050,D'Antoni; Loris,0,0,0,0
1748418104051,CSE 291P,B00,915051,Ding; Yufei,0,0,0,0
1748418105083,CSE 291T,A00,915052,Grier; Daniel T,0,0,0,0
1748418105083,CSE 291T,B00,915053,Heninger; Nadia A,0,0,0,0
1748418106110,CSE 291Y,A00,915054,Fernandes; Earlence T,0,0,0,0
1748418107143,CSE 292,A00,968504,Ousterhout; Amy,0,0,0,0
1748418108201,CSE 293,001,968115,Bafna; Vineet,9999,0,9999,0
1748418108201,CSE 293,002,968116,Bellare; Mihir,9999,0,9999,0
1748418108201,CSE 293,003,968122,Berg-Kirkpatrick; Taylor D,9999,0,9999,0
1748418108201,CSE 293,004,968298,Chandraker; Manmohan Krishna,9999,0,9999,0
1748418108201,CSE 293,005,968317,Cheng; Chung Kuan,9999,0,9999,0
1748418108201,CSE 293,006,968334,Christensen; Henrik I,9999,0,9999,0
1748418108201,CSE 293,007,968339,Coblenz; Michael J,9999,0,9999,0
1748418108201,CSE 293,008,968345,Cottrell; Garrison W,9999,0,9999,0
1748418108201,CSE 293,009,968346,Deutsch; Alin Bernard,9999,0,9999,0
1748418108201,CSE 293,010,968357,Esmaeilzadeh; Hadi,9999,0,9999,0
1748418108201,CSE 293,011,968359,Freund; Yoav,9999,0,9999,0
1748418108201,CSE 293,012,968427,Griswold; William G.,9999,0,9999,0
1748418108201,CSE 293,013,968472,Gymrek; Melissa Ann,9999,0,9999,0
1748418108201,CSE 293,014,968473,Heninger; Nadia A,9999,0,9999,0
1748418108201,CSE 293,015,968480,Impagliazzo; Russell,9999,0,9999,0
1748418108201,CSE 293,016,968489,Jhala; Ranjit,9999,0,9999,0
1748418108201,CSE 293,017,968490,Kahng; Andrew Byun,9999,0,9999,0
1748418108201,CSE 293,018,968494,Kane; Daniel Mertz,9999,0,9999,0
1748418108201,CSE 293,019,968495,Kriegman; David J,9999,0,9999,0
1748418108201,CSE 293,020,968496,Kumar; Arun Kumar,9999,0,9999,0
1748418108201,CSE 293,021,968497,Lerner; Sorin,9999,0,9999,0
1748418108201,CSE 293,022,968498,Lovett; Shachar,9999,0,9999,0
1748418108201,CSE 293,023,968499,McAuley; Julian John,9999,0,9999,0
1748418108201,CSE 293,024,968501,Micciancio; Daniele,9999,0,9999,0
1748418108201,CSE 293,025,968502,Orailoglu; Alex,9999,0,9999,0
1748418108201,CSE 293,026,968503,Pannuto; Patrick William,9999,0,9999,0
1748418108201,CSE 293,027,968505,Paturi; Ramamohan,9999,0,9999,0
1748418108201,CSE 293,028,968506,Polikarpova; Nadezhda,9999,0,9999,0
1748418108201,CSE 293,029,968507,Politz; Joseph Gibbs,9999,0,9999,0
1748418108201,CSE 293,030,968508,Porter; George M,9999,0,9999,0
1748418108201,CSE 293,031,968509,Porter; Leonard Emerson,9999,0,9999,0
1748418108201,CSE 293,032,968510,Ramamoorthi; Ravi,9999,0,9999,0
1748418108201,CSE 293,033,968511,Riek; Laurel D,9999,0,9999,0
1748418108201,CSE 293,034,968512,Sahoo; Debashis,9999,0,9999,0
1748418108201,CSE 293,035,968513,Saul; Lawrence,9999,0,9999,0
1748418108201,CSE 293,036,968514,Savage; Stefan,9999,0,9999,0
1748418108201,CSE 293,037,968515,Schulze; Jurgen P.,9999,0,9999,0
1748418108201,CSE 293,038,968516,Snoeren; Alex C.,9999,0,9999,0
1748418108201,CSE 293,039,968517,Shang; Jingbo,9999,0,9999,0
1748418108201,CSE 293,040,968575,Stefan; Deian,9999,0,9999,0
1748418108201,CSE 293,041,968580,Su; Hao,9999,0,9999,0
1748418108201,CSE 293,042,968589,Swanson; Steven James,9999,0,9999,0
1748418108201,CSE 293,043,968639,Tullsen; Dean Michael,9999,0,9999,0
1748418108201,CSE 293,044,968674,Vaccaro; Kristen Marie,9999,0,9999,0
1748418108201,CSE 293,045,968681,Voelker; Geoffrey M.,9999,0,9999,0
1748418108201,CSE 293,046,968692,Zhao; Jishen,9999,0,9999,0
1748418108201,CSE 293,047,968694,Zhou; Yuan-Yuan,9999,0,9999,0
1748418108201,CSE 293,048,968702,Gao; Sicun,9999,0,9999,0
1748418108201,CSE 293,049,968703,Weibel; Nadir,9999,0,9999,0
1748418108201,CSE 293,050,968704,Gupta; Rajesh K.,9999,0,9999,0
1748418108201,CSE 293,051,968705,Soosai Raj; Adalbert Geral,9999,0,9999,0
1748418109231,CSE 294,A00,915055,Orailoglu; Alex,0,0,0,0
1748418110256,CSS 1,A01,958041,Staff,31,0,41,10
1748418110256,CSS 1,A02,958042,Staff,41,0,41,0
1748418110256,CSS 1,A03,958043,Staff,33,0,41,8
1748418110256,CSS 1,A04,958044,Staff,39,0,41,2
1748418111288,CSS 120,A01,915059,Staff,0,0,0,0
1748418112314,CSS 204,A01,915061,Long; Bria,0,0,0,0
1748418113342,CSS 209,A00,915062,Staff,14,0,40,26
1748418114369,DDPM 200,A00,919742,Ma; Joseph David,35,0,35,0
1748418115399,DDPM 201,A00,919743,Ma; Joseph David,35,0,35,0
1748418116426,DDPM 202,A00,919761,Reed; Chantal,35,0,35,0
1748418117458,DDPM 203,A00,963085,Momper; Jeremiah D,40,0,40,0
1748418118514,DOC 1,A01,916077,Staff,4,0,4,0
1748418118514,DOC 1,A02,916080,Staff,1,0,4,3
1748418118514,DOC 1,A03,916081,Staff,1,0,4,3
1748418118514,DOC 1,A04,916082,Staff,3,0,4,1
1748418118514,DOC 1,A05,916083,Staff,2,0,4,2
1748418118514,DOC 1,A06,916084,Staff,4,0,4,0
1748418118514,DOC 1,A07,916085,Staff,4,0,4,0
1748418118514,DOC 1,A08,916096,Staff,4,0,4,0
1748418118514,DOC 1,A09,916097,Staff,4,0,4,0
1748418118514,DOC 1,A10,916099,Staff,4,0,4,0
1748418118514,DOC 1,A11,916170,Staff,0,0,0,0
1748418118514,DOC 1,A12,916186,Staff,0,0,0,0
1748418118514,DOC 1,A13,916203,Staff,4,0,4,0
1748418118514,DOC 1,A14,916222,Staff,4,0,4,0
1748418118514,DOC 1,A15,916223,Staff,4,0,4,0
1748418118514,DOC 1,A16,916224,Staff,4,0,4,0
1748418118514,DOC 1,B01,916279,Staff,4,0,4,0
1748418118514,DOC 1,B02,916281,Staff,2,0,4,2
1748418118514,DOC 1,B03,916282,Staff,3,0,4,1
1748418118514,DOC 1,B04,916283,Staff,3,0,4,1
1748418118514,DOC 1,B05,916284,Staff,2,0,4,2
1748418118514,DOC 1,B06,916285,Staff,3,0,4,1
1748418118514,DOC 1,B07,916287,Staff,4,0,4,0
1748418118514,DOC 1,B08,916288,Staff,3,0,4,1
1748418118514,DOC 1,B09,916289,Staff,0,0,0,0
1748418118514,DOC 1,B10,916290,Staff,0,0,0,0
1748418118514,DOC 1,B11,916349,Staff,4,0,4,0
1748418118514,DOC 1,B12,916375,Staff,4,0,4,0
1748418118514,DOC 1,B13,916381,Staff,3,0,4,1
1748418118514,DOC 1,B14,916382,Staff,2,0,4,2
1748418118514,DOC 1,B15,916383,Staff,4,0,4,0
1748418118514,DOC 1,B16,916384,Staff,3,0,4,1
1748418118514,DOC 1,C01,916386,Staff,4,0,4,0
1748418118514,DOC 1,C02,916387,Staff,4,0,4,0
1748418118514,DOC 1,C03,916388,Staff,4,0,4,0
1748418118514,DOC 1,C04,916389,Staff,0,0,4,4
1748418118514,DOC 1,C05,916390,Staff,2,0,4,2
1748418118514,DOC 1,C06,916391,Staff,2,0,4,2
1748418118514,DOC 1,C07,916392,Staff,4,0,4,0
1748418118514,DOC 1,C08,916417,Staff,4,0,4,0
1748418118514,DOC 1,C09,916418,Staff,0,0,0,0
1748418118514,DOC 1,C10,916426,Staff,0,0,0,0
1748418118514,DOC 1,C11,916497,Staff,4,0,4,0
1748418118514,DOC 1,C12,916506,Staff,3,0,4,1
1748418118514,DOC 1,C13,916507,Staff,3,0,4,1
1748418118514,DOC 1,C14,916508,Staff,3,0,4,1
1748418118514,DOC 1,C15,916509,Staff,4,0,4,0
1748418118514,DOC 1,C16,916510,Staff,4,0,4,0
1748418118514,DOC 1,D01,916512,Staff,4,0,4,0
1748418118514,DOC 1,D02,916513,Staff,4,0,4,0
1748418118514,DOC 1,D03,916514,Staff,4,0,4,0
1748418118514,DOC 1,D04,916515,Staff,4,0,4,0
1748418118514,DOC 1,D05,916516,Staff,1,0,4,3
1748418118514,DOC 1,D06,916555,Staff,4,0,4,0
1748418118514,DOC 1,D07,916581,Staff,4,0,4,0
1748418118514,DOC 1,D08,916582,Staff,4,0,4,0
1748418118514,DOC 1,D09,916583,Staff,0,0,0,0
1748418118514,DOC 1,D10,916584,Staff,0,0,0,0
1748418118514,DOC 1,D11,916585,Staff,4,0,4,0
1748418118514,DOC 1,D12,916586,Staff,4,0,4,0
1748418118514,DOC 1,D13,916587,Staff,4,0,4,0
1748418118514,DOC 1,D14,916588,Staff,4,0,4,0
1748418118514,DOC 1,D15,916589,Staff,3,0,4,1
1748418118514,DOC 1,D16,916590,Staff,4,0,4,0
1748418119541,DOC 100D,A00,916591,Pass; Natalye,22,0,25,3
1748418119541,DOC 100D,B00,916838,Pass; Natalye,22,0,25,3
1748418120578,DSC 10,A01,915848,Tiefenbruck; Janine LoBue,0,0,0,0
1748418120578,DSC 10,B01,915851,Tiefenbruck; Janine LoBue,0,0,0,0
1748418120578,DSC 10,C01,915854,Tiefenbruck; Janine LoBue,0,0,0,0
1748418121606,DSC 20,A01,915857,Langlois; Marina,87,0,90,3
1748418122634,DSC 30,A01,915859,Liao; Soohyun Nam,175,0,180,5
1748418123662,DSC 40A,A01,915861,Mishne; Gal,168,0,180,12
1748418124690,DSC 40B,A01,915863,Langlois; Marina,125,0,149,24
1748418125718,DSC 80,A01,915865,Eldridge; Justin Matthew,117,0,145,28
1748418125718,DSC 80,B01,915867,Eldridge; Justin Matthew,140,0,145,5
1748418126748,DSC 95,A01,915869,Langlois; Marina,50,0,50,0
1748418127775,DSC 100,A01,915871,Shannon; Kyle Michael,97,0,150,53
1748418128804,DSC 102,A01,915890,Kolovos; Alexandros,128,0,150,22
1748418129834,DSC 106,A01,915892,Lau; Samuel Ethan,74,0,90,16
1748418129834,DSC 106,B01,915894,Lau; Samuel Ethan,53,0,90,37
1748418130861,DSC 140A,A01,915896,Ustun; Tevfik Berk,135,0,150,15
1748418131888,DSC 161,A00,968072,Roberts; Margaret Earling,24,0,25,1
1748418132919,DSC 180A,A01,915898,Bellur; Umesh,0,0,0,0
1748418132919,DSC 180A,A02,969828,Bellur; Umesh,0,0,0,0
1748418132919,DSC 180A,A03,969829,Bellur; Umesh,0,0,0,0
1748418132919,DSC 180A,A04,969830,Bellur; Umesh,0,0,0,0
1748418132919,DSC 180A,A05,969831,Bellur; Umesh,0,0,0,0
1748418132919,DSC 180A,A06,969833,Bellur; Umesh,0,0,0,0
1748418132919,DSC 180A,A07,969835,Bellur; Umesh,0,0,0,0
1748418132919,DSC 180A,A08,969836,Bellur; Umesh,0,0,0,0
1748418132919,DSC 180A,A09,969978,Bellur; Umesh,0,0,0,0
1748418132919,DSC 180A,A10,969985,Bellur; Umesh,0,0,0,0
1748418132919,DSC 180A,A11,969986,Bellur; Umesh,0,0,0,0
1748418132919,DSC 180A,A12,970002,Bellur; Umesh,0,0,0,0
1748418132919,DSC 180A,A13,970008,Bellur; Umesh,0,0,0,0
1748418132919,DSC 180A,A14,970011,Bellur; Umesh,0,0,0,0
1748418132919,DSC 180A,A15,970014,Bellur; Umesh,0,0,0,0
1748418132919,DSC 180A,A16,970019,Bellur; Umesh,0,0,0,0
1748418132919,DSC 180A,A17,970020,Bellur; Umesh,0,0,0,0
1748418132919,DSC 180A,B01,915901,Bellur; Umesh,0,0,0,0
1748418132919,DSC 180A,B02,915902,Bellur; Umesh,0,0,0,0
1748418132919,DSC 180A,B03,970021,Bellur; Umesh,0,0,0,0
1748418132919,DSC 180A,B04,970024,Bellur; Umesh,0,0,0,0
1748418132919,DSC 180A,B05,970025,Bellur; Umesh,0,0,0,0
1748418132919,DSC 180A,B06,970028,Bellur; Umesh,0,0,0,0
1748418132919,DSC 180A,B07,970030,Bellur; Umesh,0,0,0,0
1748418132919,DSC 180A,B08,970031,Bellur; Umesh,0,0,0,0
1748418132919,DSC 180A,B09,970034,Bellur; Umesh,0,0,0,0
1748418132919,DSC 180A,B10,970035,Bellur; Umesh,0,0,0,0
1748418132919,DSC 180A,B11,970042,Bellur; Umesh,0,0,0,0
1748418132919,DSC 180A,B12,970043,Bellur; Umesh,0,0,0,0
1748418132919,DSC 180A,B13,970047,Bellur; Umesh,0,0,0,0
1748418132919,DSC 180A,B14,970049,Bellur; Umesh,0,0,0,0
1748418132919,DSC 180A,B15,970050,Bellur; Umesh,0,0,0,0
1748418132919,DSC 180A,B16,970052,Bellur; Umesh,0,0,0,0
1748418132919,DSC 180A,B17,970057,Bellur; Umesh,0,0,0,0
1748418132919,DSC 180A,B18,970060,Bellur; Umesh,0,0,0,0
1748418132919,DSC 180A,B19,970063,Bellur; Umesh,0,0,0,0
1748418132919,DSC 180A,B20,970068,Bellur; Umesh,0,0,0,0
1748418132919,DSC 180A,B21,970070,Bellur; Umesh,0,0,0,0
1748418132919,DSC 180A,B22,970071,Bellur; Umesh,0,0,0,0
1748418132919,DSC 180A,B23,970075,Bellur; Umesh,0,0,0,0
1748418132919,DSC 180A,B24,970076,Bellur; Umesh,0,0,0,0
1748418132919,DSC 180A,B25,970083,Bellur; Umesh,0,0,0,0
1748418132919,DSC 180A,B26,970072,Bellur; Umesh,0,0,0,0
1748418133947,DSC 190,A01,915904,Schwartzman; Armin,176,0,200,24
1748418133947,DSC 190,C01,915908,Ma; Yian,48,0,60,12
1748418134974,DSC 197,001,971692,Eldridge; Justin Matthew,9999,0,9999,0
1748418136002,DSC 200,A00,915909,Watson-Parris; Duncan,0,0,100,100
1748418137029,DSC 204A,A00,915910,Zhang; Hao,65,0,90,25
1748418138056,DSC 207R,A01,915912,Soosai Raj; Adalbert Geral,99,0,100,1
1748418139081,DSC 209R,A01,915922,Lau; Samuel Ethan,34,0,75,41
1748418140107,DSC 210,A00,915979,Weng; Tsui-Wei (lily),0,0,100,100
1748418141134,DSC 212,A00,915984,Mazumdar; Arya,0,0,90,90
1748418142163,DSC 215R,A01,916032,Saab; Rayan,99,0,100,1
1748418144213,DSC 241,A00,916052,Aoi; Mikio C,81,0,90,9
1748418145243,DSC 256R,A01,916054,McAuley; Julian John,42,0,100,58
1748418146269,DSC 257R,A01,916057,Dasgupta; Sanjoy,50,0,75,25
1748418147302,DSC 261,A00,916058,Salimi; Babak,0,0,90,90
1748418148345,DSC 291,A00,916059,Rahman; Tauhidur,0,0,60,60
1748418148345,DSC 291,B00,916060,Wang; Yuxiang,0,0,60,60
1748418148345,DSC 291,C00,916061,Li; Aobo,0,0,40,40
1748418149374,DSC 293,A00,916062,Ustun; Tevfik Berk,9983,0,9999,16
1748418150404,DSC 294,001,970730,Danks; David J,9999,0,9999,0
1748418150404,DSC 294,002,970731,Hu; Zhiting,9999,0,9999,0
1748418150404,DSC 294,003,970732,Schwartzman; Armin,9999,0,9999,0
1748418150404,DSC 294,004,970739,Salimi; Babak,9999,0,9999,0
1748418150404,DSC 294,005,970742,Wang; Yuxiang,9999,0,9999,0
1748418150404,DSC 294,006,970749,Huang; Biwei,9999,0,9999,0
1748418150404,DSC 294,007,970751,Amariuta-Bartell; Tiffany,9999,0,9999,0
1748418150404,DSC 294,008,970754,Smarr; Benjamin,9999,0,9999,0
1748418150404,DSC 294,009,970755,Jin; Haojian,9999,0,9999,0
1748418150404,DSC 294,010,970758,Ma; Yian,9999,0,9999,0
1748418150404,DSC 294,011,970763,Warstadt; Alexander Scott,9999,0,9999,0
1748418150404,DSC 294,012,970764,Wang; Yusu,9999,0,9999,0
1748418150404,DSC 294,013,970766,Lau; Samuel Ethan,9999,0,9999,0
1748418150404,DSC 294,014,970771,Politis; Dimitris,9999,0,9999,0
1748418151430,DSE 200,A00,915842,Staff,30,0,30,0
1748418152455,DSE 203,A00,915844,Staff,20,0,20,0
1748418153481,DSE 220,A00,915845,Staff,20,0,20,0
1748418154507,DSE 290,A00,915846,Staff,30,0,30,0
1748418155534,DSGN 1,A01,913417,Meyer; Michael Wayne,0,0,50,50
1748418155534,DSGN 1,A02,913418,Meyer; Michael Wayne,15,0,50,35
1748418157587,DSGN 118,A01,914325,Xia; Haijun,0,0,50,50
1748418158614,DSGN 201,A00,970721,Eikey; Elizabeth Victoria,10,0,20,10
1748418159648,ECE 5,A01,917741,Morris; Karcher William,0,0,0,0
1748418159648,ECE 5,A02,917742,Morris; Karcher William,0,0,0,0
1748418159648,ECE 5,A03,917775,Morris; Karcher William,0,0,0,0
1748418159648,ECE 5,A04,917804,Morris; Karcher William,0,0,0,0
1748418159648,ECE 5,A05,917811,Morris; Karcher William,0,0,0,0
1748418159648,ECE 5,A06,917816,Morris; Karcher William,0,0,0,0
1748418160676,ECE 15,A01,917850,Schurgers; Curt,0,0,0,0
1748418160676,ECE 15,A02,917851,Schurgers; Curt,0,0,0,0
1748418161707,ECE 17,A01,917878,Sahay; Rajeev,61,0,65,4
1748418162733,ECE 18,A01,917886,Sahay; Rajeev,42,0,50,8
1748418163769,ECE 25,A50,917898,Liu; Zhaowei,0,0,0,0
1748418163769,ECE 25,A51,917900,Liu; Zhaowei,0,0,0,0
1748418163769,ECE 25,A52,917904,Liu; Zhaowei,0,0,0,0
1748418163769,ECE 25,A53,969573,Liu; Zhaowei,0,0,0,0
1748418164815,ECE 30,A50,917909,Mir Arabbaygi; Siavash,12,0,30,18
1748418164815,ECE 30,A51,917910,Mir Arabbaygi; Siavash,21,0,30,9
1748418164815,ECE 30,A52,917912,Mir Arabbaygi; Siavash,29,0,30,1
1748418165854,ECE 35,A50,917993,Schurgers; Curt,0,0,0,0
1748418165854,ECE 35,A51,917994,Schurgers; Curt,0,0,0,0
1748418165854,ECE 35,A52,918000,Schurgers; Curt,0,0,0,0
1748418165854,ECE 35,A53,918001,Schurgers; Curt,0,0,0,0
1748418165854,ECE 35,A54,918072,Schurgers; Curt,0,0,0,0
1748418165854,ECE 35,A55,918078,Schurgers; Curt,0,0,0,0
1748418165854,ECE 35,B50,918131,Schurgers; Curt,0,0,0,0
1748418165854,ECE 35,B51,918135,Schurgers; Curt,0,0,0,0
1748418165854,ECE 35,B52,918146,Schurgers; Curt,0,0,0,0
1748418165854,ECE 35,B53,918147,Schurgers; Curt,0,0,0,0
1748418165854,ECE 35,B54,918148,Schurgers; Curt,0,0,0,0
1748418165854,ECE 35,B55,918149,Schurgers; Curt,0,0,0,0
1748418166881,ECE 45,A01,918151,Zeger; Kenneth A.,94,0,120,26
1748418167908,ECE 65,A50,918356,Baghdadchi; Saharnaz,1,0,30,29
1748418167908,ECE 65,A51,918470,Baghdadchi; Saharnaz,17,0,30,13
1748418167908,ECE 65,A52,918477,Baghdadchi; Saharnaz,25,0,30,5
1748418168935,ECE 100,A01,918485,Baghdadchi; Saharnaz,0,0,30,30
1748418168935,ECE 100,A02,918486,Baghdadchi; Saharnaz,1,0,30,29
1748418168935,ECE 100,A03,918488,Baghdadchi; Saharnaz,1,0,30,29
1748418168935,ECE 100,A04,918490,Baghdadchi; Saharnaz,22,0,30,8
1748418169961,ECE 101,A01,918495,Zheng; Yang,22,0,75,53
1748418169961,ECE 101,A02,918497,Zheng; Yang,51,0,75,24
1748418170991,ECE 102,A00,918499,Hsueh; Tzu-Chien,52,0,100,48
1748418172019,ECE 103,A01,918621,Ng; Tse Nga,45,0,60,15
1748418173054,ECE 107,A01,918642,Fullerton; Eric E,31,0,70,39
1748418174087,ECE 108,A01,918661,Turakhia; Yatish Girish,6,0,70,64
1748418175118,ECE 109,A01,918758,Poveda Fonseca; Jorge,122,0,149,27
1748418176149,ECE 111,A01,918766,Koushanfar; Farinaz,46,0,75,29
1748418177182,ECE 121A,A50,918857,Esmaili; Gholamreza,11,0,24,13
1748418177182,ECE 121A,A51,918888,Esmaili; Gholamreza,15,0,24,9
1748418177182,ECE 121A,A52,918889,Esmaili; Gholamreza,2,0,24,22
1748418178207,ECE 128A,A00,918911,Esmaili; Gholamreza,53,0,75,22
1748418179233,ECE 135A,A01,918931,Kuzum; Duygu,24,0,40,16
1748418180262,ECE 143,A00,918936,Staff,0,0,0,3
1748418181290,ECE 148,A01,918940,Silberman; Jack,14,0,24,10
1748418182317,ECE 155,A01,919022,Gonzalez Prelcic; Nuria,20,0,25,5
1748418183404,ECE 158A,A01,919041,Javidi; Tara,58,0,70,12
1748418184430,ECE 161A,A01,919070,Meyer; Florian,65,0,80,15
1748418185457,ECE 164,A00,919098,Hall; Drew A.,100,0,146,46
1748418186486,ECE 166,A50,919250,Rebeiz; Gabriel,0,0,30,30
1748418186486,ECE 166,A51,919254,Rebeiz; Gabriel,23,0,30,7
1748418186486,ECE 166,A52,919262,Rebeiz; Gabriel,29,0,30,1
1748418186486,ECE 166,A53,919316,Rebeiz; Gabriel,28,0,30,2
1748418187513,ECE 171B,A01,919338,Shi; Yuanyuan,36,0,50,14
1748418188538,ECE 174,A01,919371,Wang; Jun-Kun,77,0,100,23
1748418189566,ECE 180,A00,968047,Fainman; Yeshaiahu,30,0,30,0
1748418190610,ECE 182,A01,962444,Fainman; Yeshaiahu,24,0,30,6
1748418191640,ECE 197,001,919379,Mercier; Patrick Philip,9999,0,9999,0
1748418192670,ECE 198,001,919418,Nguyen; Truong Quang,9999,0,9999,0
1748418193701,ECE 201,A00,919420,Lo; Yu-Hwa,0,0,0,0
1748418194733,ECE 203,A01,919506,Mercier; Patrick Philip,0,0,0,0
1748418195767,ECE 207A,A00,919507,Liu; Thomas Tao-Ming & McVeigh; Elliot R.,0,0,0,0
1748418196798,ECE 212AN,A00,919508,Nomura; Kenji,0,0,0,0
1748418197825,ECE 222A,A00,919524,Rebeiz; Gabriel,0,0,0,0
1748418198857,ECE 225A,A00,919525,Orlitsky; Alon,0,0,0,0
1748418199884,ECE 230A,A00,919526,Nomura; Kenji,0,0,0,0
1748418200911,ECE 238A,A00,919540,Luo; Jian,0,0,0,0
1748418201939,ECE 240A,A00,919541,Ndao; Abdoulaye,0,0,0,0
1748418202973,ECE 247A,A00,919553,Shi; Lingyan,0,0,0,0
1748418204003,ECE 247B,A00,919562,Aran; Kiana,0,0,0,0
1748418205030,ECE 250,A00,919563,Naghizadeh Ardabili; Parinaz,0,0,0,0
1748418206058,ECE 251C,A00,919583,Parhi; Rahul,0,0,0,0
1748418207084,ECE 253,A00,919597,Nguyen; Truong Quang,0,0,0,0
1748418208111,ECE 255A,A00,919638,Orlitsky; Alon,0,0,0,0
1748418209143,ECE 257A,A01,919640,Zhang; Xinyu,0,0,0,0
1748418210170,ECE 258A,A00,919653,Heath Jr.; Robert Wendell,0,0,0,0
1748418211195,ECE 260A,A01,919655,Eldon; John,0,0,0,0
1748418212222,ECE 264C,A00,919656,Galton; Ian A,0,0,0,0
1748418213251,ECE 265C,A00,919672,Staff,0,0,0,0
1748418214283,ECE 271A,A00,919673,Vasconcelos; Nuno,0,0,0,0
1748418215308,ECE 276C,A00,919674,Yip; Michael,0,0,0,0
1748418216336,ECE 283,A00,919675,Le; Hanh-Phuc,0,0,0,0
1748418216336,ECE 283,B00,919676,Hall; Drew A.,0,0,0,0
1748418217366,ECE 284,A00,919691,Kang; Mingu,0,0,0,0
1748418218392,ECE 285,A00,919718,Naghizadeh Ardabili; Parinaz,0,0,0,0
1748418219434,ECON 1,A01,917129,Famulari; Melissa,32,0,40,8
1748418219434,ECON 1,A02,917130,Famulari; Melissa,40,0,40,0
1748418219434,ECON 1,A03,917131,Famulari; Melissa,45,0,45,0
1748418219434,ECON 1,B01,917133,Famulari; Melissa,39,0,40,1
1748418219434,ECON 1,B02,917134,Famulari; Melissa,38,0,40,2
1748418219434,ECON 1,B03,917135,Famulari; Melissa,45,0,45,0
1748418219434,ECON 1,C01,917137,Levkoff; Steven B.,53,0,60,7
1748418219434,ECON 1,C02,917138,Levkoff; Steven B.,60,0,60,0
1748418219434,ECON 1,C03,917139,Levkoff; Steven B.,59,0,60,1
1748418219434,ECON 1,C04,917140,Levkoff; Steven B.,60,0,60,0
1748418219434,ECON 1,C05,917141,Levkoff; Steven B.,59,0,60,1
1748418219434,ECON 1,D01,917144,Levkoff; Steven B.,44,0,50,6
1748418219434,ECON 1,D02,917145,Levkoff; Steven B.,50,0,50,0
1748418219434,ECON 1,D03,917146,Levkoff; Steven B.,50,0,50,0
1748418219434,ECON 1,D04,917154,Levkoff; Steven B.,50,0,50,0
1748418220468,ECON 2,A01,917160,Crane; Meredith Helen,35,0,45,10
1748418220468,ECON 2,A02,917164,Crane; Meredith Helen,43,0,45,2
1748418221498,ECON 3,A01,917170,Ma; Alyson Chan,41,0,60,19
1748418222528,ECON 4,A01,917174,Brooks; Marcus Raymond,0,0,0,0
1748418223557,ECON 5,A01,917177,Staff,12,0,30,18
1748418223557,ECON 5,B01,917182,Staff,15,0,30,15
1748418223557,ECON 5,C01,917193,Dai; Yinlin,0,0,30,30
1748418224584,ECON 86,A00,917197,Muendler; Marc,95,0,100,5
1748418225612,ECON 100A,A01,917209,Newhouse; Herbert S,32,0,50,18
1748418225612,ECON 100A,A02,917212,Newhouse; Herbert S,35,0,50,15
1748418225612,ECON 100A,A03,917213,Newhouse; Herbert S,42,0,50,8
1748418225612,ECON 100A,B01,917216,Newhouse; Herbert S,0,0,50,50
1748418225612,ECON 100A,B02,917298,Newhouse; Herbert S,22,0,50,28
1748418225612,ECON 100A,B03,917301,Newhouse; Herbert S,44,0,50,6
1748418226645,ECON 100B,A01,917305,Crane; Meredith Helen,0,0,75,75
1748418226645,ECON 100B,B01,917309,Crane; Meredith Helen,0,0,75,75
1748418227671,ECON 100C,A01,917311,Staff,0,0,25,25
1748418228699,ECON 109,A01,917313,Shishkin; Denis,58,0,65,7
1748418228699,ECON 109,B01,917315,Shishkin; Denis,59,0,75,16
1748418229733,ECON 110A,A01,917336,Jaimovich; Nir,44,0,70,26
1748418229733,ECON 110A,B01,917339,Jaimovich; Nir,19,0,37,18
1748418229733,ECON 110A,B02,917341,Jaimovich; Nir,36,0,38,2
1748418230758,ECON 110B,A01,917388,Trottner; Fabian Gunter We,0,0,50,50
1748418230758,ECON 110B,A02,917389,Trottner; Fabian Gunter We,0,0,50,50
1748418230758,ECON 110B,A03,917390,Trottner; Fabian Gunter We,14,0,50,36
1748418230758,ECON 110B,B01,917396,Trottner; Fabian Gunter We,26,0,50,24
1748418231785,ECON 120A,A01,917401,Dai; Yinlin,21,0,50,29
1748418231785,ECON 120A,A02,917405,Dai; Yinlin,40,0,50,10
1748418231785,ECON 120A,B01,917408,Dai; Yinlin,0,0,40,40
1748418231785,ECON 120A,B02,917409,Dai; Yinlin,0,0,40,40
1748418231785,ECON 120A,B03,917410,Dai; Yinlin,31,0,40,9
1748418232819,ECON 120B,A01,917415,Candido; Maria Teresa,0,0,98,98
1748418232819,ECON 120B,A02,917418,Candido; Maria Teresa,78,0,98,20
1748418232819,ECON 120B,B01,917422,Candido; Maria Teresa,34,0,98,64
1748418232819,ECON 120B,B02,917423,Candido; Maria Teresa,75,0,98,23
1748418233850,ECON 120C,A01,917505,Candido; Maria Teresa,81,0,146,65
1748418234878,ECON 121,A00,917511,Vogl; Tom Saul,68,0,70,2
1748418234878,ECON 121,B00,917516,Vogl; Tom Saul,55,0,70,15
1748418235905,ECON 130,A00,917518,Staff,165,0,190,25
1748418236934,ECON 131,A00,917519,Jacobsen; Mark,56,0,120,64
1748418237964,ECON 139,A00,917520,Arnold; David Hall,21,0,50,29
1748418238991,ECON 152,A00,917523,Fadlon; Yizhak,87,0,90,3
1748418238991,ECON 152,B00,917524,Fadlon; Yizhak,88,0,90,2
1748418240020,ECON 181,A00,965256,Esfahani; Sara,87,0,100,13
1748418241065,ECON 186,A00,917525,Ross; Stephen Geoffrey,80,0,110,30
1748418242093,ECON 191B,A00,917527,Cullen; Julie,20,0,20,0
1748418243124,ECON 200A,A00,917529,Shishkin; Denis,20,0,20,0
1748418244150,ECON 204,A00,917531,Watson; Joel Christopher,25,0,25,0
1748418245177,ECON 205,A00,917532,Du; Songzi,20,0,20,0
1748418246208,ECON 210A,A00,917536,Alon; Titan Michael,20,0,20,0
1748418247238,ECON 220A,A00,917537,Elliott; Graham,20,0,20,0
1748418248264,ECON 220D,A00,917538,Hamilton; James D.,22,0,30,8
1748418249291,ECON 221,A00,960527,Zhu; Ying,20,0,20,0
1748418250317,ECON 232,A00,917539,Fadlon; Yizhak,18,0,20,2
1748418251343,ECON 242,A00,917540,Vogl; Tom Saul & Lee; Munseob,17,0,20,3
1748418252378,ECON 250A,A00,917544,Berman; Eli & Betts; Julian & Arnold; David Hall,21,0,25,4
1748418253406,ECON 262,A00,917546,Trevino; Isabel,20,0,20,0
1748418254435,ECON 268,A00,917547,Boomhower; Judson P,18,0,20,2
1748418255463,ECON 280,A00,917549,Arnold; David Hall,20,0,20,0
1748418256493,ECON 281,A00,917550,Jacobsen; Mark,20,0,20,0
1748418256493,ECON 281,B00,917553,Jaimovich; Nir,15,0,20,5
1748418257524,ECON 285,A00,917554,Bharadwaj; Prashant & Zhu; Ying,24,0,25,1
1748418258552,ECON 286,A00,917556,Ma; Xinwei,20,0,20,0
1748418258552,ECON 286,B00,917558,Eckert; Fabian Paul & Wu; Pak Yeung,20,0,20,0
1748418258552,ECON 286,C00,917559,Bharadwaj; Prashant,20,0,20,0
1748418258552,ECON 286,D00,969571,Cullen; Julie,20,0,20,0
1748418258552,ECON 286,E00,969572,Vespa; Emanuel Ignacio,19,0,20,1
1748418259579,ECON 296,A00,917565,Bharadwaj; Prashant & Zhu; Ying,24,0,25,1
1748418260607,EDS 31,A00,960270,Bussey; Thomas J,5,0,10,5
1748418261638,EDS 88,A00,960441,Bintliff; Amy S.V.,16,0,20,4
1748418262669,EDS 110R,A01,943452,Wishard Guerra; Alison G.,33,0,60,27
1748418262669,EDS 110R,B01,960792,Wishard Guerra; Alison G.,20,0,20,0
1748418263695,EDS 111,A00,969314,Cohen; Shana R,31,0,60,29
1748418264722,EDS 112,A00,969313,Chapman; Thandeka K,32,0,50,18
1748418265751,EDS 114,A01,943493,Eguchi; Emi,19,0,20,1
1748418265751,EDS 114,A02,943494,Eguchi; Emi,18,0,20,2
1748418266776,EDS 115,A00,943495,Jones; Gabrielle Anastasia,46,0,60,14
1748418267805,EDS 117,A01,943675,Jones; Makeba,17,0,37,20
1748418267805,EDS 117,A02,943682,Jones; Makeba,36,0,37,1
1748418267805,EDS 117,A03,943683,Jones; Makeba,33,0,38,5
1748418267805,EDS 117,A04,943691,Jones; Makeba,35,0,38,3
1748418267805,EDS 117,B01,943693,Jones; Gabrielle Anastasia,21,0,30,9
1748418267805,EDS 117,B02,943694,Jones; Gabrielle Anastasia,27,0,30,3
1748418267805,EDS 117,B03,943695,Jones; Gabrielle Anastasia,28,0,30,2
1748418267805,EDS 117,B04,943696,Jones; Gabrielle Anastasia,30,0,30,0
1748418268834,EDS 124AR,A00,943698,Simon; Elizabeth A,129,0,150,21
1748418268834,EDS 124AR,B00,943699,Simon; Elizabeth A,149,0,150,1
1748418268834,EDS 124AR,C00,961307,Simon; Elizabeth A,40,0,40,0
1748418269863,EDS 124BR,A00,943700,Eguchi; Emi,122,0,150,28
1748418269863,EDS 124BR,B00,961276,Eguchi; Emi,20,0,20,0
1748418270890,EDS 125,A00,943701,Jones; Gabrielle Anastasia,49,0,60,11
1748418271921,EDS 129A,A01,943703,Heinzman; Erica M.,48,0,50,2
1748418272946,EDS 130,A01,943705,Staff,6,0,20,14
1748418272946,EDS 130,A02,943706,Staff,18,0,20,2
1748418272946,EDS 130,A03,943707,Staff,20,0,20,0
1748418273978,EDS 131,A01,943709,Staff,8,0,20,12
1748418273978,EDS 131,A02,943710,Staff,17,0,20,3
1748418275004,EDS 133,A01,960443,Bintliff; Amy S.V.,20,0,25,5
1748418275004,EDS 133,A02,960447,Bintliff; Amy S.V.,15,0,15,0
1748418276031,EDS 139,A00,943725,Heinzman; Erica M.,40,0,50,10
1748418276031,EDS 139,B00,943726,Staff,29,0,50,21
1748418276031,EDS 139,C00,943788,Staff,34,0,50,16
1748418276031,EDS 139,E00,943802,Bintliff; Amy S.V.,42,0,50,8
1748418276031,EDS 139,F00,960448,Bintliff; Amy S.V.,40,0,40,0
1748418277056,EDS 149,A00,943814,Black; Alison Michelle,20,0,20,0
1748418278085,EDS 201,A00,943816,Fine; Sarah,44,0,45,1
1748418279119,EDS 203,A01,943818,Eguchi; Emi,44,0,45,1
1748418280149,EDS 205A,A00,943819,Staff,44,0,45,1
1748418281180,EDS 246,A01,943855,Cohen; Shana R,10,0,10,0
1748418282209,EDS 250,A00,943856,Chapman; Thandeka K,49,0,50,1
1748418283235,EDS 251,A00,943862,Wishard Guerra; Alison G.,10,0,10,0
1748418284270,EDS 257,A00,943863,Datnow; Amanda Lee,7,0,10,3
1748418285296,EDS 283,A00,943871,Daly; Alan J.,15,0,15,0
1748418286321,EDS 285,A00,943872,Daly; Alan J.,15,0,15,0
1748418287415,EDS 286,A00,943873,Daly; Alan J.,15,0,15,0
1748418288442,EDS 289D,A00,943874,Hofstetter; Carolyn,15,0,15,0
1748418289469,EDS 292,A00,943876,Hofstetter; Carolyn,15,0,15,0
1748418290501,EDS 296,001,970523,Aragon; Maria Jose,9999,0,9999,0
1748418290501,EDS 296,002,970539,Bintliff; Amy S.V.,9997,0,9999,2
1748418290501,EDS 296,003,970543,Chapman; Thandeka K,9999,0,9999,0
1748418290501,EDS 296,004,970544,Clarke; Sherice Nicole,9999,0,9999,0
1748418290501,EDS 296,005,970587,Cohen; Shana R,9998,0,9999,1
1748418290501,EDS 296,006,970606,Daly; Alan J.,9998,0,9999,1
1748418290501,EDS 296,007,970607,Datnow; Amanda Lee,9997,0,9999,2
1748418290501,EDS 296,008,970608,Eguchi; Emi,9999,0,9999,0
1748418290501,EDS 296,009,970609,Fine; Sarah,9999,0,9999,0
1748418290501,EDS 296,010,970614,Hofstetter; Carolyn,9998,0,9999,1
1748418290501,EDS 296,011,970615,Hopkins; Megan Beth,9998,0,9999,1
1748418290501,EDS 296,012,970616,Jones; Makeba,9999,0,9999,0
1748418290501,EDS 296,013,970631,Jones; Gabrielle Anastasia,9999,0,9999,0
1748418290501,EDS 296,014,970636,Mamas; Christoforos,9998,0,9999,1
1748418290501,EDS 296,015,970649,Phuong; Andrew,9999,0,9999,0
1748418290501,EDS 296,016,970670,Pollock; Mica,9999,0,9999,0
1748418290501,EDS 296,017,970671,Wishard Guerra; Alison G.,9998,0,9999,1
1748418291528,EDS 297,001,972987,Staff,1,0,1,0
1748418292556,ENG 5,A00,916064,Rodriguez; Ruben,70,0,70,0
1748418293582,ENG 10,A00,916066,Evdokimenko; Ekaterina,58,0,60,2
1748418294608,ENG 15,A00,916067,Evdokimenko; Ekaterina,24,0,30,6
1748418295637,ENG 100D,A00,916069,Ngo; Anh-Thu T.,23,0,50,27
1748418296673,ENG 100L,A00,916070,Kleissl; Jan,8,0,8,0
1748418296673,ENG 100L,B00,916071,Bratton; Maryann,8,0,8,0
1748418296673,ENG 100L,C00,916072,Goldberg; Charles G.,8,0,8,0
1748418296673,ENG 100L,D00,916073,de Oliveira; Mauricio,8,0,8,0
1748418296673,ENG 100L,E00,916074,Bratton; Maryann,8,0,8,0
1748418296673,ENG 100L,F00,916075,Boyle; Mary E. T.,8,0,8,0
1748418297702,ENVR 30,A01,959899,Amoa-Bosompem; Michael,17,0,30,13
1748418297702,ENVR 30,A02,959900,Amoa-Bosompem; Michael,27,0,30,3
1748418297702,ENVR 30,A03,959901,Amoa-Bosompem; Michael,26,0,30,4
1748418297702,ENVR 30,A04,959902,Amoa-Bosompem; Michael,28,0,30,2
1748418297702,ENVR 30,A05,959903,Amoa-Bosompem; Michael,29,0,30,1
1748418297702,ENVR 30,A06,959904,Amoa-Bosompem; Michael,30,0,30,0
1748418298729,ENVR 102,A00,960031,Laughing; Cheron,23,0,25,2
1748418299762,ERC 20,A00,921227,Evans; Ivan T,30,0,30,0
1748418299762,ERC 20,B00,921229,Evans; Ivan T,30,0,30,0
1748418300796,ERC 88,A00,961214,Peterson; Johanna L,19,0,20,1
1748418301824,ESYS 101,A01,921233,Taylor; Jennifer Rebecca,21,0,32,11
1748418301824,ESYS 101,A02,921234,Taylor; Jennifer Rebecca,14,0,32,18
1748418301824,ESYS 101,A03,921235,Taylor; Jennifer Rebecca,20,0,32,12
1748418301824,ESYS 101,A04,921241,Taylor; Jennifer Rebecca,26,0,32,6
1748418302854,ESYS 187A,A01,921248,Hetherington; Elizabeth Dorsey,30,0,40,10
1748418302854,ESYS 187A,B01,921250,Shipp; Lauren Elizabeth,27,0,40,13
1748418303890,ETHN 1,A01,919800,Wilson; Brenda K,13,0,15,2
1748418303890,ETHN 1,A02,919843,Wilson; Brenda K,14,0,15,1
1748418303890,ETHN 1,A03,920214,Wilson; Brenda K,15,0,15,0
1748418303890,ETHN 1,A04,920215,Wilson; Brenda K,14,0,15,1
1748418303890,ETHN 1,A05,920223,Wilson; Brenda K,15,0,15,0
1748418303890,ETHN 1,A06,920224,Wilson; Brenda K,15,0,15,0
1748418303890,ETHN 1,A07,920225,Wilson; Brenda K,15,0,15,0
1748418303890,ETHN 1,A08,920226,Wilson; Brenda K,12,0,15,3
1748418303890,ETHN 1,A09,920237,Wilson; Brenda K,15,0,15,0
1748418303890,ETHN 1,A10,920368,Wilson; Brenda K,15,0,15,0
1748418303890,ETHN 1,A11,920402,Wilson; Brenda K,15,0,15,0
1748418303890,ETHN 1,A12,920406,Wilson; Brenda K,15,0,15,0
1748418303890,ETHN 1,A13,920410,Wilson; Brenda K,14,0,15,1
1748418303890,ETHN 1,A14,920441,Wilson; Brenda K,14,0,15,1
1748418304920,ETHN 20R,A01,920461,Sasaki; Christen T,0,0,15,15
1748418304920,ETHN 20R,A02,920467,Sasaki; Christen T,0,0,15,15
1748418304920,ETHN 20R,A03,920468,Sasaki; Christen T,0,0,15,15
1748418304920,ETHN 20R,A04,920470,Sasaki; Christen T,0,0,15,15
1748418305948,ETHN 100A,A00,920489,Patel; Shaista,18,0,35,17
1748418306977,ETHN 101TV,A01,920518,Gallagher-Geurtsen; Tricia Meghan,21,0,25,4
1748418306977,ETHN 101TV,A02,920519,Gallagher-Geurtsen; Tricia Meghan,20,0,25,5
1748418306977,ETHN 101TV,A03,920522,Gallagher-Geurtsen; Tricia Meghan,24,0,25,1
1748418306977,ETHN 101TV,A04,920523,Gallagher-Geurtsen; Tricia Meghan,23,0,25,2
1748418308007,ETHN 110,A00,920528,Klann; Mary Cameron,27,0,35,8
1748418309034,ETHN 116,A00,920529,Cuong; Marisol,29,0,35,6
1748418310064,ETHN 120,A00,920542,Tran; Ly Thi Hai,31,0,35,4
1748418311094,ETHN 122A,A00,920559,Museus; Samuel David,30,0,35,5
1748418312120,ETHN 125R,A00,920694,Sasaki; Christen T,0,0,35,35
1748418313149,ETHN 130,A00,920703,Frank; Ross H.,28,0,30,2
1748418314176,ETHN 139,A00,920704,Ruiz; Ariana,18,0,20,2
1748418315207,ETHN 150,A00,920717,Taylor-Garcia; Daphne,16,0,16,0
1748418316233,ETHN 161,A00,920826,Browne; Errol Tsekani,33,0,35,2
1748418317259,ETHN 174,A00,963091,Staff,15,0,15,0
1748418318286,ETHN 186,A00,959881,Perez; Roy,25,0,30,5
1748418319312,ETHN 187,A00,920860,Martin Sandino; Amanda Maria Yoland,16,0,16,0
1748418320338,ETHN 189,A00,920861,Museus; Samuel David,18,0,20,2
1748418321364,ETHN 200A,A00,920862,Espiritu; Yen,7,0,10,3
1748418322391,ETHN 230,A00,920864,Perreira; Christopher Michael,8,0,10,2
1748418323415,ETIM 289,A00,921224,Patel; Shaista,10,0,10,0
1748418324443,EXPR 100,A00,964355,Staff,9999,0,9999,0
1748418325468,EXPR 105,A00,964356,Staff,9999,0,9999,0
1748418326495,EXPR 201,A00,964357,Staff,9999,0,9999,0
1748418327521,EXPR 205,A00,964358,Staff,9999,0,9999,0
1748418328549,FILM 71,A01,960804,Park; Joanne Moeun,0,0,11,11
1748418328549,FILM 71,B01,960877,Park; Joanne Moeun,3,0,11,8
1748418329574,FILM 72,A01,964349,Kroopf; Jackson Stanford,9,0,11,2
1748418329574,FILM 72,B01,964351,Kroopf; Jackson Stanford,9,0,11,2
1748418330604,FILM 73,A01,964345,Staff,0,0,0,0
1748418330604,FILM 73,B01,964347,Kroopf; Jackson Stanford,7,0,11,4
1748418331630,FMPH 291,A00,969582,Tsuyuki; Kiyomi,10,0,10,0
1748418332659,FPM 291,A00,922036,Rabin; Adrienn Borsika & Stadnick; Nicole & Aarons; Gregory A,12,0,12,0
1748418333689,GLBH 20,A00,921344,Elwardani; Nile Regina,137,0,146,9
1748418334722,GLBH 100,A00,921503,Jenkins; Janis A.,5,0,12,7
1748418334722,GLBH 100,B00,921504,Schonberg; Jeffrey,18,0,20,2
1748418335754,GLBH 111,A01,921733,Burgos; Jose L.,17,0,17,0
1748418335754,GLBH 111,B01,921862,Burgos; Jose L.,17,0,17,0
1748418336781,GLBH 114,A00,921864,Olivas Hernandez; Olga Lid,42,0,50,8
1748418337810,GLBH 116,A00,921865,Villarino; Margarita,41,0,45,4
1748418338836,GLBH 117,A00,921873,Villarino; Margarita,40,0,40,0
1748418339862,GLBH 118,A00,921884,Wilson; Brenda K,25,0,32,7
1748418340888,GLBH 119,A00,921956,Elwardani; Nile Regina,40,0,40,0
1748418341918,GLBH 148,A00,921961,Walkover; Lillian B,75,0,100,25
1748418342948,GLBH 181,A00,921962,Burgos; Jose L.,188,0,216,28
1748418343975,GLBH 200,A00,921963,Schonberg; Jeffrey,15,0,18,3
1748418345002,GLBH 201,A00,921982,Staff,16,0,18,2
1748418346030,GLBH 248,A00,921999,Kaiser; Bronwyn Nicole,16,0,18,2
1748418347056,GPEC 243,A00,946441,McCord; Gordon Carlos,96,0,100,4
1748418348083,GSS 20,A00,923030,Siapno; Jacqueline A,38,0,40,2
1748418348083,GSS 20,B00,923031,Siapno; Jacqueline A,36,0,40,4
1748418349123,HDS 1,A01,923033,Reese; Clarissa Jane,25,0,25,0
1748418349123,HDS 1,A02,923034,Reese; Clarissa Jane,20,0,25,5
1748418349123,HDS 1,A03,923035,Reese; Clarissa Jane,19,0,25,6
1748418349123,HDS 1,A04,923036,Reese; Clarissa Jane,22,0,25,3
1748418349123,HDS 1,A05,923037,Reese; Clarissa Jane,22,0,25,3
1748418349123,HDS 1,A06,923038,Reese; Clarissa Jane,23,0,25,2
1748418349123,HDS 1,A07,923039,Reese; Clarissa Jane,24,0,25,1
1748418350154,HDS 60,A01,923041,Staff,25,0,30,5
1748418350154,HDS 60,A02,923042,Staff,21,0,30,9
1748418351182,HDS 111,A00,923043,Staff,13,0,40,27
1748418352209,HDS 124,A00,923044,Staff,29,0,40,11
1748418353238,HDS 150,A00,923045,Staff,20,0,20,0
1748418354265,HDS 175,A00,923046,Staff,14,0,25,11
1748418355295,HDS 181,A01,923048,Staff,30,0,30,0
1748418356322,HDS 191,A01,923050,Reese; Clarissa Jane,25,0,25,0
1748418357354,HIEA 112,A00,922103,Matsumura; Wendy Y,92,0,115,23
1748418358383,HIEA 153,A00,922106,Henry; Todd A.,43,0,51,8
1748418359411,HIEU 108,A00,922108,Balberg; Mira,30,0,70,40
1748418360438,HIEU 114,A00,959889,Staff,59,0,70,11
1748418361466,HIEU 139,A00,922110,Strasser; Ulrike,41,0,51,10
1748418362496,HIEU 140,A00,922111,Radcliff; Pamela B.,58,0,65,7
1748418363523,HIEU 154,A00,922113,Hansen; Jan Eric,55,0,65,10
1748418364560,HIEU 158,A00,922116,Hertz; Deborah,61,0,70,9
1748418365590,HIEU 171,A00,922117,Hertz; Deborah,15,0,15,0
1748418366616,HIEU 271,A00,922189,Hertz; Deborah,0,0,0,0
1748418367645,HIGR 200,A00,922191,Matsumura; Wendy Y,10,0,10,0
1748418368670,HIGR 210,A00,922221,Muscolino; Micah S,8,0,10,2
1748418369700,HIGR 222,A00,963094,Biess; Frank Peter,10,0,10,0
1748418370729,HIGR 238,A00,922242,McKenzie; Kerry V.,9,0,10,1
1748418371755,HIGR 240,A00,922253,McKenzie; Kerry V.,10,0,10,0
1748418372780,HIGR 267A,A00,922256,Widener; Daniel,8,0,10,2
1748418374835,HILA 114,A00,922118,Cowan; Benjamin A,42,0,65,23
1748418375863,HILA 131,A00,922125,Vitz; Matthew,91,0,99,8
1748418376890,HILA 161,A00,922126,Cowan; Benjamin A,12,0,15,3
1748418377921,HILD 2A,A01,922043,Staff,31,0,32,1
1748418377921,HILD 2A,A02,922044,Staff,31,0,32,1
1748418377921,HILD 2A,A03,922046,Staff,28,0,32,4
1748418377921,HILD 2A,A04,922047,Staff,32,0,32,0
1748418377921,HILD 2A,A05,922051,Staff,30,0,32,2
1748418378953,HILD 7A,A01,922063,Widener; Daniel,31,0,32,1
1748418378953,HILD 7A,A02,922066,Widener; Daniel,31,0,32,1
1748418378953,HILD 7A,A03,922067,Widener; Daniel,32,0,32,0
1748418378953,HILD 7A,A04,922070,Widener; Daniel,28,0,32,4
1748418378953,HILD 7A,A05,922072,Widener; Daniel,32,0,32,0
1748418378953,HILD 7A,A06,922074,Widener; Daniel,32,0,32,0
1748418378953,HILD 7A,A07,922078,Widener; Daniel,29,0,32,3
1748418378953,HILD 7A,A08,922080,Widener; Daniel,32,0,32,0
1748418378953,HILD 7A,A09,922081,Widener; Daniel,32,0,32,0
1748418378953,HILD 7A,A10,922082,Widener; Daniel,32,0,32,0
1748418378953,HILD 7A,A11,922083,Widener; Daniel,32,0,32,0
1748418378953,HILD 7A,A12,922084,Widener; Daniel,32,0,32,0
1748418379980,HILD 10,A01,922089,Muscolino; Micah S,30,0,32,2
1748418379980,HILD 10,A02,922090,Muscolino; Micah S,28,0,32,4
1748418379980,HILD 10,A03,922092,Muscolino; Micah S,31,0,32,1
1748418379980,HILD 10,A04,922095,Muscolino; Micah S,30,0,32,2
1748418381010,HILD 14,A01,959886,Murillo; Dana V.,26,0,32,6
1748418381010,HILD 14,A02,959887,Murillo; Dana V.,32,0,32,0
1748418382041,HINE 144,A00,922132,Provence; Michael,40,0,45,5
1748418383070,HINE 186,A00,922133,Provence; Michael,15,0,15,0
1748418384096,HISA 110,A00,922136,De; Aniket,38,0,45,7
1748418385121,HISA 122,A00,959884,De; Aniket,12,0,15,3
1748418386150,HISC 107,A00,922137,Golan; Tal,41,0,45,4
1748418387177,HISC 131,A00,922148,Golan; Tal,45,0,51,6
1748418388206,HITO 87,A00,922097,Patterson; Patrick H.,0,0,0,0
1748418388206,HITO 87,B00,922098,Patterson; Patrick H.,0,0,0,0
1748418389235,HITO 100,A00,922150,Martinez-Matsuda; Veronica,0,0,17,17
1748418390265,HITO 193,A00,954127,Hill; Seth J,9999,0,9999,0
1748418391357,HITO 194,001,970059,Hertz; Deborah,1,0,1,0
1748418391357,HITO 194,002,970084,Daly; Heather Marie,1,0,1,0
1748418391357,HITO 194,003,970086,Plant; Rebecca Jo,1,0,1,0
1748418391357,HITO 194,004,970093,Henry; Todd A.,1,0,1,0
1748418391357,HITO 194,005,970094,Biess; Frank Peter,1,0,1,0
1748418391357,HITO 194,006,970095,Shafir; Nir,1,0,1,0
1748418391357,HITO 194,007,970099,Martinez-Matsuda; Veronica,1,0,1,0
1748418391357,HITO 194,008,970101,De; Aniket,1,0,1,0
1748418391357,HITO 194,009,970126,Kwak; Nancy,1,0,1,0
1748418391357,HITO 194,010,970128,Muscolino; Micah S,1,0,1,0
1748418391357,HITO 194,011,970129,Hendrickson; Gerald M.,1,0,1,0
1748418391357,HITO 194,012,970132,Balberg; Mira,1,0,1,0
1748418392385,HITO 196,A00,922151,Man; Simeon S,14,0,22,8
1748418393410,HIUS 105,A00,922152,Bermudez; Rosie Cano,22,0,35,13
1748418394438,HIUS 106,A00,922154,Bermudez; Rosie Cano,53,0,65,12
1748418395463,HIUS 144,A00,922156,Daly; Heather Marie,31,0,35,4
1748418396490,HIUS 158,A00,922163,Frank; Ross H.,12,0,20,8
1748418397516,HIUS 181,A00,922187,Daly; Heather Marie,8,0,15,7
1748418398545,HIUS 281,A00,922264,Daly; Heather Marie,0,0,0,0
1748418399575,HUM 1,A01,946360,Markman; Kristina,14,0,15,1
1748418399575,HUM 1,A02,946361,Markman; Kristina,12,0,15,3
1748418399575,HUM 1,A03,946362,Markman; Kristina,14,0,15,1
1748418399575,HUM 1,A04,946363,Markman; Kristina,11,0,15,4
1748418399575,HUM 1,A05,946364,Markman; Kristina,14,0,15,1
1748418399575,HUM 1,A06,946365,Markman; Kristina,14,0,15,1
1748418399575,HUM 1,A07,946366,Markman; Kristina,14,0,15,1
1748418399575,HUM 1,A08,946367,Markman; Kristina,12,0,15,3
1748418399575,HUM 1,A09,946368,Markman; Kristina,13,0,15,2
1748418399575,HUM 1,A10,946369,Markman; Kristina,11,0,15,4
1748418399575,HUM 1,A11,946370,Markman; Kristina,6,0,15,9
1748418399575,HUM 1,A12,946371,Markman; Kristina,15,0,15,0
1748418400607,HUM 3,A01,946373,West; Geoffrey Scott,20,0,28,8
1748418400607,HUM 3,A02,946374,West; Geoffrey Scott,14,0,28,14
1748418400607,HUM 3,A03,946375,West; Geoffrey Scott,13,0,28,15
1748418400607,HUM 3,A04,946376,West; Geoffrey Scott,9,0,28,19
1748418400607,HUM 3,A05,946377,West; Geoffrey Scott,8,0,28,20
1748418400607,HUM 3,A06,946378,West; Geoffrey Scott,22,0,28,6
1748418400607,HUM 3,A07,946379,West; Geoffrey Scott,23,0,28,5
1748418400607,HUM 3,A08,946380,West; Geoffrey Scott,15,0,28,13
1748418400607,HUM 3,A09,946381,West; Geoffrey Scott,0,0,0,0
1748418400607,HUM 3,A10,946382,West; Geoffrey Scott,0,0,0,0
1748418400607,HUM 3,C01,946393,Crum; Matthew Stephen,0,0,0,0
1748418400607,HUM 3,C02,946394,Crum; Matthew Stephen,0,0,0,0
1748418400607,HUM 3,C03,946395,Crum; Matthew Stephen,17,0,28,11
1748418400607,HUM 3,C04,946396,Crum; Matthew Stephen,25,0,28,3
1748418400607,HUM 3,C05,946397,Crum; Matthew Stephen,16,0,28,12
1748418400607,HUM 3,C06,946398,Crum; Matthew Stephen,20,0,28,8
1748418400607,HUM 3,C07,946399,Crum; Matthew Stephen,24,0,28,4
1748418400607,HUM 3,C08,946400,Crum; Matthew Stephen,26,0,28,2
1748418400607,HUM 3,C09,946401,Crum; Matthew Stephen,18,0,28,10
1748418400607,HUM 3,C10,946402,Crum; Matthew Stephen,22,0,28,6
1748418400607,HUM 3,D01,946404,Rodriguez; Bretton Sigfred,4,0,28,24
1748418400607,HUM 3,D02,946405,Rodriguez; Bretton Sigfred,16,0,28,12
1748418400607,HUM 3,D03,946406,Rodriguez; Bretton Sigfred,25,0,28,3
1748418400607,HUM 3,D04,946407,Rodriguez; Bretton Sigfred,12,0,28,16
1748418400607,HUM 3,D05,946408,Rodriguez; Bretton Sigfred,12,0,28,16
1748418400607,HUM 3,D06,946409,Rodriguez; Bretton Sigfred,19,0,28,9
1748418400607,HUM 3,D07,946410,Rodriguez; Bretton Sigfred,0,0,0,0
1748418400607,HUM 3,D08,946411,Rodriguez; Bretton Sigfred,0,0,0,0
1748418400607,HUM 3,D09,946412,Rodriguez; Bretton Sigfred,7,0,28,21
1748418400607,HUM 3,D10,946413,Rodriguez; Bretton Sigfred,20,0,28,8
1748418401635,HUM 88,A00,969578,Markman; Kristina,0,0,0,0
1748418402738,HUM 100,A00,946414,West; Geoffrey Scott,14,0,16,2
1748418402738,HUM 100,B00,946415,West; Geoffrey Scott,15,0,16,1
1748418402738,HUM 100,C00,946416,Zavodny; Tatiana Sophia,13,0,16,3
1748418402738,HUM 100,D00,946417,Zavodny; Tatiana Sophia,15,0,16,1
1748418402738,HUM 100,E00,946419,Zavodny; Tatiana Sophia,15,0,16,1
1748418402738,HUM 100,F00,946420,Crum; Matthew Stephen,0,0,0,0
1748418402738,HUM 100,G00,946421,Crum; Matthew Stephen,0,0,0,0
1748418402738,HUM 100,H00,946422,Crum; Matthew Stephen,16,0,16,0
1748418402738,HUM 100,I00,946424,Staff,0,0,0,0
1748418402738,HUM 100,J00,946425,Crum; Matthew Stephen,16,0,16,0
1748418402738,HUM 100,K00,946426,Staff,0,0,0,0
1748418403769,INTL 100,A01,960908,Feuer; Anna Stagg,9,0,20,11
1748418403769,INTL 100,A02,960964,Feuer; Anna Stagg,16,0,20,4
1748418403769,INTL 100,A03,961088,Feuer; Anna Stagg,15,0,20,5
1748418403769,INTL 100,A04,961091,Feuer; Anna Stagg,17,0,20,3
1748418403769,INTL 100,A05,961100,Feuer; Anna Stagg,16,0,20,4
1748418403769,INTL 100,A06,961130,Feuer; Anna Stagg,19,0,20,1
1748418404795,INTL 101,A01,923053,McIntosh; Justin,1,0,30,29
1748418404795,INTL 101,A02,923055,McIntosh; Justin,8,0,30,22
1748418404795,INTL 101,A03,923127,McIntosh; Justin,5,0,30,25
1748418404795,INTL 101,A04,923140,McIntosh; Justin,0,0,30,30
1748418404795,INTL 101,A05,923148,McIntosh; Justin,9,0,30,21
1748418404795,INTL 101,A06,923186,McIntosh; Justin,10,0,30,20
1748418405820,INTL 102,A01,923194,Prather; Lauren R,3,0,30,27
1748418405820,INTL 102,A02,923195,Prather; Lauren R,4,0,30,26
1748418405820,INTL 102,A03,923199,Prather; Lauren R,13,0,30,17
1748418405820,INTL 102,A04,923202,Prather; Lauren R,8,0,30,22
1748418406846,INTL 190,A00,923203,Segui; Alan S,0,0,0,5
1748418406846,INTL 190,B00,923205,Segui; Alan S,0,0,0,9
1748418406846,INTL 190,C00,923219,Lee; Munseob,0,0,0,5
1748418407872,INTL 190H,A00,923247,Feuer; Anna Stagg,0,0,0,1
1748418408911,JAPN 10A,A01,923258,Kamioka; Sachiko,22,0,23,1
1748418408911,JAPN 10A,B01,923261,Ross; Kayoko F,23,0,23,0
1748418408911,JAPN 10A,C01,923265,Sato; Kyoko,20,0,23,3
1748418408911,JAPN 10A,D01,923268,Inada; Minori,22,0,23,1
1748418408911,JAPN 10A,E01,923270,Tipton; Yuko,9,0,12,3
1748418408911,JAPN 10A,E02,923273,Tipton; Yuko,12,0,12,0
1748418408911,JAPN 10A,F01,923352,Ross; Kayoko F,11,0,12,1
1748418408911,JAPN 10A,F02,923355,Ross; Kayoko F,12,0,12,0
1748418408911,JAPN 10A,G01,923358,McKee; Mayumi Mochizuki,7,0,10,3
1748418408911,JAPN 10A,G02,923360,McKee; Mayumi Mochizuki,6,0,10,4
1748418408911,JAPN 10A,H01,923365,Sato; Kyoko,8,0,12,4
1748418408911,JAPN 10A,H02,923370,Sato; Kyoko,12,0,12,0
1748418408911,JAPN 10A,I01,923373,Inada; Minori,8,0,12,4
1748418408911,JAPN 10A,I02,923374,Inada; Minori,8,0,12,4
1748418408911,JAPN 10A,J01,923376,McKee; Mayumi Mochizuki,11,0,12,1
1748418408911,JAPN 10A,J02,923428,McKee; Mayumi Mochizuki,11,0,12,1
1748418408911,JAPN 10A,K01,923433,Tipton; Yuko,6,0,10,4
1748418408911,JAPN 10A,K02,923437,Tipton; Yuko,9,0,10,1
1748418408911,JAPN 10A,L01,923439,Sato; Kyoko,12,0,12,0
1748418408911,JAPN 10A,L02,923449,Sato; Kyoko,11,0,12,1
1748418408911,JAPN 10A,M01,923455,Kamioka; Sachiko,22,0,23,1
1748418408911,JAPN 10A,N01,923459,McKee; Mayumi Mochizuki,22,0,23,1
1748418409943,JAPN 10AR,A01,923462,Tipton; Yuko,17,0,20,3
1748418410974,JAPN 20A,A01,923470,Takeda; Izumi,21,0,23,2
1748418410974,JAPN 20A,B01,923473,Iwamoto; Naoki,9,0,12,3
1748418410974,JAPN 20A,B02,923475,Iwamoto; Naoki,6,0,12,6
1748418410974,JAPN 20A,C01,923519,Takeda; Izumi,0,0,12,12
1748418410974,JAPN 20A,C02,923520,Takeda; Izumi,5,0,12,7
1748418410974,JAPN 20A,D01,923623,Iwamoto; Naoki,11,0,12,1
1748418410974,JAPN 20A,D02,923625,Iwamoto; Naoki,11,0,12,1
1748418410974,JAPN 20A,E01,923627,Simpson; Junko Tokuda,12,0,20,8
1748418411998,JAPN 130A,A01,923630,Kamioka; Sachiko,14,0,15,1
1748418411998,JAPN 130A,B01,923634,Ross; Kayoko F,11,0,15,4
1748418413026,JAPN 135A,A00,923636,Iwamoto; Naoki,10,0,20,10
1748418414053,JAPN 137A,A00,923638,Simpson; Junko Tokuda,19,0,20,1
1748418415082,JAPN 140A,A00,923640,Takeda; Izumi,18,0,20,2
1748418416111,JWSP 1,A01,921258,Shuster; Alana,19,0,20,1
1748418417136,JWSP 104,A01,921340,Shuster; Alana,15,0,15,0
1748418418171,LATI 10,A01,923694,Kennemore; Amy Michelle,22,0,28,6
1748418418171,LATI 10,A02,923695,Kennemore; Amy Michelle,25,0,28,3
1748418418171,LATI 10,A03,923707,Kennemore; Amy Michelle,25,0,28,3
1748418418171,LATI 10,A04,923713,Kennemore; Amy Michelle,27,0,28,1
1748418418171,LATI 10,A05,923720,Kennemore; Amy Michelle,28,0,28,0
1748418418171,LATI 10,A06,923723,Kennemore; Amy Michelle,30,0,30,0
1748418418171,LATI 10,A07,923745,Kennemore; Amy Michelle,26,0,30,4
1748418419199,LATI 50,A01,923778,Kokinis; Troy Andreas,27,0,30,3
1748418419199,LATI 50,A02,923779,Kokinis; Troy Andreas,28,0,30,2
1748418419199,LATI 50,A03,923780,Kokinis; Troy Andreas,29,0,30,1
1748418419199,LATI 50,A04,923783,Kokinis; Troy Andreas,28,0,30,2
1748418419199,LATI 50,A05,923784,Kokinis; Troy Andreas,30,0,30,0
1748418420225,LATI 166,A00,923785,Kokinis; Troy Andreas,117,0,120,3
1748418421253,LATI 170,A00,923787,Kennemore; Amy Michelle,45,0,60,15
1748418422279,LATI 180,A00,923788,Kennemore; Amy Michelle,52,0,60,8
1748418423309,LATI 184,A00,923790,Jimenez Cano; Nayeli Guada,29,0,30,1
1748418424334,LATI 200,A00,923791,Martin-Cabrera; Luis,7,0,10,3
1748418425362,LIAB 1A,A00,923983,Saab; Dima,12,0,14,2
1748418425362,LIAB 1A,B00,923984,Saab; Dima,8,0,14,6
1748418426393,LIAB 1AX,A00,923992,El Cheddadi; Youniss,25,0,28,3
1748418427421,LIAB 1D,A00,923996,Saab; Dima,7,0,14,7
1748418428448,LIAB 1DX,A00,923998,El Cheddadi; Youniss,10,0,14,4
1748418429476,LIFR 1A,A00,923999,Van Moer; Vinciane G,14,0,14,0
1748418429476,LIFR 1A,B00,924001,Van Moer; Vinciane G,14,0,14,0
1748418429476,LIFR 1A,C00,924003,Van Moer; Vinciane G,13,0,14,1
1748418429476,LIFR 1A,D00,924039,Van Moer; Vinciane G,12,0,14,2
1748418429476,LIFR 1A,E00,924044,Van Moer; Vinciane G,12,0,14,2
1748418429476,LIFR 1A,F00,924100,Van Moer; Vinciane G,10,0,14,4
1748418430503,LIFR 1AX,A00,924134,Van Moer; Vinciane G,26,0,28,2
1748418430503,LIFR 1AX,B00,924138,Van Moer; Vinciane G,24,0,28,4
1748418430503,LIFR 1AX,C00,924196,Van Moer; Vinciane G,26,0,28,2
1748418431530,LIFR 1B,A00,924197,Van Moer; Vinciane G,11,0,14,3
1748418431530,LIFR 1B,B00,924199,Van Moer; Vinciane G,11,0,14,3
1748418432563,LIFR 1BX,A00,924215,Van Moer; Vinciane G,23,0,28,5
1748418433590,LIFR 1D,A00,924216,Van Moer; Vinciane G,11,0,14,3
1748418433590,LIFR 1D,B00,924217,Van Moer; Vinciane G,12,0,14,2
1748418433590,LIFR 1D,C00,924218,Van Moer; Vinciane G,3,0,14,11
1748418434622,LIFR 1DX,A00,924219,Van Moer; Vinciane G,14,0,21,7
1748418434622,LIFR 1DX,B00,924220,Van Moer; Vinciane G,13,0,21,8
1748418435652,LIFR 11,A00,924221,Goodall; Grant Todd,10,0,10,0
1748418436682,LIGM 1A,A00,924222,Fischer-Grunski; Eva K,11,0,14,3
1748418436682,LIGM 1A,B00,924223,Fischer-Grunski; Eva K,13,0,14,1
1748418436682,LIGM 1A,C00,924224,Fischer-Grunski; Eva K,11,0,14,3
1748418436682,LIGM 1A,D00,924227,Fischer-Grunski; Eva K,11,0,14,3
1748418437713,LIGM 1AX,A00,924228,Fischer-Grunski; Eva K,28,0,28,0
1748418437713,LIGM 1AX,B00,924229,Fischer-Grunski; Eva K,19,0,28,9
1748418438738,LIGM 1D,A00,924230,Fischer-Grunski; Eva K,0,0,0,0
1748418438738,LIGM 1D,B00,924231,Fischer-Grunski; Eva K,12,0,14,2
1748418439768,LIGM 1DX,A00,924232,Fischer-Grunski; Eva K,0,0,0,0
1748418440792,LIGM 11,A00,924233,Goodall; Grant Todd,10,0,10,0
1748418441818,LIGN 5,A00,923794,Goodall; Grant Todd,112,0,120,8
1748418442845,LIGN 7,A00,923796,Mayberry; Rachel,115,0,120,5
1748418443871,LIGN 8,A00,923797,McIntosh; Justin,231,0,245,14
1748418444896,LIGN 17,A00,923798,Staff,232,0,245,13
1748418445929,LIGN 101,A01,923929,Bakovic; Eric John,26,0,30,4
1748418445929,LIGN 101,A02,923930,Bakovic; Eric John,26,0,30,4
1748418445929,LIGN 101,A04,923935,Bakovic; Eric John,19,0,30,11
1748418445929,LIGN 101,A05,923940,Bakovic; Eric John,23,0,30,7
1748418446958,LIGN 108,A00,923942,Rose; Sharon,29,0,35,6
1748418447983,LIGN 110,A01,923944,Garellek; Marc,15,0,27,12
1748418447983,LIGN 110,A02,923947,Garellek; Marc,14,0,27,13
1748418447983,LIGN 110,A03,923948,Garellek; Marc,20,0,27,7
1748418447983,LIGN 110,A04,923949,Garellek; Marc,4,0,27,23
1748418449012,LIGN 152,A00,967971,Caballero; Gabriela Hernandez,17,0,30,13
1748418450039,LIGN 160,A00,963083,Dudley; Rachel,39,0,50,11
1748418451063,LIGN 167,A00,923951,Warstadt; Alexander Scott,0,0,90,90
1748418452089,LIGN 179,A00,923955,Kluender; Robert,0,0,35,35
1748418453121,LIGN 188R,A00,923956,Clem; Emily,40,0,40,0
1748418454148,LIGN 200,A00,973075,Staff,0,0,0,0
1748418455174,LIGN 210,A00,923962,Garellek; Marc,10,0,10,0
1748418456203,LIGN 221,A00,923964,Clem; Emily,9,0,10,1
1748418457231,LIGN 236,A00,923965,Clem; Emily,8,0,10,2
1748418458256,LIGN 293,A00,923971,Caballero; Gabriela Hernandez,0,0,0,0
1748418459291,LIGN 296,001,950061,Ackerman; Farrell,10,0,10,0
1748418459291,LIGN 296,002,950062,Bakovic; Eric John,10,0,10,0
1748418459291,LIGN 296,003,950063,Bergen; Leon,10,0,10,0
1748418459291,LIGN 296,004,950064,Caballero; Gabriela Hernandez,10,0,10,0
1748418459291,LIGN 296,005,950065,Caponigro; Ivano,10,0,10,0
1748418459291,LIGN 296,006,950066,Clem; Emily,10,0,10,0
1748418459291,LIGN 296,007,950067,Dudley; Rachel,10,0,10,0
1748418459291,LIGN 296,008,950068,Garellek; Marc,10,0,10,0
1748418459291,LIGN 296,009,950070,Goodall; Grant Todd,9,0,10,1
1748418459291,LIGN 296,010,950071,Kehler; Andrew Scott,10,0,10,0
1748418459291,LIGN 296,011,950072,Kluender; Robert,10,0,10,0
1748418459291,LIGN 296,012,950073,Rose; Sharon,10,0,10,0
1748418459291,LIGN 296,013,950074,Styler; William Francis,10,0,10,0
1748418459291,LIGN 296,014,950075,Caponigro; Ivano,10,0,10,0
1748418460316,LIHL 112F,A00,923972,Pagkalinawan; Leticia Cant,15,0,28,13
1748418461345,LIHL 114F,A00,923973,Nguyen; Hoan Thi,8,0,28,20
1748418462370,LIHL 117F,A00,923974,Sadegholvad; Elham,19,0,20,1
1748418463400,LIHL 118,A00,923975,Chen; Areana Yen,23,0,28,5
1748418464425,LIHL 124F,A00,923976,Nguyen; Hoan Thi,17,0,20,3
1748418465450,LIHL 132F,A00,923978,Pagkalinawan; Leticia Cant,18,0,20,2
1748418466479,LIHL 134F,A00,923980,Nguyen; Hoan Thi,19,0,20,1
1748418467507,LIHL 138,A00,923982,Chen; Areana Yen,28,0,28,0
1748418468537,LIIT 1A,A00,924234,Carnelos; Chiara,11,0,14,3
1748418468537,LIIT 1A,B00,924235,Carnelos; Chiara,11,0,14,3
1748418468537,LIIT 1A,C00,924236,Carnelos; Chiara,13,0,14,1
1748418468537,LIIT 1A,D00,924237,Carnelos; Chiara,12,0,14,2
1748418469564,LIIT 1AX,A00,924238,Carnelos; Chiara,28,0,28,0
1748418469564,LIIT 1AX,B00,924239,Carnelos; Chiara,24,0,28,4
1748418470590,LIPO 1A,A00,924241,Paladini; Denise,13,0,14,1
1748418470590,LIPO 1A,B00,924242,Paladini; Denise,14,0,14,0
1748418471622,LIPO 1AX,A00,924243,De Abreu; Cassia,13,0,14,1
1748418471622,LIPO 1AX,B00,924244,De Abreu; Cassia,14,0,14,0
1748418472649,LIPO 1D,A00,924245,Paladini; Denise,11,0,14,3
1748418473677,LIPO 1DX,A00,924248,De Abreu; Cassia,14,0,14,0
1748418474713,LISL 1A,A00,924249,Lott; Margaret S.,9,0,14,5
1748418474713,LISL 1A,B00,924250,Lott; Margaret S.,11,0,14,3
1748418474713,LISL 1A,C00,924252,Lott; Margaret S.,7,0,14,7
1748418474713,LISL 1A,D00,924253,Lott; Margaret S.,12,0,14,2
1748418474713,LISL 1A,E00,924254,Lott; Margaret S.,4,0,14,10
1748418474713,LISL 1A,F00,924255,Lott; Margaret S.,13,0,14,1
1748418475741,LISL 1AR,A00,924257,Lott; Margaret S.,11,0,15,4
1748418475741,LISL 1AR,B00,924258,Lott; Margaret S.,10,0,15,5
1748418475741,LISL 1AR,C00,924260,Lott; Margaret S.,9,0,15,6
1748418475741,LISL 1AR,D00,968060,Lott; Margaret S.,3,0,3,0
1748418475741,LISL 1AR,E00,968061,Lott; Margaret S.,3,0,3,0
1748418475741,LISL 1AR,F00,968062,Lott; Margaret S.,3,0,3,0
1748418476767,LISL 1AX,A00,924261,Lott; Margaret S.,28,0,28,0
1748418476767,LISL 1AX,B00,924262,Lott; Margaret S.,18,0,28,10
1748418476767,LISL 1AX,C00,924263,Lott; Margaret S.,21,0,28,7
1748418477797,LISL 1B,A00,924264,Lott; Margaret S.,13,0,14,1
1748418477797,LISL 1B,B00,924265,Lott; Margaret S.,6,0,14,8
1748418477797,LISL 1B,C00,924302,Lott; Margaret S.,9,0,14,5
1748418477797,LISL 1B,D00,924304,Lott; Margaret S.,7,0,14,7
1748418477797,LISL 1B,E00,924305,Lott; Margaret S.,10,0,14,4
1748418477797,LISL 1B,F00,964375,Lott; Margaret S.,12,0,14,2
1748418478823,LISL 1BX,A00,924307,Lott; Margaret S.,12,0,28,16
1748418478823,LISL 1BX,B00,924308,Lott; Margaret S.,20,0,28,8
1748418478823,LISL 1BX,C00,924314,Lott; Margaret S.,28,0,28,0
1748418479848,LISL 1D,A00,924316,Lott; Margaret S.,0,0,14,14
1748418479848,LISL 1D,B00,924317,Lott; Margaret S.,0,0,14,14
1748418479848,LISL 1D,C00,924319,Lott; Margaret S.,0,0,14,14
1748418479848,LISL 1D,D00,924321,Lott; Margaret S.,0,0,14,14
1748418480875,LISL 1DX,A00,924323,Lott; Margaret S.,0,0,28,28
1748418480875,LISL 1DX,B00,924365,Lott; Margaret S.,0,0,28,28
1748418481911,LISP 1A,A00,924370,Munoz Sanchez; Alicia,12,0,14,2
1748418481911,LISP 1A,B00,924372,Munoz Sanchez; Alicia,8,0,14,6
1748418481911,LISP 1A,C00,924401,Munoz Sanchez; Alicia,0,0,14,14
1748418481911,LISP 1A,D00,924406,Munoz Sanchez; Alicia,3,0,14,11
1748418481911,LISP 1A,E00,924471,Munoz Sanchez; Alicia,0,0,14,14
1748418481911,LISP 1A,F00,924472,Munoz Sanchez; Alicia,4,0,14,10
1748418481911,LISP 1A,G00,924473,Munoz Sanchez; Alicia,11,0,14,3
1748418481911,LISP 1A,H00,924474,Munoz Sanchez; Alicia,9,0,14,5
1748418482937,LISP 1AX,A00,924478,Munoz Sanchez; Alicia,16,0,28,12
1748418482937,LISP 1AX,B00,924479,Munoz Sanchez; Alicia,26,0,28,2
1748418482937,LISP 1AX,C00,924484,Munoz Sanchez; Alicia,12,0,28,16
1748418482937,LISP 1AX,D00,924491,Munoz Sanchez; Alicia,18,0,28,10
1748418484047,LISP 1B,A00,924492,Munoz Sanchez; Alicia,12,0,14,2
1748418484047,LISP 1B,B00,924493,Munoz Sanchez; Alicia,6,0,14,8
1748418484047,LISP 1B,C00,924498,Munoz Sanchez; Alicia,13,0,14,1
1748418484047,LISP 1B,D00,924501,Munoz Sanchez; Alicia,13,0,14,1
1748418484047,LISP 1B,E00,924505,Munoz Sanchez; Alicia,11,0,14,3
1748418484047,LISP 1B,F00,924506,Munoz Sanchez; Alicia,9,0,14,5
1748418484047,LISP 1B,G00,924507,Munoz Sanchez; Alicia,10,0,14,4
1748418484047,LISP 1B,H00,924549,Munoz Sanchez; Alicia,12,0,14,2
1748418484047,LISP 1B,I00,924566,Munoz Sanchez; Alicia,13,0,14,1
1748418484047,LISP 1B,J00,924572,Munoz Sanchez; Alicia,13,0,14,1
1748418484047,LISP 1B,K00,924576,Munoz Sanchez; Alicia,12,0,14,2
1748418484047,LISP 1B,L00,924577,Munoz Sanchez; Alicia,13,0,14,1
1748418485075,LISP 1BX,A00,924578,Munoz Sanchez; Alicia,26,0,28,2
1748418485075,LISP 1BX,B00,924618,Munoz Sanchez; Alicia,24,0,28,4
1748418485075,LISP 1BX,C00,924619,Munoz Sanchez; Alicia,20,0,28,8
1748418485075,LISP 1BX,D00,924629,Munoz Sanchez; Alicia,24,0,28,4
1748418485075,LISP 1BX,E00,924635,Munoz Sanchez; Alicia,24,0,28,4
1748418485075,LISP 1BX,F00,924640,Munoz Sanchez; Alicia,27,0,28,1
1748418486104,LISP 1D,A00,924641,Munoz Sanchez; Alicia,10,0,14,4
1748418486104,LISP 1D,B00,924649,Munoz Sanchez; Alicia,10,0,14,4
1748418486104,LISP 1D,C00,924654,Munoz Sanchez; Alicia,11,0,14,3
1748418486104,LISP 1D,D00,924660,Munoz Sanchez; Alicia,7,0,14,7
1748418486104,LISP 1D,E00,924671,Munoz Sanchez; Alicia,5,0,14,9
1748418486104,LISP 1D,F00,924722,Munoz Sanchez; Alicia,6,0,14,8
1748418486104,LISP 1D,G00,924724,Munoz Sanchez; Alicia,8,0,14,6
1748418486104,LISP 1D,H00,924726,Munoz Sanchez; Alicia,9,0,14,5
1748418486104,LISP 1D,I00,924728,Munoz Sanchez; Alicia,13,0,14,1
1748418486104,LISP 1D,J00,924732,Munoz Sanchez; Alicia,14,0,14,0
1748418486104,LISP 1D,K00,924739,Munoz Sanchez; Alicia,13,0,14,1
1748418486104,LISP 1D,L00,924745,Munoz Sanchez; Alicia,12,0,14,2
1748418487138,LISP 1DX,A00,924747,Munoz Sanchez; Alicia,23,0,28,5
1748418487138,LISP 1DX,B00,924818,Munoz Sanchez; Alicia,27,0,28,1
1748418487138,LISP 1DX,C00,924819,Munoz Sanchez; Alicia,16,0,28,12
1748418487138,LISP 1DX,D00,924820,Munoz Sanchez; Alicia,23,0,28,5
1748418487138,LISP 1DX,E00,924821,Munoz Sanchez; Alicia,16,0,28,12
1748418487138,LISP 1DX,F00,924822,Munoz Sanchez; Alicia,22,0,28,6
1748418488165,LISP 15,A00,924823,Munoz Sanchez; Alicia,17,0,20,3
1748418489191,LISP 18,A00,924824,Munoz Sanchez; Alicia,14,0,20,6
1748418490217,LTAF 120,A00,925431,Zhiri; Oumelbanine,37,0,40,3
1748418491245,LTAM 100,A00,925432,Villafuerte Vazquez; Nadia,33,0,40,7
1748418492275,LTCH 101,A00,964372,Liao; Ping H,35,0,40,5
1748418493310,LTCO 285,A00,925806,Glaser; Amelia,0,0,0,0
1748418494340,LTCS 10,A00,924830,Bessett; Ryan Matthew,39,0,40,1
1748418495441,LTCS 87,A00,969580,Nguyen; Hoang Tan,20,0,20,0
1748418495441,LTCS 87,B00,969581,Nguyen; Hoang Tan,20,0,20,0
1748418496468,LTCS 130,A00,925434,Kim; Joo Ok,36,0,40,4
1748418497495,LTCS 150,A00,925435,Mendoza; Andrea,36,0,40,4
1748418498521,LTCS 250,A00,925807,Sanchez Cruz; Jorge,9,0,15,6
1748418499548,LTEA 120A,A00,925438,Fiss; Geraldine Anna,16,0,40,24
1748418500578,LTEA 120B,A00,925439,Liao; Ping H,211,0,225,14
1748418501604,LTEA 132,A00,925441,Mendoza; Andrea,66,0,75,9
1748418502631,LTEA 143,A00,925443,Lee; Jin-Kyung,72,0,75,3
1748418503659,LTEA 145,A00,925444,Lee; Jin-Kyung,39,0,40,1
1748418504686,LTEN 21,A01,924832,Vitkus; Daniel J.,23,0,28,5
1748418504686,LTEN 21,A02,924833,Vitkus; Daniel J.,28,0,28,0
1748418505714,LTEN 28,A01,924835,Suzuki; Erin M.,26,0,28,2
1748418505714,LTEN 28,A02,924836,Suzuki; Erin M.,25,0,28,3
1748418505714,LTEN 28,A03,924837,Suzuki; Erin M.,25,0,28,3
1748418505714,LTEN 28,A04,924838,Suzuki; Erin M.,28,0,28,0
1748418505714,LTEN 28,A05,924839,Suzuki; Erin M.,28,0,28,0
1748418505714,LTEN 28,A06,924840,Suzuki; Erin M.,28,0,28,0
1748418505714,LTEN 28,A07,924841,Suzuki; Erin M.,28,0,28,0
1748418505714,LTEN 28,A08,924842,Suzuki; Erin M.,28,0,28,0
1748418506742,LTEN 113,A00,925449,Vitkus; Daniel J.,31,0,40,9
1748418507769,LTEN 152,A00,925450,Staff,13,0,40,27
1748418508800,LTEN 169,A00,925451,Ruiz; Ariana,34,0,40,6
1748418509830,LTEN 180,A00,925452,Ruiz; Ariana,9,0,20,11
1748418510856,LTEN 181,A00,925453,Suzuki; Erin M.,27,0,40,13
1748418511882,LTEN 185,A00,963086,Staff,23,0,25,2
1748418512908,LTEN 189,A00,925458,Vijay; Ameeth Varma,35,0,40,5
1748418513935,LTEN 271,A00,925808,Garofalo; Devin,13,0,15,2
1748418514964,LTEU 140,A00,925459,De Marchi Gherini; Adriana,33,0,40,7
1748418515995,LTEU 154,A00,925461,Morse; Ainsley,25,0,30,5
1748418517021,LTFR 2A,A01,924916,Ploye; Catherine,20,0,25,5
1748418518046,LTFR 2B,A01,924920,Ploye; Catherine,25,0,25,0
1748418519071,LTFR 104,A00,925462,Ploye; Catherine,25,0,25,0
1748418520097,LTGK 1,A00,924923,Murray; Kourtney Kristine,34,0,40,6
1748418521123,LTGK 104,A00,925465,Myerston Santana; Jacobo,29,0,30,1
1748418522150,LTGM 2A,A01,924926,Fischer-Grunski; Eva K,19,0,25,6
1748418523178,LTIT 2A,A01,925054,De Marchi Gherini; Adriana,19,0,25,6
1748418524229,LTKO 1A,A01,925085,Cho; Hye Jin,25,0,28,3
1748418524229,LTKO 1A,B01,925182,Cho; Hye Jin,25,0,28,3
1748418524229,LTKO 1A,C01,925210,Cho; Hye Jin,23,0,28,5
1748418524229,LTKO 1A,D01,925229,Staff,27,0,28,1
1748418524229,LTKO 1A,E01,925246,Staff,25,0,28,3
1748418524229,LTKO 1A,F01,925248,Yim; Nancy,26,0,28,2
1748418524229,LTKO 1A,G01,925323,Yim; Nancy,26,0,28,2
1748418524229,LTKO 1A,H01,925331,Yim; Nancy,25,0,28,3
1748418525262,LTKO 2A,A01,925333,Jung; Ji Yun,14,0,28,14
1748418525262,LTKO 2A,B01,925335,Jung; Ji Yun,24,0,28,4
1748418525262,LTKO 2A,C01,925338,Lee; Jeyseon,26,0,28,2
1748418526287,LTKO 130F,A00,925468,Lee; Jeyseon,22,0,25,3
1748418527315,LTLA 1,A00,925339,Murray; Kourtney Kristine,0,0,20,20
1748418528342,LTLA 100,A00,925470,Murray; Kourtney Kristine,39,0,40,1
1748418529379,LTRU 1A,A01,925342,Wells; Patricia Rebecca,22,0,28,6
1748418530405,LTRU 2A,A01,925345,Wells; Patricia Rebecca,19,0,20,1
1748418531431,LTRU 104B,A01,925473,Wells; Patricia Rebecca,20,0,20,0
1748418532462,LTRU 150,A00,925474,Morse; Ainsley,10,0,10,0
1748418533491,LTSP 2A,A01,925347,Staff,22,0,28,6
1748418533491,LTSP 2A,B01,925349,Staff,24,0,28,4
1748418534518,LTSP 2B,A01,925351,Staff,17,0,28,11
1748418535550,LTSP 2C,A01,925353,Mastromartino; Alexandra L,22,0,28,6
1748418536575,LTSP 2F,A00,925354,Mastromartino; Alexandra L,25,0,25,0
1748418537605,LTSP 3F,A00,925355,Dominguez; Noelia,24,0,25,1
1748418537605,LTSP 3F,B00,925356,Dominguez; Noelia,22,0,25,3
1748418538650,LTSP 87,A00,925357,Bessett; Ryan Matthew,20,0,20,0
1748418539681,LTSP 100A,A00,925595,Dominguez; Noelia,21,0,25,4
1748418540710,LTSP 100F,A00,925621,Bessett; Ryan Matthew,25,0,25,0
1748418540710,LTSP 100F,B00,925623,Bessett; Ryan Matthew,25,0,25,0
1748418540710,LTSP 100F,C00,925626,Martin-Cabrera; Luis,25,0,25,0
1748418541743,LTSP 116,A00,925629,Villafuerte Vazquez; Nadia,35,0,40,5
1748418542775,LTSP 172,A00,925637,Chacon; Gloria Elizabeth,36,0,40,4
1748418543805,LTSP 174,A00,925639,Chacon; Gloria Elizabeth,34,0,40,6
1748418544838,LTTH 210A,A00,925809,Fiss; Geraldine Anna,6,0,15,9
1748418545870,LTWL 10,A00,925358,Garofalo; Devin,40,0,40,0
1748418546901,LTWL 19A,A00,925360,Myerston Santana; Jacobo,39,0,40,1
1748418547929,LTWL 101,A00,925661,Kelting; Edward William,32,0,40,8
1748418548957,LTWL 165,A00,925748,Kim; Joo Ok,40,0,40,0
1748418549985,LTWL 167,A00,964371,Glaser; Amelia,40,0,40,0
1748418551010,LTWL 183,A00,925755,Cohen; Alain J. J.,34,0,40,6
1748418552040,LTWL 194,A00,925757,Vijay; Ameeth Varma,38,0,40,2
1748418553072,LTWR 8A,A01,925362,Springer; Anna Joy,28,0,28,0
1748418553072,LTWR 8A,A02,925363,Springer; Anna Joy,23,0,28,5
1748418553072,LTWR 8A,A03,925364,Springer; Anna Joy,23,0,28,5
1748418553072,LTWR 8A,A04,925365,Springer; Anna Joy,18,0,28,10
1748418554103,LTWR 8B,A01,925368,Lopez; Casandra,18,0,28,10
1748418554103,LTWR 8B,A02,925370,Lopez; Casandra,19,0,28,9
1748418554103,LTWR 8B,A03,925371,Lopez; Casandra,28,0,28,0
1748418554103,LTWR 8B,A04,925372,Lopez; Casandra,26,0,28,2
1748418555132,LTWR 100C,A00,925759,Staff,16,0,30,14
1748418556158,LTWR 100W,A00,925760,Forbes; Camille,0,0,15,15
1748418557187,LTWR 102W,A00,925761,Lopez; Casandra,6,0,15,9
1748418558215,LTWR 104AW,A00,925762,Hoang; Lily Kim,5,0,15,10
1748418559242,LTWR 106C,A00,925764,Ali; Mohammad Kazim,22,0,30,8
1748418560269,LTWR 113C,A00,925765,Wilkinson; Marco,28,0,30,2
1748418561296,LTWR 115C,A00,925766,Ali; Mohammad Kazim,23,0,30,7
1748418562323,LTWR 124C,A00,925801,Morse; Ainsley,29,0,30,1
1748418563354,LTWR 126C,A00,925802,Forbes; Camille,28,0,30,2
1748418564387,LTWR 148,A00,925804,Wilkinson; Marco,27,0,30,3
1748418565414,LTWR 194,A00,925805,Carroll; Amy Sara,30,0,40,10
1748418566442,LTWR 215,A00,925934,Hoang; Lily Kim,13,0,20,7
1748418567467,LTWR 220,A00,925935,Springer; Anna Joy,10,0,15,5
1748418568508,MAE 2,A01,931344,Anderson; Mark Ronald,0,0,1,1
1748418568508,MAE 2,A02,931345,Anderson; Mark Ronald,0,0,1,1
1748418568508,MAE 2,A03,931347,Anderson; Mark Ronald,0,0,1,1
1748418568508,MAE 2,B01,960499,Sadeghizadeh; Zahra,0,0,1,1
1748418568508,MAE 2,B02,960500,Sadeghizadeh; Zahra,0,0,1,1
1748418568508,MAE 2,B03,960501,Sadeghizadeh; Zahra,0,0,1,1
1748418569542,MAE 3,A01,931355,Delson; Nathan Joseph,8,0,11,3
1748418569542,MAE 3,A02,931356,Delson; Nathan Joseph,10,0,11,1
1748418569542,MAE 3,A03,931357,Delson; Nathan Joseph,10,0,11,1
1748418569542,MAE 3,A04,931358,Delson; Nathan Joseph,11,0,11,0
1748418569542,MAE 3,B01,931360,Qi; Huihui,0,0,11,11
1748418569542,MAE 3,B02,931361,Qi; Huihui,6,0,11,5
1748418569542,MAE 3,B03,931362,Qi; Huihui,9,0,11,2
1748418569542,MAE 3,B04,931364,Qi; Huihui,10,0,11,1
1748418570574,MAE 8,A01,931368,Pham; Hieu Tan,90,0,100,10
1748418571603,MAE 11,A00,931369,Nomura; Keiko K.,83,0,180,97
1748418572629,MAE 20,A00,931371,Graeve; Olivia A,80,0,100,20
1748418573660,MAE 21,A01,931373,Cai; Shengqiang,1,0,10,9
1748418573660,MAE 21,A02,931375,Cai; Shengqiang,7,0,10,3
1748418573660,MAE 21,A03,931376,Cai; Shengqiang,1,0,10,9
1748418573660,MAE 21,A04,931377,Cai; Shengqiang,5,0,10,5
1748418573660,MAE 21,A05,931378,Cai; Shengqiang,10,0,10,0
1748418573660,MAE 21,A06,931381,Cai; Shengqiang,10,0,10,0
1748418573660,MAE 21,A07,931382,Cai; Shengqiang,8,0,10,2
1748418573660,MAE 21,A08,931384,Cai; Shengqiang,7,0,10,3
1748418573660,MAE 21,A09,931385,Cai; Shengqiang,8,0,10,2
1748418573660,MAE 21,A10,931386,Cai; Shengqiang,9,0,10,1
1748418574688,MAE 30A,A00,931387,Lubarda; Marko,29,0,70,41
1748418575714,MAE 40,A00,931388,Cortes; Jorge,83,0,146,63
1748418576745,MAE 101A,A00,931389,Sarkar; Sutanu,94,0,150,56
1748418577773,MAE 101C,A00,931390,Seshadri; Kalyanasundaram,175,0,200,25
1748418578804,MAE 104,A00,931391,Pham; Hieu Tan,146,0,160,14
1748418579831,MAE 105,A00,931392,Bandaru; Prabhakar,135,0,180,45
1748418580859,MAE 107,A00,931393,Chen; Renkun,0,0,90,90
1748418580859,MAE 107,B00,931394,McEneaney; William Michael,45,0,90,45
1748418581894,MAE 108,A00,931395,Hao; Xuanting,91,0,120,29
1748418582921,MAE 113,A00,931396,Seshadri; Kalyanasundaram,92,0,130,38
1748418583951,MAE 114,A00,931399,Krasheninnikov; Sergei,37,0,40,3
1748418584983,MAE 120,A00,931400,Krasheninnikov; Sergei,36,0,50,14
1748418586014,MAE 122,A00,931402,Pawlak; Geno Ronald,43,0,70,27
1748418587046,MAE 131A,A00,931403,Lubarda; Marko,47,0,70,23
1748418588072,MAE 142,A00,931404,Anderson; Mark Ronald,21,0,60,39
1748418589099,MAE 143A,A00,931406,Diagne; Mamadou Lamine,98,0,125,27
1748418590126,MAE 148,A01,931409,Silberman; Jack,11,0,30,19
1748418591152,MAE 150,A00,931411,Friend; James Robert,139,0,192,53
1748418592178,MAE 153,A00,931413,Ghazinejad; Maziar,2,0,45,43
1748418593207,MAE 156A,A01,931416,Delson; Nathan Joseph,2,0,12,10
1748418593207,MAE 156A,A02,931417,Delson; Nathan Joseph,9,0,12,3
1748418593207,MAE 156A,A03,931418,Delson; Nathan Joseph,12,0,12,0
1748418593207,MAE 156A,A04,931419,Delson; Nathan Joseph,10,0,12,2
1748418593207,MAE 156A,A05,931420,Delson; Nathan Joseph,2,0,12,10
1748418593207,MAE 156A,A06,931421,Delson; Nathan Joseph,12,0,12,0
1748418594234,MAE 165,A00,931422,Scholtes Acevedo; Claire,19,0,30,11
1748418595261,MAE 170,A01,931424,Evdokimenko; Ekaterina,9,0,30,21
1748418595261,MAE 170,A02,931427,Evdokimenko; Ekaterina,14,0,30,16
1748418595261,MAE 170,A03,931428,Evdokimenko; Ekaterina,0,0,30,30
1748418595261,MAE 170,A04,931429,Evdokimenko; Ekaterina,14,0,30,16
1748418595261,MAE 170,A05,931430,Evdokimenko; Ekaterina,27,0,30,3
1748418595261,MAE 170,A06,931434,Evdokimenko; Ekaterina,23,0,30,7
1748418596285,MAE 180,A00,931436,Sadeghizadeh; Zahra,109,0,140,31
1748418597328,MAE 181,A00,931437,Bahadori; Mohammad Yousef,53,0,80,27
1748418598362,MAE 190,A00,971317,Marinoni; Alessandro & Krasheninnikov; Sergei,19,0,20,1
1748418599440,MAE 191,A01,931442,Qi; Huihui,19,0,20,1
1748418600468,MAE 201,A00,931445,Pawlak; Geno Ronald,37,0,90,53
1748418601495,MAE 202,A00,931452,Poulikakos; Lisa Voula,42,0,90,48
1748418602522,MAE 203,A00,931455,Frazier; Michael,26,0,90,64
1748418603553,MAE 205,A00,931456,Staff,9989,0,9999,10
1748418604580,MAE 208,A00,931457,Marinoni; Alessandro,52,0,150,98
1748418605612,MAE 210A,A00,931458,Saintillan; David,37,0,60,23
1748418606638,MAE 217A,A00,931459,Arefiev; Alexey,13,0,20,7
1748418607665,MAE 221A,A00,931460,Chen; Renkun,26,0,40,14
1748418608692,MAE 232A,A00,931464,Chen; Jiun-Shyan,3,0,35,32
1748418609719,MAE 233A,A00,931466,Luan; Haiwen,29,0,40,11
1748418610744,MAE 235,A00,954132,Krysl; Petr,0,0,0,0
1748418611774,MAE 249,A00,931472,Tolley; Michael Thomas,8,0,50,42
1748418612799,MAE 251,A00,931477,Graeve; Olivia A,11,0,15,4
1748418613826,MAE 257,A00,931478,Cai; Shengqiang,0,0,10,10
1748418614852,MAE 265A,A00,931480,Bandaru; Prabhakar,10,0,15,5
1748418615878,MAE 271A,A00,931481,Luo; Jian,9,0,10,1
1748418616908,MAE 280A,A00,931482,Kramer; Boris,61,0,110,49
1748418617954,MAE 283A,A00,931484,de Callafon; Raymond A,12,0,50,38
1748418618980,MAE 285,A00,931486,Friend; James Robert,30,0,30,0
1748418620009,MAE 287,A00,931488,Diagne; Mamadou Lamine,17,0,30,13
1748418621035,MAE 290A,A00,931490,Lindsey; Stephanie,42,0,70,28
1748418622067,MAE 294A,A00,931491,Becker; Janet Maria,14,0,20,6
1748418623093,MATH 2,A01,929271,Quarfoot; David James,22,0,25,3
1748418623093,MATH 2,B01,929278,Staff,21,0,25,4
1748418624130,MATH 3B,A01,929284,Hammock; Frances H,1,0,2,1
1748418624130,MATH 3B,A02,929312,Hammock; Frances H,1,0,2,1
1748418624130,MATH 3B,A03,967979,Hammock; Frances H,2,0,2,0
1748418624130,MATH 3B,A04,967980,Hammock; Frances H,1,0,2,1
1748418624130,MATH 3B,A05,967983,Hammock; Frances H,1,0,2,1
1748418624130,MATH 3B,A06,967984,Hammock; Frances H,2,0,2,0
1748418624130,MATH 3B,D01,929666,Staff,0,0,2,2
1748418624130,MATH 3B,D02,929667,Staff,0,0,2,2
1748418624130,MATH 3B,D03,929668,Staff,0,0,2,2
1748418624130,MATH 3B,D04,967987,Staff,0,0,2,2
1748418625164,MATH 3C,A01,929670,Staff,0,0,2,2
1748418625164,MATH 3C,A02,929671,Staff,0,0,2,2
1748418625164,MATH 3C,A03,929672,Staff,2,0,2,0
1748418625164,MATH 3C,A04,929673,Staff,2,0,2,0
1748418625164,MATH 3C,A05,967985,Staff,0,0,2,2
1748418625164,MATH 3C,A06,967986,Staff,1,0,2,1
1748418625164,MATH 3C,B01,929675,Staff,0,0,0,2
1748418625164,MATH 3C,B02,929676,Staff,0,0,2,2
1748418625164,MATH 3C,B03,929677,Staff,0,0,2,2
1748418625164,MATH 3C,B04,929679,Staff,0,0,2,2
1748418625164,MATH 3C,B05,967988,Staff,0,0,2,2
1748418625164,MATH 3C,B06,967989,Staff,0,0,2,2
1748418626198,MATH 4C,B01,929698,Anzaldo; Leesa B,0,0,0,2
1748418626198,MATH 4C,B02,929699,Anzaldo; Leesa B,4,0,4,0
1748418626198,MATH 4C,B03,929700,Anzaldo; Leesa B,3,0,4,1
1748418626198,MATH 4C,B04,929701,Anzaldo; Leesa B,4,0,4,0
1748418626198,MATH 4C,D01,929709,Staff,4,0,4,0
1748418626198,MATH 4C,D02,929710,Staff,3,0,4,1
1748418626198,MATH 4C,D03,967990,Staff,4,0,4,0
1748418626198,MATH 4C,D04,967991,Staff,4,0,4,0
1748418627228,MATH 10A,A01,929713,Staff,8,0,12,4
1748418627228,MATH 10A,A02,929715,Staff,12,0,12,0
1748418627228,MATH 10A,A03,929717,Staff,5,0,5,0
1748418627228,MATH 10A,A04,929718,Staff,5,0,5,0
1748418627228,MATH 10A,A05,929719,Staff,5,0,5,0
1748418627228,MATH 10A,A06,929720,Staff,4,0,5,1
1748418627228,MATH 10A,B01,929723,Eggers; John Dietrich,0,0,0,4
1748418627228,MATH 10A,B02,929724,Eggers; John Dietrich,0,0,4,4
1748418627228,MATH 10A,B03,929726,Eggers; John Dietrich,0,0,4,4
1748418627228,MATH 10A,B04,929727,Eggers; John Dietrich,0,0,4,4
1748418627228,MATH 10A,B05,929728,Eggers; John Dietrich,0,0,4,4
1748418627228,MATH 10A,B06,929729,Eggers; John Dietrich,1,0,4,3
1748418627228,MATH 10A,C01,929732,Staff,0,0,0,3
1748418627228,MATH 10A,C02,929734,Staff,0,0,4,4
1748418627228,MATH 10A,C03,929735,Staff,0,0,4,4
1748418627228,MATH 10A,C04,929736,Staff,0,0,4,4
1748418627228,MATH 10A,C05,929737,Staff,0,0,4,4
1748418627228,MATH 10A,C06,929739,Staff,0,0,4,4
1748418627228,MATH 10A,D01,929742,Staff,0,0,4,4
1748418627228,MATH 10A,D02,929743,Staff,0,0,4,4
1748418627228,MATH 10A,D03,929744,Staff,4,0,4,0
1748418627228,MATH 10A,D04,929746,Staff,4,0,4,0
1748418627228,MATH 10A,D05,929747,Staff,3,0,4,1
1748418627228,MATH 10A,D06,929748,Staff,4,0,4,0
1748418627228,MATH 10A,D07,968012,Staff,1,0,4,3
1748418627228,MATH 10A,D08,968013,Staff,3,0,4,1
1748418627228,MATH 10A,D09,968015,Staff,4,0,4,0
1748418627228,MATH 10A,D10,968017,Staff,2,0,4,2
1748418628262,MATH 10B,A01,929759,Bowers; Adam R.,0,0,10,10
1748418628262,MATH 10B,A02,929760,Bowers; Adam R.,0,0,10,10
1748418628262,MATH 10B,A03,929761,Bowers; Adam R.,0,0,10,10
1748418628262,MATH 10B,A04,929762,Bowers; Adam R.,0,0,10,10
1748418628262,MATH 10B,A05,929763,Bowers; Adam R.,0,0,10,10
1748418628262,MATH 10B,A06,929764,Bowers; Adam R.,0,0,10,10
1748418628262,MATH 10B,B01,929767,Staff,0,0,10,10
1748418628262,MATH 10B,B02,929770,Staff,7,0,10,3
1748418628262,MATH 10B,B03,929771,Staff,10,0,10,0
1748418628262,MATH 10B,B04,929772,Staff,9,0,10,1
1748418628262,MATH 10B,B05,929774,Staff,1,0,10,9
1748418628262,MATH 10B,B06,929775,Staff,10,0,10,0
1748418628262,MATH 10B,C01,929778,Huang; Lei,0,0,8,8
1748418628262,MATH 10B,C02,929779,Huang; Lei,0,0,10,10
1748418628262,MATH 10B,C03,929780,Huang; Lei,2,0,10,8
1748418628262,MATH 10B,C04,929781,Huang; Lei,8,0,10,2
1748418628262,MATH 10B,C05,929784,Huang; Lei,0,0,10,10
1748418628262,MATH 10B,C06,929785,Huang; Lei,2,0,10,8
1748418629293,MATH 10C,A01,929788,Staff,0,0,15,15
1748418629293,MATH 10C,A02,929789,Staff,0,0,15,15
1748418629293,MATH 10C,A03,929790,Staff,12,0,15,3
1748418629293,MATH 10C,A04,929791,Staff,13,0,15,2
1748418629293,MATH 10C,A05,929792,Staff,0,0,15,15
1748418629293,MATH 10C,A06,929793,Staff,0,0,15,15
1748418629293,MATH 10C,A07,929795,Staff,4,0,15,11
1748418629293,MATH 10C,A08,929796,Staff,15,0,15,0
1748418629293,MATH 10C,B01,929798,Staff,15,0,15,0
1748418629293,MATH 10C,B02,929799,Staff,0,0,15,15
1748418629293,MATH 10C,B03,929800,Staff,11,0,15,4
1748418629293,MATH 10C,B04,929802,Staff,14,0,15,1
1748418629293,MATH 10C,B05,929803,Staff,14,0,15,1
1748418629293,MATH 10C,B06,929805,Staff,15,0,15,0
1748418630321,MATH 11,A01,929807,Rava; Denise,0,0,25,25
1748418630321,MATH 11,A02,929808,Rava; Denise,0,0,25,25
1748418630321,MATH 11,A03,929809,Rava; Denise,0,0,25,25
1748418630321,MATH 11,A04,929811,Rava; Denise,0,0,25,25
1748418630321,MATH 11,B01,929816,Rava; Denise,0,0,25,25
1748418630321,MATH 11,B02,929817,Rava; Denise,0,0,25,25
1748418630321,MATH 11,B03,929818,Rava; Denise,0,0,25,25
1748418630321,MATH 11,B04,929819,Rava; Denise,0,0,25,25
1748418631354,MATH 18,C01,929841,Peca-Medlin; John Michael,4,0,10,6
1748418631354,MATH 18,C02,929843,Peca-Medlin; John Michael,7,0,10,3
1748418631354,MATH 18,C03,929844,Peca-Medlin; John Michael,3,0,10,7
1748418631354,MATH 18,C04,929845,Peca-Medlin; John Michael,0,0,10,10
1748418631354,MATH 18,C05,929846,Peca-Medlin; John Michael,2,0,10,8
1748418631354,MATH 18,C06,929848,Peca-Medlin; John Michael,0,0,10,10
1748418631354,MATH 18,D01,929852,Anzaldo; Leesa B,0,0,10,10
1748418631354,MATH 18,D02,929855,Anzaldo; Leesa B,0,0,10,10
1748418631354,MATH 18,D03,929856,Anzaldo; Leesa B,0,0,9,9
1748418631354,MATH 18,D04,929857,Anzaldo; Leesa B,0,0,10,10
1748418631354,MATH 18,D05,929858,Anzaldo; Leesa B,0,0,10,10
1748418631354,MATH 18,D06,929859,Anzaldo; Leesa B,0,0,10,10
1748418631354,MATH 18,E01,929862,Ganesan; Priyanga,0,0,10,10
1748418631354,MATH 18,E02,929863,Ganesan; Priyanga,0,0,10,10
1748418631354,MATH 18,E03,929865,Ganesan; Priyanga,0,0,10,10
1748418631354,MATH 18,E04,929866,Ganesan; Priyanga,8,0,10,2
1748418631354,MATH 18,E05,929867,Ganesan; Priyanga,10,0,10,0
1748418631354,MATH 18,E06,929869,Ganesan; Priyanga,10,0,10,0
1748418631354,MATH 18,F01,929872,Ganesan; Priyanga,12,0,20,8
1748418631354,MATH 18,F02,929873,Ganesan; Priyanga,17,0,20,3
1748418631354,MATH 18,F03,929874,Ganesan; Priyanga,19,0,20,1
1748418631354,MATH 18,F04,929875,Ganesan; Priyanga,19,0,20,1
1748418631354,MATH 18,F05,968018,Ganesan; Priyanga,12,0,12,0
1748418631354,MATH 18,F06,968019,Ganesan; Priyanga,11,0,12,1
1748418631354,MATH 18,F07,968020,Ganesan; Priyanga,10,0,12,2
1748418631354,MATH 18,F08,968022,Ganesan; Priyanga,11,0,12,1
1748418632381,MATH 20A,A01,929880,Bowers; Adam R.,23,0,25,2
1748418632381,MATH 20A,A02,929881,Bowers; Adam R.,24,0,25,1
1748418632381,MATH 20A,A03,929883,Bowers; Adam R.,1,0,5,4
1748418632381,MATH 20A,A04,929884,Bowers; Adam R.,4,0,5,1
1748418632381,MATH 20A,B01,929886,Staff,0,0,0,0
1748418632381,MATH 20A,B02,929887,Staff,3,0,5,2
1748418632381,MATH 20A,B03,929888,Staff,5,0,5,0
1748418632381,MATH 20A,B04,929889,Staff,5,0,5,0
1748418632381,MATH 20A,B05,929890,Staff,5,0,5,0
1748418632381,MATH 20A,B06,929891,Staff,5,0,5,0
1748418632381,MATH 20A,B07,967992,Staff,5,0,5,0
1748418632381,MATH 20A,B08,967993,Staff,5,0,5,0
1748418632381,MATH 20A,B09,967994,Staff,5,0,5,0
1748418632381,MATH 20A,B10,967995,Staff,5,0,5,0
1748418633415,MATH 20B,A01,929910,Staff,14,0,15,1
1748418633415,MATH 20B,A02,929911,Staff,15,0,15,0
1748418633415,MATH 20B,A03,929982,Staff,15,0,15,0
1748418633415,MATH 20B,A04,929983,Staff,15,0,15,0
1748418633415,MATH 20B,A05,929984,Staff,15,0,15,0
1748418633415,MATH 20B,A06,929985,Staff,15,0,15,0
1748418633415,MATH 20B,C01,930160,Staff,24,0,25,1
1748418633415,MATH 20B,C02,930186,Staff,25,0,25,0
1748418633415,MATH 20B,C03,930198,Staff,15,0,15,0
1748418633415,MATH 20B,C04,968000,Staff,15,0,15,0
1748418633415,MATH 20B,D01,930241,Chou; Raymond Oliver,14,0,25,11
1748418633415,MATH 20B,D02,930242,Chou; Raymond Oliver,23,0,25,2
1748418633415,MATH 20B,D03,930244,Chou; Raymond Oliver,0,0,15,15
1748418633415,MATH 20B,D04,968002,Chou; Raymond Oliver,0,0,13,13
1748418633415,MATH 20B,E01,930428,Wesley; William J,32,0,35,3
1748418633415,MATH 20B,E02,930529,Wesley; William J,35,0,35,0
1748418633415,MATH 20B,E03,968023,Wesley; William J,15,0,15,0
1748418633415,MATH 20B,E04,968024,Wesley; William J,15,0,15,0
1748418633415,MATH 20B,E05,968025,Wesley; William J,15,0,15,0
1748418633415,MATH 20B,E06,968026,Wesley; William J,15,0,15,0
1748418634455,MATH 20C,A01,930548,Staff,18,0,20,2
1748418634455,MATH 20C,A02,930554,Staff,19,0,20,1
1748418634455,MATH 20C,A03,930584,Staff,19,0,20,1
1748418634455,MATH 20C,A04,930606,Staff,20,0,20,0
1748418634455,MATH 20C,A05,930610,Staff,19,0,20,1
1748418634455,MATH 20C,A06,930641,Staff,20,0,20,0
1748418634455,MATH 20C,A07,968027,Staff,20,0,20,0
1748418634455,MATH 20C,A08,968028,Staff,20,0,20,0
1748418634455,MATH 20C,A09,968029,Staff,19,0,20,1
1748418634455,MATH 20C,A10,968031,Staff,20,0,20,0
1748418634455,MATH 20C,C01,930911,Staff,6,0,20,14
1748418634455,MATH 20C,C02,930940,Staff,16,0,20,4
1748418634455,MATH 20C,C03,930946,Staff,18,0,20,2
1748418634455,MATH 20C,C04,930959,Staff,20,0,20,0
1748418634455,MATH 20C,C05,930966,Staff,19,0,20,1
1748418634455,MATH 20C,C06,930974,Staff,16,0,20,4
1748418634455,MATH 20C,D01,931266,Hammock; Frances H,10,0,20,10
1748418634455,MATH 20C,D02,931267,Hammock; Frances H,14,0,17,3
1748418634455,MATH 20C,D03,931268,Hammock; Frances H,17,0,20,3
1748418634455,MATH 20C,D04,931269,Hammock; Frances H,19,0,20,1
1748418634455,MATH 20C,D05,931270,Hammock; Frances H,20,0,20,0
1748418634455,MATH 20C,D06,931271,Hammock; Frances H,18,0,20,2
1748418634455,MATH 20C,E01,931273,Staff,11,0,20,9
1748418634455,MATH 20C,E02,931274,Staff,19,0,20,1
1748418634455,MATH 20C,E03,931275,Staff,17,0,20,3
1748418634455,MATH 20C,E04,931276,Staff,19,0,20,1
1748418634455,MATH 20C,E05,931278,Staff,20,0,20,0
1748418634455,MATH 20C,E06,931279,Staff,20,0,20,0
1748418634455,MATH 20C,F01,931281,Staff,20,0,25,5
1748418634455,MATH 20C,F02,931282,Staff,22,0,25,3
1748418634455,MATH 20C,F03,931283,Staff,23,0,25,2
1748418634455,MATH 20C,F04,931285,Staff,24,0,25,1
1748418635483,MATH 20D,B01,931293,Upadrashta; Pranav Kumar,0,0,24,25
1748418635483,MATH 20D,B02,931294,Upadrashta; Pranav Kumar,0,0,30,30
1748418635483,MATH 20D,B03,931297,Upadrashta; Pranav Kumar,1,0,30,29
1748418635483,MATH 20D,B04,931298,Upadrashta; Pranav Kumar,8,0,30,22
1748418635483,MATH 20D,B05,931299,Upadrashta; Pranav Kumar,1,0,30,29
1748418635483,MATH 20D,B06,931300,Upadrashta; Pranav Kumar,26,0,30,4
1748418635483,MATH 20D,C01,931305,Upadrashta; Pranav Kumar,16,0,40,24
1748418635483,MATH 20D,C02,931306,Upadrashta; Pranav Kumar,38,0,40,2
1748418635483,MATH 20D,C03,931307,Upadrashta; Pranav Kumar,12,0,30,18
1748418635483,MATH 20D,C04,931308,Upadrashta; Pranav Kumar,26,0,30,4
1748418636512,MATH 20E,A01,931313,Staff,0,0,27,27
1748418636512,MATH 20E,A02,931315,Staff,20,0,27,7
1748418636512,MATH 20E,A03,931316,Staff,27,0,27,0
1748418636512,MATH 20E,A04,931317,Staff,27,0,27,0
1748418636512,MATH 20E,A05,968032,Staff,9,0,27,18
1748418636512,MATH 20E,A06,968033,Staff,24,0,27,3
1748418636512,MATH 20E,A07,968034,Staff,27,0,27,0
1748418636512,MATH 20E,A08,968035,Staff,26,0,27,1
1748418636512,MATH 20E,C01,931327,Staff,0,0,23,23
1748418636512,MATH 20E,C02,931329,Staff,0,0,27,27
1748418636512,MATH 20E,C03,931331,Staff,0,0,27,27
1748418636512,MATH 20E,C04,931332,Staff,0,0,27,27
1748418636512,MATH 20E,C05,931333,Staff,0,0,27,27
1748418636512,MATH 20E,C06,931334,Staff,8,0,27,19
1748418637540,MATH 31AH,A01,931337,Nandi; Achinta Kumar,5,0,5,0
1748418637540,MATH 31AH,A02,931340,Nandi; Achinta Kumar,5,0,5,0
1748418638569,MATH 87,A00,970775,Harel; Guershon,0,0,0,0
1748418638569,MATH 87,B00,970803,Meyer; David A.,0,0,0,0
1748418639594,MATH 88,A00,967999,Seward; Brandon M.,30,0,35,5
1748418640623,MATH 96,A00,931341,Kane; Daniel Mertz,0,0,0,0
1748418641648,MATH 100A,A01,927335,De Vleming; Kristin Elizab,21,0,30,9
1748418641648,MATH 100A,A02,927337,De Vleming; Kristin Elizab,24,0,30,6
1748418641648,MATH 100A,B01,927341,De Vleming; Kristin Elizab,2,0,30,28
1748418641648,MATH 100A,B02,927342,De Vleming; Kristin Elizab,8,0,30,22
1748418642675,MATH 102,B01,927348,Harel; Guershon,2,0,30,28
1748418642675,MATH 102,B02,927349,Harel; Guershon,22,0,30,8
1748418643703,MATH 103A,B01,927370,Staff,16,0,30,14
1748418643703,MATH 103A,B02,927378,Staff,29,0,30,1
1748418643703,MATH 103A,B03,969574,Staff,27,0,30,3
1748418643703,MATH 103A,C01,927381,Staff,14,0,30,16
1748418643703,MATH 103A,C02,927385,Staff,24,0,30,6
1748418643703,MATH 103A,D01,927388,Suk; Andrew Hoon,0,0,30,30
1748418643703,MATH 103A,D02,927389,Suk; Andrew Hoon,0,0,30,30
1748418644732,MATH 105,A01,927391,Ganapathy; Karthik,26,0,35,9
1748418644732,MATH 105,A02,927454,Ganapathy; Karthik,29,0,35,6
1748418645771,MATH 109,B01,927493,Xiao; Ming,0,0,5,5
1748418645771,MATH 109,B02,927494,Xiao; Ming,0,0,5,5
1748418645771,MATH 109,C01,927500,Xiao; Ming,0,0,5,5
1748418645771,MATH 109,C02,927501,Xiao; Ming,0,0,5,5
1748418645771,MATH 109,D01,927516,Buzaglo; Lucas,0,0,5,5
1748418645771,MATH 109,D02,927517,Buzaglo; Lucas,0,0,5,5
1748418645771,MATH 109,E01,927519,Buzaglo; Lucas,0,0,5,5
1748418645771,MATH 109,E02,927552,Buzaglo; Lucas,0,0,5,5
1748418646800,MATH 111A,A01,927559,Meyer; David A.,0,0,35,35
1748418647831,MATH 120A,A01,927572,Eggers; John Dietrich,13,0,30,17
1748418647831,MATH 120A,A02,927574,Eggers; John Dietrich,29,0,30,1
1748418648859,MATH 140A,A01,927580,Spolaor; Luca,0,0,30,30
1748418648859,MATH 140A,A02,927582,Spolaor; Luca,6,0,30,24
1748418648859,MATH 140A,B01,927588,Ioana; Adrian,0,0,30,30
1748418648859,MATH 140A,B02,927599,Ioana; Adrian,0,0,30,30
1748418649895,MATH 142A,B01,927620,Bejenaru; Ioan,0,0,30,30
1748418649895,MATH 142A,B02,927750,Bejenaru; Ioan,13,0,30,17
1748418649895,MATH 142A,C01,927789,Staff,25,0,30,5
1748418649895,MATH 142A,C02,927815,Staff,30,0,30,0
1748418649895,MATH 142A,C03,969575,Staff,25,0,30,5
1748418649895,MATH 142A,D01,927829,Staff,15,0,30,15
1748418649895,MATH 142A,D02,927832,Staff,30,0,30,0
1748418650925,MATH 153,A01,927862,Harel; Guershon,26,0,35,9
1748418651952,MATH 154,A01,928077,Kane; Daniel Mertz,28,0,35,7
1748418651952,MATH 154,A02,928083,Kane; Daniel Mertz,35,0,35,0
1748418651952,MATH 154,A03,928085,Kane; Daniel Mertz,0,0,35,35
1748418651952,MATH 154,A04,928086,Kane; Daniel Mertz,20,0,35,15
1748418652982,MATH 170A,A01,928146,Tian; Xiaochuan,0,0,30,30
1748418652982,MATH 170A,A02,928225,Tian; Xiaochuan,3,0,30,27
1748418652982,MATH 170A,A03,928231,Tian; Xiaochuan,26,0,30,4
1748418652982,MATH 170A,A04,928237,Tian; Xiaochuan,30,0,30,0
1748418652982,MATH 170A,B01,928244,Huang; Lei,23,0,30,7
1748418652982,MATH 170A,B02,928273,Huang; Lei,30,0,30,0
1748418652982,MATH 170A,B03,928274,Huang; Lei,18,0,30,12
1748418652982,MATH 170A,B04,928276,Huang; Lei,28,0,30,2
1748418654011,MATH 173A,A01,928278,Ding; Lijun,0,0,30,30
1748418654011,MATH 173A,A02,928319,Ding; Lijun,0,0,30,30
1748418654011,MATH 173A,A03,928322,Ding; Lijun,0,0,30,30
1748418654011,MATH 173A,A04,928377,Ding; Lijun,0,0,30,30
1748418654011,MATH 173A,B01,928383,Cloninger; Alexander,0,0,30,30
1748418654011,MATH 173A,B02,928384,Cloninger; Alexander,0,0,30,30
1748418654011,MATH 173A,B03,928385,Cloninger; Alexander,0,0,30,30
1748418654011,MATH 173A,B04,928386,Cloninger; Alexander,0,0,30,30
1748418655040,MATH 174,A01,928397,Cheng; Li-Tien,15,0,28,13
1748418655040,MATH 174,A02,928402,Cheng; Li-Tien,23,0,28,5
1748418656068,MATH 180A,A01,928408,Staff,0,0,25,25
1748418656068,MATH 180A,A02,928409,Staff,18,0,25,7
1748418656068,MATH 180A,A03,928416,Staff,23,0,25,2
1748418656068,MATH 180A,A04,928417,Staff,21,0,25,4
1748418656068,MATH 180A,B01,928428,Peca-Medlin; John Michael,0,0,25,25
1748418656068,MATH 180A,B02,928435,Peca-Medlin; John Michael,12,0,25,13
1748418656068,MATH 180A,B03,928436,Peca-Medlin; John Michael,20,0,25,5
1748418656068,MATH 180A,B04,928453,Peca-Medlin; John Michael,21,0,25,4
1748418656068,MATH 180A,C01,928466,Dixit; Rishabh,20,0,25,5
1748418656068,MATH 180A,C02,928467,Dixit; Rishabh,25,0,25,0
1748418656068,MATH 180A,C03,928506,Dixit; Rishabh,22,0,25,3
1748418656068,MATH 180A,C04,928511,Dixit; Rishabh,25,0,25,0
1748418657099,MATH 180C,A01,928520,Schweinsberg; Jason,0,0,35,35
1748418657099,MATH 180C,A02,928527,Schweinsberg; Jason,0,0,35,35
1748418658126,MATH 181B,A01,928538,Lou; Zhipeng,3,0,30,27
1748418658126,MATH 181B,A02,928539,Lou; Zhipeng,21,0,30,9
1748418658126,MATH 181B,A03,928543,Lou; Zhipeng,27,0,30,3
1748418659153,MATH 183,A01,928545,Quarfoot; David James,0,0,22,22
1748418659153,MATH 183,A02,928560,Quarfoot; David James,0,0,22,22
1748418659153,MATH 183,A03,928565,Quarfoot; David James,0,0,22,22
1748418659153,MATH 183,A04,928566,Quarfoot; David James,0,0,22,22
1748418659153,MATH 183,A05,928567,Quarfoot; David James,0,0,22,22
1748418659153,MATH 183,A06,928568,Quarfoot; David James,0,0,22,22
1748418660180,MATH 184,A01,928587,Chou; Raymond Oliver,14,0,35,21
1748418660180,MATH 184,A02,928592,Chou; Raymond Oliver,29,0,35,6
1748418660180,MATH 184,A03,928593,Chou; Raymond Oliver,32,0,35,3
1748418660180,MATH 184,A04,928594,Chou; Raymond Oliver,35,0,35,0
1748418661206,MATH 187A,A01,928609,Ganapathy; Karthik,0,0,25,25
1748418661206,MATH 187A,A02,928614,Ganapathy; Karthik,0,0,25,25
1748418661206,MATH 187A,A03,928615,Ganapathy; Karthik,0,0,25,25
1748418661206,MATH 187A,A04,928616,Ganapathy; Karthik,7,0,25,18
1748418661206,MATH 187A,A05,928617,Ganapathy; Karthik,0,0,25,25
1748418661206,MATH 187A,A06,928618,Ganapathy; Karthik,12,0,25,13
1748418662233,MATH 190A,A01,928685,Roberts; Justin Deritter,15,0,35,20
1748418663260,MATH 197,001,973284,Kedlaya; Kiran S.,9999,0,9999,0
1748418664285,MATH 200A,A00,928693,Salehi Golsefidy; Alireza,20,0,20,0
1748418665314,MATH 201A,A00,928694,Wenzl; Hans G,20,0,20,0
1748418666345,MATH 202A,A00,928732,Novak; Jonathan I,15,0,20,5
1748418667376,MATH 203A,A00,928743,Izadi; Elham,20,0,20,0
1748418668405,MATH 204A,A00,928764,Sorensen; Claus M,19,0,20,1
1748418669434,MATH 208,A00,928765,Staff,10,0,10,0
1748418670463,MATH 209,A00,928766,Staff,10,0,10,0
1748418671490,MATH 210A,A00,928808,Miller; Pearson,19,0,20,1
1748418672520,MATH 211A,A00,928809,Staff,10,0,10,0
1748418673544,MATH 211B,A00,928811,Staff,10,0,10,0
1748418674570,MATH 216A,A00,928812,Webber; Robert Jacobs,12,0,20,8
1748418675597,MATH 218,A00,928828,Staff,9,0,10,1
1748418676626,MATH 220A,A00,928829,Ebenfelt; Peter F,15,0,20,5
1748418677654,MATH 240A,A00,928830,Spolaor; Luca,17,0,20,3
1748418678684,MATH 241A,A00,928831,Zlatos; Andrej,14,0,20,6
1748418679713,MATH 242,A00,928903,Bejenaru; Ioan,16,0,20,4
1748418680739,MATH 243,A00,928911,Staff,10,0,10,0
1748418681765,MATH 248,A00,928919,Staff,10,0,10,0
1748418682793,MATH 251A,A00,928970,Sam; Steven V,18,0,20,2
1748418683818,MATH 258,A00,928973,Staff,10,0,10,0
1748418684843,MATH 259A,A00,929052,Staff,18,0,20,2
1748418685869,MATH 261A,A00,929059,Warnke; Lutz Peter,10,0,20,10
1748418686896,MATH 269,A00,929060,Staff,10,0,10,0
1748418687929,MATH 270A,A00,929061,Dumitriu; Ioana,8,0,20,12
1748418688959,MATH 273A,A00,929063,Leok; Melvin,17,0,20,3
1748418689985,MATH 274,A01,929069,Cheng; Li-Tien,5,0,5,0
1748418689985,MATH 274,A02,929071,Cheng; Li-Tien,5,0,5,0
1748418691012,MATH 277A,A00,929073,Grier; Daniel T,18,0,20,2
1748418691012,MATH 277A,B00,929080,Nie; Jiawang,20,0,20,0
1748418692039,MATH 278A,A00,929092,Staff,10,0,10,0
1748418693067,MATH 278B,A00,929105,Staff,10,0,10,0
1748418694094,MATH 278C,A00,929113,Staff,10,0,10,0
1748418695124,MATH 280A,A00,929117,Ang; Jie Jun,7,0,20,13
1748418696149,MATH 281A,A00,929120,Lou; Zhipeng,9,0,20,11
1748418697179,MATH 282A,A00,929138,Zhang; Danna,4,0,20,16
1748418698211,MATH 283,A00,929153,Tesler; Glenn,0,0,0,17
1748418699243,MATH 287A,A00,967998,Politis; Dimitris,9,0,15,6
1748418700270,MATH 288,A00,929158,Staff,9,0,10,1
1748418701293,MATH 290A,A00,929180,McKernan; James,18,0,20,2
1748418702318,MATH 292,A00,929185,Staff,10,0,10,0
1748418703401,MATH 295,A00,929189,Staff,15,0,15,0
1748418704429,MATH 297,001,929218,Gamst; Anthony Collins,0,0,0,0
1748418705476,MATS 200,A00,927075,Graeve; Olivia A,9983,0,9999,16
1748418706506,MATS 201A,A00,927076,Luo; Jian,36,0,50,14
1748418707535,MATS 202,A00,927102,Staff,37,0,50,13
1748418708564,MATS 227,A00,927103,Graeve; Olivia A,36,0,50,14
1748418709591,MATS 251A,A00,927139,Bandaru; Prabhakar,40,0,50,10
1748418710622,MATS 257,A00,927140,Cai; Shengqiang,8,0,20,12
1748418711649,MATS 295,A00,927151,Graeve; Olivia A,9999,0,9999,0
1748418711649,MATS 295,B00,927152,Kummel; Andrew C,9999,0,9999,0
1748418712684,MCWP 40,001,945345,Guillen; Melinda,3,0,3,0
1748418712684,MCWP 40,002,945347,Guillen; Melinda,0,0,3,3
1748418712684,MCWP 40,003,945348,Guillen; Melinda,0,0,3,3
1748418712684,MCWP 40,004,945379,Wastal; Carrie King,3,0,3,0
1748418712684,MCWP 40,005,945382,Wastal; Carrie King,2,0,3,1
1748418712684,MCWP 40,006,945383,Compas; Sean Matthew,0,0,3,3
1748418712684,MCWP 40,007,945387,Bartulis; Jason Michael,3,0,3,0
1748418712684,MCWP 40,008,945388,Wastal; Carrie King,2,0,3,1
1748418712684,MCWP 40,009,945391,Wastal; Carrie King,3,0,3,0
1748418712684,MCWP 40,011,945394,Bartulis; Jason Michael,3,0,3,0
1748418712684,MCWP 40,012,945395,Carter; Jennifer A,3,0,3,0
1748418712684,MCWP 40,013,945396,Carter; Jennifer A,2,0,3,1
1748418712684,MCWP 40,014,945429,Carter; Jennifer A,2,0,3,1
1748418712684,MCWP 40,015,945432,Smith; Haydee Marie,3,0,3,0
1748418712684,MCWP 40,016,945433,Smith; Haydee Marie,3,0,3,0
1748418712684,MCWP 40,017,945435,Smith; Haydee Marie,3,0,3,0
1748418712684,MCWP 40,018,945436,Pham; Vincent Minhduc,3,0,3,0
1748418712684,MCWP 40,019,945453,Pham; Vincent Minhduc,3,0,3,0
1748418712684,MCWP 40,020,945459,Pham; Vincent Minhduc,3,0,3,0
1748418712684,MCWP 40,023,945469,Montejo; Carolina,3,0,3,0
1748418712684,MCWP 40,024,945472,Montejo; Carolina,3,0,3,0
1748418712684,MCWP 40,026,945708,Compas; Sean Matthew,3,0,3,0
1748418712684,MCWP 40,027,945710,Duru; Nur,2,0,3,1
1748418712684,MCWP 40,028,945714,Duru; Nur,1,0,3,2
1748418712684,MCWP 40,029,945715,Duru; Nur,2,0,3,1
1748418712684,MCWP 40,030,945718,Compas; Sean Matthew,0,0,3,3
1748418713711,MCWP 40R,A00,945742,Miller; Elizabeth Deen,0,0,0,1
1748418713711,MCWP 40R,B00,945743,Miller; Elizabeth Deen,0,0,0,0
1748418713711,MCWP 40R,C00,945744,Miller; Elizabeth Deen,0,0,0,1
1748418714743,MCWP 50,001,945745,Wastal; Carrie King,2,0,15,13
1748418714743,MCWP 50,002,945746,Carter; Andrea L,18,0,20,2
1748418714743,MCWP 50,003,945788,Carter; Andrea L,11,0,20,9
1748418714743,MCWP 50,004,945887,Carter; Andrea L,8,0,20,12
1748418715781,MCWP 125,001,945901,Nies; Laurie Elizabeth,3,0,3,0
1748418715781,MCWP 125,002,945902,Nies; Laurie Elizabeth,3,0,3,0
1748418715781,MCWP 125,003,945904,Redela; Pamela Morgan,3,0,3,0
1748418715781,MCWP 125,004,945930,Redela; Pamela Morgan,3,0,3,0
1748418715781,MCWP 125,005,945931,Redela; Pamela Morgan,3,0,3,0
1748418715781,MCWP 125,006,945932,Silva; Kelly B,3,0,3,0
1748418715781,MCWP 125,007,945933,Silva; Kelly B,3,0,3,0
1748418715781,MCWP 125,009,945935,Krone; Jarret,3,0,3,0
1748418715781,MCWP 125,010,945940,Krone; Jarret,3,0,3,0
1748418715781,MCWP 125,011,945941,Krone; Jarret,3,0,3,0
1748418715781,MCWP 125,012,945942,Morshed; Michael James,3,0,3,0
1748418715781,MCWP 125,013,945943,Morshed; Michael James,3,0,3,0
1748418715781,MCWP 125,014,945944,Morshed; Michael James,3,0,3,0
1748418716808,MGT 3,A00,945992,Wagner; Timothy Ryan,96,0,98,2
1748418717836,MGT 4,A01,945994,Brooks; Marcus Raymond,80,0,90,10
1748418718866,MGT 5,A00,945995,Molloie Jr.; William H,134,0,150,16
1748418719895,MGT 12,A00,945996,Lindenberger; Wade Douglas,63,0,98,35
1748418719895,MGT 12,B00,945997,Pecore; Joseph P.,58,0,98,40
1748418720927,MGT 16,A00,945998,Buchanan; Harold G,96,0,98,2
1748418720927,MGT 16,B00,946005,Buchanan; Harold G,90,0,98,8
1748418720927,MGT 16,C00,946006,Campbell; Robert Harold,93,0,98,5
1748418720927,MGT 16,D00,946007,Campbell; Robert Harold,93,0,98,5
1748418720927,MGT 16,E00,946022,Lindenberger; Wade Douglas,43,0,98,55
1748418721967,MGT 18,A00,946040,McKay; Michael J,95,0,98,3
1748418721967,MGT 18,B00,946041,McKay; Michael J,96,0,98,2
1748418721967,MGT 18,C00,946044,McKay; Michael J,96,0,98,2
1748418721967,MGT 18,D00,946047,Chamberlain; Travis Dean,98,0,98,0
1748418721967,MGT 18,E00,946051,Chamberlain; Travis Dean,96,0,98,2
1748418721967,MGT 18,F00,960148,Chamberlain; Travis Dean,0,0,0,2
1748418722994,MGT 45,A00,946055,Pecore; Joseph P.,81,0,150,69
1748418722994,MGT 45,B00,946057,Pecore; Joseph P.,118,0,150,32
1748418724020,MGT 52,A00,946059,Staff,77,0,98,21
1748418725047,MGT 71,A00,946060,Goodarzi; Shadi,0,0,98,98
1748418725047,MGT 71,B00,946061,Erat; Sanjiv,0,0,98,98
1748418725047,MGT 71,D00,960149,Staff,0,0,98,98
1748418726075,MGT 100,A00,946069,Yavorsky; Daniel Ryan,0,0,98,98
1748418727101,MGT 103,A00,946081,Ehrich; Kristine R,96,0,98,2
1748418727101,MGT 103,C00,946083,Ehrich; Kristine R,75,0,98,23
1748418727101,MGT 103,D00,946084,Ehrich; Kristine R,57,0,98,41
1748418727101,MGT 103,E00,946138,Bates; Kenneth Walter,82,0,98,16
1748418728129,MGT 105,A00,946139,Bates; Kenneth Walter,0,0,98,98
1748418729158,MGT 108R,A00,946141,Amir; On,888,0,999,111
1748418730184,MGT 109,A00,946142,Staff,14,0,98,84
1748418731214,MGT 112,A00,960205,Zimmermann; Carsten,31,0,98,67
1748418732240,MGT 119,A00,946144,Schurr; Amos Shlomo,96,0,98,2
1748418732240,MGT 119,B00,946153,Staff,97,0,98,1
1748418733269,MGT 121A,A00,946154,Wang; Helen Shan,89,0,98,9
1748418733269,MGT 121A,B00,946188,Wang; Helen Shan,96,0,98,2
1748418734301,MGT 127R,A00,946197,Zhu; Kevin Xiaoguo,70,0,98,28
1748418735332,MGT 131A,A00,946227,Brooks; Marcus Raymond,91,0,98,7
1748418736360,MGT 132,A00,946230,Blakley; Bruce,76,0,98,22
1748418737385,MGT 135,A00,946234,Anderson; John Charles,1,0,40,39
1748418738412,MGT 137,A00,960206,Lindenberger; Wade Douglas,0,0,98,98
1748418739438,MGT 151R,A00,946235,Staff,65,0,98,33
1748418740463,MGT 153,A00,946242,Perols; Johan Lars,0,0,90,90
1748418740463,MGT 153,B00,946244,Perols; Johan Lars,0,0,90,90
1748418741489,MGT 158,A00,946247,Bliss; Barbara Ann,85,0,98,13
1748418742515,MGT 160,A00,946265,Johnson; Erik Barry,30,0,90,60
1748418742515,MGT 160,B00,946266,Johnson; Erik Barry,58,0,90,32
1748418743545,MGT 162,A00,946267,Demill; Burritt,85,0,98,13
1748418743545,MGT 162,B00,946269,Demill; Burritt,67,0,98,31
1748418744575,MGT 162R,A00,946270,Gneezy; Uri,0,0,150,150
1748418745608,MGT 164,A00,946271,McKay; Mary A,88,0,98,10
1748418745608,MGT 164,B00,946272,McKay; Mary A,80,0,98,18
1748418745608,MGT 164,C00,946273,McKay; Mary A,88,0,98,10
1748418745608,MGT 164,D00,946274,Meyer; Alison Bloomfield,0,0,98,98
1748418746641,MGT 166,A00,946276,Moran; Cathleen L.,40,0,60,20
1748418746641,MGT 166,B00,946277,Moran; Cathleen L.,84,0,98,14
1748418746641,MGT 166,C00,946278,Moran; Cathleen L.,94,0,98,4
1748418747674,MGT 167,A00,946279,Jacob; Jo Dee C,88,0,98,10
1748418747674,MGT 167,B00,946280,Klaas; Jeffrey David,97,0,98,1
1748418749729,MGT 172,A00,946282,Hedges; Kathleen & Royal; Rebecca,92,0,98,6
1748418749729,MGT 172,B00,946283,Hedges; Kathleen,73,0,98,25
1748418749729,MGT 172,C00,946284,Zimmermann; Carsten,0,0,0,3
1748418750757,MGT 172R,A00,946285,Erat; Sanjiv,134,0,150,16
1748418751783,MGT 173,A00,946286,Hayes; Sherry Lorine,66,0,98,32
1748418752808,MGT 175,A00,946287,Gopal; Christopher S.,81,0,90,9
1748418753837,MGT 180,A00,946288,Bliss; Barbara Ann,96,0,150,54
1748418753837,MGT 180,B00,946289,Buti; Krisztina,140,0,150,10
1748418753837,MGT 180,C00,960207,Buti; Krisztina,142,0,150,8
1748418754866,MGT 181,A00,946290,Buchanan; Harold G,17,0,120,103
1748418755893,MGT 183,A00,960208,Staff,53,0,98,45
1748418756924,MGT 185,A00,946291,Dunn; Louis Jean,70,0,98,28
1748418757952,MGT 187,A00,946292,Dunn; Louis Jean,43,0,98,55
1748418758986,MGT 189,A00,946293,Staff,88,0,98,10
1748418760012,MGT 228,A00,946294,Sadoff; Sally,16,0,20,4
1748418761040,MGT 286,A00,946295,Staff,20,0,20,0
1748418762083,MGT 296,001,969295,Gneezy; Ayelet,2,0,3,1
1748418762083,MGT 296,002,969296,Amir; On,3,0,3,0
1748418762083,MGT 296,003,969297,Amir; On & Karmarkar; Uma R,2,0,3,1
1748418762083,MGT 296,004,969298,Liu; Jun,3,0,3,0
1748418762083,MGT 296,005,969300,Hansen; Karsten T.,2,0,3,1
1748418762083,MGT 296,006,969301,Erat; Sanjiv,2,0,3,1
1748418762083,MGT 296,007,969302,Avenancio-Leon; Carlos,3,0,3,0
1748418762083,MGT 296,008,969303,Engelberg; Joseph Edward,3,0,3,0
1748418762083,MGT 296,009,969304,Zhang; Zhe,3,0,3,0
1748418762083,MGT 296,010,969305,Oveis; Christopher S,3,0,3,0
1748418762083,MGT 296,011,969306,Zhu; Kevin Xiaoguo & Gneezy; Ayelet,3,0,3,0
1748418762083,MGT 296,012,969307,Luo; Danqi,3,0,3,0
1748418762083,MGT 296,013,969309,Oveis; Christopher S & Campbell; Elizabeth L,3,0,3,0
1748418762083,MGT 296,014,969310,Serra Garcia; Marta & Gneezy; Uri,3,0,3,0
1748418762083,MGT 296,015,969311,Rai; Tage S,3,0,3,0
1748418763121,MMW 11,A01,925937,Herbst; Matthew,4,0,4,0
1748418763121,MMW 11,A02,925938,Herbst; Matthew,3,0,4,1
1748418763121,MMW 11,A03,925939,Herbst; Matthew,4,0,4,0
1748418763121,MMW 11,A04,925940,Herbst; Matthew,4,0,4,0
1748418763121,MMW 11,A05,925941,Herbst; Matthew,0,0,0,0
1748418763121,MMW 11,A06,925942,Herbst; Matthew,0,0,0,0
1748418763121,MMW 11,A07,925975,Herbst; Matthew,3,0,4,1
1748418763121,MMW 11,A08,926004,Herbst; Matthew,3,0,4,1
1748418763121,MMW 11,A09,926021,Herbst; Matthew,3,0,4,1
1748418763121,MMW 11,A10,926064,Herbst; Matthew,4,0,4,0
1748418763121,MMW 11,A11,926067,Herbst; Matthew,4,0,4,0
1748418763121,MMW 11,A12,926072,Herbst; Matthew,4,0,4,0
1748418763121,MMW 11,B01,926211,Chang; Edmond Yi-Teh,3,0,4,1
1748418763121,MMW 11,B02,926212,Chang; Edmond Yi-Teh,4,0,4,0
1748418763121,MMW 11,B03,926213,Chang; Edmond Yi-Teh,4,0,4,0
1748418763121,MMW 11,B04,926214,Chang; Edmond Yi-Teh,4,0,4,0
1748418763121,MMW 11,B05,926215,Chang; Edmond Yi-Teh,4,0,4,0
1748418763121,MMW 11,B06,926216,Chang; Edmond Yi-Teh,4,0,4,0
1748418763121,MMW 11,B07,926217,Chang; Edmond Yi-Teh,4,0,4,0
1748418763121,MMW 11,B08,926218,Chang; Edmond Yi-Teh,3,0,4,1
1748418763121,MMW 11,B09,926219,Chang; Edmond Yi-Teh,4,0,4,0
1748418763121,MMW 11,B10,926220,Chang; Edmond Yi-Teh,4,0,4,0
1748418763121,MMW 11,B11,926221,Chang; Edmond Yi-Teh,0,0,0,0
1748418763121,MMW 11,B12,926233,Chang; Edmond Yi-Teh,0,0,0,0
1748418763121,MMW 11,C01,926237,Chang; Edmond Yi-Teh,4,0,4,0
1748418763121,MMW 11,C02,926238,Chang; Edmond Yi-Teh,4,0,4,0
1748418763121,MMW 11,C03,926239,Chang; Edmond Yi-Teh,3,0,4,1
1748418763121,MMW 11,C04,926240,Chang; Edmond Yi-Teh,4,0,4,0
1748418763121,MMW 11,C05,926241,Chang; Edmond Yi-Teh,4,0,4,0
1748418763121,MMW 11,C06,926242,Chang; Edmond Yi-Teh,4,0,4,0
1748418763121,MMW 11,C07,926243,Chang; Edmond Yi-Teh,4,0,4,0
1748418763121,MMW 11,C08,926244,Chang; Edmond Yi-Teh,4,0,4,0
1748418763121,MMW 11,C09,926245,Chang; Edmond Yi-Teh,0,0,0,0
1748418763121,MMW 11,C10,926301,Chang; Edmond Yi-Teh,0,0,0,0
1748418763121,MMW 11,C11,926303,Chang; Edmond Yi-Teh,4,0,4,0
1748418763121,MMW 11,C12,926305,Chang; Edmond Yi-Teh,4,0,4,0
1748418764158,MMW 14,A01,926309,Carreras; Maria Victoria,0,0,0,0
1748418764158,MMW 14,A02,926470,Carreras; Maria Victoria,0,0,0,0
1748418764158,MMW 14,A03,926472,Carreras; Maria Victoria,0,0,28,28
1748418764158,MMW 14,A04,926474,Carreras; Maria Victoria,0,0,28,28
1748418764158,MMW 14,A05,926475,Carreras; Maria Victoria,0,0,28,28
1748418764158,MMW 14,A06,926476,Carreras; Maria Victoria,0,0,28,28
1748418764158,MMW 14,A07,926477,Carreras; Maria Victoria,0,0,28,28
1748418764158,MMW 14,A08,926513,Carreras; Maria Victoria,0,0,28,28
1748418764158,MMW 14,A09,926514,Carreras; Maria Victoria,0,0,0,0
1748418764158,MMW 14,A10,926515,Carreras; Maria Victoria,0,0,0,0
1748418765200,MMW 121,A01,926517,Adamiak; Patrick John,0,0,0,0
1748418765200,MMW 121,A02,926548,Adamiak; Patrick John,0,0,0,0
1748418765200,MMW 121,A03,926549,Adamiak; Patrick John,0,0,4,4
1748418765200,MMW 121,A04,926550,Adamiak; Patrick John,2,0,4,2
1748418765200,MMW 121,A05,926551,Adamiak; Patrick John,0,0,4,4
1748418765200,MMW 121,A06,926552,Adamiak; Patrick John,3,0,4,1
1748418765200,MMW 121,A07,926585,Adamiak; Patrick John,3,0,4,1
1748418765200,MMW 121,A08,926590,Adamiak; Patrick John,3,0,4,1
1748418765200,MMW 121,A09,926641,Adamiak; Patrick John,0,0,0,0
1748418765200,MMW 121,A10,926658,Adamiak; Patrick John,0,0,0,0
1748418765200,MMW 121,B01,926680,Adamiak; Patrick John,0,0,4,4
1748418765200,MMW 121,B02,926691,Adamiak; Patrick John,0,0,4,4
1748418765200,MMW 121,B03,926710,Adamiak; Patrick John,2,0,4,2
1748418765200,MMW 121,B04,926714,Adamiak; Patrick John,4,0,4,0
1748418765200,MMW 121,B05,926750,Adamiak; Patrick John,0,0,4,4
1748418765200,MMW 121,B06,926765,Adamiak; Patrick John,4,0,4,0
1748418765200,MMW 121,B07,926769,Adamiak; Patrick John,3,0,4,1
1748418765200,MMW 121,B08,926953,Adamiak; Patrick John,3,0,4,1
1748418765200,MMW 121,B09,926954,Adamiak; Patrick John,0,0,0,0
1748418765200,MMW 121,B10,926955,Adamiak; Patrick John,0,0,0,0
1748418766229,MSED 295,A00,927153,Staff,5,0,5,0
1748418767256,MSED 296A,A00,927181,Rabin; Jeffrey Mark,13,0,15,2
1748418768284,MUS 1A,A01,931495,Staff,24,0,25,1
1748418768284,MUS 1A,A02,931499,Staff,21,0,25,4
1748418768284,MUS 1A,A03,931502,Staff,21,0,25,4
1748418768284,MUS 1A,A04,931503,Staff,25,0,25,0
1748418768284,MUS 1A,A05,931504,Staff,19,0,25,6
1748418768284,MUS 1A,A06,931505,Staff,22,0,25,3
1748418768284,MUS 1A,B01,931507,Staff,25,0,25,0
1748418768284,MUS 1A,B02,931530,Staff,22,0,25,3
1748418768284,MUS 1A,B03,931534,Staff,23,0,25,2
1748418768284,MUS 1A,B04,931536,Staff,24,0,25,1
1748418768284,MUS 1A,B05,931539,Staff,17,0,25,8
1748418768284,MUS 1A,B06,931541,Staff,13,0,25,12
1748418769312,MUS 2A,A01,931544,Carlson; Erik,40,0,40,0
1748418770337,MUS 2AK,A00,931545,Ohnishi; Takae,15,0,15,0
1748418770337,MUS 2AK,B00,931546,Ohnishi; Takae,15,0,15,0
1748418771365,MUS 4,A01,931551,Staff,24,0,25,1
1748418771365,MUS 4,A02,931552,Staff,25,0,25,0
1748418771365,MUS 4,A03,931553,Staff,24,0,25,1
1748418771365,MUS 4,A04,931554,Staff,25,0,25,0
1748418771365,MUS 4,A05,931558,Staff,24,0,25,1
1748418771365,MUS 4,A06,931561,Staff,25,0,25,0
1748418771365,MUS 4,A07,931562,Staff,25,0,25,0
1748418771365,MUS 4,A08,931563,Staff,25,0,25,0
1748418771365,MUS 4,A09,931564,Staff,25,0,25,0
1748418771365,MUS 4,A10,931566,Staff,25,0,25,0
1748418772392,MUS 6,A01,931573,Freitas Caetano; Marcelo,27,0,30,3
1748418772392,MUS 6,A02,931574,Freitas Caetano; Marcelo,28,0,30,2
1748418772392,MUS 6,A03,931677,Freitas Caetano; Marcelo,28,0,30,2
1748418772392,MUS 6,A04,931696,Freitas Caetano; Marcelo,30,0,30,0
1748418773422,MUS 8,A01,931732,Smythe; Cory Benjamin,12,0,25,13
1748418773422,MUS 8,A02,931737,Smythe; Cory Benjamin,17,0,25,8
1748418773422,MUS 8,A03,931761,Smythe; Cory Benjamin,25,0,25,0
1748418773422,MUS 8,A04,931920,Smythe; Cory Benjamin,23,0,25,2
1748418773422,MUS 8,A05,931925,Smythe; Cory Benjamin,21,0,25,4
1748418773422,MUS 8,A06,931943,Smythe; Cory Benjamin,20,0,25,5
1748418773422,MUS 8,A07,931948,Smythe; Cory Benjamin,22,0,25,3
1748418773422,MUS 8,A08,931955,Smythe; Cory Benjamin,18,0,25,7
1748418773422,MUS 8,A09,931964,Smythe; Cory Benjamin,25,0,25,0
1748418773422,MUS 8,A10,931974,Smythe; Cory Benjamin,24,0,25,1
1748418774451,MUS 13,A01,961328,Guy; Nancy,28,0,30,2
1748418774451,MUS 13,A02,961333,Guy; Nancy,30,0,30,0
1748418774451,MUS 13,A03,961343,Guy; Nancy,28,0,30,2
1748418774451,MUS 13,A04,961351,Guy; Nancy,30,0,30,0
1748418775478,MUS 14,A01,932176,McCormack; Timothy Matthew,29,0,30,1
1748418775478,MUS 14,A02,932183,McCormack; Timothy Matthew,29,0,30,1
1748418775478,MUS 14,A03,932186,McCormack; Timothy Matthew,30,0,30,0
1748418775478,MUS 14,A04,932190,McCormack; Timothy Matthew,29,0,30,1
1748418776517,MUS 15,A01,932270,Lou; Michelle Siulai,28,0,30,2
1748418776517,MUS 15,A02,932315,Lou; Michelle Siulai,29,0,30,1
1748418776517,MUS 15,A03,932316,Lou; Michelle Siulai,28,0,30,2
1748418776517,MUS 15,A04,932323,Lou; Michelle Siulai,30,0,30,0
1748418776517,MUS 15,A05,932325,Lou; Michelle Siulai,27,0,30,3
1748418776517,MUS 15,A06,932326,Lou; Michelle Siulai,27,0,30,3
1748418776517,MUS 15,A07,932327,Lou; Michelle Siulai,30,0,30,0
1748418776517,MUS 15,A08,932328,Lou; Michelle Siulai,28,0,30,2
1748418776517,MUS 15,A09,932366,Lou; Michelle Siulai,29,0,30,1
1748418776517,MUS 15,A10,932380,Lou; Michelle Siulai,25,0,30,5
1748418777545,MUS 17,A01,932416,Staff,0,0,0,0
1748418777545,MUS 17,A02,932423,Staff,0,0,0,0
1748418777545,MUS 17,A03,932437,Staff,0,0,0,0
1748418777545,MUS 17,A04,932447,Staff,0,0,0,0
1748418777545,MUS 17,A05,932460,Staff,0,0,0,0
1748418777545,MUS 17,A06,932466,Staff,0,0,0,0
1748418777545,MUS 17,A07,932475,Staff,0,0,0,0
1748418777545,MUS 17,A08,932479,Staff,0,0,0,0
1748418777545,MUS 17,A09,932480,Staff,0,0,0,0
1748418777545,MUS 17,A10,932481,Staff,0,0,0,0
1748418777545,MUS 17,A11,932487,Staff,0,0,0,9
1748418777545,MUS 17,A12,932490,Staff,0,0,0,1
1748418778576,MUS 19R,A01,932494,Britt; King James,7,0,25,18
1748418778576,MUS 19R,A02,932500,Britt; King James,20,0,25,5
1748418778576,MUS 19R,A03,932503,Britt; King James,24,0,25,1
1748418778576,MUS 19R,A04,932504,Britt; King James,23,0,25,2
1748418778576,MUS 19R,A05,932512,Britt; King James,25,0,25,0
1748418778576,MUS 19R,A06,932513,Britt; King James,17,0,25,8
1748418778576,MUS 19R,A07,932517,Britt; King James,22,0,25,3
1748418778576,MUS 19R,A08,932522,Britt; King James,20,0,25,5
1748418778576,MUS 19R,A09,960795,Britt; King James,25,0,25,0
1748418778576,MUS 19R,A10,960796,Britt; King James,15,0,25,10
1748418778576,MUS 19R,B01,960808,Britt; King James,5,0,5,0
1748418778576,MUS 19R,B02,960810,Britt; King James,4,0,5,1
1748418778576,MUS 19R,B03,960812,Britt; King James,5,0,5,0
1748418778576,MUS 19R,B04,960815,Britt; King James,5,0,5,0
1748418778576,MUS 19R,B05,960861,Britt; King James,5,0,5,0
1748418778576,MUS 19R,B06,960863,Britt; King James,5,0,5,0
1748418778576,MUS 19R,B07,960866,Britt; King James,5,0,5,0
1748418778576,MUS 19R,B08,960870,Britt; King James,5,0,5,0
1748418778576,MUS 19R,B09,960871,Britt; King James,5,0,5,0
1748418778576,MUS 19R,B10,960872,Britt; King James,5,0,5,0
1748418779615,MUS 32,001,931432,Dresser; Mark Stuart,5,0,5,0
1748418779615,MUS 32,002,931433,Smythe; Cory Benjamin,5,0,5,0
1748418779615,MUS 32,003,931438,Kenyatta; Kamau,5,0,5,0
1748418779615,MUS 32,004,931441,Curtis; Charles Rector,5,0,5,0
1748418779615,MUS 32,005,931443,Staff,5,0,5,0
1748418779615,MUS 32,006,931447,Terrazas Perez; Wilfrido D,5,0,5,0
1748418779615,MUS 32,007,931448,Ohnishi; Takae,5,0,5,0
1748418779615,MUS 32,008,931453,Burr; Anthony I,5,0,5,0
1748418779615,MUS 32,009,931454,Carlson; Erik,5,0,5,0
1748418780643,MUS 32V,A00,932529,Staff,5,0,5,0
1748418780643,MUS 32V,B00,932532,Staff,5,0,5,0
1748418781669,MUS 32VM,A00,932533,Staff,15,0,15,0
1748418782698,MUS 33A,A00,932538,Liang; Lei,16,0,17,1
1748418783725,MUS 43,A00,932540,Staff,79,0,96,17
1748418784754,MUS 95C,A00,932544,Staff,30,0,40,10
1748418785778,MUS 95D,A00,932547,Staff,30,0,30,0
1748418786804,MUS 95E,A00,932548,Staff,45,0,45,0
1748418787832,MUS 95F,A00,932549,Staff,40,0,40,0
1748418788860,MUS 95G,A00,932550,Anderson; Kenneth,374,0,395,21
1748418788860,MUS 95G,B00,932553,Anderson; Kenneth,381,0,395,14
1748418789890,MUS 95JC,A00,932555,Kenyatta; Kamau,25,0,25,0
1748418790919,MUS 95L,A00,932556,Staff,65,0,65,0
1748418791950,MUS 95P,A00,932564,Nourai; Keyavash,17,0,20,3
1748418791950,MUS 95P,B00,932565,Nourai; Keyavash,18,0,20,2
1748418792976,MUS 95W,A00,932567,Seshadri; Kartik,26,0,30,4
1748418792976,MUS 95W,B00,932570,Seshadri; Kartik,30,0,30,0
1748418794002,MUS 101A,A01,932575,Burr; Anthony I,31,0,35,4
1748418795028,MUS 107,A00,932578,Terrazas Perez; Wilfrido D,14,0,15,1
1748418796055,MUS 111,A00,932580,Liang; Lei,135,0,140,5
1748418797086,MUS 113,A00,932584,Curtis; Charles Rector,48,0,50,2
1748418798110,MUS 115,A00,932585,Narucki; Susan M,32,0,40,8
1748418799146,MUS 120A,A01,932593,Leslie Santana; Myrta,27,0,30,3
1748418800176,MUS 130,A00,932600,Ohnishi; Takae,35,0,35,0
1748418801211,MUS 132,001,931462,Dresser; Mark Stuart,5,0,5,0
1748418801211,MUS 132,002,931463,Smythe; Cory Benjamin,5,0,5,0
1748418801211,MUS 132,003,931465,Kenyatta; Kamau,5,0,5,0
1748418801211,MUS 132,004,931467,Curtis; Charles Rector,5,0,5,0
1748418801211,MUS 132,005,931468,Staff,5,0,5,0
1748418801211,MUS 132,006,931470,Terrazas Perez; Wilfrido D,5,0,5,0
1748418801211,MUS 132,007,931471,Ohnishi; Takae,5,0,5,0
1748418801211,MUS 132,008,931473,Burr; Anthony I,5,0,5,0
1748418801211,MUS 132,009,931474,Carlson; Erik,5,0,5,0
1748418802241,MUS 132R,A00,961401,Narucki; Susan M,5,0,5,0
1748418803267,MUS 132V,A00,961362,Narucki; Susan M,10,0,10,0
1748418803267,MUS 132V,B00,961397,Staff,10,0,10,0
1748418804297,MUS 134,A00,932601,Staff,30,0,30,0
1748418805323,MUS 137A,A00,932604,Kenyatta; Kamau,31,0,35,4
1748418806352,MUS 143,A00,932617,Staff,10,0,30,20
1748418807432,MUS 170,A01,932620,Freitas Caetano; Marcelo,45,0,50,5
1748418807432,MUS 170,A02,932623,Freitas Caetano; Marcelo,42,0,50,8
1748418808461,MUS 173A,A00,932625,Britt; King James,28,0,65,37
1748418809489,MUS 174A,A00,932649,Erbe; Tom,0,0,25,25
1748418810517,MUS 175,A00,932810,Smyth; Tamara R.,29,0,30,1
1748418811550,MUS 176,A00,932811,Yadegari; Shahrokh D,29,0,30,1
1748418812579,MUS 201A,A00,932812,Carlson; Erik,14,0,15,1
1748418813606,MUS 201C,A00,932818,Schick; Steven,15,0,15,0
1748418814636,MUS 203A,A00,932821,Lou; Michelle Siulai,15,0,15,0
1748418815669,MUS 203D,A00,932825,Davis; Anthony Curtis,10,0,10,0
1748418815669,MUS 203D,B00,932827,Liang; Lei,10,0,10,0
1748418815669,MUS 203D,C00,932828,Lou; Michelle Siulai,9,0,10,1
1748418815669,MUS 203D,D00,932830,Obermueller; Karola,9,0,10,1
1748418815669,MUS 203D,E00,932831,Steiger; Rand,10,0,10,0
1748418815669,MUS 203D,F00,961402,McCormack; Timothy Matthew,10,0,10,0
1748418816699,MUS 204,A00,932832,Obermueller; Karola,29,0,30,1
1748418817725,MUS 205,A00,932833,Guy; Nancy,15,0,15,0
1748418818751,MUS 206,B00,961403,Obermueller; Karola,14,0,15,1
1748418818751,MUS 206,C00,932839,Davis; Anthony Curtis,14,0,15,1
1748418819792,MUS 215A,A00,932985,Cimini; Amy Marie,15,0,15,0
1748418820820,MUS 228,A00,933096,Schick; Steven,13,0,15,2
1748418821847,MUS 229,A00,933148,McCormack; Timothy Matthew,14,0,15,1
1748418822874,MUS 232,001,931483,Dresser; Mark Stuart,5,0,5,0
1748418822874,MUS 232,002,931485,Kenyatta; Kamau,5,0,5,0
1748418822874,MUS 232,003,931487,Narucki; Susan M,4,0,5,1
1748418822874,MUS 232,004,931489,Schick; Steven,5,0,5,0
1748418822874,MUS 232,005,964353,Terrazas Perez; Wilfrido D,3,0,3,0
1748418823913,MUS 234,A00,933176,Erbe; Tom,20,0,20,0
1748418824940,MUS 270D,A00,969315,Smyth; Tamara R.,0,0,0,0
1748418825966,MUS 291,A00,933192,Curtis; Charles Rector,15,0,15,0
1748418827003,NANO 4,A01,912573,Vazquez Mena; Oscar,21,0,24,3
1748418827003,NANO 4,B01,912575,Vazquez Mena; Oscar,24,0,24,0
1748418827003,NANO 4,C01,912577,Vazquez Mena; Oscar,21,0,24,3
1748418827003,NANO 4,D01,912579,Vazquez Mena; Oscar,23,0,24,1
1748418828028,NANO 11,A00,912580,Fenning; David,143,0,146,3
1748418829060,NANO 15,A01,912583,Lubarda; Vlado,26,0,30,4
1748418830085,NANO 20L,A00,912584,Sirbuly; Donald,0,0,30,30
1748418830085,NANO 20L,B00,912585,Sirbuly; Donald,20,0,30,10
1748418831116,NANO 102,A00,912586,Tao; Andrea Rae,99,0,115,16
1748418832146,NANO 103,A00,912587,Jahed Motlagh; Zeinab,49,0,50,1
1748418833170,NANO 111,A00,912588,Vecchio; Kenneth S,50,0,60,10
1748418834200,NANO 119,A00,912589,Jokerst; Jesse Vincent,6,0,28,22
1748418834200,NANO 119,B00,912590,Jokerst; Jesse Vincent,26,0,28,2
1748418835229,NANO 148,A00,912591,Luo; Jian,55,0,70,15
1748418836254,NANO 150,A00,912592,Lubarda; Vlado,48,0,50,2
1748418837279,NANO 159,A00,912593,Wang; Joseph,44,0,50,6
1748418838307,NANO 175,A00,912594,Steinmetz; Nicole F,13,0,35,22
1748418839332,NANO 200,A00,912595,Jahed Motlagh; Zeinab,110,0,120,10
1748418840364,NANO 201,A00,912596,Sirbuly; Donald,49,0,60,11
1748418841393,NANO 202,A00,912597,Pascal; Tod A,60,0,60,0
1748418842428,NANO 203,A00,912598,Fenning; David,95,0,100,5
1748418843454,NANO 227,A00,912599,Graeve; Olivia A,14,0,15,1
1748418844481,NANO 247A,A00,912600,Shi; Lingyan,9,0,15,6
1748418845507,NANO 247B,A00,912601,Aran; Kiana,11,0,15,4
1748418846535,NANO 257,A00,912602,Cai; Shengqiang,32,0,35,3
1748418847564,NANO 265,A00,912603,Luo; Jian,9,0,10,1
1748418848593,NEU 276,A00,969333,Staff,0,0,0,0
1748418848593,NEU 276,A01,969334,Staff,0,0,0,0
1748418849628,NEUG 200A,A01,969326,Bloodgood; Brenda Laurie,0,0,0,0
1748418849628,NEUG 200A,A02,969327,Bloodgood; Brenda Laurie,0,0,0,0
1748418850657,NEUG 221,A00,969330,Dore; Kim Bohemie,6,0,6,0
1748418850657,NEUG 221,B00,969331,Bloodgood; Brenda Laurie,0,0,0,0
1748418851684,NEUG 265,A00,969329,Yaksh; Tony L.,10,0,10,0
1748418852713,NEUG 296,A00,969336,Bloodgood; Brenda Laurie,12,0,12,0
1748418853743,PH 40,A00,922279,Trinidad; Dennis Ryan,136,0,150,14
1748418853743,PH 40,B00,922283,Trinidad; Dennis Ryan,148,0,150,2
1748418854769,PH 50,A00,922284,Glockner; Susan Mariscal,160,0,175,15
1748418855797,PH 90,A00,964352,Larsen; Britta Ann,0,0,0,0
1748418856823,PH 91,A00,922286,Harrell; Maralee Mae,48,0,50,2
1748418857849,PH 101,A00,922287,Brouwer; Kimberly,0,0,50,50
1748418858878,PH 102,A01,922307,Rana; Brinda Kanti,0,0,25,25
1748418858878,PH 102,A02,922310,Rana; Brinda Kanti,0,0,25,25
1748418859905,PH 110,A00,922333,Zoumas-Morse; Christine E.,0,0,50,50
1748418860933,PH 120,A00,922392,McMenamin; Sara B,0,0,50,50
1748418861963,PH 120R,A00,922393,McMenamin; Sara B,0,0,50,50
1748418862991,PH 130,A00,922441,Kayser; Georgia Lyn,0,0,60,60
1748418864018,PH 157,A00,922444,Campbell; Chadwick Karl,29,0,50,21
1748418865044,PH 161,A00,922445,Zoumas-Morse; Christine E.,0,0,50,50
1748418866075,PH 193,A00,922468,Zoumas-Morse; Christine E.,0,0,0,0
1748418867103,PH 231,A00,970937,Hurst; Samantha,12,0,12,0
1748418868130,PH 258,A00,960659,Bazzi; Angela Robertson,15,0,15,0
1748418869158,PH 259,A00,960660,Bandoli; Gretchen,10,0,10,0
1748418870187,PH 275,A00,922474,Groessl; Erik Joseph,10,0,10,0
1748418871277,PH 280,A00,960661,Strong; David R & Skaathun; Britt Paige,10,0,10,0
1748418872308,PHAR 219,A00,954131,Ross; Camille,0,0,0,0
1748418873336,PHAR 236,A00,934403,Chen; Shu-Juan,10,0,10,0
1748418874364,PHAR 295,A00,934404,Joiner; William J.,14,0,15,1
1748418875391,PHB 221,A00,922708,Zou; Jingjing,22,0,39,17
1748418876420,PHB 224,A00,922793,Jain; Sonia,9,0,30,21
1748418877451,PHB 227,A00,922796,Liu; Lin,14,0,37,23
1748418878479,PHB 241,A00,970723,Vaida; Florin,9998,0,9999,1
1748418879512,PHB 243A,A01,922822,Tu; Xin,20,0,45,25
1748418880543,PHB 244A,A00,922870,Zhang; Xinlian,20,0,35,15
1748418881576,PHB 280,A00,922875,Messer; Karen Sue,69,0,70,1
1748418882600,PHB 281,A00,923029,Staff,62,0,65,3
1748418883630,PHIL 1,A00,934405,Sher; Gila,38,0,40,2
1748418884658,PHIL 10,A01,934409,Rudolph; Rachel Etta,34,0,39,5
1748418884658,PHIL 10,A02,934410,Rudolph; Rachel Etta,32,0,40,8
1748418884658,PHIL 10,A03,934414,Rudolph; Rachel Etta,31,0,40,9
1748418884658,PHIL 10,A04,934415,Rudolph; Rachel Etta,39,0,40,1
1748418884658,PHIL 10,A05,934416,Rudolph; Rachel Etta,35,0,40,5
1748418884658,PHIL 10,A06,934417,Rudolph; Rachel Etta,39,0,40,1
1748418885689,PHIL 12,A01,934419,Harrell; Maralee Mae,0,0,0,0
1748418885689,PHIL 12,A02,934422,Harrell; Maralee Mae,0,0,0,0
1748418885689,PHIL 12,A03,934423,Harrell; Maralee Mae,30,0,35,5
1748418885689,PHIL 12,A04,934425,Harrell; Maralee Mae,32,0,35,3
1748418886717,PHIL 13,A01,934427,Lamey; Andy M.,32,0,34,2
1748418886717,PHIL 13,A02,934429,Lamey; Andy M.,31,0,34,3
1748418886717,PHIL 13,A03,934430,Lamey; Andy M.,31,0,34,3
1748418886717,PHIL 13,A04,934432,Lamey; Andy M.,34,0,34,0
1748418887747,PHIL 25,A00,934434,Chen; Keming,66,0,70,4
1748418888778,PHIL 27,A01,934442,Brandt; Reuven A,0,0,33,33
1748418888778,PHIL 27,A02,934443,Brandt; Reuven A,7,0,33,26
1748418888778,PHIL 27,A03,934444,Brandt; Reuven A,10,0,33,23
1748418888778,PHIL 27,A04,934448,Brandt; Reuven A,0,0,33,33
1748418888778,PHIL 27,A05,934450,Brandt; Reuven A,19,0,33,14
1748418888778,PHIL 27,A06,934452,Brandt; Reuven A,0,0,33,33
1748418888778,PHIL 27,A07,934499,Brandt; Reuven A,0,0,33,33
1748418888778,PHIL 27,A08,934500,Brandt; Reuven A,6,0,33,27
1748418889812,PHIL 28,A01,934502,Brink; David O.,26,0,33,7
1748418889812,PHIL 28,A02,934506,Brink; David O.,26,0,33,7
1748418889812,PHIL 28,A03,934507,Brink; David O.,27,0,33,6
1748418889812,PHIL 28,A04,934512,Brink; David O.,8,0,33,25
1748418889812,PHIL 28,A05,934517,Brink; David O.,20,0,33,13
1748418889812,PHIL 28,A06,934518,Brink; David O.,0,0,33,33
1748418889812,PHIL 28,A07,934519,Brink; David O.,17,0,33,16
1748418889812,PHIL 28,A08,934520,Brink; David O.,27,0,33,6
1748418890841,PHIL 35,A00,934521,Vargas; Manuel Rogelio,138,0,140,2
1748418891871,PHIL 50,A00,934524,Nelkin; Dana Kay,124,0,140,16
1748418892901,PHIL 65,A00,934526,Rudolph; Rachel Etta,37,0,40,3
1748418893930,PHIL 110,A00,934529,Shields; Christopher John,38,0,42,4
1748418894955,PHIL 115,A00,934530,Nelkin; Dana Kay,15,0,20,5
1748418895982,PHIL 120,A00,934533,Kocurek; Alexander William,45,0,60,15
1748418897009,PHIL 125,A00,934534,Carr; Jennifer Rose,38,0,40,2
1748418898034,PHIL 138,A00,934535,Brink; David O.,29,0,40,11
1748418899067,PHIL 143,A00,934579,Cohen; Jonathan David,40,0,40,0
1748418900095,PHIL 148,A00,934580,Callender; Craig Adam,126,0,140,14
1748418901122,PHIL 149,A00,934581,Fulkerson; Matthew Todd,37,0,70,33
1748418902155,PHIL 158,A00,934593,Chen; Keming,21,0,40,19
1748418903186,PHIL 166,A00,934675,Lamey; Andy M.,27,0,40,13
1748418904217,PHIL 180,A00,934688,Hardimon; Michael O.,32,0,40,8
1748418905248,PHIL 200,A00,934719,Kovaka; Karenc,20,0,20,0
1748418906274,PHIL 201A,A00,934736,Shields; Christopher John,18,0,20,2
1748418907309,PHIL 209A,A00,934772,McKenzie; Kerry V.,10,0,10,0
1748418908338,PHIL 209C,A00,934787,McKenzie; Kerry V.,10,0,10,0
1748418909367,PHIL 222,A00,934789,Kocurek; Alexander William & Carr; Jennifer Rose,19,0,20,1
1748418910398,PHIL 260,A00,934791,Bazargan-Forward; Saba,18,0,20,2
1748418911477,PHIL 271,A00,934793,Vargas; Manuel Rogelio & Nelkin; Dana Kay & Fulkerson; Matthew Todd,9999,0,9999,0
1748418912509,PHIL 275,A00,934819,Watkins; Eric,9998,0,9999,1
1748418913535,PHIL 277,A00,934820,Tolley; Clinton,9997,0,9999,2
1748418914562,PHIL 278,A00,934821,Cohen; Jonathan David & Fulkerson; Matthew Todd,9999,0,9999,0
1748418915590,PHIL 280,A00,934827,Kovaka; Karenc,9999,0,9999,0
1748418916621,PHIL 281,A00,934828,Tolley; Clinton,9999,0,9999,0
1748418917650,PHIL 282,A00,934869,Bazargan-Forward; Saba,9999,0,9999,0
1748418918677,PHIL 283,A00,934870,Vargas; Manuel Rogelio & Tolley; Clinton,9999,0,9999,0
1748418919704,PHIL 286,A00,934871,Callender; Craig Adam & Chen; Keming,9999,0,9999,0
1748418920731,PHIL 287,A00,934872,Shields; Christopher John,9999,0,9999,0
1748418921799,PHIL 290,001,963258,Bazargan-Forward; Saba,9999,0,9999,0
1748418921799,PHIL 290,002,963281,Brandt; Reuven A,9999,0,9999,0
1748418921799,PHIL 290,003,963724,Brink; David O.,9999,0,9999,0
1748418921799,PHIL 290,004,963726,Callender; Craig Adam,9999,0,9999,0
1748418921799,PHIL 290,005,963740,Carr; Jennifer Rose,9999,0,9999,0
1748418921799,PHIL 290,006,963878,Cartwright; Nancy D.,9999,0,9999,0
1748418921799,PHIL 290,007,963888,Chen; Keming,9999,0,9999,0
1748418921799,PHIL 290,008,963889,Cohen; Jonathan David,9999,0,9999,0
1748418921799,PHIL 290,009,964028,Danks; David J,9999,0,9999,0
1748418921799,PHIL 290,010,964036,Fulkerson; Matthew Todd,9999,0,9999,0
1748418921799,PHIL 290,011,964044,Hardimon; Michael O.,9999,0,9999,0
1748418921799,PHIL 290,012,964084,Harrell; Maralee Mae,9999,0,9999,0
1748418921799,PHIL 290,013,964086,Johnson; Monte,9999,0,9999,0
1748418921799,PHIL 290,014,964093,Kocurek; Alexander William,9999,0,9999,0
1748418921799,PHIL 290,015,964101,Kovaka; Karenc,9999,0,9999,0
1748418921799,PHIL 290,016,964107,Lamey; Andy M.,9999,0,9999,0
1748418921799,PHIL 290,017,964113,Marechal; Patricia,9999,0,9999,0
1748418921799,PHIL 290,018,964125,McKenzie; Kerry V.,9999,0,9999,0
1748418921799,PHIL 290,019,964131,Nelkin; Dana Kay,9999,0,9999,0
1748418921799,PHIL 290,020,964132,Rickless; Samuel Charles,9999,0,9999,0
1748418921799,PHIL 290,021,964133,Rudolph; Rachel Etta,9999,0,9999,0
1748418921799,PHIL 290,022,964141,Sher; Gila,9999,0,9999,0
1748418921799,PHIL 290,023,964142,Shields; Christopher John,9999,0,9999,0
1748418921799,PHIL 290,024,964181,Tolley; Clinton,9999,0,9999,0
1748418921799,PHIL 290,025,964182,Vargas; Manuel Rogelio,9999,0,9999,0
1748418921799,PHIL 290,026,964232,Watkins; Eric,9999,0,9999,0
1748418921799,PHIL 290,027,964233,Yuan; Yuan,9999,0,9999,0
1748418922837,PHIL 295,001,964259,Bazargan-Forward; Saba,9999,0,9999,0
1748418922837,PHIL 295,002,964262,Brandt; Reuven A,9999,0,9999,0
1748418922837,PHIL 295,003,964263,Brink; David O.,9999,0,9999,0
1748418922837,PHIL 295,004,964264,Callender; Craig Adam,9999,0,9999,0
1748418922837,PHIL 295,005,964265,Carr; Jennifer Rose,9999,0,9999,0
1748418922837,PHIL 295,006,964266,Cartwright; Nancy D.,9999,0,9999,0
1748418922837,PHIL 295,007,964267,Chen; Keming,9999,0,9999,0
1748418922837,PHIL 295,008,964268,Cohen; Jonathan David,9999,0,9999,0
1748418922837,PHIL 295,009,964269,Danks; David J,9999,0,9999,0
1748418922837,PHIL 295,010,964270,Fulkerson; Matthew Todd,9999,0,9999,0
1748418922837,PHIL 295,011,964271,Hardimon; Michael O.,9999,0,9999,0
1748418922837,PHIL 295,012,964272,Harrell; Maralee Mae,9999,0,9999,0
1748418922837,PHIL 295,013,964273,Johnson; Monte,9999,0,9999,0
1748418922837,PHIL 295,014,964274,Kocurek; Alexander William,9999,0,9999,0
1748418922837,PHIL 295,015,964275,Kovaka; Karenc,9999,0,9999,0
1748418922837,PHIL 295,016,964276,Lamey; Andy M.,9999,0,9999,0
1748418922837,PHIL 295,017,964277,Marechal; Patricia,9999,0,9999,0
1748418922837,PHIL 295,018,964278,McKenzie; Kerry V.,9999,0,9999,0
1748418922837,PHIL 295,019,964279,Nelkin; Dana Kay,9999,0,9999,0
1748418922837,PHIL 295,020,964280,Rickless; Samuel Charles,9999,0,9999,0
1748418922837,PHIL 295,021,964281,Rudolph; Rachel Etta,9999,0,9999,0
1748418922837,PHIL 295,022,964282,Sher; Gila,9999,0,9999,0
1748418922837,PHIL 295,023,964283,Shields; Christopher John,9999,0,9999,0
1748418922837,PHIL 295,024,964284,Tolley; Clinton,9999,0,9999,0
1748418922837,PHIL 295,025,964285,Vargas; Manuel Rogelio,9999,0,9999,0
1748418922837,PHIL 295,026,964286,Watkins; Eric,9999,0,9999,0
1748418922837,PHIL 295,027,964287,Yuan; Yuan,9999,0,9999,0
1748418923863,PHYS 1A,A00,935435,Groisman; Alexander,434,0,589,155
1748418923863,PHYS 1A,B00,935437,Groisman; Alexander,456,0,600,144
1748418924913,PHYS 1AL,001,935439,Bal; Gurleen K & Frano Pereira; Alex M,18,0,30,12
1748418924913,PHYS 1AL,002,935440,Bal; Gurleen K & Frano Pereira; Alex M,25,0,30,5
1748418924913,PHYS 1AL,003,935443,Bal; Gurleen K & Frano Pereira; Alex M,0,0,30,30
1748418924913,PHYS 1AL,004,935445,Bal; Gurleen K & Frano Pereira; Alex M,0,0,30,30
1748418924913,PHYS 1AL,005,935448,Bal; Gurleen K & Frano Pereira; Alex M,0,0,30,30
1748418924913,PHYS 1AL,006,935449,Bal; Gurleen K & Frano Pereira; Alex M,0,0,30,30
1748418924913,PHYS 1AL,007,935451,Bal; Gurleen K & Frano Pereira; Alex M,0,0,30,30
1748418924913,PHYS 1AL,008,935452,Bal; Gurleen K & Frano Pereira; Alex M,1,0,30,29
1748418924913,PHYS 1AL,009,935454,Bal; Gurleen K & Frano Pereira; Alex M,9,0,30,21
1748418924913,PHYS 1AL,010,935589,Bal; Gurleen K & Frano Pereira; Alex M,17,0,30,13
1748418924913,PHYS 1AL,011,935590,Bal; Gurleen K & Frano Pereira; Alex M,15,0,19,4
1748418924913,PHYS 1AL,012,935591,Bal; Gurleen K & Frano Pereira; Alex M,29,0,30,1
1748418924913,PHYS 1AL,013,935652,Bal; Gurleen K & Frano Pereira; Alex M,0,0,30,30
1748418924913,PHYS 1AL,014,935675,Bal; Gurleen K & Frano Pereira; Alex M,0,0,30,30
1748418924913,PHYS 1AL,015,935680,Bal; Gurleen K & Frano Pereira; Alex M,0,0,30,30
1748418924913,PHYS 1AL,016,935703,Bal; Gurleen K & Frano Pereira; Alex M,0,0,30,30
1748418924913,PHYS 1AL,017,935704,Bal; Gurleen K & Frano Pereira; Alex M,8,0,30,22
1748418924913,PHYS 1AL,018,935729,Bal; Gurleen K & Frano Pereira; Alex M,12,0,30,18
1748418924913,PHYS 1AL,019,935825,Bal; Gurleen K & Frano Pereira; Alex M,23,0,30,7
1748418924913,PHYS 1AL,020,935826,Bal; Gurleen K & Frano Pereira; Alex M,27,0,30,3
1748418924913,PHYS 1AL,021,935946,Bal; Gurleen K & Frano Pereira; Alex M,28,0,30,2
1748418924913,PHYS 1AL,022,935947,Bal; Gurleen K & Frano Pereira; Alex M,30,0,30,0
1748418924913,PHYS 1AL,023,936029,Bal; Gurleen K & Frano Pereira; Alex M,4,0,30,26
1748418924913,PHYS 1AL,024,936031,Bal; Gurleen K & Frano Pereira; Alex M,12,0,30,18
1748418924913,PHYS 1AL,025,936033,Bal; Gurleen K & Frano Pereira; Alex M,19,0,30,11
1748418924913,PHYS 1AL,026,936034,Bal; Gurleen K & Frano Pereira; Alex M,20,0,30,10
1748418924913,PHYS 1AL,027,936036,Bal; Gurleen K & Frano Pereira; Alex M,6,0,30,24
1748418924913,PHYS 1AL,028,936038,Bal; Gurleen K & Frano Pereira; Alex M,22,0,30,8
1748418924913,PHYS 1AL,029,936044,Bal; Gurleen K & Frano Pereira; Alex M,20,0,30,10
1748418924913,PHYS 1AL,030,936045,Bal; Gurleen K & Frano Pereira; Alex M,27,0,30,3
1748418924913,PHYS 1AL,031,936054,Bal; Gurleen K & Frano Pereira; Alex M,28,0,30,2
1748418924913,PHYS 1AL,032,936056,Bal; Gurleen K & Frano Pereira; Alex M,28,0,30,2
1748418924913,PHYS 1AL,033,936057,Bal; Gurleen K & Frano Pereira; Alex M,0,0,30,30
1748418924913,PHYS 1AL,034,936059,Bal; Gurleen K & Frano Pereira; Alex M,1,0,30,29
1748418924913,PHYS 1AL,035,936060,Bal; Gurleen K & Frano Pereira; Alex M,11,0,30,19
1748418924913,PHYS 1AL,036,936063,Bal; Gurleen K & Frano Pereira; Alex M,21,0,30,9
1748418924913,PHYS 1AL,037,960551,Bal; Gurleen K & Frano Pereira; Alex M,25,0,30,5
1748418924913,PHYS 1AL,038,960592,Bal; Gurleen K & Frano Pereira; Alex M,28,0,30,2
1748418924913,PHYS 1AL,039,960618,Bal; Gurleen K & Frano Pereira; Alex M,29,0,30,1
1748418924913,PHYS 1AL,040,960644,Bal; Gurleen K & Frano Pereira; Alex M,30,0,30,0
1748418925941,PHYS 1B,A00,936064,Staff,217,0,360,143
1748418926974,PHYS 1BL,001,936066,Bal; Gurleen K & Frano Pereira; Alex M,1,0,29,28
1748418926974,PHYS 1BL,002,936067,Bal; Gurleen K & Frano Pereira; Alex M,0,0,30,30
1748418926974,PHYS 1BL,003,936068,Bal; Gurleen K & Frano Pereira; Alex M,5,0,30,25
1748418926974,PHYS 1BL,004,936072,Bal; Gurleen K & Frano Pereira; Alex M,0,0,30,30
1748418926974,PHYS 1BL,005,936074,Bal; Gurleen K & Frano Pereira; Alex M,0,0,30,30
1748418926974,PHYS 1BL,006,936075,Bal; Gurleen K & Frano Pereira; Alex M,0,0,30,30
1748418926974,PHYS 1BL,007,936116,Bal; Gurleen K & Frano Pereira; Alex M,7,0,30,23
1748418926974,PHYS 1BL,008,936125,Bal; Gurleen K & Frano Pereira; Alex M,14,0,30,16
1748418926974,PHYS 1BL,009,936128,Bal; Gurleen K & Frano Pereira; Alex M,12,0,30,18
1748418926974,PHYS 1BL,010,936145,Bal; Gurleen K & Frano Pereira; Alex M,15,0,30,15
1748418926974,PHYS 1BL,011,936146,Bal; Gurleen K & Frano Pereira; Alex M,0,0,30,30
1748418926974,PHYS 1BL,012,936147,Bal; Gurleen K & Frano Pereira; Alex M,6,0,30,24
1748418928001,PHYS 1C,A00,936148,Tsai; Philbert S,220,0,360,140
1748418929029,PHYS 1CL,001,936149,Bal; Gurleen K & Frano Pereira; Alex M,0,0,30,30
1748418929029,PHYS 1CL,002,936150,Bal; Gurleen K & Frano Pereira; Alex M,0,0,30,30
1748418929029,PHYS 1CL,003,936152,Bal; Gurleen K & Frano Pereira; Alex M,0,0,30,30
1748418929029,PHYS 1CL,004,936153,Bal; Gurleen K & Frano Pereira; Alex M,0,0,30,30
1748418929029,PHYS 1CL,005,936154,Bal; Gurleen K & Frano Pereira; Alex M,0,0,30,30
1748418929029,PHYS 1CL,006,936156,Bal; Gurleen K & Frano Pereira; Alex M,0,0,24,24
1748418929029,PHYS 1CL,007,936157,Bal; Gurleen K & Frano Pereira; Alex M,22,0,30,8
1748418929029,PHYS 1CL,008,936158,Bal; Gurleen K & Frano Pereira; Alex M,0,0,30,30
1748418929029,PHYS 1CL,009,936159,Bal; Gurleen K & Frano Pereira; Alex M,0,0,30,30
1748418929029,PHYS 1CL,010,936160,Bal; Gurleen K & Frano Pereira; Alex M,0,0,30,30
1748418929029,PHYS 1CL,011,936161,Bal; Gurleen K & Frano Pereira; Alex M,0,0,30,30
1748418929029,PHYS 1CL,012,936162,Bal; Gurleen K & Frano Pereira; Alex M,0,0,30,30
1748418930058,PHYS 2A,A01,936165,Shotwell; Brian,30,0,30,0
1748418930058,PHYS 2A,A02,936167,Shotwell; Brian,28,0,30,2
1748418930058,PHYS 2A,A03,936168,Shotwell; Brian,25,0,30,5
1748418930058,PHYS 2A,A04,936169,Shotwell; Brian,30,0,30,0
1748418930058,PHYS 2A,A05,936170,Shotwell; Brian,16,0,25,9
1748418930058,PHYS 2A,A06,936171,Shotwell; Brian,26,0,30,4
1748418930058,PHYS 2A,A07,936172,Shotwell; Brian,18,0,30,12
1748418930058,PHYS 2A,A08,936174,Shotwell; Brian,24,0,30,6
1748418930058,PHYS 2A,A09,936175,Shotwell; Brian,25,0,30,5
1748418930058,PHYS 2A,A10,936176,Shotwell; Brian,25,0,30,5
1748418930058,PHYS 2A,A11,936177,Shotwell; Brian,21,0,30,9
1748418930058,PHYS 2A,A12,936179,Shotwell; Brian,25,0,30,5
1748418931088,PHYS 2B,A01,936182,Barreiro Guerrero; Julio,13,0,30,17
1748418931088,PHYS 2B,A02,936183,Barreiro Guerrero; Julio,20,0,30,10
1748418931088,PHYS 2B,A03,936184,Barreiro Guerrero; Julio,20,0,30,10
1748418931088,PHYS 2B,A04,936185,Barreiro Guerrero; Julio,26,0,29,3
1748418931088,PHYS 2B,A05,936187,Barreiro Guerrero; Julio,27,0,30,3
1748418931088,PHYS 2B,A06,936217,Barreiro Guerrero; Julio,26,0,30,4
1748418931088,PHYS 2B,A07,936219,Barreiro Guerrero; Julio,23,0,30,7
1748418931088,PHYS 2B,A08,936220,Barreiro Guerrero; Julio,26,0,30,4
1748418931088,PHYS 2B,A09,936221,Barreiro Guerrero; Julio,29,0,30,1
1748418931088,PHYS 2B,A10,936224,Barreiro Guerrero; Julio,29,0,30,1
1748418931088,PHYS 2B,A11,936229,Barreiro Guerrero; Julio,28,0,30,2
1748418931088,PHYS 2B,A12,936231,Barreiro Guerrero; Julio,27,0,30,3
1748418932131,PHYS 2C,A01,936235,Tan; Tzer Han,23,0,30,7
1748418932131,PHYS 2C,A02,936236,Tan; Tzer Han,27,0,30,3
1748418932131,PHYS 2C,A03,936237,Tan; Tzer Han,22,0,30,8
1748418932131,PHYS 2C,A04,936246,Tan; Tzer Han,17,0,30,13
1748418932131,PHYS 2C,A05,936292,Tan; Tzer Han,16,0,28,12
1748418932131,PHYS 2C,A06,936300,Tan; Tzer Han,19,0,30,11
1748418932131,PHYS 2C,A07,936301,Tan; Tzer Han,8,0,30,22
1748418932131,PHYS 2C,A08,936302,Tan; Tzer Han,20,0,30,10
1748418932131,PHYS 2C,A09,936303,Tan; Tzer Han,26,0,30,4
1748418932131,PHYS 2C,A10,936304,Tan; Tzer Han,26,0,30,4
1748418932131,PHYS 2C,A11,936305,Tan; Tzer Han,12,0,30,18
1748418932131,PHYS 2C,A12,936332,Tan; Tzer Han,27,0,30,3
1748418932131,PHYS 2C,B01,936337,Tan; Tzer Han,0,0,30,30
1748418932131,PHYS 2C,B02,936470,Tan; Tzer Han,1,0,30,29
1748418932131,PHYS 2C,B03,936503,Tan; Tzer Han,21,0,30,9
1748418932131,PHYS 2C,B04,936533,Tan; Tzer Han,22,0,30,8
1748418932131,PHYS 2C,B05,936534,Tan; Tzer Han,20,0,30,10
1748418932131,PHYS 2C,B06,936535,Tan; Tzer Han,23,0,30,7
1748418932131,PHYS 2C,B07,936536,Tan; Tzer Han,25,0,30,5
1748418932131,PHYS 2C,B08,936537,Tan; Tzer Han,22,0,30,8
1748418932131,PHYS 2C,B09,936539,Tan; Tzer Han,26,0,30,4
1748418932131,PHYS 2C,B10,936540,Tan; Tzer Han,27,0,30,3
1748418932131,PHYS 2C,B11,936544,Tan; Tzer Han,28,0,30,2
1748418932131,PHYS 2C,B12,936548,Tan; Tzer Han,28,0,30,2
1748418933159,PHYS 2CL,A01,936555,Ni; Kaixuan,0,0,28,28
1748418933159,PHYS 2CL,A02,936556,Ni; Kaixuan,0,0,28,28
1748418933159,PHYS 2CL,A03,936557,Ni; Kaixuan,0,0,28,28
1748418933159,PHYS 2CL,A04,936559,Ni; Kaixuan,0,0,28,28
1748418933159,PHYS 2CL,A05,936566,Ni; Kaixuan,0,0,28,28
1748418933159,PHYS 2CL,A06,936582,Ni; Kaixuan,0,0,28,28
1748418933159,PHYS 2CL,A07,936583,Ni; Kaixuan,0,0,28,28
1748418934187,PHYS 2D,A01,936615,Sharma; Vivek A.,0,0,27,27
1748418935217,PHYS 2DL,A01,936627,Butov; Leonid,14,0,17,3
1748418935217,PHYS 2DL,A02,936628,Butov; Leonid,0,0,17,17
1748418935217,PHYS 2DL,A03,936629,Butov; Leonid,3,0,15,12
1748418935217,PHYS 2DL,A04,936630,Butov; Leonid,10,0,17,7
1748418935217,PHYS 2DL,A05,936631,Butov; Leonid,17,0,17,0
1748418935217,PHYS 2DL,A06,936632,Butov; Leonid,7,0,17,10
1748418935217,PHYS 2DL,A07,936633,Butov; Leonid,8,0,18,10
1748418936246,PHYS 4C,A01,936635,Chivukula; Raja S,22,0,43,21
1748418936246,PHYS 4C,A02,936636,Chivukula; Raja S,33,0,45,12
1748418936246,PHYS 4C,A03,936637,Chivukula; Raja S,38,0,45,7
1748418936246,PHYS 4C,A04,936638,Chivukula; Raja S,44,0,45,1
1748418937276,PHYS 12,A01,936640,Branson; James G,187,0,192,5
1748418938302,PHYS 87,A00,936641,Grinstein; Benjamin,20,0,20,0
1748418939330,PHYS 100A,A01,936643,Green; Daniel Richard,111,0,146,35
1748418940361,PHYS 110A,A01,936645,Dudko; Olga,107,0,146,39
1748418941386,PHYS 116,A00,936646,Diamond; Patrick H & Vergassola; Massimo,12,0,15,3
1748418942415,PHYS 130B,A01,936648,Keating; Brian,56,0,60,4
1748418943446,PHYS 133,A00,936649,Allen; Monica T,20,0,32,12
1748418944476,PHYS 136,A00,936650,Grinstein; Benjamin,42,0,50,8
1748418945507,PHYS 139,A00,936651,Hirsch; Jorge Eduardo,13,0,15,2
1748418945507,PHYS 139,B00,936663,Duarte; Javier Mauricio,0,0,0,10
1748418946534,PHYS 140A,A01,936723,Parker; Daniel E,54,0,60,6
1748418947561,PHYS 161,A01,936727,Fuller; George Michael,53,0,60,7
1748418948588,PHYS 175,A00,936728,Koslover; Elena F,11,0,15,4
1748418949615,PHYS 191,A00,936730,Yang; Liang,68,0,75,7
1748418950643,PHYS 200A,A01,936733,Di Ventra; Massimiliano,21,0,30,9
1748418951672,PHYS 201,A01,936736,Vergassola; Massimo,24,0,30,6
1748418952703,PHYS 210B,A00,936737,McGreevy; John A.,29,0,30,1
1748418953733,PHYS 211A,A00,936740,Butov; Leonid,28,0,30,2
1748418954762,PHYS 212A,A01,936873,Fogler; Michael M.,39,0,50,11
1748418955789,PHYS 215A,A00,936878,Shotwell; Brian,30,0,30,0
1748418956815,PHYS 216,A00,936879,Diamond; Patrick H & Vergassola; Massimo,15,0,15,0
1748418957845,PHYS 219,A00,936903,Allen; Monica T,5,0,5,0
1748418958872,PHYS 220,A01,936910,Arovas; Daniel P,30,0,30,0
1748418959898,PHYS 225A,A00,936911,Flauger; Raphael M,28,0,30,2
1748418960925,PHYS 239,A00,937172,Hirsch; Jorge Eduardo,14,0,15,1
1748418960925,PHYS 239,B00,937176,Duarte; Javier Mauricio,15,0,15,0
1748418960925,PHYS 239,C00,959883,Intriligator; Kenneth Arthur,30,0,30,0
1748418961950,PHYS 250,A00,937178,Hirsch; Jorge Eduardo,14,0,15,1
1748418962978,PHYS 251,A00,937182,Grinstein; Benjamin,15,0,15,0
1748418964004,PHYS 252,A00,937183,Diamond; Patrick H,15,0,15,0
1748418965031,PHYS 253,A00,937184,Fuller; George Michael,15,0,15,0
1748418966058,PHYS 254,A00,937185,Serra; Mattia,15,0,15,0
1748418967088,PHYS 255,A00,937186,Hwa; Terence T.,14,0,15,1
1748418968112,PHYS 260,A00,937187,Shpyrko; Oleg,49,0,50,1
1748418969140,PHYS 275,A00,937190,Koslover; Elena F,15,0,15,0
1748418970167,PHYS 279,A01,946429,Silva; Gabriel,0,0,0,0
1748418971197,PHYS 282,A00,937194,Hwa; Terence T.,20,0,20,0
1748418972224,POLI 5D,A01,937210,Staff,4,0,5,1
1748418972224,POLI 5D,B01,937219,Staff,5,0,5,0
1748418972224,POLI 5D,C01,937225,Dai; Yinlin,0,0,5,5
1748418973262,POLI 10D,A01,937228,Noble; Benjamin S,20,0,28,8
1748418973262,POLI 10D,A02,937229,Noble; Benjamin S,24,0,28,4
1748418973262,POLI 10D,A03,937230,Noble; Benjamin S,25,0,27,2
1748418973262,POLI 10D,A04,937231,Noble; Benjamin S,25,0,27,2
1748418973262,POLI 10D,A05,937238,Noble; Benjamin S,27,0,28,1
1748418973262,POLI 10D,A06,937243,Noble; Benjamin S,26,0,28,2
1748418974288,POLI 11D,A01,937360,Desposato; Scott,20,0,29,9
1748418974288,POLI 11D,A02,937430,Desposato; Scott,22,0,29,7
1748418974288,POLI 11D,A03,937445,Desposato; Scott,25,0,29,4
1748418974288,POLI 11D,A04,937446,Desposato; Scott,29,0,29,0
1748418974288,POLI 11D,A05,937447,Desposato; Scott,27,0,29,2
1748418974288,POLI 11D,A06,937463,Desposato; Scott,27,0,29,2
1748418975316,POLI 12D,A01,937472,Roeder; Philip G,17,0,20,3
1748418975316,POLI 12D,A02,937475,Roeder; Philip G,17,0,20,3
1748418975316,POLI 12D,A03,937485,Roeder; Philip G,17,0,19,2
1748418975316,POLI 12D,A04,937490,Roeder; Philip G,17,0,20,3
1748418975316,POLI 12D,A05,937500,Roeder; Philip G,19,0,20,1
1748418975316,POLI 12D,A06,937507,Roeder; Philip G,20,0,20,0
1748418976353,POLI 30D,A01,937510,Desposato; Scott,0,0,23,23
1748418976353,POLI 30D,A02,937530,Desposato; Scott,0,0,23,23
1748418976353,POLI 30D,A03,937531,Desposato; Scott,11,0,23,12
1748418976353,POLI 30D,A04,937532,Desposato; Scott,18,0,23,5
1748418976353,POLI 30D,A05,937591,Desposato; Scott,5,0,23,18
1748418976353,POLI 30D,A06,937592,Desposato; Scott,19,0,23,4
1748418977379,POLI 100H,A00,937593,Stout; Christopher Timothy,114,0,183,69
1748418978406,POLI 100I,A00,937594,Gause; LaGina,47,0,56,9
1748418979434,POLI 100V,A00,937596,Gause; LaGina,56,0,68,12
1748418980464,POLI 101A,A00,937597,Stout; Christopher Timothy,84,0,115,31
1748418981491,POLI 104A,A00,937598,Smith; Glenn Chatmas,207,0,290,83
1748418982517,POLI 104N,A00,937599,Stephens; Mattheus E,168,0,245,77
1748418983542,POLI 110A,A00,937600,Wiens; David,61,0,70,9
1748418984567,POLI 118,A00,937601,Wiens; David,69,0,94,25
1748418985599,POLI 122D,A00,937602,Strom; Kaare,15,0,70,55
1748418986624,POLI 125B,A00,937603,Naoi; Megumi,128,0,158,30
1748418987655,POLI 125D,A00,937604,Nichter; Simeon C,103,0,158,55
1748418988684,POLI 126,A00,937607,Nichter; Simeon C,44,0,120,76
1748418989710,POLI 133A,A00,937608,Naoi; Megumi,202,0,216,14
1748418990740,POLI 134D,A00,937609,Saiegh; Sebastian,62,0,75,13
1748418991773,POLI 143A,A00,937610,Slantchev; Branislav,147,0,158,11
1748418992803,POLI 145C,A00,937611,Fisk; David Lee,153,0,190,37
1748418993829,POLI 154,A00,937612,Fisk; David Lee,29,0,90,61
1748418994857,POLI 163,A00,937613,Saiegh; Sebastian,103,0,120,17
1748418995888,POLI 176,A00,968071,Roberts; Margaret Earling,24,0,45,21
1748418996913,POLI 191A,A00,937617,Stout; Christopher Timothy & Saiegh; Sebastian,25,0,25,0
1748418997939,POLI 194,A00,954111,Hill; Seth J,9999,0,9999,0
1748418998966,POLI 204A,A00,937618,Schneider; Christina,20,0,25,5
1748418999996,POLI 204B,A00,937619,Desposato; Scott,7,0,12,5
1748419001026,POLI 220B,A00,937621,Strom; Kaare,20,0,25,5
1748419002053,POLI 225,A00,937622,Thomas; Jakana,18,0,25,7
1748419003079,POLI 251,A00,937623,Noble; Benjamin S,24,0,25,1
1748419004111,POLI 252,A00,937624,Hajnal; Zoltan Lloyd,24,0,25,1
1748419006163,POLI 270,A00,973288,Roberts; Margaret Earling,24,0,25,1
1748419007189,POLI 279,A00,937626,Staff,8,0,12,4
1748419008219,POLI 280,A00,937628,Hafner-Burton; Emilie,21,0,25,4
1748419009245,POLI 281,A00,937629,Stout; Christopher Timothy,13,0,15,2
1748419010270,POLI 282,A00,937630,Roeder; Philip G,20,0,25,5
1748419011298,POLI 283,A00,937631,Slantchev; Branislav,18,0,25,7
1748419012328,POLI 285,A00,937632,Wiens; David,12,0,12,0
1748419013356,PSYC 1,A00,937633,Hurwitz; Ethan Scott,175,0,200,25
1748419014388,PSYC 2,A00,937634,Rose; Fred E.,133,0,150,17
1748419015471,PSYC 3R,A00,937693,Pilegard; Celeste Cristine,195,0,200,5
1748419016497,PSYC 6,A00,937694,McCullough; Michael E,142,0,150,8
1748419017527,PSYC 60,A01,957947,Lowe; Angela Beth,10,0,25,15
1748419017527,PSYC 60,A02,957948,Lowe; Angela Beth,17,0,25,8
1748419017527,PSYC 60,A03,957949,Lowe; Angela Beth,18,0,25,7
1748419017527,PSYC 60,A04,957950,Lowe; Angela Beth,24,0,25,1
1748419017527,PSYC 60,A05,957951,Lowe; Angela Beth,22,0,25,3
1748419017527,PSYC 60,A06,957952,Lowe; Angela Beth,22,0,25,3
1748419017527,PSYC 60,A07,957953,Lowe; Angela Beth,24,0,25,1
1748419017527,PSYC 60,B01,957954,Rickard; Timothy C.,24,0,25,1
1748419017527,PSYC 60,B02,957955,Rickard; Timothy C.,24,0,25,1
1748419017527,PSYC 60,B03,957956,Rickard; Timothy C.,25,0,25,0
1748419017527,PSYC 60,B04,957957,Rickard; Timothy C.,25,0,25,0
1748419017527,PSYC 60,B05,957958,Rickard; Timothy C.,24,0,25,1
1748419017527,PSYC 60,B06,957959,Rickard; Timothy C.,22,0,25,3
1748419017527,PSYC 60,B07,957960,Rickard; Timothy C.,22,0,25,3
1748419018555,PSYC 70,A01,957961,Pilegard; Celeste Cristine,6,0,25,19
1748419018555,PSYC 70,A02,957962,Pilegard; Celeste Cristine,19,0,25,6
1748419018555,PSYC 70,A03,957963,Pilegard; Celeste Cristine,19,0,25,6
1748419018555,PSYC 70,A04,957964,Pilegard; Celeste Cristine,21,0,25,4
1748419018555,PSYC 70,A05,957965,Pilegard; Celeste Cristine,24,0,25,1
1748419018555,PSYC 70,A06,957966,Pilegard; Celeste Cristine,23,0,25,2
1748419019587,PSYC 71,A01,937700,Geller; Emma Harlan,0,0,30,30
1748419019587,PSYC 71,A02,937701,Geller; Emma Harlan,0,0,30,30
1748419019587,PSYC 71,B01,937704,Steiner; Eric Tomas,0,0,25,25
1748419019587,PSYC 71,B02,937705,Steiner; Eric Tomas,0,0,25,25
1748419020612,PSYC 88,A00,937706,Dobkins; Karen R.,49,0,65,16
1748419021643,PSYC 100,A00,937707,Dickenson; Janna Alene,0,0,175,175
1748419022670,PSYC 101,A00,937709,Heyman; Gail D.,0,0,170,170
1748419023696,PSYC 104,A00,937711,Staff,0,0,175,175
1748419024723,PSYC 105,A00,937712,Geller; Emma Harlan,17,0,170,153
1748419025752,PSYC 106,A00,937713,Gremel; Christina M,90,0,170,80
1748419026782,PSYC 108,A00,937714,Adrian; Julia Anna,145,0,170,25
1748419027828,PSYC 114,A01,937720,Winkielman; Piotr,0,0,50,50
1748419028859,PSYC 122,A00,937724,Moranton; Nirelia Melbina-,241,0,250,9
1748419029885,PSYC 124,A00,937726,Chapman; Eddie Nathaniel,276,0,348,72
1748419030910,PSYC 137,A00,937727,Jolly; Eshin,249,0,295,46
1748419031938,PSYC 145,A00,937732,Lau; Aubrey,277,0,295,18
1748419032968,PSYC 154,A00,937734,Lacefield; Katharine I,18,0,300,282
1748419033997,PSYC 155,A00,937735,Dickenson; Janna Alene,140,0,295,155
1748419035031,PSYC 167,A00,937750,Walker; Caren Michelle,0,0,25,25
1748419036058,PSYC 169,A00,937751,Staff,213,0,250,37
1748419037087,PSYC 171,A00,937752,Mukku; Dhananjaya,149,0,216,67
1748419038114,PSYC 174,A00,937784,Staff,141,0,146,5
1748419039144,PSYC 178,A00,937788,Glaser; Dale,101,0,146,45
1748419040171,PSYC 181,A00,937814,Anagnostaras; Stephan,140,0,300,160
1748419041207,PSYC 184,A00,937816,Staff,267,0,295,28
1748419042238,PSYC 189,A00,937868,Gentner; Tim,14,0,55,41
1748419043269,PSYC 193,A00,937897,Chapman; Eddie Nathaniel,27,0,35,8
1748419043269,PSYC 193,B00,937917,Gorman; Michael R.,35,0,35,0
1748419043269,PSYC 193,C00,937918,Powell; Lindsey Jane,22,0,24,2
1748419044304,PSYC 193L,A01,937930,Brown; Sandra A,64,0,65,1
1748419044304,PSYC 193L,B01,937939,Lacefield; Katharine I,194,0,216,22
1748419045331,PSYC 194A,A01,937949,Heyman; Gail D.,35,0,35,0
1748419046357,PSYC 201A,A01,937954,Long; Bria,8,0,15,7
1748419047384,PSYC 205,A00,937976,Harris; Christine Renee,12,0,20,8
1748419048418,PSYC 217,A00,937977,Barner; David A.,16,0,20,4
1748419049443,PSYC 221,A00,937979,Dobkins; Karen R.,16,0,20,4
1748419050473,PSYC 224,A00,938013,Mukku; Dhananjaya,28,0,30,2
1748419051502,PSYC 242,A00,938016,Powell; Lindsey Jane,26,0,30,4
1748419052533,PSYC 244,A00,938017,Ferreira; Victor,15,0,20,5
1748419053564,PSYC 269,A00,938024,Schachner; Adena,19,0,20,1
1748419054592,PSYC 270A,A00,938028,Dobkins; Karen R.,13,0,20,7
1748419055619,PSYC 272,A00,938029,Lin; Chujun,14,0,20,6
1748419055619,PSYC 272,B00,938039,Wixted; John T,18,0,20,2
1748419056649,PSYC 274,A00,938042,McCullough; Michael E,26,0,30,4
1748419057683,PSYC 275,A00,938043,Brady; Timothy Francis,28,0,30,2
1748419058714,PSYC 280,A00,938055,Serences; John Thomas,70,0,80,10
1748419059750,PSYC 296,001,952632,Anagnostaras; Stephan,9999,0,9999,0
1748419059750,PSYC 296,002,952633,Aron; Adam,9999,0,9999,0
1748419059750,PSYC 296,003,952634,Mukku; Dhananjaya,9999,0,9999,0
1748419059750,PSYC 296,004,952635,Barner; David A.,9999,0,9999,0
1748419059750,PSYC 296,005,952636,Schachner; Adena,9999,0,9999,0
1748419059750,PSYC 296,006,952637,Brady; Timothy Francis,9999,0,9999,0
1748419059750,PSYC 296,007,952639,Brashier; Nadia Marie,9999,0,9999,0
1748419059750,PSYC 296,008,952640,Brown; Sandra A,9999,0,9999,0
1748419059750,PSYC 296,009,952641,Carver; Leslie J.,9998,0,9999,1
1748419059750,PSYC 296,010,952642,Chapman; Eddie Nathaniel,9999,0,9999,0
1748419059750,PSYC 296,011,952643,Dickenson; Janna Alene,9999,0,9999,0
1748419059750,PSYC 296,012,952644,Dobkins; Karen R.,9997,0,9999,2
1748419059750,PSYC 296,013,952646,Ferreira; Victor,9999,0,9999,0
1748419059750,PSYC 296,014,952647,Geller; Emma Harlan,9999,0,9999,0
1748419059750,PSYC 296,015,952648,Gentner; Tim,9999,0,9999,0
1748419059750,PSYC 296,016,952650,Gorman; Michael R.,9999,0,9999,0
1748419059750,PSYC 296,017,952651,Gremel; Christina M,9999,0,9999,0
1748419059750,PSYC 296,018,952652,Harris; Christine Renee,9999,0,9999,0
1748419059750,PSYC 296,019,952654,Heyman; Gail D.,9999,0,9999,0
1748419059750,PSYC 296,020,952655,Lin; Chujun,9999,0,9999,0
1748419059750,PSYC 296,021,952659,Long; Bria,9999,0,9999,0
1748419059750,PSYC 296,022,952660,McCullough; Michael E,9999,0,9999,0
1748419059750,PSYC 296,023,952661,Mc Kenzie; Craig R.M.,9999,0,9999,0
1748419059750,PSYC 296,024,952663,Miller; Cory T.,9998,0,9999,1
1748419059750,PSYC 296,025,952664,Oesch; Nicholas W,9999,0,9999,0
1748419059750,PSYC 296,026,952665,Pilegard; Celeste Cristine,9999,0,9999,0
1748419059750,PSYC 296,027,952666,Powell; Lindsey Jane,9999,0,9999,0
1748419059750,PSYC 296,028,952667,Rickard; Timothy C.,9999,0,9999,0
1748419059750,PSYC 296,029,952668,Serences; John Thomas,9999,0,9999,0
1748419059750,PSYC 296,030,952669,Walker; Caren Michelle,9998,0,9999,1
1748419059750,PSYC 296,031,952670,Winkielman; Piotr,9999,0,9999,0
1748419059750,PSYC 296,032,952671,Wixted; John T,9998,0,9999,1
1748419059750,PSYC 296,033,952673,Jolly; Eshin,9998,0,9999,1
1748419060782,REV 20,A00,946356,Yu; Paul K L,30,0,30,0
1748419060782,REV 20,B00,946357,Yu; Paul K L,30,0,30,0
1748419061813,REV 87,B00,969668,Rodriguez; Bretton Sigfred,20,0,20,0
1748419062850,SE 1,A01,938060,Van Den Einde; Yael Dahlia,0,0,9,9
1748419062850,SE 1,A02,938076,Van Den Einde; Yael Dahlia,0,0,8,8
1748419062850,SE 1,A03,938077,Van Den Einde; Yael Dahlia,0,0,8,8
1748419062850,SE 1,B01,938097,Van Den Einde; Yael Dahlia,0,0,9,9
1748419062850,SE 1,B02,938098,Van Den Einde; Yael Dahlia,0,0,8,8
1748419062850,SE 1,B03,938109,Van Den Einde; Yael Dahlia,0,0,8,8
1748419063877,SE 101A,A01,938120,Morrison; Machel Leigh,166,0,250,84
1748419064908,SE 101C,A01,938148,Zhu; Qiang,178,0,250,72
1748419065938,SE 105,A01,938153,Qiao; Yu,78,0,120,42
1748419066969,SE 125,A01,938218,Conte; Joel P,166,0,210,44
1748419067996,SE 130A,A00,938219,Loh; Kenneth J. H.,69,0,165,96
1748419069026,SE 131B,A01,938221,Krysl; Petr,119,0,210,91
1748419070054,SE 142,A01,938223,Kim; Hyonny,20,0,27,7
1748419070054,SE 142,A02,938236,Kim; Hyonny,23,0,27,4
1748419070054,SE 142,A03,938237,Kim; Hyonny,19,0,27,8
1748419070054,SE 142,A04,938238,Kim; Hyonny,19,0,22,3
1748419071083,SE 163,A01,938240,Lanza Di Scalea; Francesco,17,0,19,2
1748419071083,SE 163,A02,938241,Lanza Di Scalea; Francesco,16,0,19,3
1748419071083,SE 163,A03,938254,Lanza Di Scalea; Francesco,16,0,17,1
1748419072109,SE 180,A00,938255,Elgamal; Ahmed,142,0,170,28
1748419073137,SE 181,A01,938280,McCartney; John Scott,1,0,24,23
1748419073137,SE 181,A02,938281,McCartney; John Scott,6,0,24,18
1748419073137,SE 181,A03,938296,McCartney; John Scott,0,0,24,24
1748419073137,SE 181,A04,938297,McCartney; John Scott,0,0,24,24
1748419073137,SE 181,A05,938299,McCartney; John Scott,20,0,24,4
1748419073137,SE 181,A06,938320,McCartney; John Scott,22,0,24,2
1748419073137,SE 181,A07,938324,McCartney; John Scott,9,0,24,15
1748419074163,SE 201A,A00,938329,Mosqueda; Gilberto,36,0,65,29
1748419075194,SE 203A,A00,938331,Tsampras; Georgios,32,0,65,33
1748419076226,SE 212,A00,938332,Uang; Chia-Ming,28,0,68,40
1748419077258,SE 220,A00,965249,Mosqueda; Gilberto,28,0,36,8
1748419078301,SE 223,A00,969767,Staff,19,0,25,6
1748419079326,SE 233,A00,938555,Krysl; Petr,19,0,50,31
1748419080351,SE 241,A00,938333,Elgamal; Ahmed,0,0,20,20
1748419081376,SE 244,A00,938334,Elgamal; Ahmed,39,0,40,1
1748419082406,SE 248,A00,938363,McCartney; John Scott,20,0,30,10
1748419083435,SE 253A,A01,938448,Kim; Hyonny,3,0,5,2
1748419083435,SE 253A,A02,938451,Kim; Hyonny,3,0,5,2
1748419083435,SE 253A,A03,938452,Kim; Hyonny,3,0,5,2
1748419083435,SE 253A,A04,938453,Kim; Hyonny,2,0,2,0
1748419084464,SE 263,A01,938460,Lanza Di Scalea; Francesco,15,0,17,2
1748419084464,SE 263,A02,938461,Lanza Di Scalea; Francesco,11,0,17,6
1748419084464,SE 263,A03,938462,Lanza Di Scalea; Francesco,10,0,16,6
1748419085492,SE 271,A00,938464,Asaro; Robert J,25,0,32,7
1748419086526,SE 276A,A00,938465,Chen; Jiun-Shyan,19,0,35,16
1748419087553,SE 285,A00,938466,Kim; Hyunsun Alicia,18,0,20,2
1748419088580,SE 286,A00,938523,Kim; Hyunsun Alicia,13,0,20,7
1748419089606,SE 290,A00,938524,Lanza Di Scalea; Francesco,42,0,100,58
1748419090660,SE 296,001,953990,Asaro; Robert J,9999,0,9999,0
1748419090660,SE 296,002,953992,Chen; Jiun-Shyan,9999,0,9999,0
1748419090660,SE 296,003,953998,Conte; Joel P,9999,0,9999,0
1748419090660,SE 296,004,953999,Elgamal; Ahmed,9999,0,9999,0
1748419090660,SE 296,005,954001,Hutchinson; Tara,9999,0,9999,0
1748419090660,SE 296,006,954003,Jandaghi Semnani; Shabnam,9999,0,9999,0
1748419090660,SE 296,007,954004,Kim; Hyonny,9999,0,9999,0
1748419090660,SE 296,008,954005,Kim; Hyunsun Alicia,9999,0,9999,0
1748419090660,SE 296,009,954007,Kosmatka; John B,9999,0,9999,0
1748419090660,SE 296,010,954009,Krysl; Petr,9999,0,9999,0
1748419090660,SE 296,011,954011,Kuester; Falko,9999,0,9999,0
1748419090660,SE 296,012,954014,Lanza Di Scalea; Francesco,9999,0,9999,0
1748419090660,SE 296,013,954015,Loh; Kenneth J. H.,9999,0,9999,0
1748419090660,SE 296,014,954021,McCartney; John Scott,9999,0,9999,0
1748419090660,SE 296,015,954023,Morrison; Machel Leigh,9999,0,9999,0
1748419090660,SE 296,016,954024,Mosqueda; Gilberto,9999,0,9999,0
1748419090660,SE 296,017,954028,Qiao; Yu,9999,0,9999,0
1748419090660,SE 296,018,954030,Shing; P. Benson,9999,0,9999,0
1748419090660,SE 296,019,954031,Todd; Michael,9998,0,9999,1
1748419090660,SE 296,020,954033,Tomac; Ingrid,9999,0,9999,0
1748419090660,SE 296,021,954037,Tsampras; Georgios,9999,0,9999,0
1748419090660,SE 296,022,954040,Uang; Chia-Ming,9999,0,9999,0
1748419090660,SE 296,023,954043,Van Den Einde; Yael Dahlia,9999,0,9999,0
1748419090660,SE 296,024,954044,Zhu; Qiang,9999,0,9999,0
1748419090660,SE 296,025,954046,Tehrani; Mehran,9999,0,9999,0
1748419090660,SE 296,026,954047,Palermo; Alessandro,9999,0,9999,0
1748419090660,SE 296,027,954049,Chadha; Mayank,9999,0,9999,0
1748419091688,SIO 3,A01,938657,Hetherington; Elizabeth Dorsey,33,0,37,4
1748419091688,SIO 3,A02,938665,Hetherington; Elizabeth Dorsey,36,0,37,1
1748419092712,SIO 15,A00,938667,Laske; Gabi,294,0,348,54
1748419093742,SIO 20R,A01,938679,Russell; Lynn M.,145,0,200,55
1748419094771,SIO 25,A01,938684,Hildebrand; John A,33,0,40,7
1748419094771,SIO 25,A02,938685,Hildebrand; John A,39,0,40,1
1748419094771,SIO 25,A03,938963,Hildebrand; John A,40,0,40,0
1748419094771,SIO 25,A04,939110,Hildebrand; John A,40,0,40,0
1748419094771,SIO 25,A05,939116,Hildebrand; John A,40,0,40,0
1748419094771,SIO 25,A06,939149,Hildebrand; John A,40,0,40,0
1748419094771,SIO 25,A07,939158,Hildebrand; John A,40,0,40,0
1748419094771,SIO 25,A08,939173,Hildebrand; John A,40,0,40,0
1748419094771,SIO 25,A09,939180,Hildebrand; John A,40,0,40,0
1748419094771,SIO 25,A10,939228,Hildebrand; John A,40,0,40,0
1748419095797,SIO 30,A01,939230,Aluwihare; Lihini & Gille; Sarah T,33,0,37,4
1748419095797,SIO 30,A02,939231,Aluwihare; Lihini & Baumann-Pickering ; Simone,37,0,37,0
1748419095797,SIO 30,A03,939232,Aluwihare; Lihini & Gille; Sarah T,34,0,37,3
1748419095797,SIO 30,A04,939233,Aluwihare; Lihini & Gille; Sarah T,31,0,37,6
1748419095797,SIO 30,A05,939234,Aluwihare; Lihini & Gille; Sarah T,38,0,38,0
1748419095797,SIO 30,A06,939235,Aluwihare; Lihini & Gille; Sarah T,37,0,38,1
1748419095797,SIO 30,A07,939236,Aluwihare; Lihini & Gille; Sarah T,36,0,38,2
1748419095797,SIO 30,A08,939237,Aluwihare; Lihini & Gille; Sarah T,36,0,38,2
1748419096830,SIO 50,A01,939239,Cook; Geoffrey W,8,0,20,12
1748419096830,SIO 50,A02,939240,Cook; Geoffrey W,11,0,20,9
1748419097884,SIO 87,A00,939242,Norris; Joel Roland,20,0,20,0
1748419097884,SIO 87,B00,939306,Cook; Geoffrey W,20,0,20,0
1748419097884,SIO 87,C00,939327,Cook; Geoffrey W,20,0,20,0
1748419098915,SIO 100,A00,939328,Odlum; Margaret Larkin,0,0,30,30
1748419100160,SIO 101,A01,939330,Aluwihare; Lihini & Decima; Moira R.,0,0,35,35
1748419100160,SIO 101,A02,939331,Aluwihare; Lihini & Decima; Moira R.,12,0,35,23
1748419101193,SIO 103,A01,939371,Parnell-Turner; Ross Ernes,6,0,20,14
1748419102225,SIO 105,A00,939372,Driscoll; Neal W.,8,0,20,12
1748419103256,SIO 117,A01,939375,Keeling; Ralph F.,14,0,25,11
1748419104283,SIO 122,A01,939377,Lyons; Deirdre Colleen,6,0,30,24
1748419105310,SIO 124,A00,961131,Lukowski; April Lynn,34,0,65,31
1748419106347,SIO 132,A01,939379,Kacev; David & Hechinger; Ryan F.,9,0,34,25
1748419106347,SIO 132,A02,939380,Kacev; David & Hechinger; Ryan F.,28,0,34,6
1748419106347,SIO 132,A03,939381,Kacev; David & Hechinger; Ryan F.,19,0,34,15
1748419106347,SIO 132,A04,939480,Kacev; David & Hechinger; Ryan F.,26,0,34,8
1748419106347,SIO 132,A05,939481,Kacev; David & Hechinger; Ryan F.,18,0,34,16
1748419106347,SIO 132,A06,939482,Kacev; David & Hechinger; Ryan F.,25,0,34,9
1748419107375,SIO 136,A01,939562,Kacev; David & Shipp; Lauren Elizabeth,6,0,34,28
1748419107375,SIO 136,A02,939563,Kacev; David & Shipp; Lauren Elizabeth,24,0,34,10
1748419108402,SIO 147,A01,939566,Betancur Rodriguez; Ricard,0,0,30,30
1748419109432,SIO 166,A00,939567,Jimenez Cano; Nayeli Guada,13,0,30,17
1748419110460,SIO 167,A01,939569,Dunseth; Zachary Clark,9,0,10,1
1748419111490,SIO 170,A00,939571,Cook; Geoffrey W,39,0,45,6
1748419112517,SIO 171,A01,939573,Rudnick; Daniel Lars,44,0,50,6
1748419113551,SIO 177,A00,939574,Becker; Janet Maria,19,0,20,1
1748419114578,SIO 179,A01,939611,Martz; Todd R.,2,0,15,13
1748419115605,SIO 189,A00,939616,Staff,0,0,0,0
1748419116632,SIO 194,A00,954130,Hill; Seth J,9999,0,9999,0
1748419117660,SIOB 218,A01,960525,Staff,13,0,20,7
1748419118685,SIOB 262,A00,939617,Lukowski; April Lynn,15,0,20,5
1748419119783,SIOB 273,A00,939618,Leichter; James J.,9,0,15,6
1748419120808,SIOB 274,A01,939679,Leichter; James J.,15,0,20,5
1748419121840,SIOB 276,A01,939703,Sugihara; George,19,0,20,1
1748419122872,SIOB 279,A00,939717,Barton; Andrew David,19,0,25,6
1748419123904,SIOB 280,A00,939722,Allen; Andrew Ellis & Baumann-Pickering ; Simone,54,0,70,16
1748419124931,SIOB 296,A00,939790,Lyons; Deirdre Colleen,0,0,0,0
1748419125958,SIOB 297,A00,939795,Allen; Eric,57,0,65,8
1748419126985,SIOC 200A,A00,939821,Lin; Ying-Tsong,16,0,20,4
1748419128011,SIOC 203A,A00,939827,Becker; Janet Maria,18,0,20,2
1748419129039,SIOC 207A,A01,939909,Meyer; Florian,12,0,20,8
1748419130068,SIOC 208,A00,939913,Merrifield; Mark A,11,0,20,9
1748419131098,SIOC 210,A00,939917,Purkey; Sarah Michelle G.,25,0,35,10
1748419131098,SIOC 210,B00,939973,Purkey; Sarah Michelle G.,31,0,35,4
1748419132124,SIOC 217A,A00,940015,Evan; Amato Tomas,18,0,25,7
1748419133152,SIOC 221A,A00,940020,Alford; Matthew Hudson,16,0,20,4
1748419134179,SIOG 200C,A00,940290,Fan; Wenyuan,23,0,25,2
1748419135206,SIOG 223A,A00,940333,Constable; Catherine G,22,0,25,3
1748419136234,SIOG 225,A00,940334,Fialko; Yuri A.,19,0,20,1
1748419137471,SIOG 228,A00,940338,Diaz; Julia Michelle,15,0,40,25
1748419138503,SIOG 238,A00,940339,May; David Alexander,20,0,20,0
1748419139534,SIOG 239,A00,940340,Fan; Wenyuan,20,0,20,0
1748419139534,SIOG 239,B00,940342,Sandwell; David T,19,0,20,1
1748419140562,SIOG 240,A00,940409,Parnell-Turner; Ross Ernes,34,0,40,6
1748419141589,SIOG 249,A00,940442,Norris; Richard D.,25,0,25,0
1748419142620,SIOG 267,A01,940444,Martz; Todd R.,15,0,15,0
1748419143649,SIOG 288,A01,940446,Diaz; Julia Michelle,22,0,25,3
1748419144676,SOCE 194,A00,954128,Hill; Seth J,9999,0,9999,0
1748419145712,SOCG 200,A00,935260,Rona-Tas; Akos,2,0,12,10
1748419146740,SOCG 201,A00,935264,Shafir; Gershon,0,0,12,12
1748419147768,SOCG 203,A00,935265,Gong; Neil M,0,0,10,10
1748419148802,SOCG 207,A00,935267,Navon; Daniel,0,0,10,10
1748419149831,SOCG 208A,A00,935269,Blair-Loy; Mary,2,0,12,10
1748419150862,SOCG 226,A00,935302,Skrentny; John David,0,0,10,10
1748419151893,SOCG 227,A00,935303,Jules-Rosette; Bennetta W.,7,0,10,3
1748419152925,SOCG 244,A00,935305,Ribas Norris; Janet Vanesa,0,0,10,10
1748419153952,SOCG 252,A00,935307,Turner; Christena L.,2,0,10,8
1748419154980,SOCG 253,A00,935313,Evans; John Hyde,7,0,10,3
1748419156015,SOCG 255A,A00,934873,McKenzie; Kerry V.,10,0,10,0
1748419157044,SOCG 255C,A00,934874,McKenzie; Kerry V.,9,0,10,1
1748419158077,SOCG 271,A00,935434,Estefan; Michel,4,0,10,6
1748419159106,SOCI 1,A01,934878,Skrentny; John David,20,0,22,2
1748419159106,SOCI 1,A02,934879,Skrentny; John David,21,0,22,1
1748419159106,SOCI 1,A03,934880,Skrentny; John David,22,0,23,1
1748419159106,SOCI 1,A04,934881,Skrentny; John David,12,0,23,11
1748419159106,SOCI 1,A05,934883,Skrentny; John David,23,0,23,0
1748419159106,SOCI 1,A06,934884,Skrentny; John David,23,0,23,0
1748419159106,SOCI 1,A07,934885,Skrentny; John David,22,0,23,1
1748419159106,SOCI 1,A08,934886,Skrentny; John David,22,0,23,1
1748419159106,SOCI 1,A09,934887,Skrentny; John David,22,0,23,1
1748419160140,SOCI 30,A01,934889,Ruiz; Jonathan Joseph,18,0,20,2
1748419160140,SOCI 30,A02,934890,Ruiz; Jonathan Joseph,15,0,20,5
1748419161168,SOCI 60,A01,934892,Ribas Norris; Janet Vanesa,6,0,17,11
1748419161168,SOCI 60,A02,934896,Ribas Norris; Janet Vanesa,17,0,17,0
1748419161168,SOCI 60,A03,934965,Ribas Norris; Janet Vanesa,12,0,17,5
1748419161168,SOCI 60,A04,934974,Ribas Norris; Janet Vanesa,17,0,17,0
1748419162201,SOCI 70,A01,934984,Payne; Christine Anna,4,0,15,11
1748419162201,SOCI 70,A02,934988,Payne; Christine Anna,14,0,15,1
1748419162201,SOCI 70,A03,935006,Payne; Christine Anna,11,0,15,4
1748419162201,SOCI 70,A04,935047,Payne; Christine Anna,15,0,15,0
1748419163227,SOCI 88,A00,935058,Estefan; Michel,0,0,20,20
1748419164254,SOCI 100,A01,935065,Estefan; Michel,6,0,15,9
1748419164254,SOCI 100,A02,935068,Estefan; Michel,4,0,15,11
1748419164254,SOCI 100,A03,935069,Estefan; Michel,5,0,15,10
1748419164254,SOCI 100,A04,935071,Estefan; Michel,0,0,15,15
1748419165281,SOCI 103M,A00,935073,Kilpatrick; Kevin,22,0,30,8
1748419166309,SOCI 104,A00,935077,Arnal; Maud Marie Leonie,18,0,30,12
1748419167337,SOCI 104Q,A00,935079,Rogers; Julia,20,0,30,10
1748419168366,SOCI 105,A01,935083,Jules-Rosette; Bennetta W.,20,0,25,5
1748419169394,SOCI 109,A00,935084,Kilpatrick; Kevin,25,0,30,5
1748419170422,SOCI 112,A00,935085,Pitt; Richard Norris,61,0,65,4
1748419171451,SOCI 113,A00,935086,Rogers; Julia,68,0,75,7
1748419172484,SOCI 117,A01,935151,Jones; Makeba,0,0,13,13
1748419172484,SOCI 117,A02,935153,Jones; Makeba,4,0,13,9
1748419172484,SOCI 117,A03,935155,Jones; Makeba,11,0,12,1
1748419172484,SOCI 117,A04,935156,Jones; Makeba,10,0,12,2
1748419172484,SOCI 117,B01,935158,Jones; Gabrielle Anastasia,7,0,15,8
1748419172484,SOCI 117,B02,935159,Jones; Gabrielle Anastasia,15,0,15,0
1748419172484,SOCI 117,B03,935161,Jones; Gabrielle Anastasia,15,0,15,0
1748419172484,SOCI 117,B04,935162,Jones; Gabrielle Anastasia,15,0,15,0
1748419173510,SOCI 122,A00,935166,Lewis; Kevin Michael,101,0,120,19
1748419174538,SOCI 129,A00,935167,Pitt; Richard Norris,50,0,65,15
1748419175567,SOCI 135,A00,935170,Payne; Christine Anna,112,0,120,8
1748419176601,SOCI 136F,A00,935171,Gong; Neil M,52,0,56,4
1748419177626,SOCI 137,A00,935173,Crofts; Christine,54,0,100,46
1748419178653,SOCI 138,A00,935174,Navon; Daniel,111,0,135,24
1748419179680,SOCI 140,A00,935175,Ng; Kwai,47,0,65,18
1748419180707,SOCI 140K,A00,935176,Ng; Kwai,39,0,56,17
1748419181735,SOCI 142,A00,935177,Crofts; Christine,24,0,75,51
1748419182762,SOCI 143V,A00,935222,Lewis; Kevin Michael,99,0,140,41
1748419183792,SOCI 148,A00,935227,Shafir; Gershon,115,0,120,5
1748419184820,SOCI 148E,A00,935231,Calderon-Zaks; Michael Aar,44,0,56,12
1748419185852,SOCI 150,A00,935232,Victoria Torres; Pablo,14,0,50,36
1748419186882,SOCI 153,A00,935233,Ruiz; Jonathan Joseph,46,0,50,4
1748419187913,SOCI 166,A00,935243,Lampland; Martha,34,0,35,1
1748419188943,SOCI 170,A00,935247,Lampland; Martha,29,0,30,1
1748419189971,SOCI 172,A00,935249,Rona-Tas; Akos,40,0,45,5
1748419190999,SOCI 173,A00,935252,Arnal; Maud Marie Leonie,67,0,75,8
1748419192027,SOCI 180,A00,935253,Calderon-Zaks; Michael Aar,47,0,56,9
1748419193054,SOCI 184,A00,935254,Victoria Torres; Pablo,21,0,56,35
1748419194080,SOCI 196A,A00,935256,Turner; Christena L.,20,0,20,0
1748419195110,SPPS 200B,A00,959322,Luli; Alex J,99,0,99,0
1748419196143,SPPS 201,A00,959324,Mnatzaganian; Christina L,99,0,99,0
1748419197171,SPPS 202A,A00,959400,Tsunoda; Shirley M.,99,0,99,0
1748419198202,SPPS 204,A01,959405,Jones; John,99,0,99,0
1748419199276,SPPS 206,A00,959406,Bounthavong; Mark,80,0,80,0
1748419200312,SPPS 212A,A01,959408,Feist; Ashley,81,0,99,18
1748419201377,SPPS 213A,A00,959409,Namba; Jennifer Mariko,82,0,99,17
1748419202411,SPPS 219,A00,959410,Ma; Joseph David,81,0,99,18
1748419203444,SPPS 221,A01,959412,Siegel; Dionicio R.,80,0,80,0
1748419204471,SPPS 231,A00,959413,Penny; William F.,79,0,99,20
1748419205496,SPPS 232,A00,959415,Simonson; Tatum Sasha Summ,79,0,99,20
1748419206521,SPPS 233,A00,959417,Eckmann; Lars,79,0,99,20
1748419207554,SPPS 247,A00,959419,Brandl; Katharina,79,0,99,20
1748419208582,SPPS 251,A00,959420,Chen; Timothy,99,0,99,0
1748419209610,SPPS 264A,A00,959421,Tsunoda; Shirley M.,99,0,99,0
1748419211692,SPPS 267,A01,959426,Tsunoda; Shirley M.,25,0,25,0
1748419212720,SPPS 269,A00,959427,Atayee; Rabia Samady,29,0,30,1
1748419213751,SPPS 270A,A00,959430,Fricovsky; Eduardo Santiago,99,0,99,0
1748419214783,SPPS 271,A00,959432,Tsunoda; Shirley M.,99,0,99,0
1748419215809,SPPS 278,A00,959433,Fricovsky; Eduardo Santiago,98,0,99,1
1748419216840,SPPS 279,A00,959434,Painter; Nathan A.,99,0,99,0
1748419217873,SYN 2,001,946469,Girard; Gabrielle,3,0,20,17
1748419217873,SYN 2,002,946470,Girard; Gabrielle,0,0,20,20
1748419217873,SYN 2,003,946471,Rock; Martin,0,0,20,20
1748419217873,SYN 2,004,946472,Rock; Martin,0,0,20,20
1748419217873,SYN 2,005,946473,Iatarola; Briana Marie,0,0,20,20
1748419217873,SYN 2,006,946474,Tawater; Hanna Jean,0,0,20,20
1748419217873,SYN 2,007,946475,Browne; Emily,6,0,20,14
1748419217873,SYN 2,008,946476,Browne; Emily,0,0,20,20
1748419217873,SYN 2,009,946477,Staff,0,0,20,20
1748419217873,SYN 2,010,946478,Staff,10,0,20,10
1748419217873,SYN 2,012,946480,Deavenport; James Cary,0,0,20,20
1748419217873,SYN 2,013,946481,Deavenport; James Cary,0,0,20,20
1748419217873,SYN 2,014,946482,Staff,0,0,20,20
1748419217873,SYN 2,015,946483,Staff,0,0,20,20
1748419217873,SYN 2,016,946484,Staff,0,0,20,20
1748419217873,SYN 2,017,946485,Staff,5,0,20,15
1748419217873,SYN 2,019,946487,Atkinson; Arthur Laird,0,0,20,20
1748419217873,SYN 2,020,946488,Staff,0,0,20,20
1748419217873,SYN 2,021,946489,Staff,0,0,20,20
1748419217873,SYN 2,030,946498,Iatarola; Briana Marie,0,0,20,20
1748419217873,SYN 2,036,946587,Bishop; Graham,0,0,20,20
1748419218901,SYN 2R,001,946588,Bishop; Graham,0,0,20,20
1748419219935,SYN 100,A01,946594,Rock; Martin,0,0,15,15
1748419219935,SYN 100,A02,946595,Rock; Martin,0,0,15,15
1748419219935,SYN 100,B01,946598,Browne; Emily,0,0,15,15
1748419219935,SYN 100,B02,946600,Browne; Emily,0,0,15,15
1748419219935,SYN 100,C01,946606,Tawater; Hanna Jean,0,0,15,15
1748419219935,SYN 100,C02,946607,Tawater; Hanna Jean,0,0,15,15
1748419219935,SYN 100,D01,946610,Tawater; Hanna Jean,0,0,15,15
1748419219935,SYN 100,D02,946613,Tawater; Hanna Jean,0,0,15,15
1748419219935,SYN 100,E01,946617,Vega; Adrian,0,0,24,24
1748419219935,SYN 100,G01,946714,Iatarola; Briana Marie,0,0,15,15
1748419219935,SYN 100,G02,946721,Iatarola; Briana Marie,0,0,15,15
1748419219935,SYN 100,I01,946735,Gormally; Brenna,0,0,15,15
1748419219935,SYN 100,I02,946736,Gormally; Brenna,0,0,15,15
1748419219935,SYN 100,J01,946738,Hom; Kirstyn Courtney,0,0,15,15
1748419219935,SYN 100,J02,946739,Hom; Kirstyn Courtney,0,0,15,15
1748419219935,SYN 100,K01,946741,Hom; Kirstyn Courtney,0,0,15,15
1748419219935,SYN 100,K02,946742,Hom; Kirstyn Courtney,0,0,15,15
1748419219935,SYN 100,L01,946745,Difruscio; Mark,0,0,15,15
1748419219935,SYN 100,L02,946746,Difruscio; Mark,0,0,15,15
1748419219935,SYN 100,M01,946748,Difruscio; Mark,0,0,15,15
1748419219935,SYN 100,M02,946749,Difruscio; Mark,0,0,15,15
1748419219935,SYN 100,P01,946759,Atkinson; Arthur Laird,0,0,15,15
1748419219935,SYN 100,P02,946760,Atkinson; Arthur Laird,0,0,15,15
1748419219935,SYN 100,Q01,946763,Bishop; Graham,0,0,15,15
1748419219935,SYN 100,Q02,946764,Bishop; Graham,0,0,15,15
1748419219935,SYN 100,R01,946766,Deavenport; James Cary,0,0,15,15
1748419219935,SYN 100,R02,946767,Deavenport; James Cary,0,0,15,15
1748419220962,SYN 150,001,946771,Gladstein; Jill M,19,0,20,1
1748419220962,SYN 150,002,946772,Lagapa; Jason,17,0,20,3
1748419220962,SYN 150,003,946773,Fish; Gwendolyn Anne,19,0,20,1
1748419220962,SYN 150,004,946774,Fish; Gwendolyn Anne,20,0,20,0
1748419220962,SYN 150,006,946782,Lagapa; Jason,18,0,20,2
1748419220962,SYN 150,007,946783,Lagapa; Jason,19,0,20,1
1748419220962,SYN 150,008,946784,Fish; Gwendolyn Anne,19,0,20,1
1748419221989,SYN 150R,001,946786,Vega; Adrian,19,0,20,1
1748419223018,TDAC 1,A00,946788,Walsh; Kim C.,0,0,12,12
1748419223018,TDAC 1,B00,946789,Walsh; Kim C.,0,0,12,12
1748419223018,TDAC 1,C00,946790,Walsh; Kim C.,0,0,12,12
1748419223018,TDAC 1,D00,946791,Walsh; Kim C.,0,0,12,12
1748419223018,TDAC 1,E00,946792,Walsh; Kim C.,0,0,12,12
1748419223018,TDAC 1,F00,946793,Walsh; Kim C.,0,0,12,12
1748419224117,TDAC 101,A00,946887,Harting; Carla Kelso,3,0,12,9
1748419224117,TDAC 101,B00,946970,Salovey; Todd,9,0,12,3
1748419224117,TDAC 101,C00,946977,Walsh; Kim C.,10,0,12,2
1748419225150,TDAC 102,A00,946979,Celik; Aysan Karagasli,7,0,15,8
1748419226181,TDAC 104,A00,946994,Meyer; Ursula,14,0,15,1
1748419227215,TDAC 107,A00,946997,Stalling; Vanessa,0,0,0,0
1748419228252,TDAC 108,A00,947021,Basso; Beatrice,19,0,20,1
1748419228252,TDAC 108,B00,947025,Caban; Andrea Chudnow,12,0,20,8
1748419228252,TDAC 108,C00,968049,Buescher; Stephen W.,16,0,20,4
1748419229278,TDAC 115,A00,947050,Buescher; Stephen W.,14,0,20,6
1748419230307,TDAC 122,A00,947091,Stalling; Vanessa,30,0,30,0
1748419230307,TDAC 122,B00,947092,Perry; Lamar,30,0,30,0
1748419231334,TDAC 123,A00,947093,Castro; Robert Jess,30,0,30,0
1748419232365,TDDE 1,A01,946795,Guirguis; Mark C,10,0,11,1
1748419232365,TDDE 1,A02,946796,Guirguis; Mark C,10,0,11,1
1748419232365,TDDE 1,A03,946797,Guirguis; Mark C,7,0,11,4
1748419232365,TDDE 1,A04,946798,Guirguis; Mark C,8,0,11,3
1748419232365,TDDE 1,A05,946799,Guirguis; Mark C,11,0,11,0
1748419233396,TDDE 130,A00,947094,Guirguis; Mark C,20,0,20,0
1748419234422,TDDE 131,A00,947095,Guirguis; Mark C,17,0,20,3
1748419235452,TDDE 132,A00,947096,Guirguis; Mark C,20,0,20,0
1748419236484,TDDE 141,A00,947097,McElver; Robert Harrison,20,0,20,0
1748419237517,TDDM 1,A00,946800,Johnston; Holly,7,0,18,11
1748419238549,TDDM 100,A00,947098,Brown; Bernard Joseph,28,0,30,2
1748419239579,TDDR 101,A00,947099,Powell; Lora,4,0,20,16
1748419240607,TDDR 102,A00,947100,Powell; Lora,19,0,20,1
1748419241632,TDDR 111,A00,947101,Castro; Robert Jess,12,0,15,3
1748419242662,TDDR 190,A00,947102,Stalling; Vanessa,35,0,35,0
1748419243695,TDGE 1,A01,946802,Salovey; Todd,12,0,12,0
1748419243695,TDGE 1,A02,946803,Salovey; Todd,11,0,12,1
1748419243695,TDGE 1,A03,946804,Salovey; Todd,12,0,12,0
1748419243695,TDGE 1,A04,946806,Salovey; Todd,12,0,12,0
1748419243695,TDGE 1,A05,946807,Salovey; Todd,10,0,12,2
1748419243695,TDGE 1,A06,946808,Salovey; Todd,12,0,12,0
1748419244725,TDGE 10,A00,946810,Havis; Allan,208,0,225,17
1748419245751,TDGE 11,A00,946811,Fulton; Julia,205,0,245,40
1748419246782,TDGE 25,A00,946812,Harting; Carla Kelso,1,0,20,19
1748419246782,TDGE 25,B00,946813,Harting; Carla Kelso,5,0,20,15
1748419246782,TDGE 25,C00,946814,Harting; Carla Kelso,10,0,20,10
1748419246782,TDGE 25,D00,946815,Harting; Carla Kelso,12,0,20,8
1748419247807,TDGE 124,A00,947103,Fulton; Julia,190,0,245,55
1748419248833,TDGE 133,A00,947104,Brill; Robert L.,19,0,20,1
1748419249860,TDGR 201,A00,947268,Newcomb; James,8,0,8,0
1748419250890,TDGR 210A,A00,947269,Staff,8,0,8,0
1748419251918,TDGR 211A,A00,947270,Caban; Andrea Chudnow,8,0,8,0
1748419252946,TDGR 212,A00,947271,Meyer; Ursula,17,0,17,0
1748419252946,TDGR 212,B00,947272,Caban; Andrea Chudnow,17,0,17,0
1748419253972,TDGR 213A,A00,947273,Buescher; Stephen W.,8,0,8,0
1748419254999,TDGR 214A,A00,947274,Meyer; Ursula,8,0,8,0
1748419256025,TDGR 219,A00,947276,Stalling; Vanessa,3,0,5,2
1748419257053,TDGR 229,A00,947277,Meyer; Ursula,7,0,7,0
1748419258083,TDGR 231A,A00,947278,Meyer; Ursula,9,0,9,0
1748419259200,TDGR 233,A00,947279,Richard; Keiana Nikole,9,0,9,0
1748419260228,TDGR 235,A00,947280,Blair; Kyle Adam,9,0,9,0
1748419261261,TDGR 239,A00,947281,Staff,8,0,8,0
1748419261261,TDGR 239,B00,947282,Meyer; Ursula,9,0,9,0
1748419261261,TDGR 239,C00,947283,Staff,9,0,9,0
1748419262287,TDGR 240,A00,947284,Stalling; Vanessa,3,0,5,2
1748419263313,TDGR 244,A00,947285,Iizuka; Naomi Hisako,19,0,20,1
1748419264345,TDGR 245,A00,947287,Stalling; Vanessa,4,0,5,1
1748419265375,TDGR 250,A00,947289,Stein; Deborah Isobel,5,0,5,0
1748419266402,TDGR 251,A00,947296,Iizuka; Naomi Hisako,5,0,5,0
1748419266402,TDGR 251,B00,947355,Stein; Deborah Isobel,5,0,5,0
1748419267434,TDGR 274,A00,947358,Brill; Robert L.,19,0,20,1
1748419268462,TDGR 275,A00,947361,Staff,10,0,10,0
1748419269488,TDGR 276,A00,947362,Bokovikova; Alina V,10,0,10,0
1748419270515,TDGR 278,A00,947363,Petrovich; Victoria A.,12,0,12,0
1748419270515,TDGR 278,B00,947366,Staff,9,0,10,1
1748419271542,TDGR 279,A00,947367,Petrovich; Victoria A.,3,0,3,0
1748419271542,TDGR 279,B00,947368,Brill; Robert L.,2,0,3,1
1748419271542,TDGR 279,C00,947369,McElver; Robert Harrison,3,0,3,0
1748419271542,TDGR 279,D00,967973,Staff,0,0,0,0
1748419271542,TDGR 279,E00,967974,Bokovikova; Alina V,0,0,0,0
1748419272568,TDGR 282,A00,947370,McElver; Robert Harrison,10,0,10,0
1748419273598,TDGR 289,A00,947371,Power; Jade Yukana,10,0,10,0
1748419274623,TDGR 289C,A00,947373,Burelle; Julie Sara Veronique,10,0,10,0
1748419275653,TDGR 289D,A00,947374,Anderson; Mysia Anyse,5,0,5,0
1748419276680,TDGR 292,A00,947375,Yapp; Hentyle T,14,0,15,1
1748419277711,TDGR 295,A00,947376,Celik; Aysan Karagasli,8,0,8,0
1748419278741,TDGR 296,A00,947379,Powell; Lora,5,0,5,0
1748419279768,TDGR 297,001,947381,Meyer; Ursula,9,0,9,0
1748419280798,TDHT 10,A00,946817,Burelle; Julie Sara Veronique,23,0,25,2
1748419281829,TDHT 21,A02,946821,Power; Jade Yukana,11,0,15,4
1748419281829,TDHT 21,A03,946822,Power; Jade Yukana,8,0,15,7
1748419282854,TDHT 101,A00,947106,Perry; Lamar,19,0,25,6
1748419283882,TDHT 103,A00,947107,Yapp; Hentyle T,8,0,25,17
1748419284909,TDHT 115,A00,947108,Portes; Elizabeth Marie,16,0,25,9
1748419285936,TDMV 1,A00,946823,Arcidiacono; Kristin,18,0,30,12
1748419286962,TDMV 2,A00,946824,Wilson; Terry A.,24,0,30,6
1748419286962,TDMV 2,B00,946825,Brown; Bernard Joseph,23,0,30,7
1748419287988,TDMV 3,A00,946826,Mack; Kara Shanai',23,0,40,17
1748419289021,TDMV 11,A00,946827,Arcidiacono; Kristin,36,0,40,4
1748419289021,TDMV 11,B00,946828,Fyall; Daunte Edward,28,0,30,2
1748419290048,TDMV 20,A00,946830,Alvarez; Ana Maria,38,0,40,2
1748419290048,TDMV 20,B00,946831,Smith; Alison D,20,0,20,0
1748419291074,TDMV 110,A00,947109,Smith; Alison D,25,0,30,5
1748419292106,TDMV 120,A00,947110,Weinberg; Sadie,17,0,18,1
1748419292106,TDMV 120,B00,964374,Johnston; Holly,18,0,18,0
1748419293133,TDMV 123,A00,947111,Duran; Marcos Antonio,29,0,30,1
1748419294166,TDMV 138,A00,947113,Jun; Grace Shin Hae,4,0,40,36
1748419295194,TDMV 140,A00,947114,Corrales; Joseph Bernales,29,0,30,1
1748419295194,TDMV 140,B00,947138,Lima; Paulo Henrique,30,0,30,0
1748419295194,TDMV 140,C00,947139,Staff,25,0,30,5
1748419296220,TDMV 141,A00,947140,Caligagan; Tony,29,0,30,1
1748419297247,TDMV 142,A00,947225,Alvarez; Ana Maria,28,0,40,12
1748419297247,TDMV 142,B00,947226,Blanco; Juan Carlos,27,0,30,3
1748419298280,TDMV 143,A00,947227,Fyall; Daunte Edward,28,0,30,2
1748419299308,TDMV 144,A00,947261,Camaya; Michelle Ann,28,0,30,2
1748419299308,TDMV 144,B00,947262,Patnaik; Shibani,28,0,30,2
1748419300337,TDMV 146,A00,947263,Caligagan; Tony,30,0,30,0
1748419301363,TDPF 160,A00,947264,Mack; Kara Shanai',40,0,40,0
1748419302402,TDPR 6,A01,946869,Guirguis; Mark C,25,0,25,0
1748419302402,TDPR 6,A02,946870,Guirguis; Mark C,25,0,25,0
1748419303433,TDPR 102,A00,947265,Guirguis; Mark C,20,0,20,0
1748419304463,TDPR 104,A00,947266,Powell; Lora,15,0,15,0
1748419305494,TDPW 1,A00,946873,Stein; Deborah Isobel,6,0,10,4
1748419305494,TDPW 1,B00,946878,Stein; Deborah Isobel,10,0,10,0
1748419305494,TDPW 1,C00,946879,Stein; Deborah Isobel,10,0,10,0
1748419305494,TDPW 1,D00,946880,Stein; Deborah Isobel,7,0,10,3
1748419305494,TDPW 1,E00,946882,Stein; Deborah Isobel,7,0,10,3
1748419306521,TDPW 104,A00,947267,Loo; Eric James,13,0,20,7
1748419307548,TDTR 10,A00,946883,Wilson; Terry A.,14,0,20,6
1748419308578,TDTR 15,A00,946885,Smith; Alison D,30,0,30,0
1748419309605,TDTR 20,A00,946886,Duran; Marcos Antonio,25,0,30,5
1748419310640,USP 1,A01,943915,Garcia; Guadalupe,23,0,23,0
1748419310640,USP 1,A02,943916,Garcia; Guadalupe,19,0,23,4
1748419310640,USP 1,A03,943927,Garcia; Guadalupe,23,0,23,0
1748419310640,USP 1,A04,943933,Garcia; Guadalupe,22,0,23,1
1748419310640,USP 1,A05,943942,Garcia; Guadalupe,23,0,23,0
1748419310640,USP 1,A06,943951,Garcia; Guadalupe,22,0,23,1
1748419311666,USP 2,A01,943956,Pezzoli; Keith,15,0,23,8
1748419311666,USP 2,A02,943958,Pezzoli; Keith,20,0,22,2
1748419312693,USP 4,A00,943961,Schwaller; Nora Louise,2,0,18,16
1748419312693,USP 4,B00,943966,Schwaller; Nora Louise,12,0,18,6
1748419313723,USP 5,A01,943968,Boomhower; Matthew Charles,16,0,20,4
1748419313723,USP 5,A02,943969,Boomhower; Matthew Charles,16,0,20,4
1748419314759,USP 15,A01,943971,Anderson; William Raymond,18,0,20,2
1748419314759,USP 15,A02,944015,Anderson; William Raymond,19,0,20,1
1748419315788,USP 25,A00,944021,Shenkman; Michael Thomas,16,0,25,9
1748419316815,USP 50,A00,944025,Sun; Feiyang,3,0,30,27
1748419317842,USP 60,A01,944056,Wali; Behram,26,0,30,4
1748419318871,USP 105,A00,944057,Ruiz; Jonathan Joseph,9,0,15,6
1748419319900,USP 108,A00,944058,Pezzoli; Keith,10,0,21,11
1748419320928,USP 124,A00,944060,Devereux; Christina Schopp,16,0,35,19
1748419321961,USP 125,A00,944063,Lerner; Amy M,21,0,28,7
1748419322987,USP 136,A00,944064,Staff,27,0,35,8
1748419324015,USP 141A,A00,960658,Lewis; Leslie R,0,0,0,0
1748419325041,USP 143,A00,944065,Hinds; Juli Beth,200,0,250,50
1748419326067,USP 144,A00,944066,Chowdhury; Muhammed Zohir,94,0,100,6
1748419327093,USP 150,A00,944067,Devereux; Christina Schopp,68,0,75,7
1748419328195,USP 151,A00,944068,Clark; Christopher N,58,0,70,12
1748419329222,USP 152B,A00,944069,Moeder; Nathan L,14,0,25,11
1748419330250,USP 153,A00,944070,Shenkman; Michael Thomas,19,0,35,16
1748419331280,USP 161,A00,944071,Wartell; Julie Dara,27,0,35,8
1748419332309,USP 165C,A00,944072,Wali; Behram,25,0,30,5
1748419333339,USP 170,A00,944142,Entezam; Maryam,60,0,70,10
1748419334370,USP 171,A00,944153,Lerner; Amy M,24,0,65,41
1748419335398,USP 175,A00,944172,Peerson; Susan,0,0,25,25
1748419336428,USP 177A,A00,944173,Peerson; Susan,0,0,23,23
1748419338487,USP 185A,A01,944198,Boomhower; Matthew Charles,26,0,40,14
1748419338487,USP 185A,B01,944201,Sun; Feiyang,0,0,40,40
1748419339521,USP 186,A01,944255,Bussell; Mirle Rabinowitz,28,0,38,10
1748419339521,USP 186,A02,944262,Bussell; Mirle Rabinowitz,11,0,37,26
1748419340553,USP 189,A00,944269,Garcia; Guadalupe,35,0,35,0
1748419341580,USP 191A,A00,944270,McTague; Sarah,13,0,30,17
1748419342611,USP 193,A00,944271,Shilon; Mor,10,0,23,13
1748419343643,USP 194,A00,954112,Hill; Seth J,9999,0,9999,0
1748419344670,USP 265C,A00,944277,Wali; Behram,3,0,4,1
1748419345698,USP 271,A00,944280,Lerner; Amy M,5,0,5,0
1748419346729,VIS 1,A01,944283,Staff,4,0,12,8
1748419346729,VIS 1,A02,944284,Staff,0,0,12,12
1748419346729,VIS 1,A03,944286,Staff,0,0,12,12
1748419346729,VIS 1,A04,944288,Staff,0,0,12,12
1748419346729,VIS 1,A05,944290,Staff,0,0,12,12
1748419346729,VIS 1,A06,944292,Staff,1,0,12,11
1748419346729,VIS 1,A07,944293,Staff,9,0,12,3
1748419346729,VIS 1,A08,944300,Staff,0,0,12,12
1748419346729,VIS 1,A09,944302,Staff,12,0,12,0
1748419346729,VIS 1,A10,944303,Staff,0,0,12,12
1748419346729,VIS 1,A11,944307,Staff,0,0,12,12
1748419346729,VIS 1,A12,944309,Staff,0,0,12,12
1748419346729,VIS 1,A13,944310,Staff,0,0,12,12
1748419346729,VIS 1,A14,944312,Staff,0,0,12,12
1748419346729,VIS 1,A15,944316,Staff,7,0,12,5
1748419346729,VIS 1,A16,944319,Staff,0,0,12,12
1748419347760,VIS 20,A01,944323,Woods; Ann,14,0,16,2
1748419347760,VIS 20,A02,944325,Woods; Ann,15,0,16,1
1748419347760,VIS 20,A03,944326,Woods; Ann,14,0,16,2
1748419347760,VIS 20,A04,944328,Woods; Ann,14,0,16,2
1748419347760,VIS 20,A05,944330,Woods; Ann,16,0,16,0
1748419347760,VIS 20,A06,944334,Woods; Ann,16,0,16,0
1748419347760,VIS 20,A07,944336,Woods; Ann,14,0,16,2
1748419347760,VIS 20,A08,944337,Woods; Ann,16,0,16,0
1748419347760,VIS 20,A09,944338,Woods; Ann,15,0,16,1
1748419347760,VIS 20,A10,944339,Woods; Ann,16,0,16,0
1748419347760,VIS 20,A11,944340,Woods; Ann,15,0,16,1
1748419347760,VIS 20,A12,944342,Woods; Ann,15,0,16,1
1748419348786,VIS 23,A00,944343,Rose; Jordan M,0,0,5,5
1748419349813,VIS 30,A01,944346,Stone; Patricia,11,0,11,0
1748419349813,VIS 30,A02,944351,Stone; Patricia,0,0,11,11
1748419349813,VIS 30,A03,944353,Stone; Patricia,7,0,11,4
1748419349813,VIS 30,A04,944354,Stone; Patricia,9,0,11,2
1748419349813,VIS 30,A05,944356,Stone; Patricia,10,0,11,1
1748419349813,VIS 30,A06,944359,Stone; Patricia,6,0,11,5
1748419350842,VIS 41,A01,944391,D'Elena-Tweed; Jessica Erin,10,0,12,2
1748419350842,VIS 41,A02,944392,D'Elena-Tweed; Jessica Erin,11,0,12,1
1748419350842,VIS 41,A03,944393,D'Elena-Tweed; Jessica Erin,12,0,12,0
1748419350842,VIS 41,A04,944396,D'Elena-Tweed; Jessica Erin,9,0,12,3
1748419350842,VIS 41,A05,944397,D'Elena-Tweed; Jessica Erin,12,0,12,0
1748419350842,VIS 41,A06,944399,D'Elena-Tweed; Jessica Erin,8,0,12,4
1748419350842,VIS 41,A07,944405,D'Elena-Tweed; Jessica Erin,10,0,12,2
1748419350842,VIS 41,A08,944411,D'Elena-Tweed; Jessica Erin,10,0,12,2
1748419350842,VIS 41,A09,944412,D'Elena-Tweed; Jessica Erin,12,0,12,0
1748419350842,VIS 41,A10,944415,D'Elena-Tweed; Jessica Erin,10,0,12,2
1748419350842,VIS 41,A11,944428,D'Elena-Tweed; Jessica Erin,12,0,12,0
1748419350842,VIS 41,A12,944430,D'Elena-Tweed; Jessica Erin,11,0,12,1
1748419351874,VIS 42,A00,969576,Twomey; Robert Daniel,86,0,100,14
1748419352900,VIS 60,A01,944432,Sepuya; Paul Mpagi,10,0,12,2
1748419352900,VIS 60,A02,944434,Sepuya; Paul Mpagi,12,0,12,0
1748419352900,VIS 60,A03,944436,Sepuya; Paul Mpagi,12,0,12,0
1748419352900,VIS 60,A04,944438,Sepuya; Paul Mpagi,12,0,12,0
1748419353929,VIS 70N,A01,944456,Garnett; Mariah J,11,0,11,0
1748419353929,VIS 70N,A02,944461,Garnett; Mariah J,9,0,11,2
1748419353929,VIS 70N,A03,944462,Garnett; Mariah J,8,0,11,3
1748419353929,VIS 70N,A04,944500,Garnett; Mariah J,10,0,11,1
1748419353929,VIS 70N,A05,944501,Garnett; Mariah J,11,0,11,0
1748419353929,VIS 70N,A06,944502,Garnett; Mariah J,11,0,11,0
1748419353929,VIS 70N,A07,944503,Garnett; Mariah J,11,0,11,0
1748419353929,VIS 70N,A08,944507,Garnett; Mariah J,11,0,11,0
1748419354957,VIS 80,A01,944513,Adler; Amy,12,0,12,0
1748419354957,VIS 80,A02,944515,Adler; Amy,9,0,12,3
1748419354957,VIS 80,A03,944517,Adler; Amy,10,0,12,2
1748419354957,VIS 80,A04,944518,Adler; Amy,10,0,12,2
1748419354957,VIS 80,A05,944519,Adler; Amy,12,0,12,0
1748419354957,VIS 80,A06,944520,Adler; Amy,11,0,12,1
1748419354957,VIS 80,A07,944525,Adler; Amy,11,0,12,1
1748419354957,VIS 80,A08,944526,Adler; Amy,9,0,12,3
1748419355986,VIS 85A,A01,944694,Staff,18,0,18,0
1748419355986,VIS 85A,A02,944695,Staff,18,0,18,0
1748419355986,VIS 85A,A03,944696,Staff,17,0,18,1
1748419355986,VIS 85A,A04,944697,Staff,17,0,18,1
1748419355986,VIS 85A,A05,968082,Staff,17,0,18,1
1748419355986,VIS 85A,A06,968084,Staff,18,0,18,0
1748419355986,VIS 85A,A07,968085,Staff,17,0,18,1
1748419355986,VIS 85A,A08,968087,Staff,17,0,18,1
1748419357019,VIS 100,A00,944698,Cruz; Edwin Teddy,125,0,146,21
1748419358052,VIS 100A,A00,944699,D'Elena-Tweed; Jessica Erin,0,0,15,15
1748419359081,VIS 103D,A00,944767,Cartwright; Lisa,72,0,75,3
1748419360110,VIS 105A,A00,944769,Staff,9,0,30,21
1748419360110,VIS 105A,B00,944770,Staff,20,0,30,10
1748419361136,VIS 105B,A00,944773,Staff,16,0,30,14
1748419362164,VIS 105C,A00,944774,Ortiz-Torres; Ruben,1,0,15,14
1748419363190,VIS 106A,A00,944775,Staff,10,0,25,15
1748419364217,VIS 106B,A00,944776,Staff,0,0,25,25
1748419365244,VIS 107A,A00,944777,Staff,2,0,25,23
1748419366274,VIS 107C,A00,944780,Iglesias; Janelle Ann,11,0,15,4
1748419367302,VIS 108,A00,944781,Staff,0,0,15,15
1748419368329,VIS 110A,A00,944782,Staff,12,0,15,3
1748419369360,VIS 110G,A00,963093,Staff,14,0,15,1
1748419370391,VIS 113CN,A00,944783,Welchman; John C.,11,0,15,4
1748419371419,VIS 120A,A00,944784,Woods; Ann,118,0,146,28
1748419372450,VIS 121C,A00,944789,Tronzo; William,68,0,75,7
1748419373476,VIS 126F,A00,944793,Wardwell; Mariana Razo,74,0,75,1
1748419374503,VIS 128C,A00,944794,Staff,71,0,75,4
1748419375530,VIS 129A,A00,944799,Staff,7,0,15,8
1748419376563,VIS 132,A00,944800,Miller; Nicole L,6,0,15,9
1748419377596,VIS 133,A01,944806,Staff,32,0,34,2
1748419377596,VIS 133,A02,944809,Staff,34,0,34,0
1748419378625,VIS 133A,A00,944854,Staff,0,0,15,15
1748419379654,VIS 141A,A01,944856,Stalbaum; Brett,16,0,25,9
1748419379654,VIS 141A,A02,944858,Stalbaum; Brett,17,0,25,8
1748419379654,VIS 141A,A03,944859,Stalbaum; Brett,11,0,25,14
1748419379654,VIS 141A,A04,944861,Stalbaum; Brett,23,0,25,2
1748419380687,VIS 142,A01,944864,Stalbaum; Brett,11,0,15,4
1748419380687,VIS 142,A02,944865,Stalbaum; Brett,0,0,15,15
1748419380687,VIS 142,A03,944869,Stalbaum; Brett,11,0,15,4
1748419380687,VIS 142,A04,944873,Stalbaum; Brett,5,0,15,10
1748419380687,VIS 142,A05,944876,Stalbaum; Brett,15,0,15,0
1748419380687,VIS 142,A06,944878,Stalbaum; Brett,7,0,15,8
1748419381719,VIS 143,A00,969275,Akten; Mehmet,0,0,15,15
1748419382746,VIS 145B,A00,944879,Akten; Mehmet,0,0,15,15
1748419383778,VIS 146B,A00,944880,Twomey; Robert Daniel,14,0,15,1
1748419384805,VIS 147A,A01,944883,Staff,21,0,22,1
1748419384805,VIS 147A,A02,944923,Staff,12,0,22,10
1748419384805,VIS 147A,A03,944924,Staff,15,0,22,7
1748419384805,VIS 147A,A04,944925,Staff,17,0,22,5
1748419385836,VIS 147B,A00,944926,Staff,0,0,15,15
1748419385836,VIS 147B,B00,944927,Staff,1,0,15,14
1748419386868,VIS 149,A00,944928,Bratton; Benjamin H.,12,0,15,3
1748419386868,VIS 149,B00,944929,Crandall; Jordan,7,0,15,8
1748419387899,VIS 152D,A01,944931,Wardwell; Mariana Razo,19,0,24,5
1748419387899,VIS 152D,A02,945003,Wardwell; Mariana Razo,23,0,24,1
1748419387899,VIS 152D,A03,945007,Wardwell; Mariana Razo,24,0,24,0
1748419387899,VIS 152D,A04,945097,Wardwell; Mariana Razo,22,0,24,2
1748419388928,VIS 157,A01,945131,Cartwright; Lisa,23,0,24,1
1748419388928,VIS 157,A02,945167,Cartwright; Lisa,5,0,24,19
1748419389954,VIS 162,A00,945168,Bratton; Benjamin H.,6,0,15,9
1748419390985,VIS 163,A00,945169,Stone; Patricia,72,0,75,3
1748419392011,VIS 164,A00,945170,Sepuya; Paul Mpagi,19,0,22,3
1748419393042,VIS 165A,A00,945208,Staff,10,0,22,12
1748419394068,VIS 167,A00,945235,Staff,11,0,22,11
1748419395102,VIS 171,A00,945258,Staff,18,0,22,4
1748419396130,VIS 174,A00,945285,Cross; Brian R,0,0,22,22
1748419397155,VIS 175,A00,945286,Staff,18,0,22,4
1748419398183,VIS 179,A00,945287,Erdmann; Dean,20,0,22,2
1748419399210,VIS 180A,A00,945322,Cross; Brian R,9,0,22,13
1748419400240,VIS 180B,A00,945324,Gaines; Malik Julian,17,0,22,5
1748419401264,VIS 183B,A00,945329,Staff,4,0,22,18
1748419402294,VIS 203,A00,945331,Cruz; Edwin Teddy,4,0,15,11
1748419403324,VIS 204,A00,945333,Gaines; Malik Julian,11,0,15,4
1748419404350,VIS 205,A00,945334,Ortiz-Torres; Ruben,14,0,15,1
1748419405378,VIS 207,A00,971577,Staff,13,0,15,2
1748419406405,VIS 209,A00,945337,Welchman; John C.,10,0,15,5
1748419407434,VIS 243,A00,945340,Rose; Jordan M,8,0,15,7
1748419408462,VIS 255,A00,945342,Staff,9,0,15,6
1748419409510,VIS 295,001,971694,Miller; Nicole L,0,0,0,0
1748419409510,VIS 295,002,971695,Cruz; Edwin Teddy,0,0,0,0
1748419409510,VIS 295,003,971696,Segade; Alexandro Abraham,0,0,0,0
1748419409510,VIS 295,004,971697,Vangenderen; Monique Luise,0,0,0,0
1748419409510,VIS 295,005,971725,Sepuya; Paul Mpagi,0,0,0,0
1748419409510,VIS 295,006,971763,Sepuya; Paul Mpagi,0,0,0,0
1748419409510,VIS 295,007,971764,Mostajo; Lorena,0,0,0,0
1748419409510,VIS 295,008,971765,Akten; Mehmet,0,0,0,0
1748419410541,WCWP 10A,001,947782,Escobar; Jordan Christophe,20,0,20,0
1748419410541,WCWP 10A,002,947791,Escobar; Jordan Christophe,20,0,20,0
1748419410541,WCWP 10A,003,947792,Gagnon; Jeffrey C,0,0,0,0
1748419410541,WCWP 10A,004,947793,Escobar; Jordan Christophe,19,0,20,1
1748419410541,WCWP 10A,005,947794,Merryman; Walter,19,0,20,1
1748419410541,WCWP 10A,006,947840,Merryman; Walter,20,0,20,0
1748419410541,WCWP 10A,007,947841,Staff,0,0,0,0
1748419410541,WCWP 10A,008,947842,Staff,0,0,0,0
1748419410541,WCWP 10A,009,947843,Martiniuk; Jill,18,0,20,2
1748419410541,WCWP 10A,010,947844,Staff,0,0,0,0
1748419410541,WCWP 10A,011,947845,Martiniuk; Jill,19,0,20,1
1748419410541,WCWP 10A,012,947861,Martiniuk; Jill,20,0,20,0
1748419410541,WCWP 10A,013,947862,Staff,0,0,0,0
1748419410541,WCWP 10A,014,947863,Staff,0,0,0,0
1748419410541,WCWP 10A,015,947867,Staff,0,0,0,0
1748419410541,WCWP 10A,016,947868,Susi; Natalie,19,0,20,1
1748419410541,WCWP 10A,017,947869,Susi; Natalie,19,0,20,1
1748419410541,WCWP 10A,018,947870,Holloway Ii; Mathew,20,0,20,0
1748419410541,WCWP 10A,019,947912,Welji; Haleema Nazir,0,0,0,0
1748419410541,WCWP 10A,020,947941,Holloway Ii; Mathew,19,0,20,1
1748419410541,WCWP 10A,021,947954,Holloway Ii; Mathew,20,0,20,0
1748419410541,WCWP 10A,022,960902,Windham; Emily,19,0,20,1
1748419410541,WCWP 10A,023,960903,Windham; Emily,16,0,20,4
1748419410541,WCWP 10A,024,960904,Windham; Emily,18,0,20,2
1748419411578,WCWP 10B,001,948038,Dhir; Simrita,17,0,20,3
1748419411578,WCWP 10B,002,948042,Dhir; Simrita,14,0,20,6
1748419411578,WCWP 10B,003,948043,Uriarte; Emma,0,0,20,20
1748419411578,WCWP 10B,004,948044,Dhir; Simrita,12,0,20,8
1748419411578,WCWP 10B,005,948045,Uriarte; Emma,13,0,20,7
1748419411578,WCWP 10B,006,948046,Uriarte; Emma,13,0,20,7
1748419411578,WCWP 10B,007,948047,Staff,0,0,0,0
1748419411578,WCWP 10B,008,948075,Staff,0,0,0,0
1748419411578,WCWP 10B,009,948076,Ornelas; Tricia,15,0,20,5
1748419411578,WCWP 10B,010,948077,Staff,0,0,0,0
1748419411578,WCWP 10B,011,948096,Staff,0,0,0,0
1748419411578,WCWP 10B,012,948103,Staff,0,0,0,0
1748419411578,WCWP 10B,016,948169,Staff,0,0,0,0
1748419411578,WCWP 10B,017,948192,Ornelas; Tricia,12,0,20,8
1748419411578,WCWP 10B,018,948194,Ornelas; Tricia,14,0,20,6
1748419411578,WCWP 10B,019,948195,Staff,0,0,0,0
1748419412606,WCWP 100,A00,948196,McCleary; Keith Long,14,0,20,6
1748419412606,WCWP 100,B00,948198,McCleary; Keith Long,20,0,20,0
1748419412606,WCWP 100,C00,948199,McCleary; Keith Long,20,0,20,0
1748419412606,WCWP 100,D00,948200,Twohig; Niall Ivan,18,0,20,2
1748419412606,WCWP 100,E00,948201,Twohig; Niall Ivan,19,0,20,1
1748419412606,WCWP 100,F00,948202,Twohig; Niall Ivan,17,0,20,3
1748419412606,WCWP 100,G00,948203,Young; Mark T,18,0,20,2
1748419412606,WCWP 100,H00,948204,Young; Mark T,19,0,20,1
1748419412606,WCWP 100,I00,948205,Young; Mark T,19,0,20,1
1748419413631,WES 237C,A00,948206,Staff,15,0,15,0
1748419414663,WES 267,A00,948207,Staff,25,0,25,0
1748419415693,WES 268A,A01,948209,Staff,15,0,15,0
1748419417901,AAPI 87,A00,911745,Solomon; Amanda Lee Albaniel,20,0,20,0
1748419418931,AAS 10R,A01,912566,Butler; Elizabeth Annette,16,0,34,18
1748419418931,AAS 10R,A02,912567,Butler; Elizabeth Annette,21,0,34,13
1748419419959,AAS 170R,A00,912568,Butler; Elizabeth Annette,29,0,32,3
1748419420988,ANAR 104,A01,911408,Shtienberg; Gilad,11,0,20,9
1748419422017,ANAR 120,A00,911411,Staff,22,0,30,8
1748419423051,ANAR 166,A00,911412,Jimenez Cano; Nayeli Guada,21,0,30,9
1748419424082,ANAR 167,A01,911414,Dunseth; Zachary Clark,0,0,10,10
1748419425109,ANBI 100,A00,911416,Marchetto; Maria Carolina,36,0,40,4
1748419425109,ANBI 100,B00,961136,Staff,66,0,80,14
1748419426136,ANBI 112,A00,911417,Marchetto; Maria Carolina,0,0,20,20
1748419427164,ANBI 117,A01,961211,Fox; Patrick Keolu Ozer,33,0,40,7
1748419428191,ANBI 135,A01,911419,Non; Amy L,4,0,15,11
1748419429217,ANBI 141,A00,911420,Gagneux; Pascal,170,0,196,26
1748419430248,ANSC 108,A00,911460,Pedersen; David,38,0,40,2
1748419431282,ANSC 121,A00,911472,Sloane; Julia Kathryn,53,0,60,7
1748419432363,ANSC 124,A00,911473,Bialecki; Jon Anthony,32,0,40,8
1748419433389,ANSC 142,A00,911474,Stone; Annika Britt,31,0,40,9
1748419434415,ANSC 148,A00,911475,Walkover; Lillian B,46,0,46,0
1748419435440,ANSC 149,A00,911476,Varma; Saiba,56,0,60,4
1748419436470,ANSC 152,A00,961212,Staff,40,0,40,0
1748419437496,ANSC 190,A00,911479,Jassal; Aftab,41,0,50,9
1748419438526,ANTH 1,A00,910717,Jassal; Aftab,146,0,150,4
1748419439552,ANTH 2,A01,910719,Wilder; Linnea Lorene,31,0,36,5
1748419439552,ANTH 2,A02,910720,Wilder; Linnea Lorene,36,0,36,0
1748419439552,ANTH 2,A03,910722,Wilder; Linnea Lorene,32,0,36,4
1748419439552,ANTH 2,A04,910723,Wilder; Linnea Lorene,35,0,36,1
1748419439552,ANTH 2,A05,910724,Wilder; Linnea Lorene,35,0,36,1
1748419439552,ANTH 2,A06,910725,Wilder; Linnea Lorene,35,0,36,1
1748419439552,ANTH 2,A07,910726,Wilder; Linnea Lorene,33,0,34,1
1748419440585,ANTH 10,A00,910727,Stewart; Alexander B,148,0,175,27
1748419441621,ANTH 21,A01,910730,Stone; Annika Britt,35,0,36,1
1748419441621,ANTH 21,A02,910731,Stone; Annika Britt,34,0,36,2
1748419441621,ANTH 21,A03,910732,Stone; Annika Britt,34,0,36,2
1748419441621,ANTH 21,A04,910733,Stone; Annika Britt,30,0,36,6
1748419441621,ANTH 21,A05,910734,Stone; Annika Britt,35,0,36,1
1748419441621,ANTH 21,A06,910735,Stone; Annika Britt,30,0,36,6
1748419441621,ANTH 21,A07,910736,Stone; Annika Britt,24,0,34,10
1748419441621,ANTH 21,B01,910738,Kang; Byung Chu,36,0,36,0
1748419441621,ANTH 21,B02,910740,Kang; Byung Chu,36,0,36,0
1748419441621,ANTH 21,B03,910781,Kang; Byung Chu,34,0,36,2
1748419441621,ANTH 21,B04,910782,Kang; Byung Chu,34,0,36,2
1748419441621,ANTH 21,B05,910821,Kang; Byung Chu,36,0,36,0
1748419441621,ANTH 21,B06,910826,Kang; Byung Chu,34,0,36,2
1748419441621,ANTH 21,B07,910834,Kang; Byung Chu,34,0,34,0
1748419442655,ANTH 23,A01,910896,Stewart; Alexander B,25,0,25,0
1748419442655,ANTH 23,A02,910916,Stewart; Alexander B,25,0,25,0
1748419442655,ANTH 23,A03,910932,Stewart; Alexander B,25,0,25,0
1748419442655,ANTH 23,A04,910933,Stewart; Alexander B,24,0,25,1
1748419442655,ANTH 23,A05,910938,Stewart; Alexander B,25,0,25,0
1748419442655,ANTH 23,A06,911043,Stewart; Alexander B,25,0,25,0
1748419442655,ANTH 23,A07,911141,Stewart; Alexander B,24,0,25,1
1748419443684,ANTH 87,A00,911153,Jordan; David K.,20,0,20,0
1748419443684,ANTH 87,B00,911392,Jordan; David K.,20,0,20,0
1748419443684,ANTH 87,C00,911404,Varma; Saiba,20,0,20,0
1748419444711,ANTH 101,A01,911481,Staff,27,0,30,3
1748419444711,ANTH 101,A02,911482,Staff,15,0,30,15
1748419444711,ANTH 101,A03,911483,Staff,24,0,30,6
1748419444711,ANTH 101,A04,911484,Staff,17,0,30,13
1748419445736,ANTH 105,A00,911486,Staff,69,0,80,11
1748419446766,ANTH 108,A00,911487,Sloane; Julia Kathryn,31,0,35,4
1748419447818,ANTH 196A,A00,911488,Staff,14,0,15,1
1748419448844,ANTH 200,A00,911489,Non; Amy L,12,0,15,3
1748419449873,ANTH 203,A00,911490,Gagneux; Pascal,20,0,20,0
1748419450905,ANTH 208,A00,911491,Kang; Byung Chu,8,0,12,4
1748419451936,ANTH 268,A00,911492,McKenzie; Kerry V.,10,0,10,0
1748419452968,ANTH 273,A00,911493,McKenzie; Kerry V.,10,0,10,0
1748419453994,ANTH 281A,A00,911494,Pedersen; David,10,0,10,0
1748419455020,ANTH 285,A00,911495,Algaze; Guillermo,7,0,10,3
1748419456050,ASTR 1,A01,911506,Wright; Shelley Adams,282,0,300,18
1748419457079,ASTR 18,A01,911508,Arnold; Kam S,35,0,37,2
1748419458104,ASTR 20A,A01,911510,Theissen; Christopher Alexander,48,0,56,8
1748419459130,ASTR 65,A01,911512,Trumbo; Samantha Kathleen,49,0,50,1
1748419460163,ASTR 101,A01,911514,Burgasser; Adam Jonathan,25,0,32,7
1748419461191,ASTR 104,A01,911516,Lee; Eve Jihyun,29,0,32,3
1748419462219,ASTR 120,A01,911518,Tytler; David Robert,29,0,37,8
1748419463250,ASTR 124,A01,911520,Konopacky; Quinn Morgan,33,0,37,4
1748419464280,ASTR 150,A01,911522,Hosseinzadeh; Griffin Alex,34,0,40,6
1748419465309,ASTR 200,A00,911523,Sandstrom; Karin Marie,29,0,30,1
1748419466339,ASTR 201,A00,911524,Broekgaarden; Floor Suzan,30,0,30,0
1748419467368,ASTR 213,A00,911525,Keres; Dusan,28,0,30,2
1748419468399,ASTR 250,A00,911526,Theissen; Christopher Alexander & Hosseinzadeh; Griffin Alex,27,0,30,3
1748419469425,ASTR 251,A00,911527,Theissen; Christopher Alexander & Hosseinzadeh; Griffin Alex,27,0,30,3
1748419470479,AWP 3,001,910489,Staff,12,0,12,0
1748419470479,AWP 3,002,910490,Staff,12,0,12,0
1748419470479,AWP 3,003,910491,Staff,12,0,12,0
1748419470479,AWP 3,004,910492,Staff,12,0,12,0
1748419470479,AWP 3,005,910493,Staff,12,0,12,0
1748419470479,AWP 3,006,910495,Staff,12,0,12,0
1748419470479,AWP 3,007,910498,Staff,12,0,12,0
1748419470479,AWP 3,008,910509,Staff,12,0,12,0
1748419470479,AWP 3,009,910516,Staff,12,0,12,0
1748419470479,AWP 3,010,910525,Staff,12,0,12,0
1748419470479,AWP 3,011,910531,Staff,12,0,12,0
1748419470479,AWP 3,012,910532,Staff,12,0,12,0
1748419470479,AWP 3,013,910533,Staff,12,0,12,0
1748419470479,AWP 3,014,910534,Staff,12,0,12,0
1748419470479,AWP 3,015,910535,Staff,12,0,12,0
1748419470479,AWP 3,016,910536,Staff,12,0,12,0
1748419470479,AWP 3,017,910537,Staff,12,0,12,0
1748419470479,AWP 3,018,910538,Staff,12,0,12,0
1748419470479,AWP 3,019,910539,Staff,0,0,0,0
1748419470479,AWP 3,020,910540,Staff,0,0,0,0
1748419470479,AWP 3,021,910541,Staff,12,0,12,0
1748419470479,AWP 3,022,910542,Staff,0,0,0,0
1748419470479,AWP 3,023,910543,Staff,12,0,12,0
1748419470479,AWP 3,024,910545,Staff,12,0,12,0
1748419470479,AWP 3,025,910546,Staff,12,0,12,0
1748419470479,AWP 3,026,910547,Staff,12,0,12,0
1748419470479,AWP 3,027,910548,Staff,12,0,12,0
1748419470479,AWP 3,028,910549,Staff,12,0,12,0
1748419470479,AWP 3,029,910550,Staff,0,0,0,0
1748419470479,AWP 3,030,910551,Staff,0,0,0,0
1748419470479,AWP 3,031,910552,Staff,12,0,12,0
1748419470479,AWP 3,032,910553,Staff,12,0,12,0
1748419470479,AWP 3,033,910554,Staff,12,0,12,0
1748419470479,AWP 3,034,910555,Staff,12,0,12,0
1748419470479,AWP 3,035,910557,Staff,12,0,12,0
1748419470479,AWP 3,036,910558,Staff,12,0,12,0
1748419470479,AWP 3,037,910559,Staff,12,0,12,0
1748419470479,AWP 3,038,910560,Staff,12,0,12,0
1748419470479,AWP 3,039,910561,Staff,12,0,12,0
1748419470479,AWP 3,040,910562,Staff,12,0,12,0
1748419470479,AWP 3,041,910563,Staff,12,0,12,0
1748419470479,AWP 3,042,910564,Staff,12,0,12,0
1748419470479,AWP 3,043,910565,Staff,12,0,12,0
1748419470479,AWP 3,044,910566,Staff,12,0,12,0
1748419470479,AWP 3,045,910567,Staff,12,0,12,0
1748419470479,AWP 3,046,910568,Staff,12,0,12,0
1748419470479,AWP 3,047,910569,Staff,12,0,12,0
1748419470479,AWP 3,048,910570,Staff,12,0,12,0
1748419470479,AWP 3,049,910571,Staff,12,0,12,0
1748419470479,AWP 3,050,910576,Staff,12,0,12,0
1748419470479,AWP 3,051,910629,Staff,12,0,12,0
1748419470479,AWP 3,052,910630,Staff,12,0,12,0
1748419470479,AWP 3,053,910632,Staff,12,0,12,0
1748419470479,AWP 3,054,910633,Staff,12,0,12,0
1748419470479,AWP 3,055,910635,Staff,12,0,12,0
1748419470479,AWP 3,056,910636,Staff,12,0,12,0
1748419470479,AWP 3,057,910638,Staff,12,0,12,0
1748419470479,AWP 3,058,910640,Staff,0,0,0,0
1748419470479,AWP 3,059,910641,Staff,12,0,12,0
1748419470479,AWP 3,060,910645,Staff,12,0,12,0
1748419470479,AWP 3,061,910646,Staff,12,0,12,0
1748419470479,AWP 3,062,910648,Staff,12,0,12,0
1748419470479,AWP 3,063,910649,Staff,12,0,12,0
1748419470479,AWP 3,064,910653,Staff,12,0,12,0
1748419470479,AWP 3,065,910654,Staff,12,0,12,0
1748419470479,AWP 3,066,910656,Staff,12,0,12,0
1748419470479,AWP 3,067,910657,Staff,12,0,12,0
1748419470479,AWP 3,068,910659,Staff,15,0,15,0
1748419470479,AWP 3,069,910660,Staff,0,0,0,0
1748419470479,AWP 3,070,910662,Staff,12,0,12,0
1748419470479,AWP 3,071,910665,Staff,0,0,0,0
1748419470479,AWP 3,072,910667,Staff,12,0,12,0
1748419470479,AWP 3,073,970938,Staff,12,0,12,0
1748419470479,AWP 3,074,970939,Staff,12,0,12,0
1748419470479,AWP 3,075,970940,Staff,0,0,0,0
1748419470479,AWP 3,076,970941,Staff,12,0,12,0
1748419470479,AWP 3,077,970942,Staff,12,0,12,0
1748419470479,AWP 3,078,970943,Staff,0,0,0,0
1748419470479,AWP 3,079,970944,Staff,12,0,12,0
1748419470479,AWP 3,080,970945,Staff,0,0,0,0
1748419470479,AWP 3,081,971140,Staff,0,0,0,0
1748419470479,AWP 3,082,971141,Staff,0,0,0,0
1748419470479,AWP 3,083,971142,Staff,0,0,0,0
1748419470479,AWP 3,084,971152,Staff,0,0,0,0
1748419470479,AWP 3,085,971315,Staff,0,0,0,0
1748419471510,AWP 4B,B00,910682,Staff,0,0,0,0
1748419471510,AWP 4B,C00,910701,Staff,0,0,0,1
1748419472544,BENG 1,A01,911565,Khojah; Reem I,26,0,30,4
1748419472544,BENG 1,A02,911567,Khojah; Reem I,30,0,30,0
1748419472544,BENG 1,A03,911568,Khojah; Reem I,29,0,30,1
1748419473574,BENG 2,A00,911569,Khojah; Reem I,28,0,30,2
1748419474601,BENG 98,001,969809,Sah; Robert Lie-Yuan,9999,0,9999,0
1748419475630,BENG 99,001,969810,Sah; Robert Lie-Yuan,9999,0,9999,0
1748419476664,BENG 100,A01,911579,Taylor Amos; Alyssa C,35,0,50,15
1748419477692,BENG 110,A01,911582,Mc Culloch; Andrew Douglas,5,0,30,25
1748419477692,BENG 110,A02,911584,Mc Culloch; Andrew Douglas,17,0,30,13
1748419478722,BENG 122A,A01,958030,Cauwenberghs; Gert,54,0,70,16
1748419479758,BENG 133,A01,911589,Mali; Prashant Gulab Ram,33,0,40,7
1748419480785,BENG 135,A01,911653,Staff,32,0,40,8
1748419481811,BENG 141,A01,911674,Staff,29,0,40,11
1748419482840,BENG 161A,A01,911676,Fraley; Stephanie I.,16,0,35,19
1748419482840,BENG 161A,A02,957945,Fraley; Stephanie I.,29,0,35,6
1748419483868,BENG 162,A01,911682,Mali; Prashant Gulab Ram,0,0,30,30
1748419483868,BENG 162,A02,911683,Mali; Prashant Gulab Ram,25,0,30,5
1748419484902,BENG 166A,A02,911685,Sah; Robert Lie-Yuan,11,0,35,24
1748419485934,BENG 183,A01,911688,Zhong; Sheng,35,0,120,85
1748419486966,BENG 187B,A00,911689,Taylor Amos; Alyssa C,52,0,120,68
1748419487996,BENG 188A,A01,911691,Taylor Amos; Alyssa C,131,0,170,39
1748419489024,BENG 196,A00,911692,Cabrales; Pedro,5,0,5,0
1748419490072,BENG 197,A00,911693,Cabrales; Pedro,9999,0,9999,0
1748419491102,BENG 198,001,969812,Sah; Robert Lie-Yuan,9999,0,9999,0
1748419492158,BENG 211,A00,911720,Smarr; Benjamin,2,0,30,28
1748419493188,BENG 216,A01,911722,Cauwenberghs; Gert,1,0,40,39
1748419494245,BENG 219,A00,911723,Schoeneberg; Johannes,0,0,0,0
1748419495272,BENG 221,A00,911724,Valdez-Jasso; Daniela,27,0,70,43
1748419496297,BENG 226,A01,911727,Schmid-Schoenbein; Geert W,54,0,120,66
1748419497326,BENG 230A,A00,911728,Huang; Xiaohua,59,0,120,61
1748419498359,BENG 241A,A01,911730,Cyphert; Erika Leah,0,0,50,50
1748419499384,BENG 242,A00,911731,Cai; Shengqiang,16,0,40,24
1748419500418,BENG 247A,A00,911732,Shi; Lingyan,31,0,55,24
1748419501448,BENG 247B,A00,911733,Aran; Kiana,0,0,30,30
1748419502476,BENG 254,A01,911735,Hasty; Jeff M,0,0,20,20
1748419503505,BENG 260,A01,911737,Silva; Gabriel,15,0,45,30
1748419504541,BENG 280A,A00,911738,Liu; Thomas Tao-Ming & McVeigh; Elliot R.,34,0,70,36
1748419505573,BENG 281,A00,911739,Zhong; Sheng,5,0,90,85
1748419506601,BENG 282,A00,911740,Cabrales; Pedro,19,0,100,81
1748419507634,BENG 292,A01,911742,Ross; Camille,20,0,20,0
1748419508665,BENG 294A,A00,911743,King; Kevin R,25,0,50,25
1748419509694,BENG 295,A00,911744,Watson; John Thomas,9999,0,9999,0
1748419510729,BGGN 202,A00,943331,Kadonaga; James T,52,0,60,8
1748419511757,BGGN 204,A00,943332,Shurin; Jonathan,11,0,20,9
1748419512789,BGGN 206A,A00,943343,Bennett; Eric J,50,0,50,0
1748419513817,BGGN 208,A00,943344,Meyer; Justin Raymond & Bennett; Eric J,50,0,50,0
1748419514845,BGGN 213,A00,943349,Grant; Barry J,48,0,48,0
1748419515872,BGGN 214,A00,943351,Suel; Gurol Mehmet,23,0,50,27
1748419516899,BGGN 220,A00,943352,Dickinson; Alexandra Jazz & Pruneda-Paz; Jose L.,24,0,50,26
1748419517926,BGGN 227,A00,943372,Huffaker; Alisa,44,0,50,6
1748419518955,BGGN 249A,A01,969612,Bloodgood; Brenda Laurie,0,0,0,0
1748419518955,BGGN 249A,A02,969639,Bloodgood; Brenda Laurie,0,0,0,0
1748419519983,BGGN 260,A01,946423,Silva; Gabriel,15,0,15,0
1748419521176,BGGN 271,001,967097,Akbari; Omar Sultan,9999,0,9999,0
1748419521176,BGGN 271,002,967098,Allen; Nicola J,9999,0,9999,0
1748419521176,BGGN 271,003,967099,Alperin; Mariann,9999,0,9999,0
1748419521176,BGGN 271,004,967238,Antal; Corina Elena,9998,0,9999,1
1748419521176,BGGN 271,005,967365,Banghart; Matthew Ryan,9999,0,9999,0
1748419521176,BGGN 271,006,967368,Bier; Ethan,9999,0,9999,0
1748419521176,BGGN 271,007,967371,Boss; Gerard R.,9999,0,9999,0
1748419521176,BGGN 271,008,967375,Bouvet; Michael,9999,0,9999,0
1748419521176,BGGN 271,009,967376,Breen; Ellen C.,9999,0,9999,0
1748419521176,BGGN 271,010,967382,Bui; Jack D,9999,0,9999,0
1748419521176,BGGN 271,011,967391,Burnett; Lindsey,9998,0,9999,1
1748419521176,BGGN 271,012,967407,Caffrey; Conor,9999,0,9999,0
1748419521176,BGGN 271,013,967429,Castle; Michael James,9999,0,9999,0
1748419521176,BGGN 271,014,967431,Chang; John Tzu-yu,9999,0,9999,0
1748419521176,BGGN 271,015,967448,Chen; Xu,9999,0,9999,0
1748419521176,BGGN 271,016,967449,Cheng; Christine Shiang-Ling,9999,0,9999,0
1748419521176,BGGN 271,017,967464,Cheresh; David A.,9999,0,9999,0
1748419521176,BGGN 271,018,967496,Cherqui; Stephanie,9999,0,9999,0
1748419521176,BGGN 271,019,967500,Chu; Hiutung,9999,0,9999,0
1748419521176,BGGN 271,020,967559,Church; Kellie Breen,9999,0,9999,0
1748419521176,BGGN 271,021,967560,Cleland; Elsa Eleanor,9999,0,9999,0
1748419521176,BGGN 271,022,967561,Cohen; Shiran,9999,0,9999,0
1748419521176,BGGN 271,023,967562,Coufal; Nicole Gabriele,9999,0,9999,0
1748419521176,BGGN 271,024,967563,Croker; Ben Adam,9999,0,9999,0
1748419521176,BGGN 271,025,967564,Crotty Alexander; Laura E,9999,0,9999,0
1748419521176,BGGN 271,026,967565,Daugherty; Matthew Dorton,9998,0,9999,1
1748419521176,BGGN 271,027,967566,De Silva; Shermin,9999,0,9999,0
1748419521176,BGGN 271,028,967567,Dhar; Debanjan,9999,0,9999,0
1748419521176,BGGN 271,029,967568,Dixon; Jesse,9999,0,9999,0
1748419521176,BGGN 271,030,967569,Doherty; Taylor Alan,9998,0,9999,1
1748419521176,BGGN 271,031,967570,Dore; Kim Bohemie,9999,0,9999,0
1748419521176,BGGN 271,032,967571,Dorrestein; Pieter,9999,0,9999,0
1748419521176,BGGN 271,033,967572,Dulawa; Stephanie Carole,9999,0,9999,0
1748419521176,BGGN 271,034,967573,Fang; Xi,9999,0,9999,0
1748419521176,BGGN 271,035,967575,Farley; Emma Kristen,9998,0,9999,1
1748419521176,BGGN 271,036,967576,Ferguson; Cole John,9999,0,9999,0
1748419521176,BGGN 271,037,967578,Fisch; Kathleen Marie,9999,0,9999,0
1748419521176,BGGN 271,038,967579,George; Olivier,9999,0,9999,0
1748419521176,BGGN 271,039,967580,Ghosh; Pradipta,9998,0,9999,1
1748419521176,BGGN 271,040,967581,Glasgow; Stacey Marie,9999,0,9999,0
1748419521176,BGGN 271,041,967582,Golden; James W,9999,0,9999,0
1748419521176,BGGN 271,042,967583,Gonzalez Gamboa; Ivonne,9999,0,9999,0
1748419521176,BGGN 271,043,967584,Goren; Alon M,9999,0,9999,0
1748419521176,BGGN 271,044,967650,Guatelli; John C,9999,0,9999,0
1748419521176,BGGN 271,045,967651,Guma; Monica,9998,0,9999,1
1748419521176,BGGN 271,046,967652,Gustafsson; Asa Birgitta,9999,0,9999,0
1748419521176,BGGN 271,047,967655,Hamdoun; Amr,9999,0,9999,0
1748419521176,BGGN 271,048,967657,Hao; Nan,9999,0,9999,0
1748419521176,BGGN 271,049,967658,Hasty; Jeff M,9999,0,9999,0
1748419521176,BGGN 271,050,967660,Jiang; Qingfei,9998,0,9999,1
1748419521176,BGGN 271,051,967661,Jin; Chunyu,9999,0,9999,0
1748419521176,BGGN 271,052,967662,Jin; Yishi,9999,0,9999,0
1748419521176,BGGN 271,053,967663,Joshi; Shweta,9998,0,9999,1
1748419521176,BGGN 271,054,967664,Ju; Won-Kyu,9998,0,9999,1
1748419521176,BGGN 271,055,967665,Jun; Suckjoon,9999,0,9999,0
1748419521176,BGGN 271,056,967666,Kaech; Susan Michelle,9999,0,9999,0
1748419521176,BGGN 271,057,967668,Kauffman; Alexander,9998,0,9999,1
1748419521176,BGGN 271,058,967670,Kiger; Amy,9999,0,9999,0
1748419521176,BGGN 271,059,967720,Koloski; Miranda Jane,9998,0,9999,1
1748419521176,BGGN 271,060,967864,Komiyama; Takaki,9999,0,9999,0
1748419521176,BGGN 271,061,967865,Kronenberg; Mitchell E.,9998,0,9999,1
1748419521176,BGGN 271,062,967866,Kufareva; Irina,9999,0,9999,0
1748419521176,BGGN 271,063,967867,Lee; Yun Sok,9999,0,9999,0
1748419521176,BGGN 271,064,967869,Leutgeb; Stefan,9999,0,9999,0
1748419521176,BGGN 271,065,967870,Lewis; Warren G.,9999,0,9999,0
1748419521176,BGGN 271,066,967871,Li; Willis Xiaowei,9998,0,9999,1
1748419521176,BGGN 271,067,967872,Lim; Byungkook,9999,0,9999,0
1748419521176,BGGN 271,068,967873,Lo; Stanley M.,9998,0,9999,1
1748419521176,BGGN 271,069,967874,Lopez Ramirez; Miguel Alej,9999,0,9999,0
1748419521176,BGGN 271,070,967875,Lu; Li-Fan,9998,0,9999,1
1748419521176,BGGN 271,071,967877,Lu; Pengzhe,9999,0,9999,0
1748419521176,BGGN 271,072,967878,Lyons; Deirdre Colleen,9999,0,9999,0
1748419521176,BGGN 271,073,967879,Lyumkis; Dmitry Evgenievich,9999,0,9999,0
1748419521176,BGGN 271,074,967880,Mandyam; Chitra,9999,0,9999,0
1748419521176,BGGN 271,075,967881,McConville; Patrick James,9999,0,9999,0
1748419521176,BGGN 271,076,967882,Mertens; Jerome Stefan,9999,0,9999,0
1748419521176,BGGN 271,077,967884,Morris; Gerald P,9999,0,9999,0
1748419521176,BGGN 271,078,967885,Muroyama; Andrew David,9999,0,9999,0
1748419521176,BGGN 271,079,967886,Murre; Cornelis,9999,0,9999,0
1748419521176,BGGN 271,080,967887,Neal; Sonya E,9999,0,9999,0
1748419521176,BGGN 271,081,967889,Newton; Alexandra C.,9999,0,9999,0
1748419521176,BGGN 271,082,967890,Nieh; James Charles,9999,0,9999,0
1748419521176,BGGN 271,083,967893,Niwa; Maho,9999,0,9999,0
1748419521176,BGGN 271,084,967894,Pantham; Priyadarshini,9999,0,9999,0
1748419521176,BGGN 271,085,967895,Parast; Mana,9999,0,9999,0
1748419521176,BGGN 271,086,967899,Perry; Michael William,9999,0,9999,0
1748419521176,BGGN 271,087,967900,Pillus; Lorraine,9998,0,9999,1
1748419521176,BGGN 271,088,967902,Pogliano; Joseph,9999,0,9999,0
1748419521176,BGGN 271,089,967903,Pruneda-Paz; Jose L.,9999,0,9999,0
1748419521176,BGGN 271,090,967904,Raffatellu; Manuela,9999,0,9999,0
1748419521176,BGGN 271,091,967906,Rana; Tariq,9999,0,9999,0
1748419521176,BGGN 271,092,967907,Rao; Anjana,9998,0,9999,1
1748419521176,BGGN 271,093,967908,Raz; Eyal,9998,0,9999,1
1748419521176,BGGN 271,094,967909,Gaulton; Kyle J,9999,0,9999,0
1748419521176,BGGN 271,095,967910,Rifkin; Scott,9998,0,9999,1
1748419521176,BGGN 271,096,967912,Risbrough; Victoria Blythe,9999,0,9999,0
1748419521176,BGGN 271,097,967916,Rose; Noah Hartmann,9999,0,9999,0
1748419521176,BGGN 271,098,967917,Rouse; Gregory W.,9999,0,9999,0
1748419521176,BGGN 271,099,967918,Saier; Milton H.,9999,0,9999,0
1748419521176,BGGN 271,100,967919,Saltiel; Alan,9998,0,9999,1
1748419521176,BGGN 271,101,967920,Sanchez-Lopez; Elsa,9999,0,9999,0
1748419521176,BGGN 271,102,967921,Schenk; Simon,9999,0,9999,0
1748419521176,BGGN 271,103,967922,Schroeder; Julian I,9998,0,9999,1
1748419521176,BGGN 271,104,967923,Sebat; Lilia Mikhailovna,9999,0,9999,0
1748419521176,BGGN 271,105,967925,Sen; George L,9999,0,9999,0
1748419521176,BGGN 271,106,967926,Shaner; Nathan C.,9999,0,9999,0
1748419521176,BGGN 271,107,967927,Shao; Jianhua,9999,0,9999,0
1748419521176,BGGN 271,108,967928,Shurin; Jonathan,9998,0,9999,1
1748419521176,BGGN 271,109,967929,Sicklick; Jason Keith,9999,0,9999,0
1748419521176,BGGN 271,110,967931,Signer; Robert,9999,0,9999,0
1748419521176,BGGN 271,111,967932,Sigurdson; Christina,9999,0,9999,0
1748419521176,BGGN 271,112,967934,Simonson; Tatum Sasha Summ,9999,0,9999,0
1748419521176,BGGN 271,113,967935,Spitzer; Nicholas,9999,0,9999,0
1748419521176,BGGN 271,114,967936,Steinmetz; Nicole F,9999,0,9999,0
1748419521176,BGGN 271,115,967938,Su; Chih-Ying,9999,0,9999,0
1748419521176,BGGN 271,116,967939,Telese; Francesca,9999,0,9999,0
1748419521176,BGGN 271,117,967942,Towers; Christina Garlingt,9999,0,9999,0
1748419521176,BGGN 271,118,967943,Tye; Kay M,9999,0,9999,0
1748419521176,BGGN 271,119,967945,Wahlin; Karl Jonas,9997,0,9999,2
1748419521176,BGGN 271,120,967947,Wang; Shizhen,9999,0,9999,0
1748419521176,BGGN 271,121,967949,Wang; Jean Yin Jen,9999,0,9999,0
1748419521176,BGGN 271,122,967952,Webster; Nicholas J G,9999,0,9999,0
1748419521176,BGGN 271,123,967953,Weiskopf; Daniela,9998,0,9999,1
1748419521176,BGGN 271,124,967954,Welsbie; Derek,9999,0,9999,0
1748419521176,BGGN 271,125,967956,Wildonger; Jill Cathleen,9999,0,9999,0
1748419521176,BGGN 271,126,967957,Yelon; Deborah,9999,0,9999,0
1748419521176,BGGN 271,127,967958,Yeo; Eugene Wei-Ming,9998,0,9999,1
1748419521176,BGGN 271,128,967959,Ying; Wei,9998,0,9999,1
1748419521176,BGGN 271,129,967960,Young; Jared W.,9999,0,9999,0
1748419521176,BGGN 271,130,967961,Zage; Peter,9999,0,9999,0
1748419521176,BGGN 271,131,967962,Zengler; Karsten B,9999,0,9999,0
1748419521176,BGGN 271,132,967963,Zhang; Jin,9999,0,9999,0
1748419521176,BGGN 271,133,967964,Zhao; Yunde,9999,0,9999,0
1748419521176,BGGN 271,134,967965,Zheng; Ye,9998,0,9999,1
1748419521176,BGGN 271,135,967966,Zhou; Huilin,9998,0,9999,1
1748419521176,BGGN 271,136,967970,Zou; Yimin,9998,0,9999,1
1748419522205,BGGN 272,A00,943373,Lo; Stanley M.,14,0,15,1
1748419523231,BGGN 275,A00,943374,Pogliano; Joseph,0,0,0,0
1748419524261,BGGN 276,A00,943378,Pogliano; Joseph,0,0,0,0
1748419525287,BGJC 204,A00,943407,Lu; Li-Fan & Chang; John Tzu-yu,9998,0,9999,1
1748419526314,BGJC 215,A00,943417,Tour; Ella,9,0,10,1
1748419527505,BGRD 200,001,965406,Akbari; Omar Sultan,9999,0,9999,0
1748419527505,BGRD 200,002,965407,Allen; Eric,9999,0,9999,0
1748419527505,BGRD 200,003,965408,Allen; Nicola J,9998,0,9999,1
1748419527505,BGRD 200,004,965427,Alperin; Mariann,9999,0,9999,0
1748419527505,BGRD 200,005,965428,Amaro; Rommie E,9998,0,9999,1
1748419527505,BGRD 200,006,965429,Antal; Corina Elena,9998,0,9999,1
1748419527505,BGRD 200,007,965731,Asahina; Kenta,9999,0,9999,0
1748419527505,BGRD 200,008,965732,Augustine; Vineet,9999,0,9999,0
1748419527505,BGRD 200,009,965733,Ayres; Janelle Samantha,9998,0,9999,1
1748419527505,BGRD 200,010,965734,Banghart; Matthew Ryan,9999,0,9999,0
1748419527505,BGRD 200,011,965735,Barton; Andrew David,9999,0,9999,0
1748419527505,BGRD 200,012,965736,Bayless; Daniel Wilson,9999,0,9999,0
1748419527505,BGRD 200,013,965737,Benna; Marcus K,9999,0,9999,0
1748419527505,BGRD 200,014,965738,Bennett; Eric J,9999,0,9999,0
1748419527505,BGRD 200,015,965739,Bier; Ethan,9999,0,9999,0
1748419527505,BGRD 200,016,965740,Bloodgood; Brenda Laurie,9999,0,9999,0
1748419527505,BGRD 200,017,965741,Boss; Gerard R.,9999,0,9999,0
1748419527505,BGRD 200,018,966029,Bouvet; Michael,9999,0,9999,0
1748419527505,BGRD 200,019,966054,Breen; Ellen C.,9999,0,9999,0
1748419527505,BGRD 200,020,966072,Bui; Jack D,9999,0,9999,0
1748419527505,BGRD 200,021,966073,Burnett; Lindsey,9998,0,9999,1
1748419527505,BGRD 200,022,966080,Caffrey; Conor,9999,0,9999,0
1748419527505,BGRD 200,023,966082,Callaway; Edward M,9999,0,9999,0
1748419527505,BGRD 200,024,966087,Castle; Michael James,9999,0,9999,0
1748419527505,BGRD 200,025,966089,Chaim; Isaac,9999,0,9999,0
1748419527505,BGRD 200,026,966092,Chang; John Tzu-yu,9999,0,9999,0
1748419527505,BGRD 200,027,966094,Chen; Xu,9999,0,9999,0
1748419527505,BGRD 200,028,966095,Cheng; Christine Shiang-Ling,9999,0,9999,0
1748419527505,BGRD 200,029,966099,Cheresh; David A.,9999,0,9999,0
1748419527505,BGRD 200,030,966103,Cherqui; Stephanie,9999,0,9999,0
1748419527505,BGRD 200,031,966104,Chu; Hiutung,9999,0,9999,0
1748419527505,BGRD 200,032,966107,Church; Kellie Breen,9999,0,9999,0
1748419527505,BGRD 200,033,966108,Cleland; Elsa Eleanor,9997,0,9999,2
1748419527505,BGRD 200,034,966111,Cohen; Shiran,9999,0,9999,0
1748419527505,BGRD 200,035,966112,Cooper; Kimberly Lynn,9999,0,9999,0
1748419527505,BGRD 200,036,966114,Coufal; Nicole Gabriele,9999,0,9999,0
1748419527505,BGRD 200,037,966115,Croker; Ben Adam,9999,0,9999,0
1748419527505,BGRD 200,038,966116,Crotty Alexander; Laura E,9999,0,9999,0
1748419527505,BGRD 200,039,966117,Daugherty; Matthew Dorton,9997,0,9999,2
1748419527505,BGRD 200,040,966118,De Silva; Shermin,9998,0,9999,1
1748419527505,BGRD 200,041,966119,Desai; Arshad,9999,0,9999,0
1748419527505,BGRD 200,042,966120,Dhar; Debanjan,9999,0,9999,0
1748419527505,BGRD 200,043,966121,Dickinson; Alexandra Jazz,9999,0,9999,0
1748419527505,BGRD 200,044,966123,Dixon; Jesse,9999,0,9999,0
1748419527505,BGRD 200,045,966125,Doherty; Taylor Alan,9998,0,9999,1
1748419527505,BGRD 200,046,966128,Dore; Kim Bohemie,9999,0,9999,0
1748419527505,BGRD 200,047,966129,Dorrestein; Pieter,9999,0,9999,0
1748419527505,BGRD 200,048,966130,Dulawa; Stephanie Carole,9999,0,9999,0
1748419527505,BGRD 200,049,966131,Ecker; Joseph R,9999,0,9999,0
1748419527505,BGRD 200,050,966174,Engle; Dannielle D,9998,0,9999,1
1748419527505,BGRD 200,051,966179,Ernst; Andreas,9999,0,9999,0
1748419527505,BGRD 200,052,966182,Esko; Jeffrey D.,9999,0,9999,0
1748419527505,BGRD 200,053,966183,Fang; Xi,9999,0,9999,0
1748419527505,BGRD 200,054,966184,Farley; Emma Kristen,9998,0,9999,1
1748419527505,BGRD 200,055,966187,Ferguson; Cole John,9999,0,9999,0
1748419527505,BGRD 200,056,966190,Fisch; Kathleen Marie,9999,0,9999,0
1748419527505,BGRD 200,057,966193,Gage; Fred H,9999,0,9999,0
1748419527505,BGRD 200,058,966194,George; Monique Leana,9998,0,9999,1
1748419527505,BGRD 200,059,966196,George; Olivier,9999,0,9999,0
1748419527505,BGRD 200,060,966202,Ghosh; Pradipta,9998,0,9999,1
1748419527505,BGRD 200,061,966203,Glasgow; Stacey Marie,9999,0,9999,0
1748419527505,BGRD 200,062,966204,Glass; Christopher,9999,0,9999,0
1748419527505,BGRD 200,063,966226,Golden; James W,9999,0,9999,0
1748419527505,BGRD 200,064,966231,Goldrath; Ananda,9999,0,9999,0
1748419527505,BGRD 200,065,966232,Gonzalez Gamboa; Ivonne,9999,0,9999,0
1748419527505,BGRD 200,066,966233,Goren; Alon M,9999,0,9999,0
1748419527505,BGRD 200,067,966245,Guatelli; John C,9999,0,9999,0
1748419527505,BGRD 200,068,966247,Guma; Monica,9998,0,9999,1
1748419527505,BGRD 200,069,966253,Gustafsson; Asa Birgitta,9999,0,9999,0
1748419527505,BGRD 200,070,966255,Gutkind; Jorge Silvio,9998,0,9999,1
1748419527505,BGRD 200,071,966260,Hamdoun; Amr,9999,0,9999,0
1748419527505,BGRD 200,072,966262,Hampton; Randolph Y.,9998,0,9999,1
1748419527505,BGRD 200,073,966263,Hao; Nan,9999,0,9999,0
1748419527505,BGRD 200,074,966265,Hargreaves; Diana Clare,9997,0,9999,2
1748419527505,BGRD 200,075,966268,Hasty; Jeff M,9999,0,9999,0
1748419527505,BGRD 200,076,966270,Hollern; Daniel Patrick,9999,0,9999,0
1748419527505,BGRD 200,077,966271,Holway; David A.,9998,0,9999,1
1748419527505,BGRD 200,078,966272,Huffaker; Alisa,9999,0,9999,0
1748419527505,BGRD 200,079,966273,Hui; Enfu,9999,0,9999,0
1748419527505,BGRD 200,080,966275,Hwa; Terence T.,9999,0,9999,0
1748419527505,BGRD 200,081,966276,Jackrel; Sara,9998,0,9999,1
1748419527505,BGRD 200,082,966277,Jiang; Qingfei,9998,0,9999,1
1748419527505,BGRD 200,083,966281,Jin; Chunyu,9999,0,9999,0
1748419527505,BGRD 200,084,966283,Jin; Yishi,9999,0,9999,0
1748419527505,BGRD 200,085,966287,Joshi; Shweta,9999,0,9999,0
1748419527505,BGRD 200,086,966290,Ju; Won-Kyu,9998,0,9999,1
1748419527505,BGRD 200,087,966291,Jun; Suckjoon,9999,0,9999,0
1748419527505,BGRD 200,088,966292,Kadonaga; James T,9999,0,9999,0
1748419527505,BGRD 200,089,966293,Kaech; Susan Michelle,9999,0,9999,0
1748419527505,BGRD 200,090,966295,Kauffman; Alexander,9998,0,9999,1
1748419527505,BGRD 200,091,966301,Kendrick; Agnieszka Anasta,9999,0,9999,0
1748419527505,BGRD 200,092,966302,Kiger; Amy,9999,0,9999,0
1748419527505,BGRD 200,093,966314,Knight; Robin,9999,0,9999,0
1748419527505,BGRD 200,094,966315,Koloski; Miranda Jane,9998,0,9999,1
1748419527505,BGRD 200,095,966339,Komiyama; Takaki,9998,0,9999,1
1748419527505,BGRD 200,096,966351,Kosuri; Pallav,9999,0,9999,0
1748419527505,BGRD 200,097,966361,Kronenberg; Mitchell E.,9999,0,9999,0
1748419527505,BGRD 200,098,966374,Kryazhimskiy; Sergey A,9999,0,9999,0
1748419527505,BGRD 200,099,966377,Kufareva; Irina,9999,0,9999,0
1748419527505,BGRD 200,100,966380,Lee; Christopher Tingkuang,9999,0,9999,0
1748419527505,BGRD 200,101,966383,Lee; Kuo Fen,9999,0,9999,0
1748419527505,BGRD 200,102,966387,Lee; Yun Sok,9999,0,9999,0
1748419527505,BGRD 200,103,966397,Leutgeb; Jill K.,9999,0,9999,0
1748419527505,BGRD 200,104,966446,Leutgeb; Stefan,9998,0,9999,1
1748419527505,BGRD 200,105,966478,Lewis; Warren G.,9999,0,9999,0
1748419527505,BGRD 200,106,966490,Li; Willis Xiaowei,9998,0,9999,1
1748419527505,BGRD 200,107,966491,Lim; Byungkook,9998,0,9999,1
1748419527505,BGRD 200,108,966494,Lo; Stanley M.,9998,0,9999,1
1748419527505,BGRD 200,109,966499,Looger; Loren Lee,9998,0,9999,1
1748419527505,BGRD 200,110,966500,Lopez Ramirez; Miguel Alej,9999,0,9999,0
1748419527505,BGRD 200,111,966510,Lovett-Barron; Matthew Rod,9998,0,9999,1
1748419527505,BGRD 200,112,966513,Lu; Li-Fan,9998,0,9999,1
1748419527505,BGRD 200,113,966515,Lu; Pengzhe,9999,0,9999,0
1748419527505,BGRD 200,114,966522,Lykke-Andersen; Jens,9999,0,9999,0
1748419527505,BGRD 200,115,966526,Lyons; Deirdre Colleen,9999,0,9999,0
1748419527505,BGRD 200,116,966528,Lyumkis; Dmitry Evgenievich,9999,0,9999,0
1748419527505,BGRD 200,117,966531,Mandyam; Chitra,9999,0,9999,0
1748419527505,BGRD 200,118,966537,Manor; Uri,9999,0,9999,0
1748419527505,BGRD 200,119,966538,Mayfield; Stephen P.,9998,0,9999,1
1748419527505,BGRD 200,120,966539,McConville; Patrick James,9999,0,9999,0
1748419527505,BGRD 200,121,966546,Mertens; Jerome Stefan,9999,0,9999,0
1748419527505,BGRD 200,122,966586,Meyer; Justin Raymond,9999,0,9999,0
1748419527505,BGRD 200,123,966587,Morris; Gerald P,9999,0,9999,0
1748419527505,BGRD 200,124,966588,Mueller; Lena,9998,0,9999,1
1748419527505,BGRD 200,125,966590,Muroyama; Andrew David,9999,0,9999,0
1748419527505,BGRD 200,126,966591,Murre; Cornelis,9999,0,9999,0
1748419527505,BGRD 200,127,966593,Neal; Sonya E,9998,0,9999,1
1748419527505,BGRD 200,128,966594,Newton; Alexandra C.,9999,0,9999,0
1748419527505,BGRD 200,129,966596,Nieh; James Charles,9999,0,9999,0
1748419527505,BGRD 200,130,966597,Niwa; Maho,9999,0,9999,0
1748419527505,BGRD 200,131,966605,Nizet; Victor F.,9999,0,9999,0
1748419527505,BGRD 200,132,966606,Oegema; Karen,9999,0,9999,0
1748419527505,BGRD 200,133,966608,Panda; Satchidananda,9998,0,9999,1
1748419527505,BGRD 200,134,966610,Pantham; Priyadarshini,9999,0,9999,0
1748419527505,BGRD 200,135,966612,Parast; Mana,9999,0,9999,0
1748419527505,BGRD 200,136,966613,Pasquinelli; Amy,9999,0,9999,0
1748419527505,BGRD 200,137,966615,Pekkurnaz Banghart; Gulcin,9999,0,9999,0
1748419527505,BGRD 200,138,966639,Perry; Michael William,9998,0,9999,1
1748419527505,BGRD 200,139,966640,Pillus; Lorraine,9998,0,9999,1
1748419527505,BGRD 200,140,966654,Pogliano; Joseph,9999,0,9999,0
1748419527505,BGRD 200,141,966700,Pogliano; Kit J.,9999,0,9999,0
1748419527505,BGRD 200,142,966701,Pruneda-Paz; Jose L.,9999,0,9999,0
1748419527505,BGRD 200,143,966744,Raffatellu; Manuela,9999,0,9999,0
1748419527505,BGRD 200,144,966745,Ramanan; Deepshika,9998,0,9999,1
1748419527505,BGRD 200,145,966746,Rana; Tariq,9999,0,9999,0
1748419527505,BGRD 200,146,966747,Rao; Anjana,9999,0,9999,0
1748419527505,BGRD 200,147,966811,Raz; Eyal,9998,0,9999,1
1748419527505,BGRD 200,149,966817,Gaulton; Kyle J,9999,0,9999,0
1748419527505,BGRD 200,150,966824,Rennison; Diana,9999,0,9999,0
1748419527505,BGRD 200,151,966828,Reyes De Barboza; Nabora S,9999,0,9999,0
1748419527505,BGRD 200,152,966837,Rifkin; Scott,9998,0,9999,1
1748419527505,BGRD 200,153,966839,Risbrough; Victoria Blythe,9999,0,9999,0
1748419527505,BGRD 200,154,966846,Rivera; Fabian Chavez,9999,0,9999,0
1748419527505,BGRD 200,155,966851,Rohner; Patrick Thomas,9999,0,9999,0
1748419527505,BGRD 200,156,966859,Rose; Noah Hartmann,9999,0,9999,0
1748419527505,BGRD 200,157,966874,Rosenfeld; Michael G,9999,0,9999,0
1748419527505,BGRD 200,158,966882,Rouse; Gregory W.,9999,0,9999,0
1748419527505,BGRD 200,159,966885,Saier; Milton H.,9999,0,9999,0
1748419527505,BGRD 200,160,966923,Saltiel; Alan,9998,0,9999,1
1748419527505,BGRD 200,161,966926,Sanchez-Lopez; Elsa,9999,0,9999,0
1748419527505,BGRD 200,162,966927,Saphire; Erica Ollmann,9999,0,9999,0
1748419527505,BGRD 200,163,966931,Schenk; Simon,9999,0,9999,0
1748419527505,BGRD 200,164,966938,Schroeder; Julian I,9999,0,9999,0
1748419527505,BGRD 200,165,966966,Sebat; Lilia Mikhailovna,9999,0,9999,0
1748419527505,BGRD 200,166,966978,Sen; George L,9999,0,9999,0
1748419527505,BGRD 200,167,966981,Shah; Sameer B,9999,0,9999,0
1748419527505,BGRD 200,168,966982,Shaner; Nathan C.,9999,0,9999,0
1748419527505,BGRD 200,169,966983,Shao; Jianhua,9999,0,9999,0
1748419527505,BGRD 200,170,966984,Sharpee; Tatyana,9999,0,9999,0
1748419527505,BGRD 200,171,966985,Shaw; Reuben,9999,0,9999,0
1748419527505,BGRD 200,172,966986,Shurin; Jonathan,9997,0,9999,2
1748419527505,BGRD 200,173,966987,Sicklick; Jason Keith,9999,0,9999,0
1748419527505,BGRD 200,174,966988,Signer; Robert,9999,0,9999,0
1748419527505,BGRD 200,175,966989,Sigurdson; Christina,9999,0,9999,0
1748419527505,BGRD 200,176,966991,Simonson; Tatum Sasha Summ,9999,0,9999,0
1748419527505,BGRD 200,177,966992,Soncin; Francesca,9999,0,9999,0
1748419527505,BGRD 200,178,966993,Spitzer; Nicholas,9999,0,9999,0
1748419527505,BGRD 200,179,966994,Steinmetz; Nicole F,9999,0,9999,0
1748419527505,BGRD 200,180,966995,Su; Chih-Ying,9999,0,9999,0
1748419527505,BGRD 200,181,966996,Suel; Gurol Mehmet,9998,0,9999,1
1748419527505,BGRD 200,182,966997,Sun; Xin,9998,0,9999,1
1748419527505,BGRD 200,183,966998,Telese; Francesca,9998,0,9999,1
1748419527505,BGRD 200,184,966999,Towers; Christina Garlingt,9999,0,9999,0
1748419527505,BGRD 200,185,967000,Traver; David,9999,0,9999,0
1748419527505,BGRD 200,186,967001,Troemel; Emily Ruth,9998,0,9999,1
1748419527505,BGRD 200,187,967002,Tye; Kay M,9999,0,9999,0
1748419527505,BGRD 200,188,967003,Vijayanand; Pandurangan,9999,0,9999,0
1748419527505,BGRD 200,189,967004,Villa Rodriguez; Elizabeth,9999,0,9999,0
1748419527505,BGRD 200,190,967005,Wahlin; Karl Jonas,9997,0,9999,2
1748419527505,BGRD 200,191,967009,Wang; Shizhen,9999,0,9999,0
1748419527505,BGRD 200,192,967010,Wang; Jean Yin Jen,9999,0,9999,0
1748419527505,BGRD 200,193,967011,Webster; Nicholas J G,9999,0,9999,0
1748419527505,BGRD 200,194,967016,Weiskopf; Daniela,9998,0,9999,1
1748419527505,BGRD 200,195,967020,Welsbie; Derek,9999,0,9999,0
1748419527505,BGRD 200,196,967022,Wildonger; Jill Cathleen,9998,0,9999,1
1748419527505,BGRD 200,197,967027,Winzeler; Elizabeth A,9998,0,9999,1
1748419527505,BGRD 200,198,967029,Wodarz; Dominik Franz Xave,9999,0,9999,0
1748419527505,BGRD 200,199,967033,Yelon; Deborah,9998,0,9999,1
1748419527505,BGRD 200,200,967034,Yeo; Eugene Wei-Ming,9998,0,9999,1
1748419527505,BGRD 200,201,967040,Ying; Wei,9998,0,9999,1
1748419527505,BGRD 200,202,967052,Young; Jared W.,9999,0,9999,0
1748419527505,BGRD 200,203,967057,Zage; Peter,9999,0,9999,0
1748419527505,BGRD 200,204,967070,Zengler; Karsten B,9998,0,9999,1
1748419527505,BGRD 200,206,967081,Zhang; Jin,9999,0,9999,0
1748419527505,BGRD 200,207,967083,Zhao; Yunde,9999,0,9999,0
1748419527505,BGRD 200,208,967086,Zheng; Binhai,9999,0,9999,0
1748419527505,BGRD 200,209,967091,Zheng; Ye,9999,0,9999,0
1748419527505,BGRD 200,210,967093,Zhou; Huilin,9999,0,9999,0
1748419527505,BGRD 200,211,967095,Zou; Yimin,9998,0,9999,1
1748419527505,BGRD 200,212,967096,Zuniga; Elina I,9999,0,9999,0
1748419527505,BGRD 200,213,967978,Biering; Scott,9999,0,9999,0
1748419528531,BGSE 200,A00,943418,Tour; Ella & Petrie; Katherine Lynn,9999,0,9999,0
1748419529568,BGSE 205,A00,943419,Muroyama; Andrew David,46,0,50,4
1748419529568,BGSE 205,C00,943420,Russell; Alistair B,44,0,50,6
1748419529568,BGSE 205,D00,943421,Villa Rodriguez; Elizabeth,41,0,50,9
1748419529568,BGSE 205,E00,960271,Lim; Byungkook,45,0,50,5
1748419530607,BIBC 100,A01,959758,Flagg; Matthew Paul,0,0,38,38
1748419530607,BIBC 100,A02,959759,Flagg; Matthew Paul,0,0,38,38
1748419530607,BIBC 100,A03,959760,Flagg; Matthew Paul,0,0,38,38
1748419530607,BIBC 100,A04,959761,Flagg; Matthew Paul,0,0,36,36
1748419531642,BIBC 102,A01,959209,Pekkurnaz Banghart; Gulcin,0,0,34,34
1748419531642,BIBC 102,A02,959258,Pekkurnaz Banghart; Gulcin,0,0,34,34
1748419531642,BIBC 102,A03,959300,Pekkurnaz Banghart; Gulcin,0,0,35,35
1748419531642,BIBC 102,A04,959302,Pekkurnaz Banghart; Gulcin,0,0,34,34
1748419531642,BIBC 102,B01,959307,Pekkurnaz Banghart; Gulcin,0,0,34,34
1748419531642,BIBC 102,B02,959309,Pekkurnaz Banghart; Gulcin,0,0,34,34
1748419531642,BIBC 102,B03,959310,Pekkurnaz Banghart; Gulcin,0,0,33,33
1748419531642,BIBC 102,B04,959311,Pekkurnaz Banghart; Gulcin,0,0,34,34
1748419532673,BIBC 103,A01,942080,Grossman; Emily N,0,0,24,24
1748419532673,BIBC 103,A02,942081,Grossman; Emily N,0,0,24,24
1748419532673,BIBC 103,B01,942083,Grossman; Emily N,0,0,24,24
1748419532673,BIBC 103,B02,942129,Grossman; Emily N,0,0,24,24
1748419532673,BIBC 103,C01,942131,Burg; Michael,0,0,24,24
1748419532673,BIBC 103,C02,942152,Burg; Michael,0,0,24,24
1748419532673,BIBC 103,D01,942169,Burg; Michael,0,0,24,24
1748419532673,BIBC 103,D02,942170,Burg; Michael,0,0,24,24
1748419533713,BICD 100,A01,959831,Day; Christopher D,53,0,61,8
1748419533713,BICD 100,A02,959832,Day; Christopher D,49,0,61,12
1748419533713,BICD 100,A03,959833,Day; Christopher D,43,0,61,18
1748419533713,BICD 100,A04,959834,Day; Christopher D,58,0,61,3
1748419533713,BICD 100,B01,959749,McDonnell; Lisa Marie,0,0,61,61
1748419533713,BICD 100,B02,959750,McDonnell; Lisa Marie,0,0,61,61
1748419533713,BICD 100,B03,959751,McDonnell; Lisa Marie,0,0,61,61
1748419533713,BICD 100,B04,959752,McDonnell; Lisa Marie,37,0,61,24
1748419533713,BICD 100,C01,959835,Yelon; Deborah,0,0,61,61
1748419533713,BICD 100,C02,959836,Yelon; Deborah,54,0,61,7
1748419533713,BICD 100,C03,959837,Yelon; Deborah,61,0,61,0
1748419533713,BICD 100,C04,959838,Yelon; Deborah,57,0,61,4
1748419534740,BICD 110,A01,959312,Kiger; Amy,60,0,123,63
1748419534740,BICD 110,A02,959315,Kiger; Amy,94,0,122,28
1748419535770,BICD 130,A01,942207,Perry; Michael William,0,0,48,48
1748419535770,BICD 130,A02,942208,Perry; Michael William,37,0,48,11
1748419535770,BICD 130,A03,942209,Perry; Michael William,29,0,48,19
1748419535770,BICD 130,A04,942236,Perry; Michael William,19,0,48,29
1748419536856,BICD 140,A01,942372,Zuniga; Elina I,42,0,49,7
1748419536856,BICD 140,A02,942492,Zuniga; Elina I,45,0,49,4
1748419536856,BICD 140,A03,942493,Zuniga; Elina I,48,0,49,1
1748419536856,BICD 140,A04,942494,Zuniga; Elina I,46,0,49,3
1748419537887,BIEB 102,A01,942496,Butler; Shannon Rhey,182,0,248,66
1748419538914,BIEB 121,A00,942497,Holway; David A.,0,0,32,32
1748419538914,BIEB 121,B00,942498,Butler; Shannon Rhey,0,0,32,32
1748419539945,BIEB 141,A01,942500,Kryazhimskiy; Sergey A,23,0,40,17
1748419540972,BIEB 146,A01,942502,Petrie; Katherine Lynn,41,0,89,48
1748419540972,BIEB 146,A02,942503,Petrie; Katherine Lynn,0,0,88,88
1748419540972,BIEB 146,A03,942504,Petrie; Katherine Lynn,2,0,88,86
1748419540972,BIEB 146,A04,942505,Petrie; Katherine Lynn,21,0,89,68
1748419541999,BIEB 150,A01,942507,Rennison; Diana,28,0,41,13
1748419541999,BIEB 150,A02,942508,Rennison; Diana,32,0,41,9
1748419541999,BIEB 150,A03,942509,Rennison; Diana,36,0,41,5
1748419541999,BIEB 150,A04,942510,Rennison; Diana,6,0,40,34
1748419543028,BIEB 174,A01,942512,Cleland; Elsa Eleanor & Barton; Andrew David,9,0,41,32
1748419543028,BIEB 174,A02,942513,Cleland; Elsa Eleanor & Barton; Andrew David,37,0,41,4
1748419543028,BIEB 174,A03,942514,Cleland; Elsa Eleanor & Barton; Andrew David,35,0,41,6
1748419543028,BIEB 174,A04,942515,Cleland; Elsa Eleanor & Barton; Andrew David,30,0,40,10
1748419544059,BILD 1,A01,959729,Ochoa Mikrut; Stacy Daniel,50,0,60,10
1748419544059,BILD 1,A02,959730,Ochoa Mikrut; Stacy Daniel,48,0,59,11
1748419544059,BILD 1,A03,959731,Ochoa Mikrut; Stacy Daniel,48,0,59,11
1748419544059,BILD 1,A04,959732,Ochoa Mikrut; Stacy Daniel,50,0,59,9
1748419544059,BILD 1,B01,959733,Cooper; Andrew Michael,46,0,60,14
1748419544059,BILD 1,B02,959734,Cooper; Andrew Michael,58,0,59,1
1748419544059,BILD 1,B03,959735,Cooper; Andrew Michael,54,0,59,5
1748419544059,BILD 1,B04,959736,Cooper; Andrew Michael,50,0,59,9
1748419544059,BILD 1,C01,959737,Rusert; Jessica Marie,58,0,60,2
1748419544059,BILD 1,C02,959738,Rusert; Jessica Marie,59,0,59,0
1748419544059,BILD 1,C03,959739,Rusert; Jessica Marie,49,0,59,10
1748419544059,BILD 1,C04,959740,Rusert; Jessica Marie,55,0,59,4
1748419545098,BILD 2,A01,959013,Reyes Gonzalez; Catalina,28,0,57,29
1748419545098,BILD 2,A02,959016,Reyes Gonzalez; Catalina,51,0,57,6
1748419545098,BILD 2,A03,959017,Reyes Gonzalez; Catalina,46,0,56,10
1748419545098,BILD 2,A04,959018,Reyes Gonzalez; Catalina,51,0,55,4
1748419545098,BILD 2,B01,959078,Reyes Gonzalez; Catalina,42,0,57,15
1748419545098,BILD 2,B02,959095,Reyes Gonzalez; Catalina,50,0,57,7
1748419545098,BILD 2,B03,959165,Reyes Gonzalez; Catalina,55,0,56,1
1748419545098,BILD 2,B04,959169,Reyes Gonzalez; Catalina,54,0,55,1
1748419546129,BILD 3,A01,959741,Stockwell; Sarah R,56,0,60,4
1748419546129,BILD 3,A02,959742,Stockwell; Sarah R,57,0,59,2
1748419546129,BILD 3,A03,959743,Stockwell; Sarah R,59,0,59,0
1748419546129,BILD 3,A04,959744,Stockwell; Sarah R,55,0,59,4
1748419546129,BILD 3,B01,959745,Stockwell; Sarah R,55,0,60,5
1748419546129,BILD 3,B02,959746,Stockwell; Sarah R,59,0,59,0
1748419546129,BILD 3,B03,959747,Stockwell; Sarah R,56,0,59,3
1748419546129,BILD 3,B04,959748,Stockwell; Sarah R,58,0,59,1
1748419546129,BILD 3,C01,959823,Hammond; LaTisha Marie,47,0,60,13
1748419546129,BILD 3,C02,959824,Hammond; LaTisha Marie,48,0,59,11
1748419546129,BILD 3,C03,959825,Hammond; LaTisha Marie,56,0,59,3
1748419546129,BILD 3,C04,959826,Hammond; LaTisha Marie,58,0,59,1
1748419546129,BILD 3,D01,959827,Hammond; LaTisha Marie,43,0,60,17
1748419546129,BILD 3,D02,959828,Hammond; LaTisha Marie,49,0,59,10
1748419546129,BILD 3,D03,959829,Hammond; LaTisha Marie,52,0,59,7
1748419546129,BILD 3,D04,959830,Hammond; LaTisha Marie,56,0,59,3
1748419547181,BILD 4,A01,940749,Gonzalez Gamboa; Ivonne,0,0,0,0
1748419547181,BILD 4,A02,940750,Gonzalez Gamboa; Ivonne,0,0,0,0
1748419547181,BILD 4,A03,940909,Gonzalez Gamboa; Ivonne,0,0,0,0
1748419547181,BILD 4,A04,940922,Gonzalez Gamboa; Ivonne,0,0,0,0
1748419547181,BILD 4,A05,940925,Gonzalez Gamboa; Ivonne,0,0,0,0
1748419547181,BILD 4,A06,941008,Gonzalez Gamboa; Ivonne,0,0,0,0
1748419547181,BILD 4,A07,941009,Gonzalez Gamboa; Ivonne,0,0,0,0
1748419547181,BILD 4,A08,941114,Gonzalez Gamboa; Ivonne,0,0,0,0
1748419547181,BILD 4,B01,941116,Reuther; Keefe,0,0,0,0
1748419547181,BILD 4,B02,941119,Reuther; Keefe,0,0,0,0
1748419547181,BILD 4,B03,941120,Reuther; Keefe,0,0,0,0
1748419547181,BILD 4,B04,941143,Reuther; Keefe,0,0,0,0
1748419547181,BILD 4,B05,941182,Reuther; Keefe,0,0,0,0
1748419547181,BILD 4,B06,941183,Reuther; Keefe,0,0,0,0
1748419547181,BILD 4,B07,941184,Reuther; Keefe,0,0,0,0
1748419547181,BILD 4,B08,941202,Reuther; Keefe,0,0,0,0
1748419547181,BILD 4,C01,941209,Lo; Stanley M.,0,0,0,0
1748419547181,BILD 4,C02,941226,Lo; Stanley M.,0,0,0,0
1748419547181,BILD 4,C03,941228,Lo; Stanley M.,0,0,0,0
1748419547181,BILD 4,C04,941284,Lo; Stanley M.,0,0,0,0
1748419547181,BILD 4,C05,941394,Lo; Stanley M.,0,0,0,0
1748419547181,BILD 4,C06,941473,Lo; Stanley M.,0,0,0,0
1748419547181,BILD 4,C07,941905,Lo; Stanley M.,0,0,0,0
1748419547181,BILD 4,C08,941906,Lo; Stanley M.,0,0,0,0
1748419547181,BILD 4,D01,941908,Lo; Stanley M.,0,0,0,0
1748419547181,BILD 4,D02,941925,Lo; Stanley M.,0,0,0,0
1748419547181,BILD 4,D03,941926,Lo; Stanley M.,0,0,0,0
1748419547181,BILD 4,D04,941927,Lo; Stanley M.,0,0,0,0
1748419547181,BILD 4,D05,941928,Lo; Stanley M.,0,0,0,0
1748419547181,BILD 4,D06,941943,Lo; Stanley M.,0,0,0,0
1748419547181,BILD 4,D07,941944,Lo; Stanley M.,0,0,0,0
1748419547181,BILD 4,D08,941973,Lo; Stanley M.,0,0,0,0
1748419548274,BILD 5,A01,959177,Mueller; Liam O'Connor,0,0,0,0
1748419548274,BILD 5,A02,959178,Mueller; Liam O'Connor,0,0,0,0
1748419548274,BILD 5,A03,959179,Mueller; Liam O'Connor,0,0,0,0
1748419548274,BILD 5,A04,959181,Mueller; Liam O'Connor,0,0,0,0
1748419548274,BILD 5,B01,959183,Mueller; Liam O'Connor,0,0,0,0
1748419548274,BILD 5,B02,959184,Mueller; Liam O'Connor,0,0,0,0
1748419548274,BILD 5,B03,959188,Mueller; Liam O'Connor,0,0,0,0
1748419548274,BILD 5,B04,959189,Mueller; Liam O'Connor,0,0,0,0
1748419548274,BILD 5,C01,959190,Reuther; Keefe,0,0,0,0
1748419548274,BILD 5,C02,959191,Reuther; Keefe,0,0,0,0
1748419548274,BILD 5,C03,959196,Reuther; Keefe,0,0,0,0
1748419548274,BILD 5,C04,959199,Reuther; Keefe,0,0,0,0
1748419549303,BILD 10,A01,942020,Ochoa Mikrut; Stacy Daniel,40,0,40,0
1748419549303,BILD 10,A02,942033,Ochoa Mikrut; Stacy Daniel,35,0,39,4
1748419549303,BILD 10,A03,942045,Ochoa Mikrut; Stacy Daniel,32,0,39,7
1748419549303,BILD 10,A04,942046,Ochoa Mikrut; Stacy Daniel,30,0,39,9
1748419550333,BILD 87,A00,942047,Saier; Milton H.,20,0,20,0
1748419550333,BILD 87,B00,942060,Saier; Milton H.,20,0,20,0
1748419551366,BIMM 100,A01,959797,Lykke-Andersen; Jens,37,0,50,13
1748419551366,BIMM 100,A02,959798,Lykke-Andersen; Jens,5,0,50,45
1748419551366,BIMM 100,A03,959799,Lykke-Andersen; Jens,0,0,50,50
1748419551366,BIMM 100,A04,959800,Lykke-Andersen; Jens,3,0,50,47
1748419551366,BIMM 100,B01,959807,Pruneda-Paz; Jose L.,1,0,50,49
1748419551366,BIMM 100,B02,959808,Pruneda-Paz; Jose L.,0,0,50,50
1748419551366,BIMM 100,B03,959809,Pruneda-Paz; Jose L.,8,0,50,42
1748419551366,BIMM 100,B04,959810,Pruneda-Paz; Jose L.,37,0,50,13
1748419551366,BIMM 100,C01,959762,Pasquinelli; Amy,0,0,54,54
1748419551366,BIMM 100,C02,959763,Pasquinelli; Amy,20,0,54,34
1748419551366,BIMM 100,C03,959764,Pasquinelli; Amy,31,0,54,23
1748419551366,BIMM 100,C04,959765,Pasquinelli; Amy,47,0,54,7
1748419552404,BIMM 101,A01,942520,Meaders; Clara Leigh,0,0,24,24
1748419552404,BIMM 101,A02,942521,Meaders; Clara Leigh,0,0,24,24
1748419552404,BIMM 101,B01,942523,Meaders; Clara Leigh,0,0,24,24
1748419552404,BIMM 101,B02,942524,Meaders; Clara Leigh,0,0,24,24
1748419552404,BIMM 101,C01,942690,McDonnell; Lisa Marie,0,0,24,24
1748419552404,BIMM 101,C02,942755,McDonnell; Lisa Marie,0,0,24,24
1748419552404,BIMM 101,D01,942757,Day; Christopher D,0,0,24,24
1748419552404,BIMM 101,D02,942758,Day; Christopher D,12,0,24,12
1748419552404,BIMM 101,E01,942760,Cooper; Andrew Michael,0,0,24,24
1748419552404,BIMM 101,E02,942761,Cooper; Andrew Michael,0,0,24,24
1748419552404,BIMM 101,F01,942763,Rusert; Jessica Marie,14,0,24,10
1748419552404,BIMM 101,F02,942764,Rusert; Jessica Marie,19,0,24,5
1748419553430,BIMM 120,A01,942766,Saier; Milton H.,40,0,48,8
1748419553430,BIMM 120,A02,942767,Saier; Milton H.,40,0,48,8
1748419553430,BIMM 120,A03,942768,Saier; Milton H.,15,0,48,33
1748419553430,BIMM 120,A04,942769,Saier; Milton H.,0,0,48,48
1748419554459,BIMM 121,A01,942771,Gustafson-Brown; Cindy,0,0,24,24
1748419554459,BIMM 121,A02,942772,Gustafson-Brown; Cindy,0,0,24,24
1748419554459,BIMM 121,B01,942774,Gustafson-Brown; Cindy,1,0,24,23
1748419554459,BIMM 121,B02,942775,Gustafson-Brown; Cindy,5,0,24,19
1748419554459,BIMM 121,C01,942777,Pirino; Giorgia,0,0,24,24
1748419554459,BIMM 121,C02,942778,Pirino; Giorgia,0,0,24,24
1748419554459,BIMM 121,D01,942780,Pirino; Giorgia,0,0,24,24
1748419554459,BIMM 121,D02,942781,Pirino; Giorgia,0,0,24,24
1748419555488,BIMM 122,A01,942783,Russell; Alistair B,19,0,44,25
1748419555488,BIMM 122,A02,942784,Russell; Alistair B,29,0,44,15
1748419555488,BIMM 122,A03,942785,Russell; Alistair B,35,0,44,9
1748419555488,BIMM 122,A04,942786,Russell; Alistair B,30,0,44,14
1748419556516,BIMM 128,A01,942788,Hao; Nan,0,0,30,30
1748419556516,BIMM 128,A02,942789,Hao; Nan,0,0,31,31
1748419556516,BIMM 128,A03,942790,Hao; Nan,0,0,31,31
1748419556516,BIMM 128,A04,942791,Hao; Nan,0,0,31,31
1748419557544,BIMM 143,A01,942793,Grant; Barry J,13,0,40,27
1748419557544,BIMM 143,B01,942795,Bozinovic; Goran,21,0,40,19
1748419558572,BIMM 143R,A01,942797,Bozinovic; Goran,0,0,40,40
1748419559600,BIMM 194,A00,942798,Golden; Susan S.,5,0,32,27
1748419559600,BIMM 194,B00,942799,Golden; James W,21,0,32,11
1748419559600,BIMM 194,C00,942800,Karlseder; Jan & Saghatelian; Alan,0,0,32,32
1748419560632,BIOM 200A,A00,911746,Gordts; Philip,30,0,30,0
1748419561663,BIOM 200B,A00,911747,Gordts; Philip,35,0,35,0
1748419562693,BIOM 201,A00,911749,Daneman; Richard,35,0,35,0
1748419563722,BIOM 202,A01,911753,Corbett; Kevin Daniel,35,0,35,0
1748419564750,BIOM 203A,A00,911755,Corbett; Kevin Daniel,35,0,35,0
1748419565780,BIOM 218,A00,911756,Gagneux; Pascal,11,0,12,1
1748419566810,BIOM 219,A00,911757,Ross; Camille,20,0,20,0
1748419567836,BIOM 242,A00,911758,Hamilton; Bruce Alan,19,0,20,1
1748419568866,BIOM 293,A00,911759,Gustafsson; Asa Birgitta,35,0,35,0
1748419569898,BIOM 295,A00,911760,Joiner; William J.,0,0,0,0
1748419570929,BIOM 296,A00,911761,Yaksh; Tony L.,35,0,35,0
1748419571965,BIPN 100,A01,959801,Leutgeb; Stefan,0,0,36,36
1748419571965,BIPN 100,A02,959802,Leutgeb; Stefan,0,0,36,36
1748419571965,BIPN 100,A03,959803,Leutgeb; Stefan,3,0,36,33
1748419571965,BIPN 100,A04,959804,Leutgeb; Stefan,0,0,36,36
1748419571965,BIPN 100,B01,959766,Cooke; James Edward,33,0,41,8
1748419571965,BIPN 100,B02,959767,Cooke; James Edward,39,0,41,2
1748419571965,BIPN 100,B03,959768,Cooke; James Edward,37,0,40,3
1748419571965,BIPN 100,B04,959769,Cooke; James Edward,37,0,40,3
1748419571965,BIPN 100,C01,959770,Cooke; James Edward,35,0,41,6
1748419571965,BIPN 100,C02,959771,Cooke; James Edward,40,0,41,1
1748419571965,BIPN 100,C03,959772,Cooke; James Edward,37,0,40,3
1748419571965,BIPN 100,C04,959773,Cooke; James Edward,38,0,40,2
1748419571965,BIPN 100,D01,959811,Yang; Mingyu,0,0,41,41
1748419571965,BIPN 100,D02,959812,Yang; Mingyu,0,0,41,41
1748419571965,BIPN 100,D03,959813,Yang; Mingyu,0,0,40,40
1748419571965,BIPN 100,D04,959814,Yang; Mingyu,0,0,40,40
1748419572993,BIPN 103,A01,942981,Yang; Mingyu,0,0,48,48
1748419574022,BIPN 105,A01,942983,Armour; Jon Christopher,0,0,21,21
1748419574022,BIPN 105,A02,942984,Armour; Jon Christopher,0,0,21,21
1748419574022,BIPN 105,B01,942989,Armour; Jon Christopher,0,0,21,21
1748419574022,BIPN 105,B02,942990,Armour; Jon Christopher,0,0,21,21
1748419575057,BIPN 118,A01,960886,Banghart; Matthew Ryan,23,0,30,7
1748419575057,BIPN 118,A02,960889,Banghart; Matthew Ryan,24,0,30,6
1748419575057,BIPN 118,A03,960891,Banghart; Matthew Ryan,23,0,30,7
1748419575057,BIPN 118,A04,960892,Banghart; Matthew Ryan,27,0,30,3
1748419576092,BIPN 140,A01,942992,Owens; Melinda Tsao-Ying,9,0,32,23
1748419576092,BIPN 140,A02,942994,Owens; Melinda Tsao-Ying,0,0,32,32
1748419576092,BIPN 140,A03,942995,Owens; Melinda Tsao-Ying,1,0,32,31
1748419576092,BIPN 140,A04,942996,Owens; Melinda Tsao-Ying,9,0,30,21
1748419576092,BIPN 140,B01,942998,Owens; Melinda Tsao-Ying,4,0,32,28
1748419576092,BIPN 140,B02,942999,Owens; Melinda Tsao-Ying,3,0,32,29
1748419576092,BIPN 140,B03,943000,Owens; Melinda Tsao-Ying,18,0,32,14
1748419576092,BIPN 140,B04,943001,Owens; Melinda Tsao-Ying,23,0,30,7
1748419577128,BIPN 145,A01,943083,Maita; Isabella Vincenza,0,0,42,42
1748419577128,BIPN 145,B01,943085,Marino; Marc J,13,0,42,29
1748419577128,BIPN 145,C01,943108,Marino; Marc J,0,0,42,42
1748419578156,BIPN 148,A01,943119,Leutgeb; Jill K.,15,0,39,24
1748419578156,BIPN 148,A02,943120,Leutgeb; Jill K.,16,0,39,23
1748419578156,BIPN 148,A03,943121,Leutgeb; Jill K.,33,0,39,6
1748419578156,BIPN 148,A04,943201,Leutgeb; Jill K.,27,0,39,12
1748419579184,BIPN 189,A00,943247,Gentner; Tim,0,0,25,25
1748419580210,BISP 182,A00,943255,Pogliano; Joseph,9999,0,9999,0
1748419581240,BISP 194,A00,943261,Wertheim; Joel Okrent,0,0,32,32
1748419582269,BNFO 281,A00,961454,Gaasterland; Theresa,13,0,40,27
1748419583296,BNFO 283,A00,961457,Benner; Christopher William,69,0,100,31
1748419584323,BNFO 294,A01,961499,Ross; Camille,39,0,50,11
1748419585371,CAT 1,A01,915666,Bronstein; Phoebe Malan,13,0,16,3
1748419585371,CAT 1,A02,915673,Bronstein; Phoebe Malan,15,0,16,1
1748419585371,CAT 1,A03,915727,Bronstein; Phoebe Malan,16,0,16,0
1748419585371,CAT 1,A04,915728,Bronstein; Phoebe Malan,16,0,16,0
1748419585371,CAT 1,A05,915729,Bronstein; Phoebe Malan,16,0,16,0
1748419585371,CAT 1,A06,915730,Bronstein; Phoebe Malan,13,0,16,3
1748419585371,CAT 1,A07,915731,Bronstein; Phoebe Malan,16,0,16,0
1748419585371,CAT 1,A08,915732,Bronstein; Phoebe Malan,16,0,16,0
1748419585371,CAT 1,A09,915733,Bronstein; Phoebe Malan,14,0,16,2
1748419585371,CAT 1,A10,915734,Bronstein; Phoebe Malan,16,0,16,0
1748419585371,CAT 1,A11,915751,Bronstein; Phoebe Malan,16,0,16,0
1748419585371,CAT 1,A12,915752,Bronstein; Phoebe Malan,15,0,16,1
1748419585371,CAT 1,A13,915753,Bronstein; Phoebe Malan,15,0,16,1
1748419585371,CAT 1,A14,915754,Bronstein; Phoebe Malan,16,0,16,0
1748419585371,CAT 1,A15,915755,Bronstein; Phoebe Malan,16,0,16,0
1748419585371,CAT 1,A16,915756,Bronstein; Phoebe Malan,16,0,16,0
1748419585371,CAT 1,B01,915763,Bronstein; Phoebe Malan,15,0,16,1
1748419585371,CAT 1,B02,915764,Bronstein; Phoebe Malan,15,0,16,1
1748419585371,CAT 1,B03,915765,Bronstein; Phoebe Malan,14,0,16,2
1748419585371,CAT 1,B04,915766,Bronstein; Phoebe Malan,16,0,16,0
1748419585371,CAT 1,B05,915767,Bronstein; Phoebe Malan,12,0,16,4
1748419585371,CAT 1,B06,915768,Bronstein; Phoebe Malan,16,0,16,0
1748419585371,CAT 1,B07,915769,Bronstein; Phoebe Malan,16,0,16,0
1748419585371,CAT 1,B08,915770,Bronstein; Phoebe Malan,16,0,16,0
1748419585371,CAT 1,B09,915771,Bronstein; Phoebe Malan,16,0,16,0
1748419585371,CAT 1,B10,915772,Bronstein; Phoebe Malan,16,0,16,0
1748419585371,CAT 1,B11,915773,Bronstein; Phoebe Malan,16,0,16,0
1748419585371,CAT 1,B12,915774,Bronstein; Phoebe Malan,15,0,16,1
1748419585371,CAT 1,B13,915775,Bronstein; Phoebe Malan,16,0,16,0
1748419585371,CAT 1,B14,915776,Bronstein; Phoebe Malan,15,0,16,1
1748419585371,CAT 1,B15,915777,Bronstein; Phoebe Malan,14,0,16,2
1748419585371,CAT 1,B16,915778,Bronstein; Phoebe Malan,16,0,16,0
1748419585371,CAT 1,C01,915780,Algaze; Guillermo,11,0,16,5
1748419585371,CAT 1,C02,915781,Algaze; Guillermo,16,0,16,0
1748419585371,CAT 1,C03,915782,Algaze; Guillermo,15,0,16,1
1748419585371,CAT 1,C04,915783,Algaze; Guillermo,16,0,16,0
1748419585371,CAT 1,C05,915784,Algaze; Guillermo,16,0,16,0
1748419585371,CAT 1,C06,915785,Algaze; Guillermo,16,0,16,0
1748419585371,CAT 1,C07,915786,Algaze; Guillermo,16,0,16,0
1748419585371,CAT 1,C08,915787,Algaze; Guillermo,15,0,16,1
1748419585371,CAT 1,C09,915788,Algaze; Guillermo,16,0,16,0
1748419585371,CAT 1,C10,915790,Algaze; Guillermo,16,0,16,0
1748419585371,CAT 1,C11,915791,Algaze; Guillermo,16,0,16,0
1748419585371,CAT 1,C12,915792,Algaze; Guillermo,16,0,16,0
1748419585371,CAT 1,C13,915793,Algaze; Guillermo,16,0,16,0
1748419585371,CAT 1,C14,915794,Algaze; Guillermo,16,0,16,0
1748419585371,CAT 1,D01,915796,Marchisotto; Jennifer Anne,16,0,16,0
1748419585371,CAT 1,D02,915797,Marchisotto; Jennifer Anne,15,0,16,1
1748419585371,CAT 1,D03,915798,Marchisotto; Jennifer Anne,16,0,16,0
1748419585371,CAT 1,D04,915799,Marchisotto; Jennifer Anne,12,0,16,4
1748419585371,CAT 1,D05,915800,Marchisotto; Jennifer Anne,16,0,16,0
1748419585371,CAT 1,D06,915801,Marchisotto; Jennifer Anne,16,0,16,0
1748419585371,CAT 1,D07,915802,Marchisotto; Jennifer Anne,15,0,16,1
1748419585371,CAT 1,D08,915803,Marchisotto; Jennifer Anne,16,0,16,0
1748419585371,CAT 1,D09,915804,Marchisotto; Jennifer Anne,16,0,16,0
1748419585371,CAT 1,D10,915805,Marchisotto; Jennifer Anne,16,0,16,0
1748419585371,CAT 1,D11,915806,Marchisotto; Jennifer Anne,15,0,16,1
1748419585371,CAT 1,D12,915807,Marchisotto; Jennifer Anne,16,0,16,0
1748419585371,CAT 1,D13,915808,Marchisotto; Jennifer Anne,15,0,16,1
1748419585371,CAT 1,D14,915809,Marchisotto; Jennifer Anne,15,0,16,1
1748419586397,CAT 88,A00,969796,Popko; Elizabeth Ashley,0,0,0,0
1748419587423,CAT 90,A00,915812,Geibel; William,7,0,15,8
1748419588457,CAT 124,A01,915814,Rose; Becca Rae,0,0,20,20
1748419588457,CAT 124,B01,961453,Geibel; William,14,0,20,6
1748419589496,CAT 125,001,915815,Delaville; Romain,18,0,20,2
1748419589496,CAT 125,003,915817,Bigham; David Joseph,12,0,20,8
1748419589496,CAT 125,004,915818,Bigham; David Joseph,3,0,20,17
1748419589496,CAT 125,005,915819,Marchisotto; Jennifer Anne,11,0,20,9
1748419589496,CAT 125,006,915820,Marchisotto; Jennifer Anne,0,0,20,20
1748419589496,CAT 125,007,915821,Morales; Celeste Georgianna,12,0,20,8
1748419589496,CAT 125,008,915822,Morales; Celeste Georgianna,15,0,20,5
1748419589496,CAT 125,009,915823,Morales; Celeste Georgianna,18,0,20,2
1748419589496,CAT 125,010,915824,Irwin; Matthew Joseph,18,0,20,2
1748419589496,CAT 125,011,915825,Irwin; Matthew Joseph,15,0,20,5
1748419589496,CAT 125,012,915826,Irwin; Matthew Joseph,15,0,20,5
1748419589496,CAT 125,013,915827,Vanderschuit; Maya Alysia,16,0,20,4
1748419589496,CAT 125,014,915828,Vanderschuit; Maya Alysia,18,0,20,2
1748419589496,CAT 125,015,915829,Vanderschuit; Maya Alysia,15,0,20,5
1748419589496,CAT 125,016,915830,Rose; Becca Rae,5,0,20,15
1748419589496,CAT 125,017,915831,Rose; Becca Rae,4,0,20,16
1748419589496,CAT 125,018,915832,Hyland; Tina Mae,13,0,20,7
1748419589496,CAT 125,019,915833,Hyland; Tina Mae,17,0,20,3
1748419590524,CAT 125R,A00,915834,Hyland; Tina Mae,0,0,20,20
1748419590524,CAT 125R,B00,915835,Hyland; Tina Mae,0,0,20,20
1748419590524,CAT 125R,C00,915836,Hyland; Tina Mae,0,0,20,20
1748419590524,CAT 125R,D00,915837,Tosun; Adriana,0,0,20,20
1748419590524,CAT 125R,E00,915838,Smith; Lauryn Alissa,0,0,20,20
1748419590524,CAT 125R,F00,915839,Smith; Lauryn Alissa,0,0,20,20
1748419590524,CAT 125R,G00,915840,Smith; Lauryn Alissa,0,0,20,20
1748419591552,CAT 200,A00,915841,Popko; Elizabeth Ashley,17,0,20,3
1748419592580,CCE 1,A00,915063,Bigley; Michele Heather,30,0,40,10
1748419592580,CCE 1,B00,915064,Bigley; Michele Heather,36,0,40,4
1748419593620,CCE 2,001,915067,Santos; Vabianna Daria,0,0,20,20
1748419593620,CCE 2,002,915068,Santos; Vabianna Daria,0,0,20,20
1748419593620,CCE 2,003,915069,Santos; Vabianna Daria,18,0,20,2
1748419593620,CCE 2,004,915070,Staff,17,0,20,3
1748419593620,CCE 2,005,915071,Staff,15,0,20,5
1748419593620,CCE 2,006,915072,Staff,8,0,20,12
1748419593620,CCE 2,007,915073,Staff,10,0,20,10
1748419593620,CCE 2,008,915074,Staff,0,0,20,20
1748419593620,CCE 2,009,915090,Staff,5,0,20,15
1748419593620,CCE 2,010,915104,Merryman; Ashley,0,0,20,20
1748419593620,CCE 2,011,915114,Merryman; Ashley,0,0,20,20
1748419593620,CCE 2,012,915136,Merryman; Ashley,0,0,20,20
1748419593620,CCE 2,013,915176,Staff,13,0,20,7
1748419593620,CCE 2,014,915177,Staff,20,0,20,0
1748419593620,CCE 2,015,915178,Staff,17,0,20,3
1748419593620,CCE 2,016,915179,Staff,16,0,20,4
1748419594659,CCE 3,001,915194,Labat Ii; Michael Luis,13,0,20,7
1748419594659,CCE 3,002,915195,Labat Ii; Michael Luis,17,0,20,3
1748419594659,CCE 3,003,915196,Labat Ii; Michael Luis,17,0,20,3
1748419594659,CCE 3,004,915197,Lee; Kassandra,16,0,20,4
1748419594659,CCE 3,005,915198,Lee; Kassandra,6,0,20,14
1748419594659,CCE 3,006,915199,Lee; Kassandra,10,0,20,10
1748419594659,CCE 3,007,915200,Garcia; Kathryn Mary,0,0,20,20
1748419594659,CCE 3,008,915201,Garcia; Kathryn Mary,2,0,20,18
1748419595691,CCE 120,A01,915203,Quijada; David,26,0,30,4
1748419595691,CCE 120,B01,915205,Quijada; David,17,0,30,13
1748419595691,CCE 120,C01,915207,Williams; Danielle,21,0,30,9
1748419595691,CCE 120,D01,915275,Crawford; James,26,0,30,4
1748419595691,CCE 120,E01,915323,Kenley; Nicole,0,0,30,30
1748419595691,CCE 120,F01,915325,Kenley; Nicole,5,0,30,25
1748419596719,CENG 4,A01,913054,Li; Yanran,35,0,36,1
1748419596719,CENG 4,A02,913055,Li; Yanran,36,0,36,0
1748419596719,CENG 4,A03,913058,Li; Yanran,36,0,36,0
1748419596719,CENG 4,A04,913060,Li; Yanran,36,0,36,0
1748419597746,CENG 15,A01,913087,Lubarda; Vlado,69,0,70,1
1748419598773,CENG 100,A00,913088,Powell; Alyssa,108,0,120,12
1748419599802,CENG 101A,A00,913089,Opatkiewicz; Justin Paul,107,0,146,39
1748419600829,CENG 110,A01,913091,Powell; Alyssa,15,0,24,9
1748419601856,CENG 120,A00,913092,Opatkiewicz; Justin Paul,96,0,146,50
1748419602890,CENG 122,A00,913093,Li; Wan-Lu,120,0,140,20
1748419603916,CENG 170,A01,913196,Drews; Aaron,7,0,25,18
1748419603916,CENG 170,A02,913202,Drews; Aaron,4,0,25,21
1748419603916,CENG 170,A03,913204,Drews; Aaron,5,0,30,25
1748419604944,CENG 175,A00,913205,Steinmetz; Nicole F,14,0,35,21
1748419605971,CENG 205,A00,913207,Jahed Motlagh; Zeinab,54,0,70,16
1748419607002,CENG 210A,A00,913209,Shah; Nisarg,50,0,50,0
1748419608030,CENG 211,A00,913211,Sirbuly; Donald,23,0,25,2
1748419609058,CENG 213,A00,913213,Fenning; David,25,0,25,0
1748419610086,CENG 221A,A00,913214,Liu; Ping,38,0,50,12
1748419611113,CENG 252,A00,913215,Chen; Zheng,42,0,50,8
1748419612148,CGS 2A,A01,915347,Martin Sandino; Amanda Maria Yoland,11,0,15,4
1748419612148,CGS 2A,A02,915348,Martin Sandino; Amanda Maria Yoland,12,0,15,3
1748419612148,CGS 2A,A03,915375,Martin Sandino; Amanda Maria Yoland,11,0,15,4
1748419612148,CGS 2A,A04,915376,Martin Sandino; Amanda Maria Yoland,15,0,15,0
1748419613177,CGS 100A,A00,915379,Perez; Roy,16,0,31,15
1748419614204,CGS 109,A00,915458,Cuong; Marisol,36,0,40,4
1748419615230,CGS 110,A00,915463,Cuong; Marisol,27,0,30,3
1748419616254,CGS 113,A00,915465,Martin Sandino; Amanda Maria Yoland,8,0,16,8
1748419617281,CGS 134,A00,915498,Chatti; Deepti,17,0,32,15
1748419618307,CGS 150,A00,915508,Taylor-Garcia; Daphne,13,0,16,3
1748419619341,CGS 187,A00,915515,Martin Sandino; Amanda Maria Yoland,13,0,16,3
1748419620371,CGS 190,A00,915516,Taylor-Garcia; Daphne,7,0,7,0
1748419621397,CGS 208,A00,915517,Kang; Byung Chu,1,0,1,0
1748419622457,CHEM 4,A01,958051,Brydges; Stacey,39,0,40,1
1748419622457,CHEM 4,A02,958052,Brydges; Stacey,38,0,40,2
1748419622457,CHEM 4,A03,958053,Brydges; Stacey,37,0,40,3
1748419622457,CHEM 4,A04,958054,Brydges; Stacey,39,0,40,1
1748419622457,CHEM 4,A05,958055,Brydges; Stacey,40,0,40,0
1748419622457,CHEM 4,A06,958056,Brydges; Stacey,38,0,40,2
1748419622457,CHEM 4,A07,958057,Brydges; Stacey,40,0,40,0
1748419622457,CHEM 4,A08,958058,Brydges; Stacey,40,0,40,0
1748419622457,CHEM 4,B01,958059,Brydges; Stacey,40,0,40,0
1748419622457,CHEM 4,B02,958060,Brydges; Stacey,40,0,40,0
1748419622457,CHEM 4,B03,958061,Brydges; Stacey,40,0,40,0
1748419622457,CHEM 4,B04,958062,Brydges; Stacey,36,0,40,4
1748419622457,CHEM 4,B05,958063,Brydges; Stacey,38,0,40,2
1748419622457,CHEM 4,B06,958064,Brydges; Stacey,39,0,40,1
1748419622457,CHEM 4,B07,958065,Brydges; Stacey,40,0,40,0
1748419622457,CHEM 4,B08,958066,Brydges; Stacey,40,0,40,0
1748419623524,CHEM 6A,A01,958094,Stallings; Dontarie M,5,0,8,3
1748419623524,CHEM 6A,A02,958095,Stallings; Dontarie M,4,0,8,4
1748419623524,CHEM 6A,A03,958096,Stallings; Dontarie M,7,0,8,1
1748419623524,CHEM 6A,A04,958097,Stallings; Dontarie M,8,0,8,0
1748419623524,CHEM 6A,A05,958098,Stallings; Dontarie M,8,0,8,0
1748419623524,CHEM 6A,A06,958099,Stallings; Dontarie M,8,0,8,0
1748419623524,CHEM 6A,A07,958100,Stallings; Dontarie M,8,0,8,0
1748419623524,CHEM 6A,A08,958101,Stallings; Dontarie M,8,0,8,0
1748419623524,CHEM 6A,A09,958102,Stallings; Dontarie M,0,0,0,0
1748419623524,CHEM 6A,B01,958136,Stallings; Dontarie M,0,0,8,8
1748419623524,CHEM 6A,B02,958137,Stallings; Dontarie M,5,0,8,3
1748419623524,CHEM 6A,B03,958138,Stallings; Dontarie M,8,0,8,0
1748419623524,CHEM 6A,B04,958139,Stallings; Dontarie M,7,0,8,1
1748419623524,CHEM 6A,B05,958140,Stallings; Dontarie M,0,0,8,8
1748419623524,CHEM 6A,B06,958141,Stallings; Dontarie M,3,0,8,5
1748419623524,CHEM 6A,B07,958143,Stallings; Dontarie M,2,0,8,6
1748419623524,CHEM 6A,B08,958144,Stallings; Dontarie M,8,0,8,0
1748419623524,CHEM 6A,B09,958145,Stallings; Dontarie M,0,0,0,0
1748419623524,CHEM 6A,C01,958146,Schurmeier; Kimberly,6,0,8,2
1748419623524,CHEM 6A,C02,958147,Schurmeier; Kimberly,7,0,8,1
1748419623524,CHEM 6A,C03,958148,Schurmeier; Kimberly,8,0,8,0
1748419623524,CHEM 6A,C04,958149,Schurmeier; Kimberly,8,0,8,0
1748419623524,CHEM 6A,C05,958150,Schurmeier; Kimberly,8,0,8,0
1748419623524,CHEM 6A,C06,958151,Schurmeier; Kimberly,6,0,8,2
1748419623524,CHEM 6A,C07,958152,Schurmeier; Kimberly,8,0,8,0
1748419623524,CHEM 6A,C08,958153,Schurmeier; Kimberly,7,0,8,1
1748419623524,CHEM 6A,C09,958154,Schurmeier; Kimberly,0,0,0,0
1748419623524,CHEM 6A,D01,958155,Schurmeier; Kimberly,3,0,8,5
1748419623524,CHEM 6A,D02,958156,Schurmeier; Kimberly,3,0,8,5
1748419623524,CHEM 6A,D03,958157,Schurmeier; Kimberly,4,0,8,4
1748419623524,CHEM 6A,D04,958158,Schurmeier; Kimberly,6,0,8,2
1748419623524,CHEM 6A,D05,958159,Schurmeier; Kimberly,7,0,8,1
1748419623524,CHEM 6A,D06,958160,Schurmeier; Kimberly,7,0,8,1
1748419623524,CHEM 6A,D07,958161,Schurmeier; Kimberly,8,0,8,0
1748419623524,CHEM 6A,D08,958162,Schurmeier; Kimberly,8,0,8,0
1748419623524,CHEM 6A,D09,958195,Schurmeier; Kimberly,0,0,0,0
1748419623524,CHEM 6A,E01,958203,Zid; Brian M,0,0,8,8
1748419623524,CHEM 6A,E02,958206,Zid; Brian M,6,0,8,2
1748419623524,CHEM 6A,E03,958207,Zid; Brian M,7,0,8,1
1748419623524,CHEM 6A,E04,958350,Zid; Brian M,8,0,8,0
1748419623524,CHEM 6A,E05,958361,Zid; Brian M,7,0,8,1
1748419623524,CHEM 6A,E06,958373,Zid; Brian M,2,0,8,6
1748419623524,CHEM 6A,E07,958394,Zid; Brian M,7,0,8,1
1748419623524,CHEM 6A,E08,958395,Zid; Brian M,1,0,8,7
1748419623524,CHEM 6A,E09,958396,Zid; Brian M,0,0,0,0
1748419623524,CHEM 6A,F01,958397,Ortony; Julia Helen,8,0,8,0
1748419623524,CHEM 6A,F02,958407,Ortony; Julia Helen,0,0,8,8
1748419623524,CHEM 6A,F03,958409,Ortony; Julia Helen,2,0,8,6
1748419623524,CHEM 6A,F04,958417,Ortony; Julia Helen,6,0,8,2
1748419623524,CHEM 6A,F05,958422,Ortony; Julia Helen,8,0,8,0
1748419623524,CHEM 6A,F06,958425,Ortony; Julia Helen,8,0,8,0
1748419623524,CHEM 6A,F07,958428,Ortony; Julia Helen,7,0,8,1
1748419623524,CHEM 6A,F08,958442,Ortony; Julia Helen,8,0,8,0
1748419623524,CHEM 6A,F09,958488,Ortony; Julia Helen,0,0,0,0
1748419623524,CHEM 6A,G01,958489,Ortony; Julia Helen,7,0,8,1
1748419623524,CHEM 6A,G02,958490,Ortony; Julia Helen,8,0,8,0
1748419623524,CHEM 6A,G03,958491,Ortony; Julia Helen,3,0,8,5
1748419623524,CHEM 6A,G04,958499,Ortony; Julia Helen,2,0,8,6
1748419623524,CHEM 6A,G05,958500,Ortony; Julia Helen,4,0,8,4
1748419623524,CHEM 6A,G06,958501,Ortony; Julia Helen,8,0,8,0
1748419623524,CHEM 6A,G07,958502,Ortony; Julia Helen,8,0,8,0
1748419623524,CHEM 6A,G08,958636,Ortony; Julia Helen,8,0,8,0
1748419623524,CHEM 6A,G09,958637,Ortony; Julia Helen,0,0,0,0
1748419624569,CHEM 6B,A01,958638,Bussey; Thomas J,15,0,22,7
1748419624569,CHEM 6B,A02,958641,Bussey; Thomas J,0,0,22,22
1748419624569,CHEM 6B,A03,958646,Bussey; Thomas J,0,0,22,22
1748419624569,CHEM 6B,A04,958648,Bussey; Thomas J,11,0,22,11
1748419624569,CHEM 6B,A05,958650,Bussey; Thomas J,7,0,22,15
1748419624569,CHEM 6B,A06,958652,Bussey; Thomas J,18,0,22,4
1748419624569,CHEM 6B,A07,958653,Bussey; Thomas J,20,0,22,2
1748419624569,CHEM 6B,A08,958654,Bussey; Thomas J,19,0,22,3
1748419624569,CHEM 6B,A09,958710,Bussey; Thomas J,21,0,22,1
1748419624569,CHEM 6B,A10,958713,Bussey; Thomas J,21,0,22,1
1748419625604,CHEM 6C,A01,958743,Yuen Zhou; Joel,24,0,38,14
1748419625604,CHEM 6C,A02,958744,Yuen Zhou; Joel,20,0,38,18
1748419625604,CHEM 6C,A03,958745,Yuen Zhou; Joel,28,0,38,10
1748419625604,CHEM 6C,A04,958746,Yuen Zhou; Joel,30,0,38,8
1748419625604,CHEM 6C,A05,958747,Yuen Zhou; Joel,36,0,38,2
1748419625604,CHEM 6C,A06,958748,Yuen Zhou; Joel,23,0,38,15
1748419625604,CHEM 6C,A07,958749,Yuen Zhou; Joel,22,0,38,16
1748419625604,CHEM 6C,A08,958750,Yuen Zhou; Joel,12,0,38,26
1748419625604,CHEM 6C,A09,958751,Yuen Zhou; Joel,28,0,38,10
1748419626635,CHEM 7L,A01,912668,Leigh; Brian,0,0,24,24
1748419626635,CHEM 7L,A02,912669,Leigh; Brian,0,0,24,24
1748419626635,CHEM 7L,A03,912670,Leigh; Brian,0,0,24,24
1748419626635,CHEM 7L,A04,912671,Leigh; Brian,0,0,24,24
1748419626635,CHEM 7L,A05,912672,Leigh; Brian,0,0,24,24
1748419626635,CHEM 7L,A06,912673,Leigh; Brian,0,0,20,20
1748419626635,CHEM 7L,A07,912674,Leigh; Brian,0,0,24,24
1748419626635,CHEM 7L,A08,912675,Leigh; Brian,0,0,24,24
1748419626635,CHEM 7L,A09,912676,Leigh; Brian,0,0,24,24
1748419626635,CHEM 7L,A10,912677,Leigh; Brian,0,0,24,24
1748419626635,CHEM 7L,B01,912680,Leigh; Brian,0,0,24,24
1748419626635,CHEM 7L,B02,912681,Leigh; Brian,0,0,24,24
1748419626635,CHEM 7L,B03,912682,Leigh; Brian,0,0,24,24
1748419626635,CHEM 7L,B04,912683,Leigh; Brian,0,0,24,24
1748419626635,CHEM 7L,B05,912684,Leigh; Brian,0,0,24,24
1748419626635,CHEM 7L,B06,912685,Leigh; Brian,0,0,24,24
1748419626635,CHEM 7L,B07,912686,Leigh; Brian,0,0,24,24
1748419626635,CHEM 7L,B08,912687,Leigh; Brian,0,0,24,24
1748419626635,CHEM 7L,B09,912688,Leigh; Brian,0,0,24,24
1748419626635,CHEM 7L,B10,912689,Leigh; Brian,0,0,24,24
1748419627679,CHEM 40A,A01,958809,Bertrand; Guy,0,0,34,34
1748419627679,CHEM 40A,A02,958811,Bertrand; Guy,0,0,29,29
1748419627679,CHEM 40A,A03,958812,Bertrand; Guy,0,0,34,34
1748419627679,CHEM 40A,A04,958813,Bertrand; Guy,0,0,34,34
1748419627679,CHEM 40A,A05,958814,Bertrand; Guy,0,0,34,34
1748419627679,CHEM 40A,A06,958816,Bertrand; Guy,0,0,34,34
1748419627679,CHEM 40A,A07,958822,Bertrand; Guy,0,0,34,34
1748419627679,CHEM 40A,A08,958824,Bertrand; Guy,0,0,34,34
1748419627679,CHEM 40A,B01,958825,Bertrand; Guy,0,0,34,34
1748419627679,CHEM 40A,B02,958826,Bertrand; Guy,0,0,34,34
1748419627679,CHEM 40A,B03,958828,Bertrand; Guy,0,0,34,34
1748419627679,CHEM 40A,B04,958829,Bertrand; Guy,0,0,34,34
1748419627679,CHEM 40A,B05,958898,Bertrand; Guy,0,0,34,34
1748419627679,CHEM 40A,B06,958899,Bertrand; Guy,0,0,34,34
1748419627679,CHEM 40A,B07,958900,Bertrand; Guy,0,0,34,34
1748419627679,CHEM 40A,B08,958901,Bertrand; Guy,0,0,34,34
1748419627679,CHEM 40A,C01,958086,Yang; Jerry,30,0,34,4
1748419627679,CHEM 40A,C02,958087,Yang; Jerry,32,0,34,2
1748419627679,CHEM 40A,C03,958088,Yang; Jerry,31,0,34,3
1748419627679,CHEM 40A,C04,958089,Yang; Jerry,34,0,34,0
1748419627679,CHEM 40A,C05,958090,Yang; Jerry,34,0,34,0
1748419627679,CHEM 40A,C06,958091,Yang; Jerry,27,0,34,7
1748419627679,CHEM 40A,C07,958092,Yang; Jerry,29,0,34,5
1748419627679,CHEM 40A,C08,958093,Yang; Jerry,27,0,34,7
1748419627679,CHEM 40A,D01,958113,Albizati; Kim F.,0,0,34,34
1748419627679,CHEM 40A,D02,958114,Albizati; Kim F.,0,0,34,34
1748419627679,CHEM 40A,D03,958115,Albizati; Kim F.,0,0,34,34
1748419627679,CHEM 40A,D04,958116,Albizati; Kim F.,0,0,34,34
1748419627679,CHEM 40A,D05,958117,Albizati; Kim F.,0,0,34,34
1748419627679,CHEM 40A,D06,958118,Albizati; Kim F.,0,0,34,34
1748419627679,CHEM 40A,D07,958119,Albizati; Kim F.,0,0,34,34
1748419627679,CHEM 40A,D08,958120,Albizati; Kim F.,0,0,34,34
1748419628708,CHEM 40B,A01,958752,Molinski; Tadeusz,0,0,31,31
1748419628708,CHEM 40B,A02,958754,Molinski; Tadeusz,0,0,32,32
1748419628708,CHEM 40B,A03,958755,Molinski; Tadeusz,0,0,32,32
1748419628708,CHEM 40B,A04,958756,Molinski; Tadeusz,0,0,32,32
1748419628708,CHEM 40B,A05,958757,Molinski; Tadeusz,0,0,32,32
1748419628708,CHEM 40B,A06,958758,Molinski; Tadeusz,0,0,32,32
1748419628708,CHEM 40B,A07,958759,Molinski; Tadeusz,0,0,32,32
1748419628708,CHEM 40B,A08,958760,Molinski; Tadeusz,2,0,32,30
1748419628708,CHEM 40B,A09,958761,Molinski; Tadeusz,32,0,32,0
1748419629738,CHEM 41A,A01,958071,Klosterman; Jeremy K,0,0,22,22
1748419629738,CHEM 41A,A02,958072,Klosterman; Jeremy K,1,0,36,35
1748419629738,CHEM 41A,A03,958073,Klosterman; Jeremy K,16,0,36,20
1748419629738,CHEM 41A,A04,958074,Klosterman; Jeremy K,32,0,36,4
1748419629738,CHEM 41A,A05,958075,Klosterman; Jeremy K,0,0,0,0
1748419629738,CHEM 41A,A06,958076,Klosterman; Jeremy K,24,0,36,12
1748419629738,CHEM 41A,A07,958077,Klosterman; Jeremy K,3,0,36,33
1748419629738,CHEM 41A,A08,958078,Klosterman; Jeremy K,0,0,36,36
1748419629738,CHEM 41A,A09,958079,Klosterman; Jeremy K,36,0,36,0
1748419630773,CHEM 41C,A01,958105,Tor; Yitzhak,0,0,38,38
1748419630773,CHEM 41C,A02,958106,Tor; Yitzhak,0,0,40,40
1748419631810,CHEM 43A,A01,912711,Lam; Tin Yiu,0,0,24,24
1748419631810,CHEM 43A,A02,912712,Lam; Tin Yiu,0,0,24,24
1748419631810,CHEM 43A,A03,912713,Lam; Tin Yiu,0,0,24,24
1748419631810,CHEM 43A,A04,912714,Lam; Tin Yiu,0,0,24,24
1748419631810,CHEM 43A,A05,912715,Lam; Tin Yiu,0,0,24,24
1748419631810,CHEM 43A,A06,912716,Lam; Tin Yiu,0,0,24,24
1748419631810,CHEM 43A,A07,912717,Lam; Tin Yiu,0,0,24,24
1748419631810,CHEM 43A,A08,912718,Lam; Tin Yiu,0,0,24,24
1748419631810,CHEM 43A,A09,912719,Lam; Tin Yiu,0,0,24,24
1748419631810,CHEM 43A,A10,912720,Lam; Tin Yiu,0,0,24,24
1748419631810,CHEM 43A,B01,912722,Lam; Tin Yiu,0,0,24,24
1748419631810,CHEM 43A,B02,912723,Lam; Tin Yiu,0,0,24,24
1748419631810,CHEM 43A,B03,912724,Lam; Tin Yiu,0,0,19,19
1748419631810,CHEM 43A,B04,912725,Lam; Tin Yiu,0,0,24,24
1748419631810,CHEM 43A,B05,912726,Lam; Tin Yiu,0,0,24,24
1748419631810,CHEM 43A,B06,912727,Lam; Tin Yiu,0,0,24,24
1748419631810,CHEM 43A,B07,912728,Lam; Tin Yiu,0,0,24,24
1748419631810,CHEM 43A,B08,912729,Lam; Tin Yiu,0,0,24,24
1748419631810,CHEM 43A,B09,912730,Lam; Tin Yiu,0,0,24,24
1748419631810,CHEM 43A,B10,912731,Lam; Tin Yiu,0,0,24,24
1748419632837,CHEM 96,A00,960251,Bussey; Thomas J,15,0,20,5
1748419633874,CHEM 100A,A01,912734,Leigh; Brian,0,0,24,24
1748419633874,CHEM 100A,A02,912735,Leigh; Brian,0,0,24,24
1748419633874,CHEM 100A,A03,912736,Leigh; Brian,0,0,24,24
1748419633874,CHEM 100A,A04,912737,Leigh; Brian,0,0,24,24
1748419633874,CHEM 100A,A05,912738,Leigh; Brian,0,0,24,24
1748419633874,CHEM 100A,A06,912739,Leigh; Brian,0,0,24,24
1748419634907,CHEM 108,A01,912741,Ghosh; Gourisankar,0,0,24,24
1748419634907,CHEM 108,A02,912742,Ghosh; Gourisankar,0,0,24,24
1748419634907,CHEM 108,A03,912743,Ghosh; Gourisankar,13,0,24,11
1748419634907,CHEM 108,A04,912744,Ghosh; Gourisankar,23,0,24,1
1748419635941,CHEM 109,A01,912746,Muller; Ulrich K.,0,0,24,24
1748419635941,CHEM 109,A02,912747,Muller; Ulrich K.,0,0,24,24
1748419635941,CHEM 109,A03,912748,Muller; Ulrich K.,0,0,24,24
1748419635941,CHEM 109,A04,912749,Muller; Ulrich K.,15,0,24,9
1748419636983,CHEM 114A,A01,958067,Toor; Navtej,23,0,30,7
1748419636983,CHEM 114A,A02,958068,Toor; Navtej,18,0,30,12
1748419636983,CHEM 114A,A03,958069,Toor; Navtej,15,0,30,15
1748419636983,CHEM 114A,A04,958070,Toor; Navtej,0,0,30,30
1748419636983,CHEM 114A,B01,958080,Guseman; Alex,0,0,30,30
1748419636983,CHEM 114A,B02,958081,Guseman; Alex,0,0,30,30
1748419636983,CHEM 114A,B03,958082,Guseman; Alex,20,0,30,10
1748419636983,CHEM 114A,B04,958083,Guseman; Alex,24,0,30,6
1748419638010,CHEM 114D,A00,912752,Ghosh; Gourisankar,11,0,20,9
1748419639038,CHEM 116,A01,958121,Godula; Kamil,35,0,50,15
1748419639038,CHEM 116,A02,958122,Godula; Kamil,29,0,50,21
1748419640069,CHEM 117,A00,912754,Jones; Lisa Michelle,89,0,100,11
1748419641151,CHEM 126A,A01,958126,Schoeneberg; Johannes,14,0,35,21
1748419641151,CHEM 126A,A02,958127,Schoeneberg; Johannes,4,0,35,31
1748419641151,CHEM 126A,A03,958128,Schoeneberg; Johannes,0,0,35,35
1748419641151,CHEM 126A,A04,958129,Schoeneberg; Johannes,1,0,35,34
1748419641151,CHEM 126A,A05,958130,Schoeneberg; Johannes,34,0,35,1
1748419641151,CHEM 126A,A06,958131,Schoeneberg; Johannes,25,0,35,10
1748419642181,CHEM 130,A01,958084,Sinha; Amitabha,6,0,35,29
1748419642181,CHEM 130,A02,958085,Sinha; Amitabha,21,0,35,14
1748419643211,CHEM 142,A00,912758,Godula; Kamil,112,0,135,23
1748419644237,CHEM 143C,A01,912760,Klosterman; Jeremy K,8,0,24,16
1748419644237,CHEM 143C,A02,912761,Klosterman; Jeremy K,11,0,24,13
1748419645266,CHEM 152,A00,912762,Schmidt; Valerie A,18,0,30,12
1748419646292,CHEM 163,A00,912763,Jones; Lisa Michelle,1,0,10,9
1748419647326,CHEM 171,A01,958103,Slade; Jonathan,30,0,40,10
1748419647326,CHEM 171,A02,958104,Slade; Jonathan,36,0,40,4
1748419648356,CHEM 204,A00,912765,Ghosh; Partho,29,0,30,1
1748419649380,CHEM 209,A00,912766,Toor; Navtej,36,0,40,4
1748419650410,CHEM 213A,A00,912767,Guseman; Alex,46,0,50,4
1748419651436,CHEM 214,A00,912768,Ghosh; Gourisankar,18,0,20,2
1748419652463,CHEM 216,A00,912769,Godula; Kamil,28,0,30,2
1748419653491,CHEM 219A,A00,912770,Zid; Brian M,43,0,45,2
1748419654520,CHEM 222,A00,912771,Graeve; Olivia A,4,0,5,1
1748419655547,CHEM 224,A00,912772,Rinehart; Jeffrey Dennis,19,0,20,1
1748419656574,CHEM 227,A00,912773,Schimpf; Alina M,28,0,30,2
1748419658630,CHEM 231,A00,912775,Yong; Haiwang,20,0,20,0
1748419659660,CHEM 232A,A00,963071,Yuen Zhou; Joel,15,0,15,0
1748419660690,CHEM 234,A00,912776,Pun; Andrew Brian,39,0,40,1
1748419661718,CHEM 242,A00,912777,Godula; Kamil,22,0,25,3
1748419662744,CHEM 252,A00,912778,Schmidt; Valerie A,27,0,30,3
1748419663770,CHEM 263,A00,912779,Jones; Lisa Michelle,28,0,30,2
1748419664803,CHEM 291,A00,912780,Staff,20,0,20,0
1748419665833,CHEM 294,A00,912781,Staff,49,0,50,1
1748419666863,CHIN 10AD,A01,913381,Liu; Mingming,10,0,12,2
1748419666863,CHIN 10AD,A02,913382,Liu; Mingming,10,0,12,2
1748419667892,CHIN 10AM,A01,913384,Chen; Pei-Chia,9,0,12,3
1748419667892,CHIN 10AM,A02,913385,Chen; Pei-Chia,10,0,12,2
1748419668920,CHIN 10AN,A01,913387,Xu; Li,10,0,10,0
1748419668920,CHIN 10AN,A02,913388,Xu; Li,10,0,10,0
1748419668920,CHIN 10AN,B01,913390,Xu; Li,9,0,10,1
1748419668920,CHIN 10AN,B02,913391,Xu; Li,8,0,10,2
1748419668920,CHIN 10AN,C01,913393,Xu; Li,12,0,12,0
1748419668920,CHIN 10AN,C02,913394,Xu; Li,11,0,12,1
1748419669946,CHIN 20AD,A01,913396,Liu; Mingming,12,0,14,2
1748419669946,CHIN 20AD,A02,913397,Liu; Mingming,13,0,14,1
1748419670975,CHIN 20AM,A01,913399,Wang; Xiao,11,0,12,1
1748419670975,CHIN 20AM,A02,913400,Wang; Xiao,9,0,12,3
1748419670975,CHIN 20AM,B01,913402,Wang; Xiao,12,0,12,0
1748419670975,CHIN 20AM,B02,913403,Wang; Xiao,12,0,12,0
1748419672001,CHIN 20AN,A01,913405,Anderson; Qin-Hong,8,0,12,4
1748419672001,CHIN 20AN,A02,913406,Anderson; Qin-Hong,7,0,12,5
1748419672001,CHIN 20AN,B01,913408,Anderson; Qin-Hong,6,0,12,6
1748419672001,CHIN 20AN,B02,913409,Anderson; Qin-Hong,9,0,12,3
1748419672001,CHIN 20AN,C01,913411,Anderson; Qin-Hong,11,0,12,1
1748419673027,CHIN 100AM,A00,913412,Wang; Xiao,12,0,15,3
1748419674055,CHIN 100AN,A00,913413,Chen; Pei-Chia,8,0,15,7
1748419675088,CHIN 185A,A00,913414,Liu; Mingming,15,0,15,0
1748419676115,CLIN 294A,A00,914822,Weingarten; Amanda Gooding,10,0,10,0
1748419677144,CLIN 296,A00,914825,Moore; David Joseph,100,0,100,0
1748419677144,CLIN 296,B00,914826,Brookman; Lauren Irene,5,0,5,0
1748419678170,CLIN 297,A00,914827,Wall; Tamara Lynn,100,0,100,0
1748419679197,CLRE 254,A00,914830,Vaida; Florin,9997,0,9999,2
1748419680224,CLRE 255,A01,914832,Cuomo; Raphael Eduardo,9997,0,9999,2
1748419681251,CLRE 256,A01,914835,Morris; Sheldon,9996,0,9999,3
1748419682336,CLRE 257,A00,914836,Mehta; Ravindra L.,9997,0,9999,2
1748419683362,CLRE 258,A00,914839,Mehta; Ravindra L.,9997,0,9999,2
1748419684392,CLRE 260,A00,914840,Cuomo; Raphael Eduardo,9999,0,9999,0
1748419685420,CLRE 295A,A00,914845,Cuomo; Raphael Eduardo,9999,0,9999,0
1748419686449,CLRE 297,001,914847,Cuomo; Raphael Eduardo,9999,0,9999,0
1748419687478,CLX 87,A00,913379,Castro; Robert Jess,20,0,20,0
1748419688507,COGR 200A,A00,914800,Dewaard; Andrew Michael,5,0,5,0
1748419689536,COGR 200C,A00,914801,Irani; Lilly C,5,0,5,0
1748419690567,COGR 225A,A00,914803,McKenzie; Kerry V.,10,0,10,0
1748419691593,COGR 225C,A00,914804,McKenzie; Kerry V.,9,0,10,1
1748419692621,COGR 275,A00,914805,Jack; Caroline Sarah,9,0,10,1
1748419692621,COGR 275,B00,914807,Zilberg; Elana,9,0,10,1
1748419692621,COGR 275,C00,914809,Goldfarb; Brian,7,0,10,3
1748419693655,COGS 1,A01,913420,Beatty-Martinez; Anne,47,0,56,9
1748419693655,COGS 1,A02,913421,Beatty-Martinez; Anne,39,0,56,17
1748419693655,COGS 1,A03,913422,Beatty-Martinez; Anne,51,0,55,4
1748419693655,COGS 1,A04,913423,Beatty-Martinez; Anne,46,0,50,4
1748419693655,COGS 1,A05,913424,Beatty-Martinez; Anne,41,0,50,9
1748419693655,COGS 1,A06,913425,Beatty-Martinez; Anne,44,0,50,6
1748419693655,COGS 1,A07,913426,Beatty-Martinez; Anne,48,0,50,2
1748419693655,COGS 1,A08,913427,Beatty-Martinez; Anne,45,0,50,5
1748419694683,COGS 2,A01,913429,Boyle; Mary E. T.,49,0,50,1
1748419694683,COGS 2,A02,913430,Boyle; Mary E. T.,47,0,50,3
1748419694683,COGS 2,A03,913431,Boyle; Mary E. T.,46,0,50,4
1748419694683,COGS 2,A04,913432,Boyle; Mary E. T.,49,0,50,1
1748419694683,COGS 2,A05,913433,Boyle; Mary E. T.,47,0,50,3
1748419695710,COGS 3,A01,913435,Boyle; Mary E. T.,48,0,60,12
1748419695710,COGS 3,A02,913436,Boyle; Mary E. T.,52,0,60,8
1748419696738,COGS 9,A01,913439,Khosla; Meenakshi,48,0,50,2
1748419696738,COGS 9,A02,913440,Khosla; Meenakshi,49,0,50,1
1748419696738,COGS 9,A03,913441,Khosla; Meenakshi,48,0,50,2
1748419696738,COGS 9,A04,913442,Khosla; Meenakshi,46,0,50,4
1748419696738,COGS 9,A05,913443,Khosla; Meenakshi,44,0,50,6
1748419696738,COGS 9,A06,913444,Khosla; Meenakshi,46,0,50,4
1748419697771,COGS 10,A01,913446,Staff,42,0,50,8
1748419697771,COGS 10,A02,913447,Staff,46,0,50,4
1748419697771,COGS 10,A03,913448,Staff,47,0,50,3
1748419697771,COGS 10,A04,913449,Staff,47,0,50,3
1748419697771,COGS 10,A05,913450,Staff,50,0,50,0
1748419697771,COGS 10,A06,913451,Staff,45,0,50,5
1748419698797,COGS 11,A01,913453,Boroditsky; Lera,142,0,149,7
1748419699835,COGS 14A,A01,913455,Creel; Sarah,29,0,50,21
1748419699835,COGS 14A,A02,913456,Creel; Sarah,37,0,50,13
1748419699835,COGS 14A,A03,913457,Creel; Sarah,42,0,50,8
1748419699835,COGS 14A,A04,913458,Creel; Sarah,45,0,50,5
1748419699835,COGS 14A,A05,913459,Creel; Sarah,47,0,50,3
1748419699835,COGS 14A,A06,913460,Creel; Sarah,48,0,50,2
1748419699835,COGS 14A,A07,913461,Creel; Sarah,46,0,50,4
1748419700863,COGS 14B,A01,913463,Barrera; Steven James,32,0,50,18
1748419700863,COGS 14B,A02,913464,Barrera; Steven James,45,0,50,5
1748419700863,COGS 14B,A03,913465,Barrera; Steven James,40,0,50,10
1748419700863,COGS 14B,A04,913466,Barrera; Steven James,46,0,50,4
1748419700863,COGS 14B,A05,913467,Barrera; Steven James,40,0,50,10
1748419701890,COGS 15,A01,913469,Bergen; Benjamin,57,0,60,3
1748419701890,COGS 15,A02,913470,Bergen; Benjamin,57,0,60,3
1748419702920,COGS 17,A01,913472,Johnson; Christine M.,38,0,50,12
1748419702920,COGS 17,A02,913473,Johnson; Christine M.,47,0,50,3
1748419702920,COGS 17,A03,913474,Johnson; Christine M.,39,0,50,11
1748419702920,COGS 17,A04,913475,Johnson; Christine M.,42,0,50,8
1748419702920,COGS 17,A05,913476,Johnson; Christine M.,48,0,50,2
1748419702920,COGS 17,A06,913477,Johnson; Christine M.,48,0,50,2
1748419702920,COGS 17,A07,913478,Johnson; Christine M.,50,0,54,4
1748419702920,COGS 17,A08,913479,Johnson; Christine M.,43,0,56,13
1748419703953,COGS 18,A01,913481,Morgan; Eric,27,0,35,8
1748419703953,COGS 18,A02,913482,Morgan; Eric,30,0,35,5
1748419703953,COGS 18,A03,913483,Morgan; Eric,29,0,35,6
1748419703953,COGS 18,A04,913484,Morgan; Eric,32,0,35,3
1748419703953,COGS 18,A05,913485,Morgan; Eric,31,0,35,4
1748419703953,COGS 18,A06,913486,Morgan; Eric,31,0,35,4
1748419703953,COGS 18,A07,913487,Morgan; Eric,30,0,35,5
1748419703953,COGS 18,A08,913488,Morgan; Eric,31,0,35,4
1748419703953,COGS 18,A09,913520,Morgan; Eric,28,0,35,7
1748419703953,COGS 18,B01,968089,Morgan; Eric,34,0,35,1
1748419703953,COGS 18,B02,968090,Morgan; Eric,35,0,35,0
1748419703953,COGS 18,B03,968091,Morgan; Eric,35,0,35,0
1748419703953,COGS 18,B04,968092,Morgan; Eric,35,0,35,0
1748419703953,COGS 18,B05,968093,Morgan; Eric,35,0,35,0
1748419703953,COGS 18,B06,968094,Morgan; Eric,35,0,35,0
1748419703953,COGS 18,B07,968095,Morgan; Eric,35,0,35,0
1748419703953,COGS 18,B08,968096,Morgan; Eric,34,0,35,1
1748419703953,COGS 18,B09,968097,Morgan; Eric,34,0,35,1
1748419704987,COGS 100,A01,913580,Staff,58,0,60,2
1748419704987,COGS 100,A02,913581,Staff,55,0,60,5
1748419704987,COGS 100,A03,913621,Staff,55,0,60,5
1748419704987,COGS 100,A04,913622,Staff,55,0,60,5
1748419704987,COGS 100,A05,913663,Staff,54,0,60,6
1748419706016,COGS 101A,A01,913705,Barrera; Steven James,37,0,50,13
1748419706016,COGS 101A,A02,913709,Barrera; Steven James,35,0,50,15
1748419706016,COGS 101A,A03,913713,Barrera; Steven James,18,0,50,32
1748419706016,COGS 101A,A04,913715,Barrera; Steven James,25,0,50,25
1748419706016,COGS 101A,A05,913718,Barrera; Steven James,44,0,50,6
1748419706016,COGS 101A,A06,913721,Barrera; Steven James,36,0,50,14
1748419706016,COGS 101A,A07,913722,Barrera; Steven James,41,0,50,9
1748419707044,COGS 101B,A01,913725,Hoffman; Drew Ellen,26,0,50,24
1748419707044,COGS 101B,A02,913726,Hoffman; Drew Ellen,44,0,50,6
1748419707044,COGS 101B,A03,913727,Hoffman; Drew Ellen,47,0,50,3
1748419707044,COGS 101B,A04,913730,Hoffman; Drew Ellen,50,0,50,0
1748419708074,COGS 102A,A01,968009,Staff,41,0,48,7
1748419708074,COGS 102A,A02,968010,Staff,36,0,48,12
1748419708074,COGS 102A,A03,968011,Staff,47,0,50,3
1748419709104,COGS 107A,A01,913748,Rangel; Lara M,44,0,56,12
1748419709104,COGS 107A,A02,913750,Rangel; Lara M,43,0,54,11
1748419709104,COGS 107A,A03,913751,Rangel; Lara M,31,0,50,19
1748419709104,COGS 107A,A04,913754,Rangel; Lara M,22,0,50,28
1748419709104,COGS 107A,A05,913755,Rangel; Lara M,27,0,50,23
1748419709104,COGS 107A,A06,913756,Rangel; Lara M,0,0,50,50
1748419710133,COGS 107B,A01,968098,Staff,0,0,50,50
1748419710133,COGS 107B,A02,968099,Staff,7,0,50,43
1748419710133,COGS 107B,A03,968102,Staff,37,0,49,12
1748419711172,COGS 108,A01,913846,Fleischer; Jason G,0,0,56,56
1748419711172,COGS 108,A02,913847,Fleischer; Jason G,17,0,56,39
1748419711172,COGS 108,A03,913858,Fleischer; Jason G,20,0,50,30
1748419711172,COGS 108,A04,913899,Fleischer; Jason G,44,0,55,11
1748419711172,COGS 108,A05,913984,Fleischer; Jason G,29,0,50,21
1748419711172,COGS 108,A06,914035,Fleischer; Jason G,31,0,50,19
1748419711172,COGS 108,A07,914036,Fleischer; Jason G,36,0,50,14
1748419711172,COGS 108,A08,914037,Fleischer; Jason G,44,0,50,6
1748419711172,COGS 108,B01,914039,Fleischer; Jason G,38,0,50,12
1748419711172,COGS 108,B02,914040,Fleischer; Jason G,48,0,50,2
1748419711172,COGS 108,B03,914172,Fleischer; Jason G,32,0,50,18
1748419711172,COGS 108,B04,914182,Fleischer; Jason G,36,0,50,14
1748419711172,COGS 108,B05,914185,Fleischer; Jason G,28,0,50,22
1748419711172,COGS 108,B06,914188,Fleischer; Jason G,20,0,50,30
1748419711172,COGS 108,B07,914209,Fleischer; Jason G,39,0,54,15
1748419711172,COGS 108,B08,914210,Fleischer; Jason G,49,0,56,7
1748419712200,COGS 109,A01,968106,Mukamel; Eran A,30,0,48,18
1748419712200,COGS 109,A02,968107,Mukamel; Eran A,39,0,49,10
1748419712200,COGS 109,A03,968108,Mukamel; Eran A,47,0,49,2
1748419713228,COGS 111,A01,914261,Hoffman; Drew Ellen,34,0,50,16
1748419713228,COGS 111,A02,914262,Hoffman; Drew Ellen,49,0,50,1
1748419713228,COGS 111,A03,914263,Hoffman; Drew Ellen,46,0,50,4
1748419713228,COGS 111,A04,914264,Hoffman; Drew Ellen,28,0,50,22
1748419714259,COGS 115,A01,914266,Deak; Gedeon O.,35,0,70,35
1748419715292,COGS 116,A01,914268,Greene; Deanna Jacquelyn,49,0,70,21
1748419716321,COGS 118A,A01,914270,Tu; Zhuowen,30,0,50,20
1748419716321,COGS 118A,A02,914271,Tu; Zhuowen,31,0,50,19
1748419716321,COGS 118A,A03,914272,Tu; Zhuowen,7,0,50,43
1748419716321,COGS 118A,A04,914273,Tu; Zhuowen,6,0,50,44
1748419717355,COGS 118B,A01,969817,De Sa; Virginia,32,0,49,17
1748419717355,COGS 118B,A02,969818,De Sa; Virginia,34,0,49,15
1748419717355,COGS 118B,A03,969819,De Sa; Virginia,31,0,49,18
1748419717355,COGS 118B,A04,969822,De Sa; Virginia,43,0,49,6
1748419718382,COGS 125,A00,968043,Klemmer; Scott R,48,0,50,2
1748419719414,COGS 128,A01,914278,Staff,16,0,50,34
1748419719414,COGS 128,A02,914279,Staff,0,0,50,50
1748419720447,COGS 143,A01,914284,Johnson; Christine M.,16,0,40,24
1748419721473,COGS 150,A01,968112,Staff,36,0,50,14
1748419721473,COGS 150,A02,968113,Staff,44,0,49,5
1748419721473,COGS 150,A03,968114,Staff,43,0,48,5
1748419722503,COGS 151,A00,968044,Coulson; Seana M,48,0,50,2
1748419723536,COGS 160,A00,914286,Kirsh; David Joel,25,0,25,0
1748419724568,COGS 165,A01,914291,Kiyonaga; Anastasia,0,0,50,50
1748419725595,COGS 187A,A01,914293,Kirsh; David Joel,0,0,50,50
1748419725595,COGS 187A,A02,914294,Kirsh; David Joel,0,0,50,50
1748419725595,COGS 187A,A03,914295,Kirsh; David Joel,16,0,49,33
1748419726621,COGS 189,A00,914296,De Sa; Virginia,119,0,200,81
1748419727650,COGS 190A,A00,914297,Staff,9999,0,9999,0
1748419728677,COGS 194,A00,914298,Hill; Seth J,9999,0,9999,0
1748419729706,COGS 203,A00,914326,Zettersten; Martin,11,0,20,9
1748419730736,COGS 210A,001,914327,Kirsh; David Joel,9999,0,9999,0
1748419730736,COGS 210A,002,914328,Greene; Deanna Jacquelyn,9998,0,9999,1
1748419730736,COGS 210A,003,914329,Xia; Haijun,9998,0,9999,1
1748419730736,COGS 210A,004,914330,Nitz; Douglas A.,9999,0,9999,0
1748419730736,COGS 210A,005,914331,Hollan; James D.,9999,0,9999,0
1748419730736,COGS 210A,006,914332,De Sa; Virginia,9998,0,9999,1
1748419730736,COGS 210A,007,914333,Rossano; Federico,9999,0,9999,0
1748419730736,COGS 210A,008,914334,Kiyonaga; Anastasia,9999,0,9999,0
1748419730736,COGS 210A,009,914335,Coulson; Seana M,9998,0,9999,1
1748419731764,COGS 211A,A00,914336,Boroditsky; Lera,9995,0,9999,4
1748419732797,COGS 230,A00,914337,Munyaka; Imani N. S.,3,0,15,12
1748419733824,COGS 234,A00,970720,Xia; Haijun,4,0,20,16
1748419734855,COGS 260,A00,914340,Voytek; Bradley Thomas,9994,0,9999,5
1748419735894,COMM 10,A01,914366,Whitworth-Smith; Andrew C,6,0,10,4
1748419735894,COMM 10,A02,914367,Whitworth-Smith; Andrew C,7,0,10,3
1748419735894,COMM 10,A03,914368,Whitworth-Smith; Andrew C,9,0,10,1
1748419735894,COMM 10,A04,914369,Whitworth-Smith; Andrew C,6,0,10,4
1748419735894,COMM 10,A05,914370,Whitworth-Smith; Andrew C,10,0,10,0
1748419735894,COMM 10,A06,914371,Whitworth-Smith; Andrew C,9,0,10,1
1748419735894,COMM 10,A07,914372,Whitworth-Smith; Andrew C,9,0,10,1
1748419735894,COMM 10,A08,914373,Whitworth-Smith; Andrew C,7,0,10,3
1748419735894,COMM 10,A09,914374,Whitworth-Smith; Andrew C,9,0,10,1
1748419735894,COMM 10,A10,914375,Whitworth-Smith; Andrew C,10,0,10,0
1748419735894,COMM 10,A11,914376,Whitworth-Smith; Andrew C,6,0,10,4
1748419735894,COMM 10,A12,914377,Whitworth-Smith; Andrew C,10,0,10,0
1748419736923,COMM 20,A01,914385,Hill; Erin Truesdell,75,0,75,0
1748419737953,COMM 40,A00,914386,Jack; Caroline Sarah,61,0,75,14
1748419738984,COMM 50,A00,914387,Staff,21,0,25,4
1748419740014,COMM 80,A01,914389,Staff,77,0,80,3
1748419741042,COMM 100A,A01,914391,Harb; Anthony Joseph,1,0,10,9
1748419741042,COMM 100A,A02,914392,Harb; Anthony Joseph,0,0,10,10
1748419741042,COMM 100A,A03,914393,Harb; Anthony Joseph,0,0,10,10
1748419741042,COMM 100A,A04,914394,Harb; Anthony Joseph,0,0,10,10
1748419741042,COMM 100A,A05,914395,Harb; Anthony Joseph,0,0,10,10
1748419741042,COMM 100A,A06,914396,Harb; Anthony Joseph,0,0,10,10
1748419741042,COMM 100A,A07,914397,Harb; Anthony Joseph,1,0,10,9
1748419741042,COMM 100A,A08,914398,Harb; Anthony Joseph,6,0,10,4
1748419741042,COMM 100A,A09,914399,Harb; Anthony Joseph,7,0,10,3
1748419741042,COMM 100A,A10,914400,Harb; Anthony Joseph,7,0,10,3
1748419742072,COMM 101,A01,914404,Martinico; Daniel J,8,0,15,7
1748419742072,COMM 101,A02,914405,Martinico; Daniel J,2,0,15,13
1748419742072,COMM 101,A03,914406,Martinico; Daniel J,1,0,15,14
1748419742072,COMM 101,A04,914407,Martinico; Daniel J,13,0,15,2
1748419743102,COMM 101K,A00,914408,Staff,0,0,0,0
1748419744130,COMM 101M,A00,914409,Halm; Gavin Patrick,10,0,18,8
1748419745212,COMM 101N,A00,914410,Martinico; Daniel J,4,0,16,12
1748419746240,COMM 101T,A00,914411,Davis; Zeinabu I.,12,0,18,6
1748419747268,COMM 102C,A01,914417,Campion; Camille E,0,0,6,6
1748419747268,COMM 102C,A02,914423,Campion; Camille E,0,0,6,6
1748419747268,COMM 102C,A03,914432,Campion; Camille E,0,0,6,6
1748419748299,COMM 106,A00,914439,Kidman; Shawna F,54,0,70,16
1748419749325,COMM 106F,A00,914442,Hill; Erin Truesdell,23,0,42,19
1748419750353,COMM 106N,A00,914480,Hallin; Daniel C,46,0,70,24
1748419751383,COMM 108D,A00,914491,Goldfarb; Brian,45,0,46,1
1748419752413,COMM 113T,A00,914493,Dominguez Rubio; Fernando,43,0,46,3
1748419753440,COMM 114E,A00,914767,Pavon Aramburu; Maria Laur,41,0,44,3
1748419754467,COMM 114I,A00,914768,Rojo Solis; Juan Jose,39,0,44,5
1748419755497,COMM 115,A00,914769,Alac; Morana,35,0,46,11
1748419756527,COMM 119,A01,914771,Staff,50,0,50,0
1748419757561,COMM 120M,A00,914773,Abuelhiga; Soraya Jill,37,0,44,7
1748419758586,COMM 127,A00,914774,Abuelhiga; Soraya Jill,33,0,44,11
1748419759614,COMM 133,A00,914775,Dewey; Matthew D,35,0,44,9
1748419760645,COMM 134,A00,914777,Kidman; Shawna F,31,0,44,13
1748419761673,COMM 135,A00,914778,Davis; Zeinabu I.,43,0,46,3
1748419762699,COMM 142,A00,914779,McKenna; Denise,22,0,44,22
1748419763732,COMM 146,A00,914780,Halm; Gavin Patrick,34,0,44,10
1748419763732,COMM 146,B00,968068,Ybarra; Megan,41,0,44,3
1748419764764,COMM 148,A00,914785,Staff,0,0,0,0
1748419765795,COMM 164,A00,914786,Dominguez Rubio; Fernando,9,0,25,16
1748419766824,COMM 173,A00,914787,Alac; Morana,4,0,25,21
1748419767850,COMM 177,A00,914788,Rojo Solis; Juan Jose,2,0,25,23
1748419768877,COMM 185,A00,914792,Boateng; Boatema,21,0,25,4
1748419769906,COMM 190,B00,914793,Staff,0,0,23,23
1748419769906,COMM 190,C00,914794,Staff,10,0,23,13
1748419769906,COMM 190,D00,914795,Hassanpour; Anvar,4,0,23,19
1748419770934,COMM 194,A00,954115,Hill; Seth J,9999,0,9999,0
1748419771961,COMM 196A,A00,914796,Dewaard; Andrew Michael,0,0,0,1
1748419772990,CSE 3,A50,914849,Alvarado; Christine J.,49,0,50,1
1748419772990,CSE 3,A51,914850,Alvarado; Christine J.,49,0,50,1
1748419772990,CSE 3,A52,914852,Alvarado; Christine J.,46,0,46,0
1748419774024,CSE 6R,A01,914856,Soosai Raj; Adalbert Geral,238,0,250,12
1748419775067,CSE 8A,A50,914860,Soosai Raj; Adalbert Geral,2,0,3,1
1748419775067,CSE 8A,A51,914868,Soosai Raj; Adalbert Geral,0,0,3,3
1748419775067,CSE 8A,A52,914870,Soosai Raj; Adalbert Geral,1,0,3,2
1748419775067,CSE 8A,A53,914871,Soosai Raj; Adalbert Geral,1,0,3,2
1748419775067,CSE 8A,A54,914872,Soosai Raj; Adalbert Geral,2,0,3,1
1748419775067,CSE 8A,A55,914873,Soosai Raj; Adalbert Geral,2,0,3,1
1748419775067,CSE 8A,A56,914875,Soosai Raj; Adalbert Geral,3,0,3,0
1748419775067,CSE 8A,A57,914876,Soosai Raj; Adalbert Geral,1,0,3,2
1748419776104,CSE 11,A01,958990,Cao; Yingjun,0,0,50,50
1748419776104,CSE 11,B01,959775,Ochoa; Benjamin Lawrence,103,0,115,12
1748419777143,CSE 12,A01,958991,Cao; Yingjun,0,0,100,100
1748419778170,CSE 20,A01,959784,Jones; Miles E,0,0,25,25
1748419778170,CSE 20,A02,968053,Jones; Miles E,1,0,25,24
1748419779202,CSE 21,A01,959776,Jones; Miles E,0,0,30,30
1748419779202,CSE 21,A02,968059,Jones; Miles E,3,0,30,27
1748419780239,CSE 29,A50,914888,Politz; Joseph Gibbs,0,0,10,10
1748419780239,CSE 29,A51,914889,Politz; Joseph Gibbs,0,0,10,10
1748419780239,CSE 29,A52,914891,Politz; Joseph Gibbs,0,0,10,10
1748419780239,CSE 29,A53,914892,Politz; Joseph Gibbs,0,0,10,10
1748419780239,CSE 29,B50,914897,Shalev; Aaron D,0,0,10,10
1748419780239,CSE 29,B51,914898,Shalev; Aaron D,0,0,10,10
1748419780239,CSE 29,B52,914900,Shalev; Aaron D,0,0,10,10
1748419780239,CSE 29,B53,914901,Shalev; Aaron D,0,0,10,10
1748419781272,CSE 30,A01,959778,Eldon; John,0,0,15,15
1748419782304,CSE 87,A00,914904,Moshiri; Niema,20,0,20,0
1748419783332,CSE 89,A00,914906,Minnes Kemp; Mor Mia,100,0,100,0
1748419783332,CSE 89,B00,969276,Minnes Kemp; Mor Mia,100,0,100,0
1748419784361,CSE 95,A00,914907,Cao; Yingjun,100,0,100,0
1748419785389,CSE 100,A01,959787,Moshiri; Niema,0,0,75,75
1748419786422,CSE 100R,A01,914911,Moshiri; Niema,0,0,125,125
1748419787456,CSE 101,A01,958995,Impagliazzo; Russell,0,0,30,30
1748419787456,CSE 101,A02,958998,Impagliazzo; Russell,0,0,30,30
1748419787456,CSE 101,A03,959000,Impagliazzo; Russell,0,0,30,30
1748419787456,CSE 101,B01,959777,Liu; Qipeng,94,0,175,81
1748419788521,CSE 103,A01,959001,Freund; Yoav,69,0,96,27
1748419789548,CSE 105,A01,959785,Lovett; Shachar,0,0,45,45
1748419790581,CSE 107,A01,959002,Bellare; Mihir,81,0,96,15
1748419791618,CSE 110,A50,914923,Coblenz; Michael J,10,0,50,40
1748419791618,CSE 110,A51,914925,Coblenz; Michael J,18,0,50,32
1748419791618,CSE 110,A52,914926,Coblenz; Michael J,44,0,50,6
1748419791618,CSE 110,A53,914928,Coblenz; Michael J,33,0,50,17
1748419791618,CSE 110,A54,914930,Coblenz; Michael J,42,0,50,8
1748419791618,CSE 110,A55,914931,Coblenz; Michael J,36,0,45,9
1748419792651,CSE 118,A50,914934,Weibel; Nadir,16,0,25,9
1748419793684,CSE 120,A01,959780,Voelker; Geoffrey M.,130,0,295,165
1748419794716,CSE 127,A01,959795,Savage; Stefan,88,0,192,104
1748419795743,CSE 130,A01,959003,Polikarpova; Nadezhda,118,0,145,27
1748419796771,CSE 131,A01,914941,Politz; Joseph Gibbs,33,0,50,17
1748419797800,CSE 132A,A01,959790,Gupta; Amarnath,141,0,196,55
1748419798833,CSE 134B,A01,959005,Powell; Thomas Allan,115,0,146,31
1748419799858,CSE 140,A01,914947,Orailoglu; Alex,124,0,146,22
1748419800887,CSE 140L,A01,914949,Orailoglu; Alex,112,0,146,34
1748419801919,CSE 141,A01,959006,Pannuto; Patrick William,79,0,146,67
1748419802950,CSE 141L,A01,961134,Eldon; John,75,0,146,71
1748419803982,CSE 142,A01,959781,Swanson; Steven James,250,0,295,45
1748419805009,CSE 150A,A01,959774,Bonjour; Trevor,101,0,225,124
1748419806036,CSE 150B,A01,959791,Solares; Edwin A,187,0,196,9
1748419807063,CSE 151A,A01,959782,Dasgupta; Sanjoy,187,0,250,63
1748419807063,CSE 151A,B01,959783,Dasgupta; Sanjoy,226,0,250,24
1748419808090,CSE 152A,A01,959792,Su; Hao,0,0,0,0
1748419809122,CSE 158,A01,959793,McAuley; Julian John,100,0,196,96
1748419810151,CSE 158R,A01,914961,McAuley; Julian John,449,0,550,101
1748419810151,CSE 158R,B01,968064,McAuley; Julian John,100,0,100,0
1748419811178,CSE 167,A01,959796,Li; Tzumao,110,0,192,82
1748419812217,CSE 170,A01,914965,Vaccaro; Kristen Marie,13,0,20,7
1748419812217,CSE 170,A02,914967,Vaccaro; Kristen Marie,0,0,20,20
1748419812217,CSE 170,A03,914968,Vaccaro; Kristen Marie,17,0,20,3
1748419812217,CSE 170,A04,914969,Vaccaro; Kristen Marie,15,0,20,5
1748419812217,CSE 170,A05,914970,Vaccaro; Kristen Marie,17,0,20,3
1748419812217,CSE 170,A06,914971,Vaccaro; Kristen Marie,18,0,20,2
1748419812217,CSE 170,A07,914972,Vaccaro; Kristen Marie,16,0,19,3
1748419812217,CSE 170,A08,914973,Vaccaro; Kristen Marie,1,0,19,18
1748419812217,CSE 170,A09,914974,Vaccaro; Kristen Marie,8,0,19,11
1748419812217,CSE 170,A10,969577,Vaccaro; Kristen Marie,18,0,19,1
1748419813244,CSE 190,A00,914975,Vaccaro; Kristen Marie,146,0,146,0
1748419814268,CSE 191,A00,914976,Minnes Kemp; Mor Mia,9999,0,9999,0
1748419815304,CSE 193,A01,959007,Bonjour; Trevor,50,0,50,0
1748419816333,CSE 194,A01,959009,Munyaka; Imani N. S.,6,0,60,54
1748419817359,CSE 197,001,914980,Minnes Kemp; Mor Mia,9999,0,9999,0
1748419818386,CSE 202,A00,914981,Liu; Qipeng,0,0,0,0
1748419819413,CSE 206A,A00,914982,Micciancio; Daniele,0,0,0,0
1748419820446,CSE 207B,A00,914983,Heninger; Nadia A,0,0,0,0
1748419821473,CSE 209A,A00,914984,Impagliazzo; Russell,0,0,0,0
1748419822503,CSE 209B,A00,914985,Bellare; Mihir,0,0,0,0
1748419823530,CSE 210,A00,914986,Powell; Thomas Allan,0,0,0,0
1748419824557,CSE 216,A00,914987,Munyaka; Imani N. S.,0,0,0,0
1748419825588,CSE 221,A00,914988,Ousterhout; Amy,0,0,0,0
1748419826618,CSE 227,A00,914989,Fernandes; Earlence T,0,0,0,0
1748419827646,CSE 229A,A00,914990,Snoeren; Alex C.,0,0,0,0
1748419828675,CSE 229C,A00,914993,Fernandes; Earlence T,0,0,0,0
1748419829706,CSE 237C,A00,914994,Kastner; Ryan Charles,0,0,0,0
1748419830739,CSE 239B,A00,914996,D'Antoni; Loris,0,0,0,0
1748419831767,CSE 240A,A00,914997,Tullsen; Dean Michael,0,0,0,0
1748419832802,CSE 249E,A00,914998,Pannuto; Patrick William,0,0,0,0
1748419833831,CSE 250A,A00,914999,Bonjour; Trevor,0,0,0,0
1748419834858,CSE 252A,A00,915000,Ochoa; Benjamin Lawrence,0,0,0,0
1748419835885,CSE 258,A01,959794,McAuley; Julian John,0,0,0,0
1748419836914,CSE 258R,A01,915004,McAuley; Julian John,0,0,0,0
1748419837946,CSE 259,A00,915005,Prithviraj; Ammanabrolu,0,0,0,0
1748419838980,CSE 260,A01,959011,Chin; Bryan W.,0,0,0,0
1748419840006,CSE 270,A01,959012,Chern; Albert Ren-Haur,0,0,0,0
1748419841038,CSE 276A,A00,915009,Christensen; Henrik I,0,0,0,0
1748419842066,CSE 290,A00,915013,Bafna; Vineet,0,0,0,0
1748419842066,CSE 290,B00,915014,Nakashole; Ndapandula,0,0,0,0
1748419842066,CSE 290,C00,915015,Ramamoorthi; Ravi,0,0,0,0
1748419842066,CSE 290,D00,915017,Tullsen; Dean Michael,0,0,0,0
1748419842066,CSE 290,F00,915020,Vaccaro; Kristen Marie,0,0,0,0
1748419843095,CSE 291A,A00,915021,Yu; Qi,0,0,0,0
1748419843095,CSE 291A,B00,915022,Weibel; Nadir,0,0,0,0
1748419843095,CSE 291A,C00,915049,Munyaka; Imani N. S.,0,0,0,0
1748419843095,CSE 291A,D00,968730,Zhang; Yiying,0,0,0,0
1748419844124,CSE 291P,A00,915050,D'Antoni; Loris,0,0,0,0
1748419844124,CSE 291P,B00,915051,Ding; Yufei,0,0,0,0
1748419845152,CSE 291T,A00,915052,Grier; Daniel T,0,0,0,0
1748419845152,CSE 291T,B00,915053,Heninger; Nadia A,0,0,0,0
1748419846181,CSE 291Y,A00,915054,Fernandes; Earlence T,0,0,0,0
1748419847208,CSE 292,A00,968504,Ousterhout; Amy,0,0,0,0
1748419848253,CSE 293,001,968115,Bafna; Vineet,9999,0,9999,0
1748419848253,CSE 293,002,968116,Bellare; Mihir,9999,0,9999,0
1748419848253,CSE 293,003,968122,Berg-Kirkpatrick; Taylor D,9999,0,9999,0
1748419848253,CSE 293,004,968298,Chandraker; Manmohan Krishna,9999,0,9999,0
1748419848253,CSE 293,005,968317,Cheng; Chung Kuan,9999,0,9999,0
1748419848253,CSE 293,006,968334,Christensen; Henrik I,9999,0,9999,0
1748419848253,CSE 293,007,968339,Coblenz; Michael J,9999,0,9999,0
1748419848253,CSE 293,008,968345,Cottrell; Garrison W,9999,0,9999,0
1748419848253,CSE 293,009,968346,Deutsch; Alin Bernard,9999,0,9999,0
1748419848253,CSE 293,010,968357,Esmaeilzadeh; Hadi,9999,0,9999,0
1748419848253,CSE 293,011,968359,Freund; Yoav,9999,0,9999,0
1748419848253,CSE 293,012,968427,Griswold; William G.,9999,0,9999,0
1748419848253,CSE 293,013,968472,Gymrek; Melissa Ann,9999,0,9999,0
1748419848253,CSE 293,014,968473,Heninger; Nadia A,9999,0,9999,0
1748419848253,CSE 293,015,968480,Impagliazzo; Russell,9999,0,9999,0
1748419848253,CSE 293,016,968489,Jhala; Ranjit,9999,0,9999,0
1748419848253,CSE 293,017,968490,Kahng; Andrew Byun,9999,0,9999,0
1748419848253,CSE 293,018,968494,Kane; Daniel Mertz,9999,0,9999,0
1748419848253,CSE 293,019,968495,Kriegman; David J,9999,0,9999,0
1748419848253,CSE 293,020,968496,Kumar; Arun Kumar,9999,0,9999,0
1748419848253,CSE 293,021,968497,Lerner; Sorin,9999,0,9999,0
1748419848253,CSE 293,022,968498,Lovett; Shachar,9999,0,9999,0
1748419848253,CSE 293,023,968499,McAuley; Julian John,9999,0,9999,0
1748419848253,CSE 293,024,968501,Micciancio; Daniele,9999,0,9999,0
1748419848253,CSE 293,025,968502,Orailoglu; Alex,9999,0,9999,0
1748419848253,CSE 293,026,968503,Pannuto; Patrick William,9999,0,9999,0
1748419848253,CSE 293,027,968505,Paturi; Ramamohan,9999,0,9999,0
1748419848253,CSE 293,028,968506,Polikarpova; Nadezhda,9999,0,9999,0
1748419848253,CSE 293,029,968507,Politz; Joseph Gibbs,9999,0,9999,0
1748419848253,CSE 293,030,968508,Porter; George M,9999,0,9999,0
1748419848253,CSE 293,031,968509,Porter; Leonard Emerson,9999,0,9999,0
1748419848253,CSE 293,032,968510,Ramamoorthi; Ravi,9999,0,9999,0
1748419848253,CSE 293,033,968511,Riek; Laurel D,9999,0,9999,0
1748419848253,CSE 293,034,968512,Sahoo; Debashis,9999,0,9999,0
1748419848253,CSE 293,035,968513,Saul; Lawrence,9999,0,9999,0
1748419848253,CSE 293,036,968514,Savage; Stefan,9999,0,9999,0
1748419848253,CSE 293,037,968515,Schulze; Jurgen P.,9999,0,9999,0
1748419848253,CSE 293,038,968516,Snoeren; Alex C.,9999,0,9999,0
1748419848253,CSE 293,039,968517,Shang; Jingbo,9999,0,9999,0
1748419848253,CSE 293,040,968575,Stefan; Deian,9999,0,9999,0
1748419848253,CSE 293,041,968580,Su; Hao,9999,0,9999,0
1748419848253,CSE 293,042,968589,Swanson; Steven James,9999,0,9999,0
1748419848253,CSE 293,043,968639,Tullsen; Dean Michael,9999,0,9999,0
1748419848253,CSE 293,044,968674,Vaccaro; Kristen Marie,9999,0,9999,0
1748419848253,CSE 293,045,968681,Voelker; Geoffrey M.,9999,0,9999,0
1748419848253,CSE 293,046,968692,Zhao; Jishen,9999,0,9999,0
1748419848253,CSE 293,047,968694,Zhou; Yuan-Yuan,9999,0,9999,0
1748419848253,CSE 293,048,968702,Gao; Sicun,9999,0,9999,0
1748419848253,CSE 293,049,968703,Weibel; Nadir,9999,0,9999,0
1748419848253,CSE 293,050,968704,Gupta; Rajesh K.,9999,0,9999,0
1748419848253,CSE 293,051,968705,Soosai Raj; Adalbert Geral,9999,0,9999,0
1748419849332,CSE 294,A00,915055,Orailoglu; Alex,0,0,0,0
1748419850357,CSS 1,A01,958041,Staff,31,0,41,10
1748419850357,CSS 1,A02,958042,Staff,41,0,41,0
1748419850357,CSS 1,A03,958043,Staff,33,0,41,8
1748419850357,CSS 1,A04,958044,Staff,39,0,41,2
1748419851385,CSS 120,A01,915059,Staff,0,0,0,0
1748419852413,CSS 204,A01,915061,Long; Bria,0,0,0,0
1748419853438,CSS 209,A00,915062,Staff,14,0,40,26
1748419854473,DDPM 200,A00,919742,Ma; Joseph David,35,0,35,0
1748419855500,DDPM 201,A00,919743,Ma; Joseph David,35,0,35,0
1748419856530,DDPM 202,A00,919761,Reed; Chantal,35,0,35,0
1748419857558,DDPM 203,A00,963085,Momper; Jeremiah D,40,0,40,0
1748419858594,DOC 1,A01,916077,Staff,4,0,4,0
1748419858594,DOC 1,A02,916080,Staff,1,0,4,3
1748419858594,DOC 1,A03,916081,Staff,1,0,4,3
1748419858594,DOC 1,A04,916082,Staff,3,0,4,1
1748419858594,DOC 1,A05,916083,Staff,2,0,4,2
1748419858594,DOC 1,A06,916084,Staff,4,0,4,0
1748419858594,DOC 1,A07,916085,Staff,4,0,4,0
1748419858594,DOC 1,A08,916096,Staff,4,0,4,0
1748419858594,DOC 1,A09,916097,Staff,4,0,4,0
1748419858594,DOC 1,A10,916099,Staff,4,0,4,0
1748419858594,DOC 1,A11,916170,Staff,0,0,0,0
1748419858594,DOC 1,A12,916186,Staff,0,0,0,0
1748419858594,DOC 1,A13,916203,Staff,4,0,4,0
1748419858594,DOC 1,A14,916222,Staff,4,0,4,0
1748419858594,DOC 1,A15,916223,Staff,4,0,4,0
1748419858594,DOC 1,A16,916224,Staff,4,0,4,0
1748419858594,DOC 1,B01,916279,Staff,4,0,4,0
1748419858594,DOC 1,B02,916281,Staff,2,0,4,2
1748419858594,DOC 1,B03,916282,Staff,3,0,4,1
1748419858594,DOC 1,B04,916283,Staff,3,0,4,1
1748419858594,DOC 1,B05,916284,Staff,2,0,4,2
1748419858594,DOC 1,B06,916285,Staff,3,0,4,1
1748419858594,DOC 1,B07,916287,Staff,4,0,4,0
1748419858594,DOC 1,B08,916288,Staff,3,0,4,1
1748419858594,DOC 1,B09,916289,Staff,0,0,0,0
1748419858594,DOC 1,B10,916290,Staff,0,0,0,0
1748419858594,DOC 1,B11,916349,Staff,4,0,4,0
1748419858594,DOC 1,B12,916375,Staff,4,0,4,0
1748419858594,DOC 1,B13,916381,Staff,3,0,4,1
1748419858594,DOC 1,B14,916382,Staff,2,0,4,2
1748419858594,DOC 1,B15,916383,Staff,4,0,4,0
1748419858594,DOC 1,B16,916384,Staff,3,0,4,1
1748419858594,DOC 1,C01,916386,Staff,4,0,4,0
1748419858594,DOC 1,C02,916387,Staff,4,0,4,0
1748419858594,DOC 1,C03,916388,Staff,4,0,4,0
1748419858594,DOC 1,C04,916389,Staff,0,0,4,4
1748419858594,DOC 1,C05,916390,Staff,2,0,4,2
1748419858594,DOC 1,C06,916391,Staff,2,0,4,2
1748419858594,DOC 1,C07,916392,Staff,4,0,4,0
1748419858594,DOC 1,C08,916417,Staff,4,0,4,0
1748419858594,DOC 1,C09,916418,Staff,0,0,0,0
1748419858594,DOC 1,C10,916426,Staff,0,0,0,0
1748419858594,DOC 1,C11,916497,Staff,4,0,4,0
1748419858594,DOC 1,C12,916506,Staff,3,0,4,1
1748419858594,DOC 1,C13,916507,Staff,3,0,4,1
1748419858594,DOC 1,C14,916508,Staff,3,0,4,1
1748419858594,DOC 1,C15,916509,Staff,4,0,4,0
1748419858594,DOC 1,C16,916510,Staff,4,0,4,0
1748419858594,DOC 1,D01,916512,Staff,4,0,4,0
1748419858594,DOC 1,D02,916513,Staff,4,0,4,0
1748419858594,DOC 1,D03,916514,Staff,4,0,4,0
1748419858594,DOC 1,D04,916515,Staff,4,0,4,0
1748419858594,DOC 1,D05,916516,Staff,1,0,4,3
1748419858594,DOC 1,D06,916555,Staff,4,0,4,0
1748419858594,DOC 1,D07,916581,Staff,4,0,4,0
1748419858594,DOC 1,D08,916582,Staff,4,0,4,0
1748419858594,DOC 1,D09,916583,Staff,0,0,0,0
1748419858594,DOC 1,D10,916584,Staff,0,0,0,0
1748419858594,DOC 1,D11,916585,Staff,4,0,4,0
1748419858594,DOC 1,D12,916586,Staff,4,0,4,0
1748419858594,DOC 1,D13,916587,Staff,4,0,4,0
1748419858594,DOC 1,D14,916588,Staff,4,0,4,0
1748419858594,DOC 1,D15,916589,Staff,3,0,4,1
1748419858594,DOC 1,D16,916590,Staff,4,0,4,0
1748419859623,DOC 100D,A00,916591,Pass; Natalye,22,0,25,3
1748419859623,DOC 100D,B00,916838,Pass; Natalye,22,0,25,3
1748419860652,DSC 10,A01,915848,Tiefenbruck; Janine LoBue,0,0,0,0
1748419860652,DSC 10,B01,915851,Tiefenbruck; Janine LoBue,0,0,0,0
1748419860652,DSC 10,C01,915854,Tiefenbruck; Janine LoBue,0,0,0,0
1748419861684,DSC 20,A01,915857,Langlois; Marina,87,0,90,3
1748419862709,DSC 30,A01,915859,Liao; Soohyun Nam,175,0,180,5
1748419863740,DSC 40A,A01,915861,Mishne; Gal,167,0,180,13
1748419864771,DSC 40B,A01,915863,Langlois; Marina,125,0,149,24
1748419865803,DSC 80,A01,915865,Eldridge; Justin Matthew,117,0,145,28
1748419865803,DSC 80,B01,915867,Eldridge; Justin Matthew,140,0,145,5
1748419866830,DSC 95,A01,915869,Langlois; Marina,50,0,50,0
1748419867861,DSC 100,A01,915871,Shannon; Kyle Michael,97,0,150,53
1748419868893,DSC 102,A01,915890,Kolovos; Alexandros,128,0,150,22
1748419869925,DSC 106,A01,915892,Lau; Samuel Ethan,74,0,90,16
1748419869925,DSC 106,B01,915894,Lau; Samuel Ethan,53,0,90,37
1748419870958,DSC 140A,A01,915896,Ustun; Tevfik Berk,135,0,150,15
1748419871987,DSC 161,A00,968072,Roberts; Margaret Earling,24,0,25,1
1748419873030,DSC 180A,A01,915898,Bellur; Umesh,0,0,0,0
1748419873030,DSC 180A,A02,969828,Bellur; Umesh,0,0,0,0
1748419873030,DSC 180A,A03,969829,Bellur; Umesh,0,0,0,0
1748419873030,DSC 180A,A04,969830,Bellur; Umesh,0,0,0,0
1748419873030,DSC 180A,A05,969831,Bellur; Umesh,0,0,0,0
1748419873030,DSC 180A,A06,969833,Bellur; Umesh,0,0,0,0
1748419873030,DSC 180A,A07,969835,Bellur; Umesh,0,0,0,0
1748419873030,DSC 180A,A08,969836,Bellur; Umesh,0,0,0,0
1748419873030,DSC 180A,A09,969978,Bellur; Umesh,0,0,0,0
1748419873030,DSC 180A,A10,969985,Bellur; Umesh,0,0,0,0
1748419873030,DSC 180A,A11,969986,Bellur; Umesh,0,0,0,0
1748419873030,DSC 180A,A12,970002,Bellur; Umesh,0,0,0,0
1748419873030,DSC 180A,A13,970008,Bellur; Umesh,0,0,0,0
1748419873030,DSC 180A,A14,970011,Bellur; Umesh,0,0,0,0
1748419873030,DSC 180A,A15,970014,Bellur; Umesh,0,0,0,0
1748419873030,DSC 180A,A16,970019,Bellur; Umesh,0,0,0,0
1748419873030,DSC 180A,A17,970020,Bellur; Umesh,0,0,0,0
1748419873030,DSC 180A,B01,915901,Bellur; Umesh,0,0,0,0
1748419873030,DSC 180A,B02,915902,Bellur; Umesh,0,0,0,0
1748419873030,DSC 180A,B03,970021,Bellur; Umesh,0,0,0,0
1748419873030,DSC 180A,B04,970024,Bellur; Umesh,0,0,0,0
1748419873030,DSC 180A,B05,970025,Bellur; Umesh,0,0,0,0
1748419873030,DSC 180A,B06,970028,Bellur; Umesh,0,0,0,0
1748419873030,DSC 180A,B07,970030,Bellur; Umesh,0,0,0,0
1748419873030,DSC 180A,B08,970031,Bellur; Umesh,0,0,0,0
1748419873030,DSC 180A,B09,970034,Bellur; Umesh,0,0,0,0
1748419873030,DSC 180A,B10,970035,Bellur; Umesh,0,0,0,0
1748419873030,DSC 180A,B11,970042,Bellur; Umesh,0,0,0,0
1748419873030,DSC 180A,B12,970043,Bellur; Umesh,0,0,0,0
1748419873030,DSC 180A,B13,970047,Bellur; Umesh,0,0,0,0
1748419873030,DSC 180A,B14,970049,Bellur; Umesh,0,0,0,0
1748419873030,DSC 180A,B15,970050,Bellur; Umesh,0,0,0,0
1748419873030,DSC 180A,B16,970052,Bellur; Umesh,0,0,0,0
1748419873030,DSC 180A,B17,970057,Bellur; Umesh,0,0,0,0
1748419873030,DSC 180A,B18,970060,Bellur; Umesh,0,0,0,0
1748419873030,DSC 180A,B19,970063,Bellur; Umesh,0,0,0,0
1748419873030,DSC 180A,B20,970068,Bellur; Umesh,0,0,0,0
1748419873030,DSC 180A,B21,970070,Bellur; Umesh,0,0,0,0
1748419873030,DSC 180A,B22,970071,Bellur; Umesh,0,0,0,0
1748419873030,DSC 180A,B23,970075,Bellur; Umesh,0,0,0,0
1748419873030,DSC 180A,B24,970076,Bellur; Umesh,0,0,0,0
1748419873030,DSC 180A,B25,970083,Bellur; Umesh,0,0,0,0
1748419873030,DSC 180A,B26,970072,Bellur; Umesh,0,0,0,0
1748419874059,DSC 190,A01,915904,Schwartzman; Armin,176,0,200,24
1748419874059,DSC 190,C01,915908,Ma; Yian,48,0,60,12
1748419875087,DSC 197,001,971692,Eldridge; Justin Matthew,9999,0,9999,0
1748419876119,DSC 200,A00,915909,Watson-Parris; Duncan,0,0,100,100
1748419877146,DSC 204A,A00,915910,Zhang; Hao,65,0,90,25
1748419878174,DSC 207R,A01,915912,Soosai Raj; Adalbert Geral,99,0,100,1
1748419879203,DSC 209R,A01,915922,Lau; Samuel Ethan,34,0,75,41
1748419880237,DSC 210,A00,915979,Weng; Tsui-Wei (lily),0,0,100,100
1748419881270,DSC 212,A00,915984,Mazumdar; Arya,0,0,90,90
1748419882297,DSC 215R,A01,916032,Saab; Rayan,99,0,100,1
1748419884353,DSC 241,A00,916052,Aoi; Mikio C,81,0,90,9
1748419885380,DSC 256R,A01,916054,McAuley; Julian John,42,0,100,58
1748419886409,DSC 257R,A01,916057,Dasgupta; Sanjoy,50,0,75,25
1748419887436,DSC 261,A00,916058,Salimi; Babak,0,0,90,90
1748419888469,DSC 291,A00,916059,Rahman; Tauhidur,0,0,60,60
1748419888469,DSC 291,B00,916060,Wang; Yuxiang,0,0,60,60
1748419888469,DSC 291,C00,916061,Li; Aobo,0,0,40,40
1748419889494,DSC 293,A00,916062,Ustun; Tevfik Berk,9983,0,9999,16
1748419890531,DSC 294,001,970730,Danks; David J,9999,0,9999,0
1748419890531,DSC 294,002,970731,Hu; Zhiting,9999,0,9999,0
1748419890531,DSC 294,003,970732,Schwartzman; Armin,9999,0,9999,0
1748419890531,DSC 294,004,970739,Salimi; Babak,9999,0,9999,0
1748419890531,DSC 294,005,970742,Wang; Yuxiang,9999,0,9999,0
1748419890531,DSC 294,006,970749,Huang; Biwei,9999,0,9999,0
1748419890531,DSC 294,007,970751,Amariuta-Bartell; Tiffany,9999,0,9999,0
1748419890531,DSC 294,008,970754,Smarr; Benjamin,9999,0,9999,0
1748419890531,DSC 294,009,970755,Jin; Haojian,9999,0,9999,0
1748419890531,DSC 294,010,970758,Ma; Yian,9999,0,9999,0
1748419890531,DSC 294,011,970763,Warstadt; Alexander Scott,9999,0,9999,0
1748419890531,DSC 294,012,970764,Wang; Yusu,9999,0,9999,0
1748419890531,DSC 294,013,970766,Lau; Samuel Ethan,9999,0,9999,0
1748419890531,DSC 294,014,970771,Politis; Dimitris,9999,0,9999,0
1748419891558,DSE 200,A00,915842,Staff,30,0,30,0
1748419892585,DSE 203,A00,915844,Staff,20,0,20,0
1748419893611,DSE 220,A00,915845,Staff,20,0,20,0
1748419894636,DSE 290,A00,915846,Staff,30,0,30,0
1748419895670,DSGN 1,A01,913417,Meyer; Michael Wayne,0,0,50,50
1748419895670,DSGN 1,A02,913418,Meyer; Michael Wayne,15,0,50,35
1748419897730,DSGN 118,A01,914325,Xia; Haijun,0,0,50,50
1748419898757,DSGN 201,A00,970721,Eikey; Elizabeth Victoria,10,0,20,10
1748419899789,ECE 5,A01,917741,Morris; Karcher William,0,0,0,0
1748419899789,ECE 5,A02,917742,Morris; Karcher William,0,0,0,0
1748419899789,ECE 5,A03,917775,Morris; Karcher William,0,0,0,0
1748419899789,ECE 5,A04,917804,Morris; Karcher William,0,0,0,0
1748419899789,ECE 5,A05,917811,Morris; Karcher William,0,0,0,0
1748419899789,ECE 5,A06,917816,Morris; Karcher William,0,0,0,0
1748419900817,ECE 15,A01,917850,Schurgers; Curt,0,0,0,0
1748419900817,ECE 15,A02,917851,Schurgers; Curt,0,0,0,0
1748419901848,ECE 17,A01,917878,Sahay; Rajeev,61,0,65,4
1748419902877,ECE 18,A01,917886,Sahay; Rajeev,42,0,50,8
1748419903906,ECE 25,A50,917898,Liu; Zhaowei,0,0,0,0
1748419903906,ECE 25,A51,917900,Liu; Zhaowei,0,0,0,0
1748419903906,ECE 25,A52,917904,Liu; Zhaowei,0,0,0,0
1748419903906,ECE 25,A53,969573,Liu; Zhaowei,0,0,0,0
1748419904935,ECE 30,A50,917909,Mir Arabbaygi; Siavash,11,0,30,19
1748419904935,ECE 30,A51,917910,Mir Arabbaygi; Siavash,21,0,30,9
1748419904935,ECE 30,A52,917912,Mir Arabbaygi; Siavash,29,0,30,1
1748419905978,ECE 35,A50,917993,Schurgers; Curt,0,0,0,0
1748419905978,ECE 35,A51,917994,Schurgers; Curt,0,0,0,0
1748419905978,ECE 35,A52,918000,Schurgers; Curt,0,0,0,0
1748419905978,ECE 35,A53,918001,Schurgers; Curt,0,0,0,0
1748419905978,ECE 35,A54,918072,Schurgers; Curt,0,0,0,0
1748419905978,ECE 35,A55,918078,Schurgers; Curt,0,0,0,0
1748419905978,ECE 35,B50,918131,Schurgers; Curt,0,0,0,0
1748419905978,ECE 35,B51,918135,Schurgers; Curt,0,0,0,0
1748419905978,ECE 35,B52,918146,Schurgers; Curt,0,0,0,0
1748419905978,ECE 35,B53,918147,Schurgers; Curt,0,0,0,0
1748419905978,ECE 35,B54,918148,Schurgers; Curt,0,0,0,0
1748419905978,ECE 35,B55,918149,Schurgers; Curt,0,0,0,0
1748419907005,ECE 45,A01,918151,Zeger; Kenneth A.,94,0,120,26
1748419908041,ECE 65,A50,918356,Baghdadchi; Saharnaz,1,0,30,29
1748419908041,ECE 65,A51,918470,Baghdadchi; Saharnaz,17,0,30,13
1748419908041,ECE 65,A52,918477,Baghdadchi; Saharnaz,25,0,30,5
1748419909082,ECE 100,A01,918485,Baghdadchi; Saharnaz,0,0,30,30
1748419909082,ECE 100,A02,918486,Baghdadchi; Saharnaz,1,0,30,29
1748419909082,ECE 100,A03,918488,Baghdadchi; Saharnaz,1,0,30,29
1748419909082,ECE 100,A04,918490,Baghdadchi; Saharnaz,22,0,30,8
1748419910108,ECE 101,A01,918495,Zheng; Yang,22,0,75,53
1748419910108,ECE 101,A02,918497,Zheng; Yang,51,0,75,24
1748419911137,ECE 102,A00,918499,Hsueh; Tzu-Chien,52,0,100,48
1748419912165,ECE 103,A01,918621,Ng; Tse Nga,45,0,60,15
1748419913193,ECE 107,A01,918642,Fullerton; Eric E,31,0,70,39
1748419914220,ECE 108,A01,918661,Turakhia; Yatish Girish,6,0,70,64
1748419915255,ECE 109,A01,918758,Poveda Fonseca; Jorge,122,0,149,27
1748419916287,ECE 111,A01,918766,Koushanfar; Farinaz,46,0,75,29
1748419917315,ECE 121A,A50,918857,Esmaili; Gholamreza,11,0,24,13
1748419917315,ECE 121A,A51,918888,Esmaili; Gholamreza,15,0,24,9
1748419917315,ECE 121A,A52,918889,Esmaili; Gholamreza,2,0,24,22
1748419918343,ECE 128A,A00,918911,Esmaili; Gholamreza,53,0,75,22
1748419919377,ECE 135A,A01,918931,Kuzum; Duygu,24,0,40,16
1748419920406,ECE 143,A00,918936,Staff,0,0,0,3
1748419921435,ECE 148,A01,918940,Silberman; Jack,14,0,24,10
1748419922463,ECE 155,A01,919022,Gonzalez Prelcic; Nuria,20,0,25,5
1748419923491,ECE 158A,A01,919041,Javidi; Tara,58,0,70,12
1748419924521,ECE 161A,A01,919070,Meyer; Florian,65,0,80,15
1748419925549,ECE 164,A00,919098,Hall; Drew A.,100,0,146,46
1748419926577,ECE 166,A50,919250,Rebeiz; Gabriel,0,0,30,30
1748419926577,ECE 166,A51,919254,Rebeiz; Gabriel,23,0,30,7
1748419926577,ECE 166,A52,919262,Rebeiz; Gabriel,29,0,30,1
1748419926577,ECE 166,A53,919316,Rebeiz; Gabriel,28,0,30,2
1748419927607,ECE 171B,A01,919338,Shi; Yuanyuan,36,0,50,14
1748419928639,ECE 174,A01,919371,Wang; Jun-Kun,77,0,100,23
1748419929670,ECE 180,A00,968047,Fainman; Yeshaiahu,30,0,30,0
1748419930701,ECE 182,A01,962444,Fainman; Yeshaiahu,24,0,30,6
1748419931728,ECE 197,001,919379,Mercier; Patrick Philip,9999,0,9999,0
1748419932758,ECE 198,001,919418,Nguyen; Truong Quang,9999,0,9999,0
1748419933791,ECE 201,A00,919420,Lo; Yu-Hwa,0,0,0,0
1748419934821,ECE 203,A01,919506,Mercier; Patrick Philip,0,0,0,0
1748419935855,ECE 207A,A00,919507,Liu; Thomas Tao-Ming & McVeigh; Elliot R.,0,0,0,0
1748419936886,ECE 212AN,A00,919508,Nomura; Kenji,0,0,0,0
1748419937911,ECE 222A,A00,919524,Rebeiz; Gabriel,0,0,0,0
1748419938944,ECE 225A,A00,919525,Orlitsky; Alon,0,0,0,0
1748419939972,ECE 230A,A00,919526,Nomura; Kenji,0,0,0,0
1748419941002,ECE 238A,A00,919540,Luo; Jian,0,0,0,0
1748419942028,ECE 240A,A00,919541,Ndao; Abdoulaye,0,0,0,0
1748419943058,ECE 247A,A00,919553,Shi; Lingyan,0,0,0,0
1748419944084,ECE 247B,A00,919562,Aran; Kiana,0,0,0,0
1748419945115,ECE 250,A00,919563,Naghizadeh Ardabili; Parinaz,0,0,0,0
1748419946140,ECE 251C,A00,919583,Parhi; Rahul,0,0,0,0
1748419947168,ECE 253,A00,919597,Nguyen; Truong Quang,0,0,0,0
1748419948195,ECE 255A,A00,919638,Orlitsky; Alon,0,0,0,0
1748419949222,ECE 257A,A01,919640,Zhang; Xinyu,0,0,0,0
1748419950253,ECE 258A,A00,919653,Heath Jr.; Robert Wendell,0,0,0,0
1748419951278,ECE 260A,A01,919655,Eldon; John,0,0,0,0
1748419952304,ECE 264C,A00,919656,Galton; Ian A,0,0,0,0
1748419953403,ECE 265C,A00,919672,Staff,0,0,0,0
1748419954429,ECE 271A,A00,919673,Vasconcelos; Nuno,0,0,0,0
1748419955460,ECE 276C,A00,919674,Yip; Michael,0,0,0,0
1748419956491,ECE 283,A00,919675,Le; Hanh-Phuc,0,0,0,0
1748419956491,ECE 283,B00,919676,Hall; Drew A.,0,0,0,0
1748419957518,ECE 284,A00,919691,Kang; Mingu,0,0,0,0
1748419958543,ECE 285,A00,919718,Naghizadeh Ardabili; Parinaz,0,0,0,0
1748419959586,ECON 1,A01,917129,Famulari; Melissa,33,0,40,7
1748419959586,ECON 1,A02,917130,Famulari; Melissa,39,0,40,1
1748419959586,ECON 1,A03,917131,Famulari; Melissa,45,0,45,0
1748419959586,ECON 1,B01,917133,Famulari; Melissa,39,0,40,1
1748419959586,ECON 1,B02,917134,Famulari; Melissa,38,0,40,2
1748419959586,ECON 1,B03,917135,Famulari; Melissa,45,0,45,0
1748419959586,ECON 1,C01,917137,Levkoff; Steven B.,53,0,60,7
1748419959586,ECON 1,C02,917138,Levkoff; Steven B.,60,0,60,0
1748419959586,ECON 1,C03,917139,Levkoff; Steven B.,59,0,60,1
1748419959586,ECON 1,C04,917140,Levkoff; Steven B.,60,0,60,0
1748419959586,ECON 1,C05,917141,Levkoff; Steven B.,59,0,60,1
1748419959586,ECON 1,D01,917144,Levkoff; Steven B.,44,0,50,6
1748419959586,ECON 1,D02,917145,Levkoff; Steven B.,50,0,50,0
1748419959586,ECON 1,D03,917146,Levkoff; Steven B.,50,0,50,0
1748419959586,ECON 1,D04,917154,Levkoff; Steven B.,50,0,50,0
1748419960614,ECON 2,A01,917160,Crane; Meredith Helen,35,0,45,10
1748419960614,ECON 2,A02,917164,Crane; Meredith Helen,43,0,45,2
1748419961641,ECON 3,A01,917170,Ma; Alyson Chan,41,0,60,19
1748419962667,ECON 4,A01,917174,Brooks; Marcus Raymond,0,0,0,0
1748419963695,ECON 5,A01,917177,Staff,12,0,30,18
1748419963695,ECON 5,B01,917182,Staff,16,0,30,14
1748419963695,ECON 5,C01,917193,Dai; Yinlin,0,0,30,30
1748419964722,ECON 86,A00,917197,Muendler; Marc,95,0,100,5
1748419965749,ECON 100A,A01,917209,Newhouse; Herbert S,32,0,50,18
1748419965749,ECON 100A,A02,917212,Newhouse; Herbert S,35,0,50,15
1748419965749,ECON 100A,A03,917213,Newhouse; Herbert S,42,0,50,8
1748419965749,ECON 100A,B01,917216,Newhouse; Herbert S,0,0,50,50
1748419965749,ECON 100A,B02,917298,Newhouse; Herbert S,22,0,50,28
1748419965749,ECON 100A,B03,917301,Newhouse; Herbert S,44,0,50,6
1748419966776,ECON 100B,A01,917305,Crane; Meredith Helen,0,0,75,75
1748419966776,ECON 100B,B01,917309,Crane; Meredith Helen,0,0,75,75
1748419967803,ECON 100C,A01,917311,Staff,0,0,25,25
1748419968829,ECON 109,A01,917313,Shishkin; Denis,58,0,65,7
1748419968829,ECON 109,B01,917315,Shishkin; Denis,59,0,75,16
1748419969857,ECON 110A,A01,917336,Jaimovich; Nir,44,0,70,26
1748419969857,ECON 110A,B01,917339,Jaimovich; Nir,19,0,37,18
1748419969857,ECON 110A,B02,917341,Jaimovich; Nir,36,0,38,2
1748419970893,ECON 110B,A01,917388,Trottner; Fabian Gunter We,0,0,50,50
1748419970893,ECON 110B,A02,917389,Trottner; Fabian Gunter We,0,0,50,50
1748419970893,ECON 110B,A03,917390,Trottner; Fabian Gunter We,14,0,50,36
1748419970893,ECON 110B,B01,917396,Trottner; Fabian Gunter We,26,0,50,24
1748419971924,ECON 120A,A01,917401,Dai; Yinlin,21,0,50,29
1748419971924,ECON 120A,A02,917405,Dai; Yinlin,40,0,50,10
1748419971924,ECON 120A,B01,917408,Dai; Yinlin,0,0,40,40
1748419971924,ECON 120A,B02,917409,Dai; Yinlin,0,0,40,40
1748419971924,ECON 120A,B03,917410,Dai; Yinlin,31,0,40,9
1748419972959,ECON 120B,A01,917415,Candido; Maria Teresa,0,0,98,98
1748419972959,ECON 120B,A02,917418,Candido; Maria Teresa,78,0,98,20
1748419972959,ECON 120B,B01,917422,Candido; Maria Teresa,34,0,98,64
1748419972959,ECON 120B,B02,917423,Candido; Maria Teresa,75,0,98,23
1748419973985,ECON 120C,A01,917505,Candido; Maria Teresa,81,0,146,65
1748419975011,ECON 121,A00,917511,Vogl; Tom Saul,68,0,70,2
1748419975011,ECON 121,B00,917516,Vogl; Tom Saul,55,0,70,15
1748419976035,ECON 130,A00,917518,Staff,165,0,190,25
1748419977062,ECON 131,A00,917519,Jacobsen; Mark,56,0,120,64
1748419978089,ECON 139,A00,917520,Arnold; David Hall,21,0,50,29
1748419979116,ECON 152,A00,917523,Fadlon; Yizhak,87,0,90,3
1748419979116,ECON 152,B00,917524,Fadlon; Yizhak,88,0,90,2
1748419980141,ECON 181,A00,965256,Esfahani; Sara,88,0,100,12
1748419981168,ECON 186,A00,917525,Ross; Stephen Geoffrey,80,0,110,30
1748419982204,ECON 191B,A00,917527,Cullen; Julie,20,0,20,0
1748419983231,ECON 200A,A00,917529,Shishkin; Denis,20,0,20,0
1748419984261,ECON 204,A00,917531,Watson; Joel Christopher,25,0,25,0
1748419985291,ECON 205,A00,917532,Du; Songzi,20,0,20,0
1748419986317,ECON 210A,A00,917536,Alon; Titan Michael,20,0,20,0
1748419987351,ECON 220A,A00,917537,Elliott; Graham,20,0,20,0
1748419988380,ECON 220D,A00,917538,Hamilton; James D.,22,0,30,8
1748419989411,ECON 221,A00,960527,Zhu; Ying,20,0,20,0
1748419990441,ECON 232,A00,917539,Fadlon; Yizhak,18,0,20,2
1748419991472,ECON 242,A00,917540,Vogl; Tom Saul & Lee; Munseob,17,0,20,3
1748419992503,ECON 250A,A00,917544,Berman; Eli & Betts; Julian & Arnold; David Hall,21,0,25,4
1748419993529,ECON 262,A00,917546,Trevino; Isabel,20,0,20,0
1748419994555,ECON 268,A00,917547,Boomhower; Judson P,18,0,20,2
1748419995585,ECON 280,A00,917549,Arnold; David Hall,20,0,20,0
1748419996612,ECON 281,A00,917550,Jacobsen; Mark,20,0,20,0
1748419996612,ECON 281,B00,917553,Jaimovich; Nir,15,0,20,5
1748419997638,ECON 285,A00,917554,Bharadwaj; Prashant & Zhu; Ying,24,0,25,1
1748419998675,ECON 286,A00,917556,Ma; Xinwei,20,0,20,0
1748419998675,ECON 286,B00,917558,Eckert; Fabian Paul & Wu; Pak Yeung,20,0,20,0
1748419998675,ECON 286,C00,917559,Bharadwaj; Prashant,20,0,20,0
1748419998675,ECON 286,D00,969571,Cullen; Julie,20,0,20,0
1748419998675,ECON 286,E00,969572,Vespa; Emanuel Ignacio,19,0,20,1
1748419999704,ECON 296,A00,917565,Bharadwaj; Prashant & Zhu; Ying,24,0,25,1
1748420000732,EDS 31,A00,960270,Bussey; Thomas J,5,0,10,5
1748420001765,EDS 88,A00,960441,Bintliff; Amy S.V.,16,0,20,4
1748420002796,EDS 110R,A01,943452,Wishard Guerra; Alison G.,33,0,60,27
1748420002796,EDS 110R,B01,960792,Wishard Guerra; Alison G.,20,0,20,0
1748420003823,EDS 111,A00,969314,Cohen; Shana R,31,0,60,29
1748420004852,EDS 112,A00,969313,Chapman; Thandeka K,32,0,50,18
1748420005878,EDS 114,A01,943493,Eguchi; Emi,19,0,20,1
1748420005878,EDS 114,A02,943494,Eguchi; Emi,18,0,20,2
1748420006906,EDS 115,A00,943495,Jones; Gabrielle Anastasia,46,0,60,14
1748420007934,EDS 117,A01,943675,Jones; Makeba,17,0,37,20
1748420007934,EDS 117,A02,943682,Jones; Makeba,36,0,37,1
1748420007934,EDS 117,A03,943683,Jones; Makeba,33,0,38,5
1748420007934,EDS 117,A04,943691,Jones; Makeba,35,0,38,3
1748420007934,EDS 117,B01,943693,Jones; Gabrielle Anastasia,21,0,30,9
1748420007934,EDS 117,B02,943694,Jones; Gabrielle Anastasia,27,0,30,3
1748420007934,EDS 117,B03,943695,Jones; Gabrielle Anastasia,28,0,30,2
1748420007934,EDS 117,B04,943696,Jones; Gabrielle Anastasia,30,0,30,0
1748420008965,EDS 124AR,A00,943698,Simon; Elizabeth A,129,0,150,21
1748420008965,EDS 124AR,B00,943699,Simon; Elizabeth A,149,0,150,1
1748420008965,EDS 124AR,C00,961307,Simon; Elizabeth A,40,0,40,0
1748420009992,EDS 124BR,A00,943700,Eguchi; Emi,122,0,150,28
1748420009992,EDS 124BR,B00,961276,Eguchi; Emi,20,0,20,0
1748420011020,EDS 125,A00,943701,Jones; Gabrielle Anastasia,49,0,60,11
1748420012052,EDS 129A,A01,943703,Heinzman; Erica M.,48,0,50,2
1748420013082,EDS 130,A01,943705,Staff,6,0,20,14
1748420013082,EDS 130,A02,943706,Staff,18,0,20,2
1748420013082,EDS 130,A03,943707,Staff,20,0,20,0
1748420014110,EDS 131,A01,943709,Staff,8,0,20,12
1748420014110,EDS 131,A02,943710,Staff,17,0,20,3
1748420015137,EDS 133,A01,960443,Bintliff; Amy S.V.,20,0,25,5
1748420015137,EDS 133,A02,960447,Bintliff; Amy S.V.,15,0,15,0
1748420016165,EDS 139,A00,943725,Heinzman; Erica M.,40,0,50,10
1748420016165,EDS 139,B00,943726,Staff,29,0,50,21
1748420016165,EDS 139,C00,943788,Staff,34,0,50,16
1748420016165,EDS 139,E00,943802,Bintliff; Amy S.V.,42,0,50,8
1748420016165,EDS 139,F00,960448,Bintliff; Amy S.V.,40,0,40,0
1748420017191,EDS 149,A00,943814,Black; Alison Michelle,20,0,20,0
1748420018218,EDS 201,A00,943816,Fine; Sarah,44,0,45,1
1748420019252,EDS 203,A01,943818,Eguchi; Emi,44,0,45,1
1748420020279,EDS 205A,A00,943819,Staff,44,0,45,1
1748420021306,EDS 246,A01,943855,Cohen; Shana R,10,0,10,0
1748420022334,EDS 250,A00,943856,Chapman; Thandeka K,49,0,50,1
1748420023364,EDS 251,A00,943862,Wishard Guerra; Alison G.,10,0,10,0
1748420024393,EDS 257,A00,943863,Datnow; Amanda Lee,7,0,10,3
1748420025423,EDS 283,A00,943871,Daly; Alan J.,15,0,15,0
1748420026449,EDS 285,A00,943872,Daly; Alan J.,15,0,15,0
1748420027474,EDS 286,A00,943873,Daly; Alan J.,15,0,15,0
1748420028501,EDS 289D,A00,943874,Hofstetter; Carolyn,15,0,15,0
1748420029531,EDS 292,A00,943876,Hofstetter; Carolyn,15,0,15,0
1748420030579,EDS 296,001,970523,Aragon; Maria Jose,9999,0,9999,0
1748420030579,EDS 296,002,970539,Bintliff; Amy S.V.,9997,0,9999,2
1748420030579,EDS 296,003,970543,Chapman; Thandeka K,9999,0,9999,0
1748420030579,EDS 296,004,970544,Clarke; Sherice Nicole,9999,0,9999,0
1748420030579,EDS 296,005,970587,Cohen; Shana R,9998,0,9999,1
1748420030579,EDS 296,006,970606,Daly; Alan J.,9998,0,9999,1
1748420030579,EDS 296,007,970607,Datnow; Amanda Lee,9997,0,9999,2
1748420030579,EDS 296,008,970608,Eguchi; Emi,9999,0,9999,0
1748420030579,EDS 296,009,970609,Fine; Sarah,9999,0,9999,0
1748420030579,EDS 296,010,970614,Hofstetter; Carolyn,9998,0,9999,1
1748420030579,EDS 296,011,970615,Hopkins; Megan Beth,9998,0,9999,1
1748420030579,EDS 296,012,970616,Jones; Makeba,9999,0,9999,0
1748420030579,EDS 296,013,970631,Jones; Gabrielle Anastasia,9999,0,9999,0
1748420030579,EDS 296,014,970636,Mamas; Christoforos,9998,0,9999,1
1748420030579,EDS 296,015,970649,Phuong; Andrew,9999,0,9999,0
1748420030579,EDS 296,016,970670,Pollock; Mica,9999,0,9999,0
1748420030579,EDS 296,017,970671,Wishard Guerra; Alison G.,9998,0,9999,1
1748420031605,EDS 297,001,972987,Staff,1,0,1,0
1748420032631,ENG 5,A00,916064,Rodriguez; Ruben,70,0,70,0
1748420033662,ENG 10,A00,916066,Evdokimenko; Ekaterina,58,0,60,2
1748420034690,ENG 15,A00,916067,Evdokimenko; Ekaterina,24,0,30,6
1748420035718,ENG 100D,A00,916069,Ngo; Anh-Thu T.,23,0,50,27
1748420036745,ENG 100L,A00,916070,Kleissl; Jan,8,0,8,0
1748420036745,ENG 100L,B00,916071,Bratton; Maryann,8,0,8,0
1748420036745,ENG 100L,C00,916072,Goldberg; Charles G.,8,0,8,0
1748420036745,ENG 100L,D00,916073,de Oliveira; Mauricio,8,0,8,0
1748420036745,ENG 100L,E00,916074,Bratton; Maryann,8,0,8,0
1748420036745,ENG 100L,F00,916075,Boyle; Mary E. T.,8,0,8,0
1748420037775,ENVR 30,A01,959899,Amoa-Bosompem; Michael,17,0,30,13
1748420037775,ENVR 30,A02,959900,Amoa-Bosompem; Michael,27,0,30,3
1748420037775,ENVR 30,A03,959901,Amoa-Bosompem; Michael,26,0,30,4
1748420037775,ENVR 30,A04,959902,Amoa-Bosompem; Michael,28,0,30,2
1748420037775,ENVR 30,A05,959903,Amoa-Bosompem; Michael,29,0,30,1
1748420037775,ENVR 30,A06,959904,Amoa-Bosompem; Michael,30,0,30,0
1748420038803,ENVR 102,A00,960031,Laughing; Cheron,23,0,25,2
1748420039841,ERC 20,A00,921227,Evans; Ivan T,30,0,30,0
1748420039841,ERC 20,B00,921229,Evans; Ivan T,30,0,30,0
1748420040868,ERC 88,A00,961214,Peterson; Johanna L,19,0,20,1
1748420041895,ESYS 101,A01,921233,Taylor; Jennifer Rebecca,21,0,32,11
1748420041895,ESYS 101,A02,921234,Taylor; Jennifer Rebecca,14,0,32,18
1748420041895,ESYS 101,A03,921235,Taylor; Jennifer Rebecca,20,0,32,12
1748420041895,ESYS 101,A04,921241,Taylor; Jennifer Rebecca,26,0,32,6
1748420042923,ESYS 187A,A01,921248,Hetherington; Elizabeth Dorsey,30,0,40,10
1748420042923,ESYS 187A,B01,921250,Shipp; Lauren Elizabeth,27,0,40,13
1748420043961,ETHN 1,A01,919800,Wilson; Brenda K,13,0,15,2
1748420043961,ETHN 1,A02,919843,Wilson; Brenda K,14,0,15,1
1748420043961,ETHN 1,A03,920214,Wilson; Brenda K,15,0,15,0
1748420043961,ETHN 1,A04,920215,Wilson; Brenda K,14,0,15,1
1748420043961,ETHN 1,A05,920223,Wilson; Brenda K,15,0,15,0
1748420043961,ETHN 1,A06,920224,Wilson; Brenda K,15,0,15,0
1748420043961,ETHN 1,A07,920225,Wilson; Brenda K,15,0,15,0
1748420043961,ETHN 1,A08,920226,Wilson; Brenda K,12,0,15,3
1748420043961,ETHN 1,A09,920237,Wilson; Brenda K,15,0,15,0
1748420043961,ETHN 1,A10,920368,Wilson; Brenda K,15,0,15,0
1748420043961,ETHN 1,A11,920402,Wilson; Brenda K,15,0,15,0
1748420043961,ETHN 1,A12,920406,Wilson; Brenda K,15,0,15,0
1748420043961,ETHN 1,A13,920410,Wilson; Brenda K,14,0,15,1
1748420043961,ETHN 1,A14,920441,Wilson; Brenda K,14,0,15,1
1748420044990,ETHN 20R,A01,920461,Sasaki; Christen T,0,0,15,15
1748420044990,ETHN 20R,A02,920467,Sasaki; Christen T,0,0,15,15
1748420044990,ETHN 20R,A03,920468,Sasaki; Christen T,0,0,15,15
1748420044990,ETHN 20R,A04,920470,Sasaki; Christen T,0,0,15,15
1748420046017,ETHN 100A,A00,920489,Patel; Shaista,18,0,35,17
1748420047044,ETHN 101TV,A01,920518,Gallagher-Geurtsen; Tricia Meghan,21,0,25,4
1748420047044,ETHN 101TV,A02,920519,Gallagher-Geurtsen; Tricia Meghan,20,0,25,5
1748420047044,ETHN 101TV,A03,920522,Gallagher-Geurtsen; Tricia Meghan,24,0,25,1
1748420047044,ETHN 101TV,A04,920523,Gallagher-Geurtsen; Tricia Meghan,23,0,25,2
1748420048072,ETHN 110,A00,920528,Klann; Mary Cameron,27,0,35,8
1748420049100,ETHN 116,A00,920529,Cuong; Marisol,29,0,35,6
1748420050130,ETHN 120,A00,920542,Tran; Ly Thi Hai,31,0,35,4
1748420051158,ETHN 122A,A00,920559,Museus; Samuel David,30,0,35,5
1748420052185,ETHN 125R,A00,920694,Sasaki; Christen T,0,0,35,35
1748420053219,ETHN 130,A00,920703,Frank; Ross H.,28,0,30,2
1748420054246,ETHN 139,A00,920704,Ruiz; Ariana,18,0,20,2
1748420055278,ETHN 150,A00,920717,Taylor-Garcia; Daphne,16,0,16,0
1748420056307,ETHN 161,A00,920826,Browne; Errol Tsekani,33,0,35,2
1748420057406,ETHN 174,A00,963091,Staff,15,0,15,0
1748420058436,ETHN 186,A00,959881,Perez; Roy,25,0,30,5
1748420059462,ETHN 187,A00,920860,Martin Sandino; Amanda Maria Yoland,16,0,16,0
1748420060488,ETHN 189,A00,920861,Museus; Samuel David,18,0,20,2
1748420061516,ETHN 200A,A00,920862,Espiritu; Yen,7,0,10,3
1748420062546,ETHN 230,A00,920864,Perreira; Christopher Michael,8,0,10,2
1748420063575,ETIM 289,A00,921224,Patel; Shaista,10,0,10,0
1748420064601,EXPR 100,A00,964355,Staff,9999,0,9999,0
1748420065627,EXPR 105,A00,964356,Staff,9999,0,9999,0
1748420066653,EXPR 201,A00,964357,Staff,9999,0,9999,0
1748420067680,EXPR 205,A00,964358,Staff,9999,0,9999,0
1748420068708,FILM 71,A01,960804,Park; Joanne Moeun,0,0,11,11
1748420068708,FILM 71,B01,960877,Park; Joanne Moeun,3,0,11,8
1748420069740,FILM 72,A01,964349,Kroopf; Jackson Stanford,9,0,11,2
1748420069740,FILM 72,B01,964351,Kroopf; Jackson Stanford,9,0,11,2
1748420070767,FILM 73,A01,964345,Staff,0,0,0,0
1748420070767,FILM 73,B01,964347,Kroopf; Jackson Stanford,7,0,11,4
1748420071794,FMPH 291,A00,969582,Tsuyuki; Kiyomi,10,0,10,0
1748420072821,FPM 291,A00,922036,Rabin; Adrienn Borsika & Stadnick; Nicole & Aarons; Gregory A,12,0,12,0
1748420073848,GLBH 20,A00,921344,Elwardani; Nile Regina,137,0,146,9
1748420074877,GLBH 100,A00,921503,Jenkins; Janis A.,5,0,12,7
1748420074877,GLBH 100,B00,921504,Schonberg; Jeffrey,18,0,20,2
1748420075903,GLBH 111,A01,921733,Burgos; Jose L.,17,0,17,0
1748420075903,GLBH 111,B01,921862,Burgos; Jose L.,17,0,17,0
1748420076947,GLBH 114,A00,921864,Olivas Hernandez; Olga Lid,42,0,50,8
1748420077974,GLBH 116,A00,921865,Villarino; Margarita,41,0,45,4
1748420079001,GLBH 117,A00,921873,Villarino; Margarita,40,0,40,0
1748420080031,GLBH 118,A00,921884,Wilson; Brenda K,25,0,32,7
1748420081062,GLBH 119,A00,921956,Elwardani; Nile Regina,40,0,40,0
1748420082089,GLBH 148,A00,921961,Walkover; Lillian B,75,0,100,25
1748420083119,GLBH 181,A00,921962,Burgos; Jose L.,188,0,216,28
1748420084145,GLBH 200,A00,921963,Schonberg; Jeffrey,15,0,18,3
1748420085171,GLBH 201,A00,921982,Staff,16,0,18,2
1748420086202,GLBH 248,A00,921999,Kaiser; Bronwyn Nicole,16,0,18,2
1748420087229,GPEC 243,A00,946441,McCord; Gordon Carlos,96,0,100,4
1748420088260,GSS 20,A00,923030,Siapno; Jacqueline A,38,0,40,2
1748420088260,GSS 20,B00,923031,Siapno; Jacqueline A,36,0,40,4
1748420089288,HDS 1,A01,923033,Reese; Clarissa Jane,25,0,25,0
1748420089288,HDS 1,A02,923034,Reese; Clarissa Jane,20,0,25,5
1748420089288,HDS 1,A03,923035,Reese; Clarissa Jane,19,0,25,6
1748420089288,HDS 1,A04,923036,Reese; Clarissa Jane,22,0,25,3
1748420089288,HDS 1,A05,923037,Reese; Clarissa Jane,22,0,25,3
1748420089288,HDS 1,A06,923038,Reese; Clarissa Jane,23,0,25,2
1748420089288,HDS 1,A07,923039,Reese; Clarissa Jane,24,0,25,1
1748420090314,HDS 60,A01,923041,Staff,25,0,30,5
1748420090314,HDS 60,A02,923042,Staff,21,0,30,9
1748420091344,HDS 111,A00,923043,Staff,13,0,40,27
1748420092371,HDS 124,A00,923044,Staff,29,0,40,11
1748420093401,HDS 150,A00,923045,Staff,20,0,20,0
1748420094427,HDS 175,A00,923046,Staff,14,0,25,11
1748420095452,HDS 181,A01,923048,Staff,30,0,30,0
1748420096478,HDS 191,A01,923050,Reese; Clarissa Jane,25,0,25,0
1748420097505,HIEA 112,A00,922103,Matsumura; Wendy Y,92,0,115,23
1748420098532,HIEA 153,A00,922106,Henry; Todd A.,43,0,51,8
1748420099563,HIEU 108,A00,922108,Balberg; Mira,30,0,70,40
1748420100589,HIEU 114,A00,959889,Staff,59,0,70,11
1748420101615,HIEU 139,A00,922110,Strasser; Ulrike,40,0,51,11
1748420102641,HIEU 140,A00,922111,Radcliff; Pamela B.,58,0,65,7
1748420103666,HIEU 154,A00,922113,Hansen; Jan Eric,55,0,65,10
1748420104694,HIEU 158,A00,922116,Hertz; Deborah,61,0,70,9
1748420105775,HIEU 171,A00,922117,Hertz; Deborah,15,0,15,0
1748420106801,HIEU 271,A00,922189,Hertz; Deborah,0,0,0,0
1748420107829,HIGR 200,A00,922191,Matsumura; Wendy Y,10,0,10,0
1748420108856,HIGR 210,A00,922221,Muscolino; Micah S,8,0,10,2
1748420109886,HIGR 222,A00,963094,Biess; Frank Peter,10,0,10,0
1748420110913,HIGR 238,A00,922242,McKenzie; Kerry V.,9,0,10,1
1748420111940,HIGR 240,A00,922253,McKenzie; Kerry V.,10,0,10,0
1748420113171,HIGR 267A,A00,922256,Widener; Daniel,8,0,10,2
1748420115227,HILA 114,A00,922118,Cowan; Benjamin A,42,0,65,23
1748420116257,HILA 131,A00,922125,Vitz; Matthew,91,0,99,8
1748420117283,HILA 161,A00,922126,Cowan; Benjamin A,12,0,15,3
1748420118314,HILD 2A,A01,922043,Staff,31,0,32,1
1748420118314,HILD 2A,A02,922044,Staff,31,0,32,1
1748420118314,HILD 2A,A03,922046,Staff,28,0,32,4
1748420118314,HILD 2A,A04,922047,Staff,32,0,32,0
1748420118314,HILD 2A,A05,922051,Staff,30,0,32,2
1748420119343,HILD 7A,A01,922063,Widener; Daniel,31,0,32,1
1748420119343,HILD 7A,A02,922066,Widener; Daniel,31,0,32,1
1748420119343,HILD 7A,A03,922067,Widener; Daniel,32,0,32,0
1748420119343,HILD 7A,A04,922070,Widener; Daniel,28,0,32,4
1748420119343,HILD 7A,A05,922072,Widener; Daniel,32,0,32,0
1748420119343,HILD 7A,A06,922074,Widener; Daniel,32,0,32,0
1748420119343,HILD 7A,A07,922078,Widener; Daniel,29,0,32,3
1748420119343,HILD 7A,A08,922080,Widener; Daniel,32,0,32,0
1748420119343,HILD 7A,A09,922081,Widener; Daniel,32,0,32,0
1748420119343,HILD 7A,A10,922082,Widener; Daniel,32,0,32,0
1748420119343,HILD 7A,A11,922083,Widener; Daniel,32,0,32,0
1748420119343,HILD 7A,A12,922084,Widener; Daniel,32,0,32,0
1748420120368,HILD 10,A01,922089,Muscolino; Micah S,30,0,32,2
1748420120368,HILD 10,A02,922090,Muscolino; Micah S,28,0,32,4
1748420120368,HILD 10,A03,922092,Muscolino; Micah S,31,0,32,1
1748420120368,HILD 10,A04,922095,Muscolino; Micah S,30,0,32,2
1748420121396,HILD 14,A01,959886,Murillo; Dana V.,26,0,32,6
1748420121396,HILD 14,A02,959887,Murillo; Dana V.,32,0,32,0
1748420122428,HINE 144,A00,922132,Provence; Michael,40,0,45,5
1748420123457,HINE 186,A00,922133,Provence; Michael,15,0,15,0
1748420124485,HISA 110,A00,922136,De; Aniket,38,0,45,7
1748420125511,HISA 122,A00,959884,De; Aniket,12,0,15,3
1748420126541,HISC 107,A00,922137,Golan; Tal,41,0,45,4
1748420127568,HISC 131,A00,922148,Golan; Tal,45,0,51,6
1748420128595,HITO 87,A00,922097,Patterson; Patrick H.,0,0,0,0
1748420128595,HITO 87,B00,922098,Patterson; Patrick H.,0,0,0,0
1748420129621,HITO 100,A00,922150,Martinez-Matsuda; Veronica,0,0,17,17
1748420130647,HITO 193,A00,954127,Hill; Seth J,9999,0,9999,0
1748420131677,HITO 194,001,970059,Hertz; Deborah,1,0,1,0
1748420131677,HITO 194,002,970084,Daly; Heather Marie,1,0,1,0
1748420131677,HITO 194,003,970086,Plant; Rebecca Jo,1,0,1,0
1748420131677,HITO 194,004,970093,Henry; Todd A.,1,0,1,0
1748420131677,HITO 194,005,970094,Biess; Frank Peter,1,0,1,0
1748420131677,HITO 194,006,970095,Shafir; Nir,1,0,1,0
1748420131677,HITO 194,007,970099,Martinez-Matsuda; Veronica,1,0,1,0
1748420131677,HITO 194,008,970101,De; Aniket,1,0,1,0
1748420131677,HITO 194,009,970126,Kwak; Nancy,1,0,1,0
1748420131677,HITO 194,010,970128,Muscolino; Micah S,1,0,1,0
1748420131677,HITO 194,011,970129,Hendrickson; Gerald M.,1,0,1,0
1748420131677,HITO 194,012,970132,Balberg; Mira,1,0,1,0
1748420132708,HITO 196,A00,922151,Man; Simeon S,14,0,22,8
1748420133736,HIUS 105,A00,922152,Bermudez; Rosie Cano,22,0,35,13
1748420134768,HIUS 106,A00,922154,Bermudez; Rosie Cano,53,0,65,12
1748420135799,HIUS 144,A00,922156,Daly; Heather Marie,31,0,35,4
1748420136826,HIUS 158,A00,922163,Frank; Ross H.,12,0,20,8
1748420137856,HIUS 181,A00,922187,Daly; Heather Marie,8,0,15,7
1748420138883,HIUS 281,A00,922264,Daly; Heather Marie,0,0,0,0
1748420139914,HUM 1,A01,946360,Markman; Kristina,14,0,15,1
1748420139914,HUM 1,A02,946361,Markman; Kristina,12,0,15,3
1748420139914,HUM 1,A03,946362,Markman; Kristina,14,0,15,1
1748420139914,HUM 1,A04,946363,Markman; Kristina,11,0,15,4
1748420139914,HUM 1,A05,946364,Markman; Kristina,14,0,15,1
1748420139914,HUM 1,A06,946365,Markman; Kristina,14,0,15,1
1748420139914,HUM 1,A07,946366,Markman; Kristina,14,0,15,1
1748420139914,HUM 1,A08,946367,Markman; Kristina,12,0,15,3
1748420139914,HUM 1,A09,946368,Markman; Kristina,13,0,15,2
1748420139914,HUM 1,A10,946369,Markman; Kristina,11,0,15,4
1748420139914,HUM 1,A11,946370,Markman; Kristina,6,0,15,9
1748420139914,HUM 1,A12,946371,Markman; Kristina,15,0,15,0
1748420140947,HUM 3,A01,946373,West; Geoffrey Scott,20,0,28,8
1748420140947,HUM 3,A02,946374,West; Geoffrey Scott,14,0,28,14
1748420140947,HUM 3,A03,946375,West; Geoffrey Scott,13,0,28,15
1748420140947,HUM 3,A04,946376,West; Geoffrey Scott,9,0,28,19
1748420140947,HUM 3,A05,946377,West; Geoffrey Scott,8,0,28,20
1748420140947,HUM 3,A06,946378,West; Geoffrey Scott,22,0,28,6
1748420140947,HUM 3,A07,946379,West; Geoffrey Scott,23,0,28,5
1748420140947,HUM 3,A08,946380,West; Geoffrey Scott,15,0,28,13
1748420140947,HUM 3,A09,946381,West; Geoffrey Scott,0,0,0,0
1748420140947,HUM 3,A10,946382,West; Geoffrey Scott,0,0,0,0
1748420140947,HUM 3,C01,946393,Crum; Matthew Stephen,0,0,0,0
1748420140947,HUM 3,C02,946394,Crum; Matthew Stephen,0,0,0,0
1748420140947,HUM 3,C03,946395,Crum; Matthew Stephen,17,0,28,11
1748420140947,HUM 3,C04,946396,Crum; Matthew Stephen,25,0,28,3
1748420140947,HUM 3,C05,946397,Crum; Matthew Stephen,16,0,28,12
1748420140947,HUM 3,C06,946398,Crum; Matthew Stephen,20,0,28,8
1748420140947,HUM 3,C07,946399,Crum; Matthew Stephen,24,0,28,4
1748420140947,HUM 3,C08,946400,Crum; Matthew Stephen,26,0,28,2
1748420140947,HUM 3,C09,946401,Crum; Matthew Stephen,18,0,28,10
1748420140947,HUM 3,C10,946402,Crum; Matthew Stephen,22,0,28,6
1748420140947,HUM 3,D01,946404,Rodriguez; Bretton Sigfred,4,0,28,24
1748420140947,HUM 3,D02,946405,Rodriguez; Bretton Sigfred,16,0,28,12
1748420140947,HUM 3,D03,946406,Rodriguez; Bretton Sigfred,25,0,28,3
1748420140947,HUM 3,D04,946407,Rodriguez; Bretton Sigfred,12,0,28,16
1748420140947,HUM 3,D05,946408,Rodriguez; Bretton Sigfred,12,0,28,16
1748420140947,HUM 3,D06,946409,Rodriguez; Bretton Sigfred,19,0,28,9
1748420140947,HUM 3,D07,946410,Rodriguez; Bretton Sigfred,0,0,0,0
1748420140947,HUM 3,D08,946411,Rodriguez; Bretton Sigfred,0,0,0,0
1748420140947,HUM 3,D09,946412,Rodriguez; Bretton Sigfred,7,0,28,21
1748420140947,HUM 3,D10,946413,Rodriguez; Bretton Sigfred,20,0,28,8
1748420141977,HUM 88,A00,969578,Markman; Kristina,0,0,0,0
1748420143005,HUM 100,A00,946414,West; Geoffrey Scott,14,0,16,2
1748420143005,HUM 100,B00,946415,West; Geoffrey Scott,15,0,16,1
1748420143005,HUM 100,C00,946416,Zavodny; Tatiana Sophia,13,0,16,3
1748420143005,HUM 100,D00,946417,Zavodny; Tatiana Sophia,15,0,16,1
1748420143005,HUM 100,E00,946419,Zavodny; Tatiana Sophia,15,0,16,1
1748420143005,HUM 100,F00,946420,Crum; Matthew Stephen,0,0,0,0
1748420143005,HUM 100,G00,946421,Crum; Matthew Stephen,0,0,0,0
1748420143005,HUM 100,H00,946422,Crum; Matthew Stephen,16,0,16,0
1748420143005,HUM 100,I00,946424,Staff,0,0,0,0
1748420143005,HUM 100,J00,946425,Crum; Matthew Stephen,16,0,16,0
1748420143005,HUM 100,K00,946426,Staff,0,0,0,0
1748420144041,INTL 100,A01,960908,Feuer; Anna Stagg,9,0,20,11
1748420144041,INTL 100,A02,960964,Feuer; Anna Stagg,16,0,20,4
1748420144041,INTL 100,A03,961088,Feuer; Anna Stagg,15,0,20,5
1748420144041,INTL 100,A04,961091,Feuer; Anna Stagg,17,0,20,3
1748420144041,INTL 100,A05,961100,Feuer; Anna Stagg,16,0,20,4
1748420144041,INTL 100,A06,961130,Feuer; Anna Stagg,19,0,20,1
1748420154547,INTL 101,A01,923053,McIntosh; Justin,1,0,30,29
1748420154547,INTL 101,A02,923055,McIntosh; Justin,8,0,30,22
1748420154547,INTL 101,A03,923127,McIntosh; Justin,5,0,30,25
1748420154547,INTL 101,A04,923140,McIntosh; Justin,0,0,30,30
1748420154547,INTL 101,A05,923148,McIntosh; Justin,9,0,30,21
1748420154547,INTL 101,A06,923186,McIntosh; Justin,10,0,30,20
1748420155578,INTL 102,A01,923194,Prather; Lauren R,3,0,30,27
1748420155578,INTL 102,A02,923195,Prather; Lauren R,4,0,30,26
1748420155578,INTL 102,A03,923199,Prather; Lauren R,13,0,30,17
1748420155578,INTL 102,A04,923202,Prather; Lauren R,8,0,30,22
1748420156605,INTL 190,A00,923203,Segui; Alan S,0,0,0,5
1748420156605,INTL 190,B00,923205,Segui; Alan S,0,0,0,9
1748420156605,INTL 190,C00,923219,Lee; Munseob,0,0,0,5
1748420157631,INTL 190H,A00,923247,Feuer; Anna Stagg,0,0,0,1
1748420158682,JAPN 10A,A01,923258,Kamioka; Sachiko,22,0,23,1
1748420158682,JAPN 10A,B01,923261,Ross; Kayoko F,23,0,23,0
1748420158682,JAPN 10A,C01,923265,Sato; Kyoko,20,0,23,3
1748420158682,JAPN 10A,D01,923268,Inada; Minori,22,0,23,1
1748420158682,JAPN 10A,E01,923270,Tipton; Yuko,9,0,12,3
1748420158682,JAPN 10A,E02,923273,Tipton; Yuko,12,0,12,0
1748420158682,JAPN 10A,F01,923352,Ross; Kayoko F,11,0,12,1
1748420158682,JAPN 10A,F02,923355,Ross; Kayoko F,12,0,12,0
1748420158682,JAPN 10A,G01,923358,McKee; Mayumi Mochizuki,7,0,10,3
1748420158682,JAPN 10A,G02,923360,McKee; Mayumi Mochizuki,6,0,10,4
1748420158682,JAPN 10A,H01,923365,Sato; Kyoko,8,0,12,4
1748420158682,JAPN 10A,H02,923370,Sato; Kyoko,12,0,12,0
1748420158682,JAPN 10A,I01,923373,Inada; Minori,8,0,12,4
1748420158682,JAPN 10A,I02,923374,Inada; Minori,8,0,12,4
1748420158682,JAPN 10A,J01,923376,McKee; Mayumi Mochizuki,11,0,12,1
1748420158682,JAPN 10A,J02,923428,McKee; Mayumi Mochizuki,11,0,12,1
1748420158682,JAPN 10A,K01,923433,Tipton; Yuko,6,0,10,4
1748420158682,JAPN 10A,K02,923437,Tipton; Yuko,9,0,10,1
1748420158682,JAPN 10A,L01,923439,Sato; Kyoko,12,0,12,0
1748420158682,JAPN 10A,L02,923449,Sato; Kyoko,11,0,12,1
1748420158682,JAPN 10A,M01,923455,Kamioka; Sachiko,22,0,23,1
1748420158682,JAPN 10A,N01,923459,McKee; Mayumi Mochizuki,22,0,23,1
1748420159713,JAPN 10AR,A01,923462,Tipton; Yuko,17,0,20,3
1748420160752,JAPN 20A,A01,923470,Takeda; Izumi,21,0,23,2
1748420160752,JAPN 20A,B01,923473,Iwamoto; Naoki,9,0,12,3
1748420160752,JAPN 20A,B02,923475,Iwamoto; Naoki,6,0,12,6
1748420160752,JAPN 20A,C01,923519,Takeda; Izumi,0,0,12,12
1748420160752,JAPN 20A,C02,923520,Takeda; Izumi,5,0,12,7
1748420160752,JAPN 20A,D01,923623,Iwamoto; Naoki,11,0,12,1
1748420160752,JAPN 20A,D02,923625,Iwamoto; Naoki,11,0,12,1
1748420160752,JAPN 20A,E01,923627,Simpson; Junko Tokuda,12,0,20,8
1748420161780,JAPN 130A,A01,923630,Kamioka; Sachiko,14,0,15,1
1748420161780,JAPN 130A,B01,923634,Ross; Kayoko F,11,0,15,4
1748420162811,JAPN 135A,A00,923636,Iwamoto; Naoki,10,0,20,10
1748420163838,JAPN 137A,A00,923638,Simpson; Junko Tokuda,19,0,20,1
1748420164869,JAPN 140A,A00,923640,Takeda; Izumi,18,0,20,2
1748420165896,JWSP 1,A01,921258,Shuster; Alana,19,0,20,1
1748420166926,JWSP 104,A01,921340,Shuster; Alana,15,0,15,0
1748420167956,LATI 10,A01,923694,Kennemore; Amy Michelle,22,0,28,6
1748420167956,LATI 10,A02,923695,Kennemore; Amy Michelle,25,0,28,3
1748420167956,LATI 10,A03,923707,Kennemore; Amy Michelle,25,0,28,3
1748420167956,LATI 10,A04,923713,Kennemore; Amy Michelle,27,0,28,1
1748420167956,LATI 10,A05,923720,Kennemore; Amy Michelle,28,0,28,0
1748420167956,LATI 10,A06,923723,Kennemore; Amy Michelle,30,0,30,0
1748420167956,LATI 10,A07,923745,Kennemore; Amy Michelle,26,0,30,4
1748420168990,LATI 50,A01,923778,Kokinis; Troy Andreas,27,0,30,3
1748420168990,LATI 50,A02,923779,Kokinis; Troy Andreas,28,0,30,2
1748420168990,LATI 50,A03,923780,Kokinis; Troy Andreas,29,0,30,1
1748420168990,LATI 50,A04,923783,Kokinis; Troy Andreas,28,0,30,2
1748420168990,LATI 50,A05,923784,Kokinis; Troy Andreas,30,0,30,0
1748420170017,LATI 166,A00,923785,Kokinis; Troy Andreas,117,0,120,3
1748420171098,LATI 170,A00,923787,Kennemore; Amy Michelle,45,0,60,15
1748420172124,LATI 180,A00,923788,Kennemore; Amy Michelle,52,0,60,8
1748420173151,LATI 184,A00,923790,Jimenez Cano; Nayeli Guada,29,0,30,1
1748420174187,LATI 200,A00,923791,Martin-Cabrera; Luis,7,0,10,3
1748420175218,LIAB 1A,A00,923983,Saab; Dima,12,0,14,2
1748420175218,LIAB 1A,B00,923984,Saab; Dima,8,0,14,6
1748420176249,LIAB 1AX,A00,923992,El Cheddadi; Youniss,25,0,28,3
1748420177276,LIAB 1D,A00,923996,Saab; Dima,7,0,14,7
1748420178305,LIAB 1DX,A00,923998,El Cheddadi; Youniss,10,0,14,4
1748420179333,LIFR 1A,A00,923999,Van Moer; Vinciane G,14,0,14,0
1748420179333,LIFR 1A,B00,924001,Van Moer; Vinciane G,14,0,14,0
1748420179333,LIFR 1A,C00,924003,Van Moer; Vinciane G,13,0,14,1
1748420179333,LIFR 1A,D00,924039,Van Moer; Vinciane G,12,0,14,2
1748420179333,LIFR 1A,E00,924044,Van Moer; Vinciane G,12,0,14,2
1748420179333,LIFR 1A,F00,924100,Van Moer; Vinciane G,10,0,14,4
1748420180359,LIFR 1AX,A00,924134,Van Moer; Vinciane G,26,0,28,2
1748420180359,LIFR 1AX,B00,924138,Van Moer; Vinciane G,24,0,28,4
1748420180359,LIFR 1AX,C00,924196,Van Moer; Vinciane G,26,0,28,2
1748420181384,LIFR 1B,A00,924197,Van Moer; Vinciane G,11,0,14,3
1748420181384,LIFR 1B,B00,924199,Van Moer; Vinciane G,11,0,14,3
1748420182426,LIFR 1BX,A00,924215,Van Moer; Vinciane G,23,0,28,5
1748420183457,LIFR 1D,A00,924216,Van Moer; Vinciane G,11,0,14,3
1748420183457,LIFR 1D,B00,924217,Van Moer; Vinciane G,12,0,14,2
1748420183457,LIFR 1D,C00,924218,Van Moer; Vinciane G,3,0,14,11
1748420184483,LIFR 1DX,A00,924219,Van Moer; Vinciane G,14,0,21,7
1748420184483,LIFR 1DX,B00,924220,Van Moer; Vinciane G,13,0,21,8
1748420185510,LIFR 11,A00,924221,Goodall; Grant Todd,10,0,10,0
1748420186541,LIGM 1A,A00,924222,Fischer-Grunski; Eva K,11,0,14,3
1748420186541,LIGM 1A,B00,924223,Fischer-Grunski; Eva K,13,0,14,1
1748420186541,LIGM 1A,C00,924224,Fischer-Grunski; Eva K,11,0,14,3
1748420186541,LIGM 1A,D00,924227,Fischer-Grunski; Eva K,11,0,14,3
1748420187574,LIGM 1AX,A00,924228,Fischer-Grunski; Eva K,28,0,28,0
1748420187574,LIGM 1AX,B00,924229,Fischer-Grunski; Eva K,19,0,28,9
1748420188600,LIGM 1D,A00,924230,Fischer-Grunski; Eva K,0,0,0,0
1748420188600,LIGM 1D,B00,924231,Fischer-Grunski; Eva K,12,0,14,2
1748420189631,LIGM 1DX,A00,924232,Fischer-Grunski; Eva K,0,0,0,0
1748420190658,LIGM 11,A00,924233,Goodall; Grant Todd,10,0,10,0
1748420191691,LIGN 5,A00,923794,Goodall; Grant Todd,112,0,120,8
1748420192717,LIGN 7,A00,923796,Mayberry; Rachel,115,0,120,5
1748420193750,LIGN 8,A00,923797,McIntosh; Justin,231,0,245,14
1748420194776,LIGN 17,A00,923798,Staff,232,0,245,13
1748420195810,LIGN 101,A01,923929,Bakovic; Eric John,26,0,30,4
1748420195810,LIGN 101,A02,923930,Bakovic; Eric John,26,0,30,4
1748420195810,LIGN 101,A04,923935,Bakovic; Eric John,19,0,30,11
1748420195810,LIGN 101,A05,923940,Bakovic; Eric John,23,0,30,7
1748420196841,LIGN 108,A00,923942,Rose; Sharon,29,0,35,6
1748420197868,LIGN 110,A01,923944,Garellek; Marc,15,0,27,12
1748420197868,LIGN 110,A02,923947,Garellek; Marc,14,0,27,13
1748420197868,LIGN 110,A03,923948,Garellek; Marc,20,0,27,7
1748420197868,LIGN 110,A04,923949,Garellek; Marc,4,0,27,23
1748420198897,LIGN 152,A00,967971,Caballero; Gabriela Hernandez,17,0,30,13
1748420199923,LIGN 160,A00,963083,Dudley; Rachel,39,0,50,11
1748420200948,LIGN 167,A00,923951,Warstadt; Alexander Scott,0,0,90,90
1748420201974,LIGN 179,A00,923955,Kluender; Robert,0,0,35,35
1748420203001,LIGN 188R,A00,923956,Clem; Emily,40,0,40,0
1748420204032,LIGN 200,A00,973075,Staff,0,0,0,0
1748420205058,LIGN 210,A00,923962,Garellek; Marc,10,0,10,0
1748420206085,LIGN 221,A00,923964,Clem; Emily,9,0,10,1
1748420207111,LIGN 236,A00,923965,Clem; Emily,8,0,10,2
1748420208138,LIGN 293,A00,923971,Caballero; Gabriela Hernandez,0,0,0,0
1748420209169,LIGN 296,001,950061,Ackerman; Farrell,10,0,10,0
1748420209169,LIGN 296,002,950062,Bakovic; Eric John,10,0,10,0
1748420209169,LIGN 296,003,950063,Bergen; Leon,10,0,10,0
1748420209169,LIGN 296,004,950064,Caballero; Gabriela Hernandez,10,0,10,0
1748420209169,LIGN 296,005,950065,Caponigro; Ivano,10,0,10,0
1748420209169,LIGN 296,006,950066,Clem; Emily,10,0,10,0
1748420209169,LIGN 296,007,950067,Dudley; Rachel,10,0,10,0
1748420209169,LIGN 296,008,950068,Garellek; Marc,10,0,10,0
1748420209169,LIGN 296,009,950070,Goodall; Grant Todd,9,0,10,1
1748420209169,LIGN 296,010,950071,Kehler; Andrew Scott,10,0,10,0
1748420209169,LIGN 296,011,950072,Kluender; Robert,10,0,10,0
1748420209169,LIGN 296,012,950073,Rose; Sharon,10,0,10,0
1748420209169,LIGN 296,013,950074,Styler; William Francis,10,0,10,0
1748420209169,LIGN 296,014,950075,Caponigro; Ivano,10,0,10,0
1748420210196,LIHL 112F,A00,923972,Pagkalinawan; Leticia Cant,15,0,28,13
1748420211225,LIHL 114F,A00,923973,Nguyen; Hoan Thi,8,0,28,20
1748420212252,LIHL 117F,A00,923974,Sadegholvad; Elham,19,0,20,1
1748420213279,LIHL 118,A00,923975,Chen; Areana Yen,23,0,28,5
1748420214308,LIHL 124F,A00,923976,Nguyen; Hoan Thi,17,0,20,3
1748420215335,LIHL 132F,A00,923978,Pagkalinawan; Leticia Cant,18,0,20,2
1748420216366,LIHL 134F,A00,923980,Nguyen; Hoan Thi,19,0,20,1
1748420217393,LIHL 138,A00,923982,Chen; Areana Yen,28,0,28,0
1748420218425,LIIT 1A,A00,924234,Carnelos; Chiara,11,0,14,3
1748420218425,LIIT 1A,B00,924235,Carnelos; Chiara,11,0,14,3
1748420218425,LIIT 1A,C00,924236,Carnelos; Chiara,13,0,14,1
1748420218425,LIIT 1A,D00,924237,Carnelos; Chiara,12,0,14,2
1748420219453,LIIT 1AX,A00,924238,Carnelos; Chiara,28,0,28,0
1748420219453,LIIT 1AX,B00,924239,Carnelos; Chiara,24,0,28,4
1748420220481,LIPO 1A,A00,924241,Paladini; Denise,13,0,14,1
1748420220481,LIPO 1A,B00,924242,Paladini; Denise,14,0,14,0
1748420221512,LIPO 1AX,A00,924243,De Abreu; Cassia,13,0,14,1
1748420221512,LIPO 1AX,B00,924244,De Abreu; Cassia,14,0,14,0
1748420222542,LIPO 1D,A00,924245,Paladini; Denise,11,0,14,3
1748420223568,LIPO 1DX,A00,924248,De Abreu; Cassia,14,0,14,0
1748420224597,LISL 1A,A00,924249,Lott; Margaret S.,9,0,14,5
1748420224597,LISL 1A,B00,924250,Lott; Margaret S.,11,0,14,3
1748420224597,LISL 1A,C00,924252,Lott; Margaret S.,7,0,14,7
1748420224597,LISL 1A,D00,924253,Lott; Margaret S.,12,0,14,2
1748420224597,LISL 1A,E00,924254,Lott; Margaret S.,4,0,14,10
1748420224597,LISL 1A,F00,924255,Lott; Margaret S.,13,0,14,1
1748420225624,LISL 1AR,A00,924257,Lott; Margaret S.,11,0,15,4
1748420225624,LISL 1AR,B00,924258,Lott; Margaret S.,10,0,15,5
1748420225624,LISL 1AR,C00,924260,Lott; Margaret S.,9,0,15,6
1748420225624,LISL 1AR,D00,968060,Lott; Margaret S.,3,0,3,0
1748420225624,LISL 1AR,E00,968061,Lott; Margaret S.,3,0,3,0
1748420225624,LISL 1AR,F00,968062,Lott; Margaret S.,3,0,3,0
1748420226655,LISL 1AX,A00,924261,Lott; Margaret S.,28,0,28,0
1748420226655,LISL 1AX,B00,924262,Lott; Margaret S.,18,0,28,10
1748420226655,LISL 1AX,C00,924263,Lott; Margaret S.,21,0,28,7
1748420227682,LISL 1B,A00,924264,Lott; Margaret S.,13,0,14,1
1748420227682,LISL 1B,B00,924265,Lott; Margaret S.,6,0,14,8
1748420227682,LISL 1B,C00,924302,Lott; Margaret S.,9,0,14,5
1748420227682,LISL 1B,D00,924304,Lott; Margaret S.,7,0,14,7
1748420227682,LISL 1B,E00,924305,Lott; Margaret S.,10,0,14,4
1748420227682,LISL 1B,F00,964375,Lott; Margaret S.,12,0,14,2
1748420228709,LISL 1BX,A00,924307,Lott; Margaret S.,12,0,28,16
1748420228709,LISL 1BX,B00,924308,Lott; Margaret S.,20,0,28,8
1748420228709,LISL 1BX,C00,924314,Lott; Margaret S.,28,0,28,0
1748420229740,LISL 1D,A00,924316,Lott; Margaret S.,0,0,14,14
1748420229740,LISL 1D,B00,924317,Lott; Margaret S.,0,0,14,14
1748420229740,LISL 1D,C00,924319,Lott; Margaret S.,0,0,14,14
1748420229740,LISL 1D,D00,924321,Lott; Margaret S.,0,0,14,14
1748420230771,LISL 1DX,A00,924323,Lott; Margaret S.,0,0,28,28
1748420230771,LISL 1DX,B00,924365,Lott; Margaret S.,0,0,28,28
1748420231800,LISP 1A,A00,924370,Munoz Sanchez; Alicia,12,0,14,2
1748420231800,LISP 1A,B00,924372,Munoz Sanchez; Alicia,8,0,14,6
1748420231800,LISP 1A,C00,924401,Munoz Sanchez; Alicia,0,0,14,14
1748420231800,LISP 1A,D00,924406,Munoz Sanchez; Alicia,3,0,14,11
1748420231800,LISP 1A,E00,924471,Munoz Sanchez; Alicia,0,0,14,14
1748420231800,LISP 1A,F00,924472,Munoz Sanchez; Alicia,4,0,14,10
1748420231800,LISP 1A,G00,924473,Munoz Sanchez; Alicia,11,0,14,3
1748420231800,LISP 1A,H00,924474,Munoz Sanchez; Alicia,9,0,14,5
1748420232828,LISP 1AX,A00,924478,Munoz Sanchez; Alicia,16,0,28,12
1748420232828,LISP 1AX,B00,924479,Munoz Sanchez; Alicia,26,0,28,2
1748420232828,LISP 1AX,C00,924484,Munoz Sanchez; Alicia,12,0,28,16
1748420232828,LISP 1AX,D00,924491,Munoz Sanchez; Alicia,18,0,28,10
1748420233868,LISP 1B,A00,924492,Munoz Sanchez; Alicia,12,0,14,2
1748420233868,LISP 1B,B00,924493,Munoz Sanchez; Alicia,6,0,14,8
1748420233868,LISP 1B,C00,924498,Munoz Sanchez; Alicia,13,0,14,1
1748420233868,LISP 1B,D00,924501,Munoz Sanchez; Alicia,13,0,14,1
1748420233868,LISP 1B,E00,924505,Munoz Sanchez; Alicia,11,0,14,3
1748420233868,LISP 1B,F00,924506,Munoz Sanchez; Alicia,9,0,14,5
1748420233868,LISP 1B,G00,924507,Munoz Sanchez; Alicia,10,0,14,4
1748420233868,LISP 1B,H00,924549,Munoz Sanchez; Alicia,12,0,14,2
1748420233868,LISP 1B,I00,924566,Munoz Sanchez; Alicia,13,0,14,1
1748420233868,LISP 1B,J00,924572,Munoz Sanchez; Alicia,13,0,14,1
1748420233868,LISP 1B,K00,924576,Munoz Sanchez; Alicia,12,0,14,2
1748420233868,LISP 1B,L00,924577,Munoz Sanchez; Alicia,13,0,14,1
1748420234894,LISP 1BX,A00,924578,Munoz Sanchez; Alicia,26,0,28,2
1748420234894,LISP 1BX,B00,924618,Munoz Sanchez; Alicia,24,0,28,4
1748420234894,LISP 1BX,C00,924619,Munoz Sanchez; Alicia,20,0,28,8
1748420234894,LISP 1BX,D00,924629,Munoz Sanchez; Alicia,24,0,28,4
1748420234894,LISP 1BX,E00,924635,Munoz Sanchez; Alicia,24,0,28,4
1748420234894,LISP 1BX,F00,924640,Munoz Sanchez; Alicia,27,0,28,1
1748420235927,LISP 1D,A00,924641,Munoz Sanchez; Alicia,10,0,14,4
1748420235927,LISP 1D,B00,924649,Munoz Sanchez; Alicia,10,0,14,4
1748420235927,LISP 1D,C00,924654,Munoz Sanchez; Alicia,11,0,14,3
1748420235927,LISP 1D,D00,924660,Munoz Sanchez; Alicia,7,0,14,7
1748420235927,LISP 1D,E00,924671,Munoz Sanchez; Alicia,5,0,14,9
1748420235927,LISP 1D,F00,924722,Munoz Sanchez; Alicia,6,0,14,8
1748420235927,LISP 1D,G00,924724,Munoz Sanchez; Alicia,8,0,14,6
1748420235927,LISP 1D,H00,924726,Munoz Sanchez; Alicia,9,0,14,5
1748420235927,LISP 1D,I00,924728,Munoz Sanchez; Alicia,13,0,14,1
1748420235927,LISP 1D,J00,924732,Munoz Sanchez; Alicia,14,0,14,0
1748420235927,LISP 1D,K00,924739,Munoz Sanchez; Alicia,13,0,14,1
1748420235927,LISP 1D,L00,924745,Munoz Sanchez; Alicia,12,0,14,2
1748420236960,LISP 1DX,A00,924747,Munoz Sanchez; Alicia,23,0,28,5
1748420236960,LISP 1DX,B00,924818,Munoz Sanchez; Alicia,27,0,28,1
1748420236960,LISP 1DX,C00,924819,Munoz Sanchez; Alicia,16,0,28,12
1748420236960,LISP 1DX,D00,924820,Munoz Sanchez; Alicia,23,0,28,5
1748420236960,LISP 1DX,E00,924821,Munoz Sanchez; Alicia,16,0,28,12
1748420236960,LISP 1DX,F00,924822,Munoz Sanchez; Alicia,22,0,28,6
1748420237989,LISP 15,A00,924823,Munoz Sanchez; Alicia,17,0,20,3
1748420239017,LISP 18,A00,924824,Munoz Sanchez; Alicia,14,0,20,6
1748420240050,LTAF 120,A00,925431,Zhiri; Oumelbanine,37,0,40,3
1748420241076,LTAM 100,A00,925432,Villafuerte Vazquez; Nadia,33,0,40,7
1748420242107,LTCH 101,A00,964372,Liao; Ping H,35,0,40,5
1748420243133,LTCO 285,A00,925806,Glaser; Amelia,0,0,0,0
1748420244164,LTCS 10,A00,924830,Bessett; Ryan Matthew,39,0,40,1
1748420245195,LTCS 87,A00,969580,Nguyen; Hoang Tan,20,0,20,0
1748420245195,LTCS 87,B00,969581,Nguyen; Hoang Tan,20,0,20,0
1748420246223,LTCS 130,A00,925434,Kim; Joo Ok,36,0,40,4
1748420247251,LTCS 150,A00,925435,Mendoza; Andrea,36,0,40,4
1748420248278,LTCS 250,A00,925807,Sanchez Cruz; Jorge,9,0,15,6
1748420249306,LTEA 120A,A00,925438,Fiss; Geraldine Anna,16,0,40,24
1748420250332,LTEA 120B,A00,925439,Liao; Ping H,211,0,225,14
1748420251361,LTEA 132,A00,925441,Mendoza; Andrea,66,0,75,9
1748420252389,LTEA 143,A00,925443,Lee; Jin-Kyung,72,0,75,3
1748420253415,LTEA 145,A00,925444,Lee; Jin-Kyung,39,0,40,1
1748420254444,LTEN 21,A01,924832,Vitkus; Daniel J.,23,0,28,5
1748420254444,LTEN 21,A02,924833,Vitkus; Daniel J.,28,0,28,0
1748420255471,LTEN 28,A01,924835,Suzuki; Erin M.,26,0,28,2
1748420255471,LTEN 28,A02,924836,Suzuki; Erin M.,25,0,28,3
1748420255471,LTEN 28,A03,924837,Suzuki; Erin M.,25,0,28,3
1748420255471,LTEN 28,A04,924838,Suzuki; Erin M.,28,0,28,0
1748420255471,LTEN 28,A05,924839,Suzuki; Erin M.,28,0,28,0
1748420255471,LTEN 28,A06,924840,Suzuki; Erin M.,28,0,28,0
1748420255471,LTEN 28,A07,924841,Suzuki; Erin M.,28,0,28,0
1748420255471,LTEN 28,A08,924842,Suzuki; Erin M.,28,0,28,0
1748420256496,LTEN 113,A00,925449,Vitkus; Daniel J.,31,0,40,9
1748420257526,LTEN 152,A00,925450,Staff,13,0,40,27
1748420258557,LTEN 169,A00,925451,Ruiz; Ariana,34,0,40,6
1748420259584,LTEN 180,A00,925452,Ruiz; Ariana,9,0,20,11
1748420260612,LTEN 181,A00,925453,Suzuki; Erin M.,27,0,40,13
1748420261639,LTEN 185,A00,963086,Staff,23,0,25,2
1748420262664,LTEN 189,A00,925458,Vijay; Ameeth Varma,35,0,40,5
1748420263690,LTEN 271,A00,925808,Garofalo; Devin,13,0,15,2
1748420264722,LTEU 140,A00,925459,De Marchi Gherini; Adriana,33,0,40,7
1748420265755,LTEU 154,A00,925461,Morse; Ainsley,25,0,30,5
1748420266782,LTFR 2A,A01,924916,Ploye; Catherine,20,0,25,5
1748420267814,LTFR 2B,A01,924920,Ploye; Catherine,25,0,25,0
1748420268839,LTFR 104,A00,925462,Ploye; Catherine,25,0,25,0
1748420269867,LTGK 1,A00,924923,Murray; Kourtney Kristine,34,0,40,6
1748420270896,LTGK 104,A00,925465,Myerston Santana; Jacobo,29,0,30,1
1748420271922,LTGM 2A,A01,924926,Fischer-Grunski; Eva K,19,0,25,6
1748420272954,LTIT 2A,A01,925054,De Marchi Gherini; Adriana,19,0,25,6
1748420273995,LTKO 1A,A01,925085,Cho; Hye Jin,25,0,28,3
1748420273995,LTKO 1A,B01,925182,Cho; Hye Jin,25,0,28,3
1748420273995,LTKO 1A,C01,925210,Cho; Hye Jin,23,0,28,5
1748420273995,LTKO 1A,D01,925229,Staff,27,0,28,1
1748420273995,LTKO 1A,E01,925246,Staff,25,0,28,3
1748420273995,LTKO 1A,F01,925248,Yim; Nancy,26,0,28,2
1748420273995,LTKO 1A,G01,925323,Yim; Nancy,26,0,28,2
1748420273995,LTKO 1A,H01,925331,Yim; Nancy,25,0,28,3
1748420275082,LTKO 2A,A01,925333,Jung; Ji Yun,14,0,28,14
1748420275082,LTKO 2A,B01,925335,Jung; Ji Yun,24,0,28,4
1748420275082,LTKO 2A,C01,925338,Lee; Jeyseon,26,0,28,2
1748420276109,LTKO 130F,A00,925468,Lee; Jeyseon,22,0,25,3
1748420277136,LTLA 1,A00,925339,Murray; Kourtney Kristine,0,0,20,20
1748420278162,LTLA 100,A00,925470,Murray; Kourtney Kristine,39,0,40,1
1748420279193,LTRU 1A,A01,925342,Wells; Patricia Rebecca,22,0,28,6
1748420280220,LTRU 2A,A01,925345,Wells; Patricia Rebecca,19,0,20,1
1748420281250,LTRU 104B,A01,925473,Wells; Patricia Rebecca,20,0,20,0
1748420282282,LTRU 150,A00,925474,Morse; Ainsley,10,0,10,0
1748420283312,LTSP 2A,A01,925347,Staff,22,0,28,6
1748420283312,LTSP 2A,B01,925349,Staff,24,0,28,4
1748420284338,LTSP 2B,A01,925351,Staff,17,0,28,11
1748420285365,LTSP 2C,A01,925353,Mastromartino; Alexandra L,22,0,28,6
1748420286394,LTSP 2F,A00,925354,Mastromartino; Alexandra L,25,0,25,0
1748420287421,LTSP 3F,A00,925355,Dominguez; Noelia,24,0,25,1
1748420287421,LTSP 3F,B00,925356,Dominguez; Noelia,22,0,25,3
1748420288449,LTSP 87,A00,925357,Bessett; Ryan Matthew,20,0,20,0
1748420289476,LTSP 100A,A00,925595,Dominguez; Noelia,21,0,25,4
1748420290503,LTSP 100F,A00,925621,Bessett; Ryan Matthew,25,0,25,0
1748420290503,LTSP 100F,B00,925623,Bessett; Ryan Matthew,25,0,25,0
1748420290503,LTSP 100F,C00,925626,Martin-Cabrera; Luis,25,0,25,0
1748420291531,LTSP 116,A00,925629,Villafuerte Vazquez; Nadia,35,0,40,5
1748420292561,LTSP 172,A00,925637,Chacon; Gloria Elizabeth,36,0,40,4
1748420293590,LTSP 174,A00,925639,Chacon; Gloria Elizabeth,34,0,40,6
1748420294621,LTTH 210A,A00,925809,Fiss; Geraldine Anna,6,0,15,9
1748420295647,LTWL 10,A00,925358,Garofalo; Devin,40,0,40,0
1748420296679,LTWL 19A,A00,925360,Myerston Santana; Jacobo,39,0,40,1
1748420297707,LTWL 101,A00,925661,Kelting; Edward William,32,0,40,8
1748420298734,LTWL 165,A00,925748,Kim; Joo Ok,40,0,40,0
1748420299767,LTWL 167,A00,964371,Glaser; Amelia,40,0,40,0
1748420300795,LTWL 183,A00,925755,Cohen; Alain J. J.,34,0,40,6
1748420301825,LTWL 194,A00,925757,Vijay; Ameeth Varma,38,0,40,2
1748420302855,LTWR 8A,A01,925362,Springer; Anna Joy,28,0,28,0
1748420302855,LTWR 8A,A02,925363,Springer; Anna Joy,23,0,28,5
1748420302855,LTWR 8A,A03,925364,Springer; Anna Joy,23,0,28,5
1748420302855,LTWR 8A,A04,925365,Springer; Anna Joy,18,0,28,10
1748420303883,LTWR 8B,A01,925368,Lopez; Casandra,18,0,28,10
1748420303883,LTWR 8B,A02,925370,Lopez; Casandra,19,0,28,9
1748420303883,LTWR 8B,A03,925371,Lopez; Casandra,28,0,28,0
1748420303883,LTWR 8B,A04,925372,Lopez; Casandra,26,0,28,2
1748420304909,LTWR 100C,A00,925759,Staff,16,0,30,14
1748420305939,LTWR 100W,A00,925760,Forbes; Camille,0,0,15,15
1748420306966,LTWR 102W,A00,925761,Lopez; Casandra,6,0,15,9
1748420307993,LTWR 104AW,A00,925762,Hoang; Lily Kim,5,0,15,10
1748420309023,LTWR 106C,A00,925764,Ali; Mohammad Kazim,22,0,30,8
1748420310048,LTWR 113C,A00,925765,Wilkinson; Marco,28,0,30,2
1748420311077,LTWR 115C,A00,925766,Ali; Mohammad Kazim,23,0,30,7
1748420312104,LTWR 124C,A00,925801,Morse; Ainsley,29,0,30,1
1748420313132,LTWR 126C,A00,925802,Forbes; Camille,28,0,30,2
1748420314159,LTWR 148,A00,925804,Wilkinson; Marco,27,0,30,3
1748420315185,LTWR 194,A00,925805,Carroll; Amy Sara,30,0,40,10
1748420316216,LTWR 215,A00,925934,Hoang; Lily Kim,13,0,20,7
1748420317242,LTWR 220,A00,925935,Springer; Anna Joy,10,0,15,5
1748420318278,MAE 2,A01,931344,Anderson; Mark Ronald,0,0,1,1
1748420318278,MAE 2,A02,931345,Anderson; Mark Ronald,0,0,1,1
1748420318278,MAE 2,A03,931347,Anderson; Mark Ronald,0,0,1,1
1748420318278,MAE 2,B01,960499,Sadeghizadeh; Zahra,0,0,1,1
1748420318278,MAE 2,B02,960500,Sadeghizadeh; Zahra,0,0,1,1
1748420318278,MAE 2,B03,960501,Sadeghizadeh; Zahra,0,0,1,1
1748420319312,MAE 3,A01,931355,Delson; Nathan Joseph,8,0,11,3
1748420319312,MAE 3,A02,931356,Delson; Nathan Joseph,10,0,11,1
1748420319312,MAE 3,A03,931357,Delson; Nathan Joseph,10,0,11,1
1748420319312,MAE 3,A04,931358,Delson; Nathan Joseph,11,0,11,0
1748420319312,MAE 3,B01,931360,Qi; Huihui,0,0,11,11
1748420319312,MAE 3,B02,931361,Qi; Huihui,6,0,11,5
1748420319312,MAE 3,B03,931362,Qi; Huihui,9,0,11,2
1748420319312,MAE 3,B04,931364,Qi; Huihui,10,0,11,1
1748420320344,MAE 8,A01,931368,Pham; Hieu Tan,90,0,100,10
1748420321374,MAE 11,A00,931369,Nomura; Keiko K.,83,0,180,97
1748420322404,MAE 20,A00,931371,Graeve; Olivia A,80,0,100,20
1748420323439,MAE 21,A01,931373,Cai; Shengqiang,1,0,10,9
1748420323439,MAE 21,A02,931375,Cai; Shengqiang,7,0,10,3
1748420323439,MAE 21,A03,931376,Cai; Shengqiang,1,0,10,9
1748420323439,MAE 21,A04,931377,Cai; Shengqiang,5,0,10,5
1748420323439,MAE 21,A05,931378,Cai; Shengqiang,10,0,10,0
1748420323439,MAE 21,A06,931381,Cai; Shengqiang,10,0,10,0
1748420323439,MAE 21,A07,931382,Cai; Shengqiang,8,0,10,2
1748420323439,MAE 21,A08,931384,Cai; Shengqiang,7,0,10,3
1748420323439,MAE 21,A09,931385,Cai; Shengqiang,8,0,10,2
1748420323439,MAE 21,A10,931386,Cai; Shengqiang,9,0,10,1
1748420324469,MAE 30A,A00,931387,Lubarda; Marko,29,0,70,41
1748420325496,MAE 40,A00,931388,Cortes; Jorge,83,0,146,63
1748420326522,MAE 101A,A00,931389,Sarkar; Sutanu,94,0,150,56
1748420327552,MAE 101C,A00,931390,Seshadri; Kalyanasundaram,175,0,200,25
1748420328578,MAE 104,A00,931391,Pham; Hieu Tan,146,0,160,14
1748420329608,MAE 105,A00,931392,Bandaru; Prabhakar,135,0,180,45
1748420330637,MAE 107,A00,931393,Chen; Renkun,0,0,90,90
1748420330637,MAE 107,B00,931394,McEneaney; William Michael,45,0,90,45
1748420331667,MAE 108,A00,931395,Hao; Xuanting,91,0,120,29
1748420332699,MAE 113,A00,931396,Seshadri; Kalyanasundaram,92,0,130,38
1748420333732,MAE 114,A00,931399,Krasheninnikov; Sergei,37,0,40,3
1748420334764,MAE 120,A00,931400,Krasheninnikov; Sergei,36,0,50,14
1748420335792,MAE 122,A00,931402,Pawlak; Geno Ronald,43,0,70,27
1748420336819,MAE 131A,A00,931403,Lubarda; Marko,47,0,70,23
1748420337851,MAE 142,A00,931404,Anderson; Mark Ronald,21,0,60,39
1748420338882,MAE 143A,A00,931406,Diagne; Mamadou Lamine,98,0,125,27
1748420339909,MAE 148,A01,931409,Silberman; Jack,11,0,30,19
1748420340940,MAE 150,A00,931411,Friend; James Robert,139,0,192,53
1748420341968,MAE 153,A00,931413,Ghazinejad; Maziar,2,0,45,43
1748420342996,MAE 156A,A01,931416,Delson; Nathan Joseph,2,0,12,10
1748420342996,MAE 156A,A02,931417,Delson; Nathan Joseph,9,0,12,3
1748420342996,MAE 156A,A03,931418,Delson; Nathan Joseph,12,0,12,0
1748420342996,MAE 156A,A04,931419,Delson; Nathan Joseph,10,0,12,2
1748420342996,MAE 156A,A05,931420,Delson; Nathan Joseph,2,0,12,10
1748420342996,MAE 156A,A06,931421,Delson; Nathan Joseph,12,0,12,0
1748420344023,MAE 165,A00,931422,Scholtes Acevedo; Claire,19,0,30,11
1748420345050,MAE 170,A01,931424,Evdokimenko; Ekaterina,9,0,30,21
1748420345050,MAE 170,A02,931427,Evdokimenko; Ekaterina,14,0,30,16
1748420345050,MAE 170,A03,931428,Evdokimenko; Ekaterina,0,0,30,30
1748420345050,MAE 170,A04,931429,Evdokimenko; Ekaterina,14,0,30,16
1748420345050,MAE 170,A05,931430,Evdokimenko; Ekaterina,27,0,30,3
1748420345050,MAE 170,A06,931434,Evdokimenko; Ekaterina,23,0,30,7
1748420346080,MAE 180,A00,931436,Sadeghizadeh; Zahra,109,0,140,31
1748420347108,MAE 181,A00,931437,Bahadori; Mohammad Yousef,53,0,80,27
1748420348144,MAE 190,A00,971317,Marinoni; Alessandro & Krasheninnikov; Sergei,19,0,20,1
1748420349172,MAE 191,A01,931442,Qi; Huihui,19,0,20,1
1748420350198,MAE 201,A00,931445,Pawlak; Geno Ronald,36,0,90,54
1748420351224,MAE 202,A00,931452,Poulikakos; Lisa Voula,42,0,90,48
1748420352255,MAE 203,A00,931455,Frazier; Michael,26,0,90,64
1748420353279,MAE 205,A00,931456,Staff,9989,0,9999,10
1748420354309,MAE 208,A00,931457,Marinoni; Alessandro,52,0,150,98
1748420355340,MAE 210A,A00,931458,Saintillan; David,37,0,60,23
1748420356368,MAE 217A,A00,931459,Arefiev; Alexey,13,0,20,7
1748420357392,MAE 221A,A00,931460,Chen; Renkun,26,0,40,14
1748420358423,MAE 232A,A00,931464,Chen; Jiun-Shyan,3,0,35,32
1748420359454,MAE 233A,A00,931466,Luan; Haiwen,29,0,40,11
1748420360480,MAE 235,A00,954132,Krysl; Petr,0,0,0,0
1748420361507,MAE 249,A00,931472,Tolley; Michael Thomas,8,0,50,42
1748420362534,MAE 251,A00,931477,Graeve; Olivia A,12,0,15,3
1748420363560,MAE 257,A00,931478,Cai; Shengqiang,0,0,10,10
1748420364587,MAE 265A,A00,931480,Bandaru; Prabhakar,10,0,15,5
1748420365617,MAE 271A,A00,931481,Luo; Jian,9,0,10,1
1748420366644,MAE 280A,A00,931482,Kramer; Boris,61,0,110,49
1748420367671,MAE 283A,A00,931484,de Callafon; Raymond A,12,0,50,38
1748420368700,MAE 285,A00,931486,Friend; James Robert,30,0,30,0
1748420369727,MAE 287,A00,931488,Diagne; Mamadou Lamine,17,0,30,13
1748420370754,MAE 290A,A00,931490,Lindsey; Stephanie,42,0,70,28
1748420371786,MAE 294A,A00,931491,Becker; Janet Maria,14,0,20,6
1748420372818,MATH 2,A01,929271,Quarfoot; David James,22,0,25,3
1748420372818,MATH 2,B01,929278,Staff,21,0,25,4
1748420373845,MATH 3B,A01,929284,Hammock; Frances H,1,0,2,1
1748420373845,MATH 3B,A02,929312,Hammock; Frances H,1,0,2,1
1748420373845,MATH 3B,A03,967979,Hammock; Frances H,2,0,2,0
1748420373845,MATH 3B,A04,967980,Hammock; Frances H,1,0,2,1
1748420373845,MATH 3B,A05,967983,Hammock; Frances H,1,0,2,1
1748420373845,MATH 3B,A06,967984,Hammock; Frances H,2,0,2,0
1748420373845,MATH 3B,D01,929666,Staff,0,0,2,2
1748420373845,MATH 3B,D02,929667,Staff,0,0,2,2
1748420373845,MATH 3B,D03,929668,Staff,0,0,2,2
1748420373845,MATH 3B,D04,967987,Staff,0,0,2,2
1748420374877,MATH 3C,A01,929670,Staff,0,0,2,2
1748420374877,MATH 3C,A02,929671,Staff,0,0,2,2
1748420374877,MATH 3C,A03,929672,Staff,2,0,2,0
1748420374877,MATH 3C,A04,929673,Staff,2,0,2,0
1748420374877,MATH 3C,A05,967985,Staff,0,0,2,2
1748420374877,MATH 3C,A06,967986,Staff,1,0,2,1
1748420374877,MATH 3C,B01,929675,Staff,0,0,0,2
1748420374877,MATH 3C,B02,929676,Staff,0,0,2,2
1748420374877,MATH 3C,B03,929677,Staff,0,0,2,2
1748420374877,MATH 3C,B04,929679,Staff,0,0,2,2
1748420374877,MATH 3C,B05,967988,Staff,0,0,2,2
1748420374877,MATH 3C,B06,967989,Staff,0,0,2,2
1748420375906,MATH 4C,B01,929698,Anzaldo; Leesa B,0,0,0,2
1748420375906,MATH 4C,B02,929699,Anzaldo; Leesa B,4,0,4,0
1748420375906,MATH 4C,B03,929700,Anzaldo; Leesa B,3,0,4,1
1748420375906,MATH 4C,B04,929701,Anzaldo; Leesa B,4,0,4,0
1748420375906,MATH 4C,D01,929709,Staff,4,0,4,0
1748420375906,MATH 4C,D02,929710,Staff,3,0,4,1
1748420375906,MATH 4C,D03,967990,Staff,4,0,4,0
1748420375906,MATH 4C,D04,967991,Staff,4,0,4,0
1748420376948,MATH 10A,A01,929713,Staff,8,0,12,4
1748420376948,MATH 10A,A02,929715,Staff,12,0,12,0
1748420376948,MATH 10A,A03,929717,Staff,5,0,5,0
1748420376948,MATH 10A,A04,929718,Staff,5,0,5,0
1748420376948,MATH 10A,A05,929719,Staff,5,0,5,0
1748420376948,MATH 10A,A06,929720,Staff,4,0,5,1
1748420376948,MATH 10A,B01,929723,Eggers; John Dietrich,0,0,0,4
1748420376948,MATH 10A,B02,929724,Eggers; John Dietrich,0,0,4,4
1748420376948,MATH 10A,B03,929726,Eggers; John Dietrich,0,0,4,4
1748420376948,MATH 10A,B04,929727,Eggers; John Dietrich,0,0,4,4
1748420376948,MATH 10A,B05,929728,Eggers; John Dietrich,0,0,4,4
1748420376948,MATH 10A,B06,929729,Eggers; John Dietrich,1,0,4,3
1748420376948,MATH 10A,C01,929732,Staff,0,0,0,3
1748420376948,MATH 10A,C02,929734,Staff,0,0,4,4
1748420376948,MATH 10A,C03,929735,Staff,0,0,4,4
1748420376948,MATH 10A,C04,929736,Staff,0,0,4,4
1748420376948,MATH 10A,C05,929737,Staff,0,0,4,4
1748420376948,MATH 10A,C06,929739,Staff,0,0,4,4
1748420376948,MATH 10A,D01,929742,Staff,0,0,4,4
1748420376948,MATH 10A,D02,929743,Staff,0,0,4,4
1748420376948,MATH 10A,D03,929744,Staff,4,0,4,0
1748420376948,MATH 10A,D04,929746,Staff,4,0,4,0
1748420376948,MATH 10A,D05,929747,Staff,3,0,4,1
1748420376948,MATH 10A,D06,929748,Staff,4,0,4,0
1748420376948,MATH 10A,D07,968012,Staff,0,0,4,4
1748420376948,MATH 10A,D08,968013,Staff,3,0,4,1
1748420376948,MATH 10A,D09,968015,Staff,4,0,4,0
1748420376948,MATH 10A,D10,968017,Staff,2,0,4,2
1748420377976,MATH 10B,A01,929759,Bowers; Adam R.,0,0,10,10
1748420377976,MATH 10B,A02,929760,Bowers; Adam R.,0,0,10,10
1748420377976,MATH 10B,A03,929761,Bowers; Adam R.,0,0,10,10
1748420377976,MATH 10B,A04,929762,Bowers; Adam R.,0,0,10,10
1748420377976,MATH 10B,A05,929763,Bowers; Adam R.,0,0,10,10
1748420377976,MATH 10B,A06,929764,Bowers; Adam R.,0,0,10,10
1748420377976,MATH 10B,B01,929767,Staff,0,0,10,10
1748420377976,MATH 10B,B02,929770,Staff,7,0,10,3
1748420377976,MATH 10B,B03,929771,Staff,10,0,10,0
1748420377976,MATH 10B,B04,929772,Staff,9,0,10,1
1748420377976,MATH 10B,B05,929774,Staff,1,0,10,9
1748420377976,MATH 10B,B06,929775,Staff,10,0,10,0
1748420377976,MATH 10B,C01,929778,Huang; Lei,0,0,8,8
1748420377976,MATH 10B,C02,929779,Huang; Lei,0,0,10,10
1748420377976,MATH 10B,C03,929780,Huang; Lei,2,0,10,8
1748420377976,MATH 10B,C04,929781,Huang; Lei,8,0,10,2
1748420377976,MATH 10B,C05,929784,Huang; Lei,0,0,10,10
1748420377976,MATH 10B,C06,929785,Huang; Lei,2,0,10,8
1748420379063,MATH 10C,A01,929788,Staff,0,0,15,15
1748420379063,MATH 10C,A02,929789,Staff,0,0,15,15
1748420379063,MATH 10C,A03,929790,Staff,12,0,15,3
1748420379063,MATH 10C,A04,929791,Staff,13,0,15,2
1748420379063,MATH 10C,A05,929792,Staff,0,0,15,15
1748420379063,MATH 10C,A06,929793,Staff,0,0,15,15
1748420379063,MATH 10C,A07,929795,Staff,3,0,15,12
1748420379063,MATH 10C,A08,929796,Staff,15,0,15,0
1748420379063,MATH 10C,B01,929798,Staff,15,0,15,0
1748420379063,MATH 10C,B02,929799,Staff,0,0,15,15
1748420379063,MATH 10C,B03,929800,Staff,11,0,15,4
1748420379063,MATH 10C,B04,929802,Staff,14,0,15,1
1748420379063,MATH 10C,B05,929803,Staff,14,0,15,1
1748420379063,MATH 10C,B06,929805,Staff,15,0,15,0
1748420380092,MATH 11,A01,929807,Rava; Denise,0,0,25,25
1748420380092,MATH 11,A02,929808,Rava; Denise,0,0,25,25
1748420380092,MATH 11,A03,929809,Rava; Denise,0,0,25,25
1748420380092,MATH 11,A04,929811,Rava; Denise,0,0,25,25
1748420380092,MATH 11,B01,929816,Rava; Denise,0,0,25,25
1748420380092,MATH 11,B02,929817,Rava; Denise,0,0,25,25
1748420380092,MATH 11,B03,929818,Rava; Denise,0,0,25,25
1748420380092,MATH 11,B04,929819,Rava; Denise,0,0,25,25
1748420381127,MATH 18,C01,929841,Peca-Medlin; John Michael,4,0,10,6
1748420381127,MATH 18,C02,929843,Peca-Medlin; John Michael,7,0,10,3
1748420381127,MATH 18,C03,929844,Peca-Medlin; John Michael,3,0,10,7
1748420381127,MATH 18,C04,929845,Peca-Medlin; John Michael,0,0,10,10
1748420381127,MATH 18,C05,929846,Peca-Medlin; John Michael,2,0,10,8
1748420381127,MATH 18,C06,929848,Peca-Medlin; John Michael,0,0,10,10
1748420381127,MATH 18,D01,929852,Anzaldo; Leesa B,0,0,10,10
1748420381127,MATH 18,D02,929855,Anzaldo; Leesa B,0,0,10,10
1748420381127,MATH 18,D03,929856,Anzaldo; Leesa B,0,0,9,9
1748420381127,MATH 18,D04,929857,Anzaldo; Leesa B,0,0,10,10
1748420381127,MATH 18,D05,929858,Anzaldo; Leesa B,0,0,10,10
1748420381127,MATH 18,D06,929859,Anzaldo; Leesa B,0,0,10,10
1748420381127,MATH 18,E01,929862,Ganesan; Priyanga,0,0,10,10
1748420381127,MATH 18,E02,929863,Ganesan; Priyanga,0,0,10,10
1748420381127,MATH 18,E03,929865,Ganesan; Priyanga,0,0,10,10
1748420381127,MATH 18,E04,929866,Ganesan; Priyanga,8,0,10,2
1748420381127,MATH 18,E05,929867,Ganesan; Priyanga,10,0,10,0
1748420381127,MATH 18,E06,929869,Ganesan; Priyanga,10,0,10,0
1748420381127,MATH 18,F01,929872,Ganesan; Priyanga,12,0,20,8
1748420381127,MATH 18,F02,929873,Ganesan; Priyanga,17,0,20,3
1748420381127,MATH 18,F03,929874,Ganesan; Priyanga,19,0,20,1
1748420381127,MATH 18,F04,929875,Ganesan; Priyanga,19,0,20,1
1748420381127,MATH 18,F05,968018,Ganesan; Priyanga,12,0,12,0
1748420381127,MATH 18,F06,968019,Ganesan; Priyanga,11,0,12,1
1748420381127,MATH 18,F07,968020,Ganesan; Priyanga,10,0,12,2
1748420381127,MATH 18,F08,968022,Ganesan; Priyanga,11,0,12,1
1748420382161,MATH 20A,A01,929880,Bowers; Adam R.,23,0,25,2
1748420382161,MATH 20A,A02,929881,Bowers; Adam R.,24,0,25,1
1748420382161,MATH 20A,A03,929883,Bowers; Adam R.,1,0,5,4
1748420382161,MATH 20A,A04,929884,Bowers; Adam R.,4,0,5,1
1748420382161,MATH 20A,B01,929886,Staff,0,0,0,0
1748420382161,MATH 20A,B02,929887,Staff,3,0,5,2
1748420382161,MATH 20A,B03,929888,Staff,5,0,5,0
1748420382161,MATH 20A,B04,929889,Staff,5,0,5,0
1748420382161,MATH 20A,B05,929890,Staff,5,0,5,0
1748420382161,MATH 20A,B06,929891,Staff,5,0,5,0
1748420382161,MATH 20A,B07,967992,Staff,5,0,5,0
1748420382161,MATH 20A,B08,967993,Staff,5,0,5,0
1748420382161,MATH 20A,B09,967994,Staff,5,0,5,0
1748420382161,MATH 20A,B10,967995,Staff,5,0,5,0
1748420383191,MATH 20B,A01,929910,Staff,14,0,15,1
1748420383191,MATH 20B,A02,929911,Staff,15,0,15,0
1748420383191,MATH 20B,A03,929982,Staff,15,0,15,0
1748420383191,MATH 20B,A04,929983,Staff,15,0,15,0
1748420383191,MATH 20B,A05,929984,Staff,15,0,15,0
1748420383191,MATH 20B,A06,929985,Staff,15,0,15,0
1748420383191,MATH 20B,C01,930160,Staff,24,0,25,1
1748420383191,MATH 20B,C02,930186,Staff,25,0,25,0
1748420383191,MATH 20B,C03,930198,Staff,15,0,15,0
1748420383191,MATH 20B,C04,968000,Staff,15,0,15,0
1748420383191,MATH 20B,D01,930241,Chou; Raymond Oliver,13,0,25,12
1748420383191,MATH 20B,D02,930242,Chou; Raymond Oliver,23,0,25,2
1748420383191,MATH 20B,D03,930244,Chou; Raymond Oliver,0,0,15,15
1748420383191,MATH 20B,D04,968002,Chou; Raymond Oliver,0,0,13,13
1748420383191,MATH 20B,E01,930428,Wesley; William J,32,0,35,3
1748420383191,MATH 20B,E02,930529,Wesley; William J,35,0,35,0
1748420383191,MATH 20B,E03,968023,Wesley; William J,15,0,15,0
1748420383191,MATH 20B,E04,968024,Wesley; William J,15,0,15,0
1748420383191,MATH 20B,E05,968025,Wesley; William J,15,0,15,0
1748420383191,MATH 20B,E06,968026,Wesley; William J,15,0,15,0
1748420384233,MATH 20C,A01,930548,Staff,18,0,20,2
1748420384233,MATH 20C,A02,930554,Staff,19,0,20,1
1748420384233,MATH 20C,A03,930584,Staff,19,0,20,1
1748420384233,MATH 20C,A04,930606,Staff,20,0,20,0
1748420384233,MATH 20C,A05,930610,Staff,19,0,20,1
1748420384233,MATH 20C,A06,930641,Staff,20,0,20,0
1748420384233,MATH 20C,A07,968027,Staff,20,0,20,0
1748420384233,MATH 20C,A08,968028,Staff,20,0,20,0
1748420384233,MATH 20C,A09,968029,Staff,19,0,20,1
1748420384233,MATH 20C,A10,968031,Staff,20,0,20,0
1748420384233,MATH 20C,C01,930911,Staff,6,0,20,14
1748420384233,MATH 20C,C02,930940,Staff,16,0,20,4
1748420384233,MATH 20C,C03,930946,Staff,18,0,20,2
1748420384233,MATH 20C,C04,930959,Staff,20,0,20,0
1748420384233,MATH 20C,C05,930966,Staff,19,0,20,1
1748420384233,MATH 20C,C06,930974,Staff,16,0,20,4
1748420384233,MATH 20C,D01,931266,Hammock; Frances H,10,0,20,10
1748420384233,MATH 20C,D02,931267,Hammock; Frances H,14,0,17,3
1748420384233,MATH 20C,D03,931268,Hammock; Frances H,17,0,20,3
1748420384233,MATH 20C,D04,931269,Hammock; Frances H,19,0,20,1
1748420384233,MATH 20C,D05,931270,Hammock; Frances H,20,0,20,0
1748420384233,MATH 20C,D06,931271,Hammock; Frances H,18,0,20,2
1748420384233,MATH 20C,E01,931273,Staff,11,0,20,9
1748420384233,MATH 20C,E02,931274,Staff,19,0,20,1
1748420384233,MATH 20C,E03,931275,Staff,17,0,20,3
1748420384233,MATH 20C,E04,931276,Staff,19,0,20,1
1748420384233,MATH 20C,E05,931278,Staff,20,0,20,0
1748420384233,MATH 20C,E06,931279,Staff,20,0,20,0
1748420384233,MATH 20C,F01,931281,Staff,20,0,25,5
1748420384233,MATH 20C,F02,931282,Staff,22,0,25,3
1748420384233,MATH 20C,F03,931283,Staff,23,0,25,2
1748420384233,MATH 20C,F04,931285,Staff,24,0,25,1
1748420385262,MATH 20D,B01,931293,Upadrashta; Pranav Kumar,0,0,24,25
1748420385262,MATH 20D,B02,931294,Upadrashta; Pranav Kumar,0,0,30,30
1748420385262,MATH 20D,B03,931297,Upadrashta; Pranav Kumar,1,0,30,29
1748420385262,MATH 20D,B04,931298,Upadrashta; Pranav Kumar,8,0,30,22
1748420385262,MATH 20D,B05,931299,Upadrashta; Pranav Kumar,1,0,30,29
1748420385262,MATH 20D,B06,931300,Upadrashta; Pranav Kumar,26,0,30,4
1748420385262,MATH 20D,C01,931305,Upadrashta; Pranav Kumar,15,0,40,25
1748420385262,MATH 20D,C02,931306,Upadrashta; Pranav Kumar,38,0,40,2
1748420385262,MATH 20D,C03,931307,Upadrashta; Pranav Kumar,12,0,30,18
1748420385262,MATH 20D,C04,931308,Upadrashta; Pranav Kumar,26,0,30,4
1748420386291,MATH 20E,A01,931313,Staff,0,0,27,27
1748420386291,MATH 20E,A02,931315,Staff,19,0,27,8
1748420386291,MATH 20E,A03,931316,Staff,27,0,27,0
1748420386291,MATH 20E,A04,931317,Staff,27,0,27,0
1748420386291,MATH 20E,A05,968032,Staff,9,0,27,18
1748420386291,MATH 20E,A06,968033,Staff,24,0,27,3
1748420386291,MATH 20E,A07,968034,Staff,27,0,27,0
1748420386291,MATH 20E,A08,968035,Staff,26,0,27,1
1748420386291,MATH 20E,C01,931327,Staff,0,0,23,23
1748420386291,MATH 20E,C02,931329,Staff,0,0,27,27
1748420386291,MATH 20E,C03,931331,Staff,0,0,27,27
1748420386291,MATH 20E,C04,931332,Staff,0,0,27,27
1748420386291,MATH 20E,C05,931333,Staff,0,0,27,27
1748420386291,MATH 20E,C06,931334,Staff,8,0,27,19
1748420387317,MATH 31AH,A01,931337,Nandi; Achinta Kumar,5,0,5,0
1748420387317,MATH 31AH,A02,931340,Nandi; Achinta Kumar,5,0,5,0
1748420388359,MATH 87,A00,970775,Harel; Guershon,0,0,0,0
1748420388359,MATH 87,B00,970803,Meyer; David A.,0,0,0,0
1748420389385,MATH 88,A00,967999,Seward; Brandon M.,30,0,35,5
1748420390412,MATH 96,A00,931341,Kane; Daniel Mertz,0,0,0,0
1748420391440,MATH 100A,A01,927335,De Vleming; Kristin Elizab,21,0,30,9
1748420391440,MATH 100A,A02,927337,De Vleming; Kristin Elizab,24,0,30,6
1748420391440,MATH 100A,B01,927341,De Vleming; Kristin Elizab,2,0,30,28
1748420391440,MATH 100A,B02,927342,De Vleming; Kristin Elizab,8,0,30,22
1748420392469,MATH 102,B01,927348,Harel; Guershon,2,0,30,28
1748420392469,MATH 102,B02,927349,Harel; Guershon,22,0,30,8
1748420393503,MATH 103A,B01,927370,Staff,16,0,30,14
1748420393503,MATH 103A,B02,927378,Staff,29,0,30,1
1748420393503,MATH 103A,B03,969574,Staff,27,0,30,3
1748420393503,MATH 103A,C01,927381,Staff,13,0,30,17
1748420393503,MATH 103A,C02,927385,Staff,24,0,30,6
1748420393503,MATH 103A,D01,927388,Suk; Andrew Hoon,0,0,30,30
1748420393503,MATH 103A,D02,927389,Suk; Andrew Hoon,0,0,30,30
1748420394531,MATH 105,A01,927391,Ganapathy; Karthik,26,0,35,9
1748420394531,MATH 105,A02,927454,Ganapathy; Karthik,29,0,35,6
1748420395561,MATH 109,B01,927493,Xiao; Ming,0,0,5,5
1748420395561,MATH 109,B02,927494,Xiao; Ming,0,0,5,5
1748420395561,MATH 109,C01,927500,Xiao; Ming,0,0,5,5
1748420395561,MATH 109,C02,927501,Xiao; Ming,0,0,5,5
1748420395561,MATH 109,D01,927516,Buzaglo; Lucas,0,0,5,5
1748420395561,MATH 109,D02,927517,Buzaglo; Lucas,0,0,5,5
1748420395561,MATH 109,E01,927519,Buzaglo; Lucas,0,0,5,5
1748420395561,MATH 109,E02,927552,Buzaglo; Lucas,0,0,5,5
1748420396586,MATH 111A,A01,927559,Meyer; David A.,0,0,35,35
1748420397613,MATH 120A,A01,927572,Eggers; John Dietrich,13,0,30,17
1748420397613,MATH 120A,A02,927574,Eggers; John Dietrich,29,0,30,1
1748420398648,MATH 140A,A01,927580,Spolaor; Luca,0,0,30,30
1748420398648,MATH 140A,A02,927582,Spolaor; Luca,6,0,30,24
1748420398648,MATH 140A,B01,927588,Ioana; Adrian,0,0,30,30
1748420398648,MATH 140A,B02,927599,Ioana; Adrian,0,0,30,30
1748420399680,MATH 142A,B01,927620,Bejenaru; Ioan,0,0,30,30
1748420399680,MATH 142A,B02,927750,Bejenaru; Ioan,13,0,30,17
1748420399680,MATH 142A,C01,927789,Staff,25,0,30,5
1748420399680,MATH 142A,C02,927815,Staff,30,0,30,0
1748420399680,MATH 142A,C03,969575,Staff,25,0,30,5
1748420399680,MATH 142A,D01,927829,Staff,15,0,30,15
1748420399680,MATH 142A,D02,927832,Staff,30,0,30,0
1748420400707,MATH 153,A01,927862,Harel; Guershon,26,0,35,9
1748420401738,MATH 154,A01,928077,Kane; Daniel Mertz,28,0,35,7
1748420401738,MATH 154,A02,928083,Kane; Daniel Mertz,35,0,35,0
1748420401738,MATH 154,A03,928085,Kane; Daniel Mertz,0,0,35,35
1748420401738,MATH 154,A04,928086,Kane; Daniel Mertz,20,0,35,15
1748420402769,MATH 170A,A01,928146,Tian; Xiaochuan,0,0,30,30
1748420402769,MATH 170A,A02,928225,Tian; Xiaochuan,3,0,30,27
1748420402769,MATH 170A,A03,928231,Tian; Xiaochuan,26,0,30,4
1748420402769,MATH 170A,A04,928237,Tian; Xiaochuan,30,0,30,0
1748420402769,MATH 170A,B01,928244,Huang; Lei,23,0,30,7
1748420402769,MATH 170A,B02,928273,Huang; Lei,30,0,30,0
1748420402769,MATH 170A,B03,928274,Huang; Lei,18,0,30,12
1748420402769,MATH 170A,B04,928276,Huang; Lei,28,0,30,2
1748420403803,MATH 173A,A01,928278,Ding; Lijun,0,0,30,30
1748420403803,MATH 173A,A02,928319,Ding; Lijun,0,0,30,30
1748420403803,MATH 173A,A03,928322,Ding; Lijun,0,0,30,30
1748420403803,MATH 173A,A04,928377,Ding; Lijun,0,0,30,30
1748420403803,MATH 173A,B01,928383,Cloninger; Alexander,0,0,30,30
1748420403803,MATH 173A,B02,928384,Cloninger; Alexander,0,0,30,30
1748420403803,MATH 173A,B03,928385,Cloninger; Alexander,0,0,30,30
1748420403803,MATH 173A,B04,928386,Cloninger; Alexander,0,0,30,30
1748420404831,MATH 174,A01,928397,Cheng; Li-Tien,15,0,28,13
1748420404831,MATH 174,A02,928402,Cheng; Li-Tien,23,0,28,5
1748420405866,MATH 180A,A01,928408,Staff,0,0,25,25
1748420405866,MATH 180A,A02,928409,Staff,18,0,25,7
1748420405866,MATH 180A,A03,928416,Staff,23,0,25,2
1748420405866,MATH 180A,A04,928417,Staff,21,0,25,4
1748420405866,MATH 180A,B01,928428,Peca-Medlin; John Michael,0,0,25,25
1748420405866,MATH 180A,B02,928435,Peca-Medlin; John Michael,11,0,25,14
1748420405866,MATH 180A,B03,928436,Peca-Medlin; John Michael,20,0,25,5
1748420405866,MATH 180A,B04,928453,Peca-Medlin; John Michael,21,0,25,4
1748420405866,MATH 180A,C01,928466,Dixit; Rishabh,20,0,25,5
1748420405866,MATH 180A,C02,928467,Dixit; Rishabh,25,0,25,0
1748420405866,MATH 180A,C03,928506,Dixit; Rishabh,22,0,25,3
1748420405866,MATH 180A,C04,928511,Dixit; Rishabh,25,0,25,0
1748420406899,MATH 180C,A01,928520,Schweinsberg; Jason,0,0,35,35
1748420406899,MATH 180C,A02,928527,Schweinsberg; Jason,0,0,35,35
1748420407932,MATH 181B,A01,928538,Lou; Zhipeng,3,0,30,27
1748420407932,MATH 181B,A02,928539,Lou; Zhipeng,21,0,30,9
1748420407932,MATH 181B,A03,928543,Lou; Zhipeng,27,0,30,3
1748420408960,MATH 183,A01,928545,Quarfoot; David James,0,0,22,22
1748420408960,MATH 183,A02,928560,Quarfoot; David James,0,0,22,22
1748420408960,MATH 183,A03,928565,Quarfoot; David James,0,0,22,22
1748420408960,MATH 183,A04,928566,Quarfoot; David James,0,0,22,22
1748420408960,MATH 183,A05,928567,Quarfoot; David James,0,0,22,22
1748420408960,MATH 183,A06,928568,Quarfoot; David James,0,0,22,22
1748420409993,MATH 184,A01,928587,Chou; Raymond Oliver,14,0,35,21
1748420409993,MATH 184,A02,928592,Chou; Raymond Oliver,29,0,35,6
1748420409993,MATH 184,A03,928593,Chou; Raymond Oliver,32,0,35,3
1748420409993,MATH 184,A04,928594,Chou; Raymond Oliver,35,0,35,0
1748420411021,MATH 187A,A01,928609,Ganapathy; Karthik,0,0,25,25
1748420411021,MATH 187A,A02,928614,Ganapathy; Karthik,0,0,25,25
1748420411021,MATH 187A,A03,928615,Ganapathy; Karthik,0,0,25,25
1748420411021,MATH 187A,A04,928616,Ganapathy; Karthik,7,0,25,18
1748420411021,MATH 187A,A05,928617,Ganapathy; Karthik,0,0,25,25
1748420411021,MATH 187A,A06,928618,Ganapathy; Karthik,12,0,25,13
1748420412049,MATH 190A,A01,928685,Roberts; Justin Deritter,15,0,35,20
1748420413077,MATH 197,001,973284,Kedlaya; Kiran S.,9999,0,9999,0
1748420414134,MATH 200A,A00,928693,Salehi Golsefidy; Alireza,20,0,20,0
1748420415160,MATH 201A,A00,928694,Wenzl; Hans G,20,0,20,0
1748420416191,MATH 202A,A00,928732,Novak; Jonathan I,15,0,20,5
1748420417218,MATH 203A,A00,928743,Izadi; Elham,20,0,20,0
1748420418245,MATH 204A,A00,928764,Sorensen; Claus M,19,0,20,1
1748420419271,MATH 208,A00,928765,Staff,10,0,10,0
1748420420297,MATH 209,A00,928766,Staff,10,0,10,0
1748420421328,MATH 210A,A00,928808,Miller; Pearson,19,0,20,1
1748420422356,MATH 211A,A00,928809,Staff,10,0,10,0
1748420423384,MATH 211B,A00,928811,Staff,10,0,10,0
1748420424414,MATH 216A,A00,928812,Webber; Robert Jacobs,12,0,20,8
1748420425441,MATH 218,A00,928828,Staff,9,0,10,1
1748420426468,MATH 220A,A00,928829,Ebenfelt; Peter F,15,0,20,5
1748420427499,MATH 240A,A00,928830,Spolaor; Luca,17,0,20,3
1748420428524,MATH 241A,A00,928831,Zlatos; Andrej,14,0,20,6
1748420429556,MATH 242,A00,928903,Bejenaru; Ioan,16,0,20,4
1748420430582,MATH 243,A00,928911,Staff,10,0,10,0
1748420431609,MATH 248,A00,928919,Staff,10,0,10,0
1748420432636,MATH 251A,A00,928970,Sam; Steven V,18,0,20,2
1748420433665,MATH 258,A00,928973,Staff,10,0,10,0
1748420434692,MATH 259A,A00,929052,Staff,18,0,20,2
1748420435722,MATH 261A,A00,929059,Warnke; Lutz Peter,10,0,20,10
1748420436746,MATH 269,A00,929060,Staff,10,0,10,0
1748420437773,MATH 270A,A00,929061,Dumitriu; Ioana,8,0,20,12
1748420438800,MATH 273A,A00,929063,Leok; Melvin,17,0,20,3
1748420439829,MATH 274,A01,929069,Cheng; Li-Tien,5,0,5,0
1748420439829,MATH 274,A02,929071,Cheng; Li-Tien,5,0,5,0
1748420440857,MATH 277A,A00,929073,Grier; Daniel T,18,0,20,2
1748420440857,MATH 277A,B00,929080,Nie; Jiawang,20,0,20,0
1748420441883,MATH 278A,A00,929092,Staff,10,0,10,0
1748420442913,MATH 278B,A00,929105,Staff,10,0,10,0
1748420443940,MATH 278C,A00,929113,Staff,10,0,10,0
1748420444967,MATH 280A,A00,929117,Ang; Jie Jun,7,0,20,13
1748420445993,MATH 281A,A00,929120,Lou; Zhipeng,9,0,20,11
1748420447026,MATH 282A,A00,929138,Zhang; Danna,4,0,20,16
1748420448057,MATH 283,A00,929153,Tesler; Glenn,0,0,0,17
1748420449096,MATH 287A,A00,967998,Politis; Dimitris,9,0,15,6
1748420450127,MATH 288,A00,929158,Staff,9,0,10,1
1748420451153,MATH 290A,A00,929180,McKernan; James,18,0,20,2
1748420452181,MATH 292,A00,929185,Staff,10,0,10,0
1748420453207,MATH 295,A00,929189,Staff,15,0,15,0
1748420454237,MATH 297,001,929218,Gamst; Anthony Collins,0,0,0,0
1748420455267,MATS 200,A00,927075,Graeve; Olivia A,9983,0,9999,16
1748420456296,MATS 201A,A00,927076,Luo; Jian,36,0,50,14
1748420457322,MATS 202,A00,927102,Staff,37,0,50,13
1748420458348,MATS 227,A00,927103,Graeve; Olivia A,36,0,50,14
1748420459374,MATS 251A,A00,927139,Bandaru; Prabhakar,40,0,50,10
1748420460402,MATS 257,A00,927140,Cai; Shengqiang,8,0,20,12
1748420461429,MATS 295,A00,927151,Graeve; Olivia A,9999,0,9999,0
1748420461429,MATS 295,B00,927152,Kummel; Andrew C,9999,0,9999,0
1748420462469,MCWP 40,001,945345,Guillen; Melinda,3,0,3,0
1748420462469,MCWP 40,002,945347,Guillen; Melinda,0,0,3,3
1748420462469,MCWP 40,003,945348,Guillen; Melinda,0,0,3,3
1748420462469,MCWP 40,004,945379,Wastal; Carrie King,3,0,3,0
1748420462469,MCWP 40,005,945382,Wastal; Carrie King,2,0,3,1
1748420462469,MCWP 40,006,945383,Compas; Sean Matthew,0,0,3,3
1748420462469,MCWP 40,007,945387,Bartulis; Jason Michael,3,0,3,0
1748420462469,MCWP 40,008,945388,Wastal; Carrie King,2,0,3,1
1748420462469,MCWP 40,009,945391,Wastal; Carrie King,3,0,3,0
1748420462469,MCWP 40,011,945394,Bartulis; Jason Michael,3,0,3,0
1748420462469,MCWP 40,012,945395,Carter; Jennifer A,3,0,3,0
1748420462469,MCWP 40,013,945396,Carter; Jennifer A,2,0,3,1
1748420462469,MCWP 40,014,945429,Carter; Jennifer A,2,0,3,1
1748420462469,MCWP 40,015,945432,Smith; Haydee Marie,3,0,3,0
1748420462469,MCWP 40,016,945433,Smith; Haydee Marie,3,0,3,0
1748420462469,MCWP 40,017,945435,Smith; Haydee Marie,3,0,3,0
1748420462469,MCWP 40,018,945436,Pham; Vincent Minhduc,3,0,3,0
1748420462469,MCWP 40,019,945453,Pham; Vincent Minhduc,3,0,3,0
1748420462469,MCWP 40,020,945459,Pham; Vincent Minhduc,3,0,3,0
1748420462469,MCWP 40,023,945469,Montejo; Carolina,3,0,3,0
1748420462469,MCWP 40,024,945472,Montejo; Carolina,3,0,3,0
1748420462469,MCWP 40,026,945708,Compas; Sean Matthew,3,0,3,0
1748420462469,MCWP 40,027,945710,Duru; Nur,2,0,3,1
1748420462469,MCWP 40,028,945714,Duru; Nur,1,0,3,2
1748420462469,MCWP 40,029,945715,Duru; Nur,2,0,3,1
1748420462469,MCWP 40,030,945718,Compas; Sean Matthew,0,0,3,3
1748420463495,MCWP 40R,A00,945742,Miller; Elizabeth Deen,0,0,0,1
1748420463495,MCWP 40R,B00,945743,Miller; Elizabeth Deen,0,0,0,0
1748420463495,MCWP 40R,C00,945744,Miller; Elizabeth Deen,0,0,0,1
1748420464528,MCWP 50,001,945745,Wastal; Carrie King,2,0,15,13
1748420464528,MCWP 50,002,945746,Carter; Andrea L,18,0,20,2
1748420464528,MCWP 50,003,945788,Carter; Andrea L,11,0,20,9
1748420464528,MCWP 50,004,945887,Carter; Andrea L,8,0,20,12
1748420465561,MCWP 125,001,945901,Nies; Laurie Elizabeth,3,0,3,0
1748420465561,MCWP 125,002,945902,Nies; Laurie Elizabeth,3,0,3,0
1748420465561,MCWP 125,003,945904,Redela; Pamela Morgan,3,0,3,0
1748420465561,MCWP 125,004,945930,Redela; Pamela Morgan,3,0,3,0
1748420465561,MCWP 125,005,945931,Redela; Pamela Morgan,3,0,3,0
1748420465561,MCWP 125,006,945932,Silva; Kelly B,3,0,3,0
1748420465561,MCWP 125,007,945933,Silva; Kelly B,3,0,3,0
1748420465561,MCWP 125,009,945935,Krone; Jarret,3,0,3,0
1748420465561,MCWP 125,010,945940,Krone; Jarret,3,0,3,0
1748420465561,MCWP 125,011,945941,Krone; Jarret,3,0,3,0
1748420465561,MCWP 125,012,945942,Morshed; Michael James,3,0,3,0
1748420465561,MCWP 125,013,945943,Morshed; Michael James,3,0,3,0
1748420465561,MCWP 125,014,945944,Morshed; Michael James,3,0,3,0
1748420466588,MGT 3,A00,945992,Wagner; Timothy Ryan,96,0,98,2
1748420467616,MGT 4,A01,945994,Brooks; Marcus Raymond,80,0,90,10
1748420468644,MGT 5,A00,945995,Molloie Jr.; William H,134,0,150,16
1748420469675,MGT 12,A00,945996,Lindenberger; Wade Douglas,63,0,98,35
1748420469675,MGT 12,B00,945997,Pecore; Joseph P.,58,0,98,40
1748420470709,MGT 16,A00,945998,Buchanan; Harold G,96,0,98,2
1748420470709,MGT 16,B00,946005,Buchanan; Harold G,90,0,98,8
1748420470709,MGT 16,C00,946006,Campbell; Robert Harold,92,0,98,6
1748420470709,MGT 16,D00,946007,Campbell; Robert Harold,93,0,98,5
1748420470709,MGT 16,E00,946022,Lindenberger; Wade Douglas,42,0,98,56
1748420471747,MGT 18,A00,946040,McKay; Michael J,95,0,98,3
1748420471747,MGT 18,B00,946041,McKay; Michael J,96,0,98,2
1748420471747,MGT 18,C00,946044,McKay; Michael J,96,0,98,2
1748420471747,MGT 18,D00,946047,Chamberlain; Travis Dean,98,0,98,0
1748420471747,MGT 18,E00,946051,Chamberlain; Travis Dean,96,0,98,2
1748420471747,MGT 18,F00,960148,Chamberlain; Travis Dean,0,0,0,2
1748420472778,MGT 45,A00,946055,Pecore; Joseph P.,81,0,150,69
1748420472778,MGT 45,B00,946057,Pecore; Joseph P.,118,0,150,32
1748420473806,MGT 52,A00,946059,Staff,77,0,98,21
1748420474843,MGT 71,A00,946060,Goodarzi; Shadi,0,0,98,98
1748420474843,MGT 71,B00,946061,Erat; Sanjiv,0,0,98,98
1748420474843,MGT 71,D00,960149,Staff,0,0,98,98
1748420475870,MGT 100,A00,946069,Yavorsky; Daniel Ryan,0,0,98,98
1748420476902,MGT 103,A00,946081,Ehrich; Kristine R,96,0,98,2
1748420476902,MGT 103,C00,946083,Ehrich; Kristine R,75,0,98,23
1748420476902,MGT 103,D00,946084,Ehrich; Kristine R,57,0,98,41
1748420476902,MGT 103,E00,946138,Bates; Kenneth Walter,82,0,98,16
1748420477931,MGT 105,A00,946139,Bates; Kenneth Walter,0,0,98,98
1748420478963,MGT 108R,A00,946141,Amir; On,888,0,999,111
1748420479990,MGT 109,A00,946142,Staff,14,0,98,84
1748420481017,MGT 112,A00,960205,Zimmermann; Carsten,30,0,98,68
1748420482050,MGT 119,A00,946144,Schurr; Amos Shlomo,96,0,98,2
1748420482050,MGT 119,B00,946153,Staff,97,0,98,1
1748420483130,MGT 121A,A00,946154,Wang; Helen Shan,89,0,98,9
1748420483130,MGT 121A,B00,946188,Wang; Helen Shan,96,0,98,2
1748420484159,MGT 127R,A00,946197,Zhu; Kevin Xiaoguo,70,0,98,28
1748420485189,MGT 131A,A00,946227,Brooks; Marcus Raymond,91,0,98,7
1748420486219,MGT 132,A00,946230,Blakley; Bruce,76,0,98,22
1748420487246,MGT 135,A00,946234,Anderson; John Charles,1,0,40,39
1748420488272,MGT 137,A00,960206,Lindenberger; Wade Douglas,0,0,98,98
1748420489296,MGT 151R,A00,946235,Staff,65,0,98,33
1748420490328,MGT 153,A00,946242,Perols; Johan Lars,0,0,90,90
1748420490328,MGT 153,B00,946244,Perols; Johan Lars,0,0,90,90
1748420491354,MGT 158,A00,946247,Bliss; Barbara Ann,85,0,98,13
1748420492379,MGT 160,A00,946265,Johnson; Erik Barry,30,0,90,60
1748420492379,MGT 160,B00,946266,Johnson; Erik Barry,58,0,90,32
1748420493411,MGT 162,A00,946267,Demill; Burritt,85,0,98,13
1748420493411,MGT 162,B00,946269,Demill; Burritt,67,0,98,31
1748420494441,MGT 162R,A00,946270,Gneezy; Uri,0,0,150,150
1748420495472,MGT 164,A00,946271,McKay; Mary A,88,0,98,10
1748420495472,MGT 164,B00,946272,McKay; Mary A,80,0,98,18
1748420495472,MGT 164,C00,946273,McKay; Mary A,88,0,98,10
1748420495472,MGT 164,D00,946274,Meyer; Alison Bloomfield,0,0,98,98
1748420496502,MGT 166,A00,946276,Moran; Cathleen L.,40,0,60,20
1748420496502,MGT 166,B00,946277,Moran; Cathleen L.,84,0,98,14
1748420496502,MGT 166,C00,946278,Moran; Cathleen L.,94,0,98,4
1748420497534,MGT 167,A00,946279,Jacob; Jo Dee C,88,0,98,10
1748420497534,MGT 167,B00,946280,Klaas; Jeffrey David,97,0,98,1
1748420499592,MGT 172,A00,946282,Hedges; Kathleen & Royal; Rebecca,92,0,98,6
1748420499592,MGT 172,B00,946283,Hedges; Kathleen,73,0,98,25
1748420499592,MGT 172,C00,946284,Zimmermann; Carsten,0,0,0,3
1748420500617,MGT 172R,A00,946285,Erat; Sanjiv,134,0,150,16
1748420501650,MGT 173,A00,946286,Hayes; Sherry Lorine,66,0,98,32
1748420502677,MGT 175,A00,946287,Gopal; Christopher S.,81,0,90,9
1748420503710,MGT 180,A00,946288,Bliss; Barbara Ann,96,0,150,54
1748420503710,MGT 180,B00,946289,Buti; Krisztina,140,0,150,10
1748420503710,MGT 180,C00,960207,Buti; Krisztina,142,0,150,8
1748420504741,MGT 181,A00,946290,Buchanan; Harold G,17,0,120,103
1748420505768,MGT 183,A00,960208,Staff,53,0,98,45
1748420506795,MGT 185,A00,946291,Dunn; Louis Jean,70,0,98,28
1748420507838,MGT 187,A00,946292,Dunn; Louis Jean,43,0,98,55
1748420508872,MGT 189,A00,946293,Staff,88,0,98,10
1748420509899,MGT 228,A00,946294,Sadoff; Sally,16,0,20,4
1748420510926,MGT 286,A00,946295,Staff,20,0,20,0
1748420511960,MGT 296,001,969295,Gneezy; Ayelet,2,0,3,1
1748420511960,MGT 296,002,969296,Amir; On,3,0,3,0
1748420511960,MGT 296,003,969297,Amir; On & Karmarkar; Uma R,2,0,3,1
1748420511960,MGT 296,004,969298,Liu; Jun,3,0,3,0
1748420511960,MGT 296,005,969300,Hansen; Karsten T.,2,0,3,1
1748420511960,MGT 296,006,969301,Erat; Sanjiv,2,0,3,1
1748420511960,MGT 296,007,969302,Avenancio-Leon; Carlos,3,0,3,0
1748420511960,MGT 296,008,969303,Engelberg; Joseph Edward,3,0,3,0
1748420511960,MGT 296,009,969304,Zhang; Zhe,3,0,3,0
1748420511960,MGT 296,010,969305,Oveis; Christopher S,3,0,3,0
1748420511960,MGT 296,011,969306,Zhu; Kevin Xiaoguo & Gneezy; Ayelet,3,0,3,0
1748420511960,MGT 296,012,969307,Luo; Danqi,3,0,3,0
1748420511960,MGT 296,013,969309,Oveis; Christopher S & Campbell; Elizabeth L,3,0,3,0
1748420511960,MGT 296,014,969310,Serra Garcia; Marta & Gneezy; Uri,3,0,3,0
1748420511960,MGT 296,015,969311,Rai; Tage S,3,0,3,0
1748420513001,MMW 11,A01,925937,Herbst; Matthew,4,0,4,0
1748420513001,MMW 11,A02,925938,Herbst; Matthew,3,0,4,1
1748420513001,MMW 11,A03,925939,Herbst; Matthew,4,0,4,0
1748420513001,MMW 11,A04,925940,Herbst; Matthew,4,0,4,0
1748420513001,MMW 11,A05,925941,Herbst; Matthew,0,0,0,0
1748420513001,MMW 11,A06,925942,Herbst; Matthew,0,0,0,0
1748420513001,MMW 11,A07,925975,Herbst; Matthew,3,0,4,1
1748420513001,MMW 11,A08,926004,Herbst; Matthew,3,0,4,1
1748420513001,MMW 11,A09,926021,Herbst; Matthew,3,0,4,1
1748420513001,MMW 11,A10,926064,Herbst; Matthew,4,0,4,0
1748420513001,MMW 11,A11,926067,Herbst; Matthew,4,0,4,0
1748420513001,MMW 11,A12,926072,Herbst; Matthew,4,0,4,0
1748420513001,MMW 11,B01,926211,Chang; Edmond Yi-Teh,3,0,4,1
1748420513001,MMW 11,B02,926212,Chang; Edmond Yi-Teh,4,0,4,0
1748420513001,MMW 11,B03,926213,Chang; Edmond Yi-Teh,4,0,4,0
1748420513001,MMW 11,B04,926214,Chang; Edmond Yi-Teh,4,0,4,0
1748420513001,MMW 11,B05,926215,Chang; Edmond Yi-Teh,4,0,4,0
1748420513001,MMW 11,B06,926216,Chang; Edmond Yi-Teh,4,0,4,0
1748420513001,MMW 11,B07,926217,Chang; Edmond Yi-Teh,4,0,4,0
1748420513001,MMW 11,B08,926218,Chang; Edmond Yi-Teh,3,0,4,1
1748420513001,MMW 11,B09,926219,Chang; Edmond Yi-Teh,4,0,4,0
1748420513001,MMW 11,B10,926220,Chang; Edmond Yi-Teh,4,0,4,0
1748420513001,MMW 11,B11,926221,Chang; Edmond Yi-Teh,0,0,0,0
1748420513001,MMW 11,B12,926233,Chang; Edmond Yi-Teh,0,0,0,0
1748420513001,MMW 11,C01,926237,Chang; Edmond Yi-Teh,4,0,4,0
1748420513001,MMW 11,C02,926238,Chang; Edmond Yi-Teh,4,0,4,0
1748420513001,MMW 11,C03,926239,Chang; Edmond Yi-Teh,3,0,4,1
1748420513001,MMW 11,C04,926240,Chang; Edmond Yi-Teh,4,0,4,0
1748420513001,MMW 11,C05,926241,Chang; Edmond Yi-Teh,4,0,4,0
1748420513001,MMW 11,C06,926242,Chang; Edmond Yi-Teh,4,0,4,0
1748420513001,MMW 11,C07,926243,Chang; Edmond Yi-Teh,4,0,4,0
1748420513001,MMW 11,C08,926244,Chang; Edmond Yi-Teh,4,0,4,0
1748420513001,MMW 11,C09,926245,Chang; Edmond Yi-Teh,0,0,0,0
1748420513001,MMW 11,C10,926301,Chang; Edmond Yi-Teh,0,0,0,0
1748420513001,MMW 11,C11,926303,Chang; Edmond Yi-Teh,4,0,4,0
1748420513001,MMW 11,C12,926305,Chang; Edmond Yi-Teh,4,0,4,0
1748420514031,MMW 14,A01,926309,Carreras; Maria Victoria,0,0,0,0
1748420514031,MMW 14,A02,926470,Carreras; Maria Victoria,0,0,0,0
1748420514031,MMW 14,A03,926472,Carreras; Maria Victoria,0,0,28,28
1748420514031,MMW 14,A04,926474,Carreras; Maria Victoria,0,0,28,28
1748420514031,MMW 14,A05,926475,Carreras; Maria Victoria,0,0,28,28
1748420514031,MMW 14,A06,926476,Carreras; Maria Victoria,0,0,28,28
1748420514031,MMW 14,A07,926477,Carreras; Maria Victoria,0,0,28,28
1748420514031,MMW 14,A08,926513,Carreras; Maria Victoria,0,0,28,28
1748420514031,MMW 14,A09,926514,Carreras; Maria Victoria,0,0,0,0
1748420514031,MMW 14,A10,926515,Carreras; Maria Victoria,0,0,0,0
1748420515074,MMW 121,A01,926517,Adamiak; Patrick John,0,0,0,0
1748420515074,MMW 121,A02,926548,Adamiak; Patrick John,0,0,0,0
1748420515074,MMW 121,A03,926549,Adamiak; Patrick John,0,0,4,4
1748420515074,MMW 121,A04,926550,Adamiak; Patrick John,2,0,4,2
1748420515074,MMW 121,A05,926551,Adamiak; Patrick John,0,0,4,4
1748420515074,MMW 121,A06,926552,Adamiak; Patrick John,3,0,4,1
1748420515074,MMW 121,A07,926585,Adamiak; Patrick John,3,0,4,1
1748420515074,MMW 121,A08,926590,Adamiak; Patrick John,3,0,4,1
1748420515074,MMW 121,A09,926641,Adamiak; Patrick John,0,0,0,0
1748420515074,MMW 121,A10,926658,Adamiak; Patrick John,0,0,0,0
1748420515074,MMW 121,B01,926680,Adamiak; Patrick John,0,0,4,4
1748420515074,MMW 121,B02,926691,Adamiak; Patrick John,0,0,4,4
1748420515074,MMW 121,B03,926710,Adamiak; Patrick John,2,0,4,2
1748420515074,MMW 121,B04,926714,Adamiak; Patrick John,4,0,4,0
1748420515074,MMW 121,B05,926750,Adamiak; Patrick John,0,0,4,4
1748420515074,MMW 121,B06,926765,Adamiak; Patrick John,4,0,4,0
1748420515074,MMW 121,B07,926769,Adamiak; Patrick John,3,0,4,1
1748420515074,MMW 121,B08,926953,Adamiak; Patrick John,3,0,4,1
1748420515074,MMW 121,B09,926954,Adamiak; Patrick John,0,0,0,0
1748420515074,MMW 121,B10,926955,Adamiak; Patrick John,0,0,0,0
1748420516101,MSED 295,A00,927153,Staff,5,0,5,0
1748420517132,MSED 296A,A00,927181,Rabin; Jeffrey Mark,13,0,15,2
1748420518166,MUS 1A,A01,931495,Staff,24,0,25,1
1748420518166,MUS 1A,A02,931499,Staff,21,0,25,4
1748420518166,MUS 1A,A03,931502,Staff,21,0,25,4
1748420518166,MUS 1A,A04,931503,Staff,25,0,25,0
1748420518166,MUS 1A,A05,931504,Staff,19,0,25,6
1748420518166,MUS 1A,A06,931505,Staff,22,0,25,3
1748420518166,MUS 1A,B01,931507,Staff,25,0,25,0
1748420518166,MUS 1A,B02,931530,Staff,22,0,25,3
1748420518166,MUS 1A,B03,931534,Staff,23,0,25,2
1748420518166,MUS 1A,B04,931536,Staff,24,0,25,1
1748420518166,MUS 1A,B05,931539,Staff,17,0,25,8
1748420518166,MUS 1A,B06,931541,Staff,13,0,25,12
1748420519199,MUS 2A,A01,931544,Carlson; Erik,40,0,40,0
1748420520228,MUS 2AK,A00,931545,Ohnishi; Takae,15,0,15,0
1748420520228,MUS 2AK,B00,931546,Ohnishi; Takae,15,0,15,0
1748420521257,MUS 4,A01,931551,Staff,24,0,25,1
1748420521257,MUS 4,A02,931552,Staff,25,0,25,0
1748420521257,MUS 4,A03,931553,Staff,24,0,25,1
1748420521257,MUS 4,A04,931554,Staff,25,0,25,0
1748420521257,MUS 4,A05,931558,Staff,24,0,25,1
1748420521257,MUS 4,A06,931561,Staff,25,0,25,0
1748420521257,MUS 4,A07,931562,Staff,25,0,25,0
1748420521257,MUS 4,A08,931563,Staff,25,0,25,0
1748420521257,MUS 4,A09,931564,Staff,25,0,25,0
1748420521257,MUS 4,A10,931566,Staff,25,0,25,0
1748420522285,MUS 6,A01,931573,Freitas Caetano; Marcelo,27,0,30,3
1748420522285,MUS 6,A02,931574,Freitas Caetano; Marcelo,28,0,30,2
1748420522285,MUS 6,A03,931677,Freitas Caetano; Marcelo,28,0,30,2
1748420522285,MUS 6,A04,931696,Freitas Caetano; Marcelo,30,0,30,0
1748420523313,MUS 8,A01,931732,Smythe; Cory Benjamin,12,0,25,13
1748420523313,MUS 8,A02,931737,Smythe; Cory Benjamin,17,0,25,8
1748420523313,MUS 8,A03,931761,Smythe; Cory Benjamin,25,0,25,0
1748420523313,MUS 8,A04,931920,Smythe; Cory Benjamin,23,0,25,2
1748420523313,MUS 8,A05,931925,Smythe; Cory Benjamin,21,0,25,4
1748420523313,MUS 8,A06,931943,Smythe; Cory Benjamin,19,0,25,6
1748420523313,MUS 8,A07,931948,Smythe; Cory Benjamin,22,0,25,3
1748420523313,MUS 8,A08,931955,Smythe; Cory Benjamin,18,0,25,7
1748420523313,MUS 8,A09,931964,Smythe; Cory Benjamin,25,0,25,0
1748420523313,MUS 8,A10,931974,Smythe; Cory Benjamin,24,0,25,1
1748420524345,MUS 13,A01,961328,Guy; Nancy,28,0,30,2
1748420524345,MUS 13,A02,961333,Guy; Nancy,30,0,30,0
1748420524345,MUS 13,A03,961343,Guy; Nancy,28,0,30,2
1748420524345,MUS 13,A04,961351,Guy; Nancy,30,0,30,0
1748420525371,MUS 14,A01,932176,McCormack; Timothy Matthew,29,0,30,1
1748420525371,MUS 14,A02,932183,McCormack; Timothy Matthew,29,0,30,1
1748420525371,MUS 14,A03,932186,McCormack; Timothy Matthew,30,0,30,0
1748420525371,MUS 14,A04,932190,McCormack; Timothy Matthew,29,0,30,1
1748420526412,MUS 15,A01,932270,Lou; Michelle Siulai,28,0,30,2
1748420526412,MUS 15,A02,932315,Lou; Michelle Siulai,29,0,30,1
1748420526412,MUS 15,A03,932316,Lou; Michelle Siulai,28,0,30,2
1748420526412,MUS 15,A04,932323,Lou; Michelle Siulai,30,0,30,0
1748420526412,MUS 15,A05,932325,Lou; Michelle Siulai,27,0,30,3
1748420526412,MUS 15,A06,932326,Lou; Michelle Siulai,27,0,30,3
1748420526412,MUS 15,A07,932327,Lou; Michelle Siulai,30,0,30,0
1748420526412,MUS 15,A08,932328,Lou; Michelle Siulai,28,0,30,2
1748420526412,MUS 15,A09,932366,Lou; Michelle Siulai,29,0,30,1
1748420526412,MUS 15,A10,932380,Lou; Michelle Siulai,25,0,30,5
1748420527446,MUS 17,A01,932416,Staff,0,0,0,0
1748420527446,MUS 17,A02,932423,Staff,0,0,0,0
1748420527446,MUS 17,A03,932437,Staff,0,0,0,0
1748420527446,MUS 17,A04,932447,Staff,0,0,0,0
1748420527446,MUS 17,A05,932460,Staff,0,0,0,0
1748420527446,MUS 17,A06,932466,Staff,0,0,0,0
1748420527446,MUS 17,A07,932475,Staff,0,0,0,0
1748420527446,MUS 17,A08,932479,Staff,0,0,0,0
1748420527446,MUS 17,A09,932480,Staff,0,0,0,0
1748420527446,MUS 17,A10,932481,Staff,0,0,0,0
1748420527446,MUS 17,A11,932487,Staff,0,0,0,9
1748420527446,MUS 17,A12,932490,Staff,0,0,0,1
1748420528477,MUS 19R,A01,932494,Britt; King James,7,0,25,18
1748420528477,MUS 19R,A02,932500,Britt; King James,20,0,25,5
1748420528477,MUS 19R,A03,932503,Britt; King James,24,0,25,1
1748420528477,MUS 19R,A04,932504,Britt; King James,23,0,25,2
1748420528477,MUS 19R,A05,932512,Britt; King James,25,0,25,0
1748420528477,MUS 19R,A06,932513,Britt; King James,17,0,25,8
1748420528477,MUS 19R,A07,932517,Britt; King James,22,0,25,3
1748420528477,MUS 19R,A08,932522,Britt; King James,20,0,25,5
1748420528477,MUS 19R,A09,960795,Britt; King James,25,0,25,0
1748420528477,MUS 19R,A10,960796,Britt; King James,15,0,25,10
1748420528477,MUS 19R,B01,960808,Britt; King James,5,0,5,0
1748420528477,MUS 19R,B02,960810,Britt; King James,4,0,5,1
1748420528477,MUS 19R,B03,960812,Britt; King James,5,0,5,0
1748420528477,MUS 19R,B04,960815,Britt; King James,5,0,5,0
1748420528477,MUS 19R,B05,960861,Britt; King James,5,0,5,0
1748420528477,MUS 19R,B06,960863,Britt; King James,5,0,5,0
1748420528477,MUS 19R,B07,960866,Britt; King James,5,0,5,0
1748420528477,MUS 19R,B08,960870,Britt; King James,5,0,5,0
1748420528477,MUS 19R,B09,960871,Britt; King James,5,0,5,0
1748420528477,MUS 19R,B10,960872,Britt; King James,5,0,5,0
1748420529510,MUS 32,001,931432,Dresser; Mark Stuart,5,0,5,0
1748420529510,MUS 32,002,931433,Smythe; Cory Benjamin,5,0,5,0
1748420529510,MUS 32,003,931438,Kenyatta; Kamau,5,0,5,0
1748420529510,MUS 32,004,931441,Curtis; Charles Rector,5,0,5,0
1748420529510,MUS 32,005,931443,Staff,5,0,5,0
1748420529510,MUS 32,006,931447,Terrazas Perez; Wilfrido D,5,0,5,0
1748420529510,MUS 32,007,931448,Ohnishi; Takae,5,0,5,0
1748420529510,MUS 32,008,931453,Burr; Anthony I,5,0,5,0
1748420529510,MUS 32,009,931454,Carlson; Erik,5,0,5,0
1748420530537,MUS 32V,A00,932529,Staff,5,0,5,0
1748420530537,MUS 32V,B00,932532,Staff,5,0,5,0
1748420531562,MUS 32VM,A00,932533,Staff,15,0,15,0
1748420532594,MUS 33A,A00,932538,Liang; Lei,16,0,17,1
1748420533620,MUS 43,A00,932540,Staff,79,0,96,17
1748420534648,MUS 95C,A00,932544,Staff,30,0,40,10
1748420535677,MUS 95D,A00,932547,Staff,30,0,30,0
1748420536706,MUS 95E,A00,932548,Staff,45,0,45,0
1748420537732,MUS 95F,A00,932549,Staff,40,0,40,0
1748420538759,MUS 95G,A00,932550,Anderson; Kenneth,374,0,395,21
1748420538759,MUS 95G,B00,932553,Anderson; Kenneth,381,0,395,14
1748420539789,MUS 95JC,A00,932555,Kenyatta; Kamau,25,0,25,0
1748420540815,MUS 95L,A00,932556,Staff,65,0,65,0
1748420541843,MUS 95P,A00,932564,Nourai; Keyavash,17,0,20,3
1748420541843,MUS 95P,B00,932565,Nourai; Keyavash,18,0,20,2
1748420542874,MUS 95W,A00,932567,Seshadri; Kartik,26,0,30,4
1748420542874,MUS 95W,B00,932570,Seshadri; Kartik,30,0,30,0
1748420543906,MUS 101A,A01,932575,Burr; Anthony I,31,0,35,4
1748420544932,MUS 107,A00,932578,Terrazas Perez; Wilfrido D,14,0,15,1
1748420545959,MUS 111,A00,932580,Liang; Lei,135,0,140,5
1748420546989,MUS 113,A00,932584,Curtis; Charles Rector,48,0,50,2
1748420548016,MUS 115,A00,932585,Narucki; Susan M,32,0,40,8
1748420549044,MUS 120A,A01,932593,Leslie Santana; Myrta,27,0,30,3
1748420550071,MUS 130,A00,932600,Ohnishi; Takae,35,0,35,0
1748420551102,MUS 132,001,931462,Dresser; Mark Stuart,5,0,5,0
1748420551102,MUS 132,002,931463,Smythe; Cory Benjamin,5,0,5,0
1748420551102,MUS 132,003,931465,Kenyatta; Kamau,5,0,5,0
1748420551102,MUS 132,004,931467,Curtis; Charles Rector,5,0,5,0
1748420551102,MUS 132,005,931468,Staff,5,0,5,0
1748420551102,MUS 132,006,931470,Terrazas Perez; Wilfrido D,5,0,5,0
1748420551102,MUS 132,007,931471,Ohnishi; Takae,5,0,5,0
1748420551102,MUS 132,008,931473,Burr; Anthony I,5,0,5,0
1748420551102,MUS 132,009,931474,Carlson; Erik,5,0,5,0
1748420552132,MUS 132R,A00,961401,Narucki; Susan M,5,0,5,0
1748420553158,MUS 132V,A00,961362,Narucki; Susan M,10,0,10,0
1748420553158,MUS 132V,B00,961397,Staff,10,0,10,0
1748420554189,MUS 134,A00,932601,Staff,30,0,30,0
1748420555218,MUS 137A,A00,932604,Kenyatta; Kamau,31,0,35,4
1748420556243,MUS 143,A00,932617,Staff,10,0,30,20
1748420557276,MUS 170,A01,932620,Freitas Caetano; Marcelo,45,0,50,5
1748420557276,MUS 170,A02,932623,Freitas Caetano; Marcelo,42,0,50,8
1748420558329,MUS 173A,A00,932625,Britt; King James,28,0,65,37
1748420559354,MUS 174A,A00,932649,Erbe; Tom,0,0,25,25
1748420560387,MUS 175,A00,932810,Smyth; Tamara R.,29,0,30,1
1748420561413,MUS 176,A00,932811,Yadegari; Shahrokh D,29,0,30,1
1748420562441,MUS 201A,A00,932812,Carlson; Erik,14,0,15,1
1748420563478,MUS 201C,A00,932818,Schick; Steven,15,0,15,0
1748420564512,MUS 203A,A00,932821,Lou; Michelle Siulai,15,0,15,0
1748420565545,MUS 203D,A00,932825,Davis; Anthony Curtis,10,0,10,0
1748420565545,MUS 203D,B00,932827,Liang; Lei,10,0,10,0
1748420565545,MUS 203D,C00,932828,Lou; Michelle Siulai,9,0,10,1
1748420565545,MUS 203D,D00,932830,Obermueller; Karola,9,0,10,1
1748420565545,MUS 203D,E00,932831,Steiger; Rand,10,0,10,0
1748420565545,MUS 203D,F00,961402,McCormack; Timothy Matthew,10,0,10,0
1748420566570,MUS 204,A00,932832,Obermueller; Karola,29,0,30,1
1748420567602,MUS 205,A00,932833,Guy; Nancy,15,0,15,0
1748420568631,MUS 206,B00,961403,Obermueller; Karola,14,0,15,1
1748420568631,MUS 206,C00,932839,Davis; Anthony Curtis,14,0,15,1
1748420569656,MUS 215A,A00,932985,Cimini; Amy Marie,15,0,15,0
1748420570680,MUS 228,A00,933096,Schick; Steven,13,0,15,2
1748420571705,MUS 229,A00,933148,McCormack; Timothy Matthew,14,0,15,1
1748420572732,MUS 232,001,931483,Dresser; Mark Stuart,5,0,5,0
1748420572732,MUS 232,002,931485,Kenyatta; Kamau,5,0,5,0
1748420572732,MUS 232,003,931487,Narucki; Susan M,4,0,5,1
1748420572732,MUS 232,004,931489,Schick; Steven,5,0,5,0
1748420572732,MUS 232,005,964353,Terrazas Perez; Wilfrido D,3,0,3,0
1748420573804,MUS 234,A00,933176,Erbe; Tom,20,0,20,0
1748420574830,MUS 270D,A00,969315,Smyth; Tamara R.,0,0,0,0
1748420575858,MUS 291,A00,933192,Curtis; Charles Rector,15,0,15,0
1748420576884,NANO 4,A01,912573,Vazquez Mena; Oscar,21,0,24,3
1748420576884,NANO 4,B01,912575,Vazquez Mena; Oscar,24,0,24,0
1748420576884,NANO 4,C01,912577,Vazquez Mena; Oscar,21,0,24,3
1748420576884,NANO 4,D01,912579,Vazquez Mena; Oscar,23,0,24,1
1748420577909,NANO 11,A00,912580,Fenning; David,143,0,146,3
1748420578933,NANO 15,A01,912583,Lubarda; Vlado,26,0,30,4
1748420579964,NANO 20L,A00,912584,Sirbuly; Donald,0,0,30,30
1748420579964,NANO 20L,B00,912585,Sirbuly; Donald,20,0,30,10
1748420580989,NANO 102,A00,912586,Tao; Andrea Rae,99,0,115,16
1748420582020,NANO 103,A00,912587,Jahed Motlagh; Zeinab,49,0,50,1
1748420583046,NANO 111,A00,912588,Vecchio; Kenneth S,50,0,60,10
1748420584073,NANO 119,A00,912589,Jokerst; Jesse Vincent,6,0,28,22
1748420584073,NANO 119,B00,912590,Jokerst; Jesse Vincent,26,0,28,2
1748420585099,NANO 148,A00,912591,Luo; Jian,55,0,70,15
1748420586130,NANO 150,A00,912592,Lubarda; Vlado,48,0,50,2
1748420587212,NANO 159,A00,912593,Wang; Joseph,44,0,50,6
1748420588244,NANO 175,A00,912594,Steinmetz; Nicole F,13,0,35,22
1748420589271,NANO 200,A00,912595,Jahed Motlagh; Zeinab,110,0,120,10
1748420590301,NANO 201,A00,912596,Sirbuly; Donald,49,0,60,11
1748420591334,NANO 202,A00,912597,Pascal; Tod A,60,0,60,0
1748420592369,NANO 203,A00,912598,Fenning; David,95,0,100,5
1748420593400,NANO 227,A00,912599,Graeve; Olivia A,14,0,15,1
1748420594426,NANO 247A,A00,912600,Shi; Lingyan,9,0,15,6
1748420595454,NANO 247B,A00,912601,Aran; Kiana,11,0,15,4
1748420596486,NANO 257,A00,912602,Cai; Shengqiang,32,0,35,3
1748420597511,NANO 265,A00,912603,Luo; Jian,9,0,10,1
1748420598535,NEU 276,A00,969333,Staff,0,0,0,0
1748420598535,NEU 276,A01,969334,Staff,0,0,0,0
1748420599568,NEUG 200A,A01,969326,Bloodgood; Brenda Laurie,0,0,0,0
1748420599568,NEUG 200A,A02,969327,Bloodgood; Brenda Laurie,0,0,0,0
1748420600599,NEUG 221,A00,969330,Dore; Kim Bohemie,6,0,6,0
1748420600599,NEUG 221,B00,969331,Bloodgood; Brenda Laurie,0,0,0,0
1748420601626,NEUG 265,A00,969329,Yaksh; Tony L.,10,0,10,0
1748420602653,NEUG 296,A00,969336,Bloodgood; Brenda Laurie,12,0,12,0
1748420603682,PH 40,A00,922279,Trinidad; Dennis Ryan,136,0,150,14
1748420603682,PH 40,B00,922283,Trinidad; Dennis Ryan,148,0,150,2
1748420604709,PH 50,A00,922284,Glockner; Susan Mariscal,160,0,175,15
1748420605736,PH 90,A00,964352,Larsen; Britta Ann,0,0,0,0
1748420606763,PH 91,A00,922286,Harrell; Maralee Mae,48,0,50,2
1748420607794,PH 101,A00,922287,Brouwer; Kimberly,0,0,50,50
1748420608827,PH 102,A01,922307,Rana; Brinda Kanti,0,0,25,25
1748420608827,PH 102,A02,922310,Rana; Brinda Kanti,0,0,25,25
1748420609854,PH 110,A00,922333,Zoumas-Morse; Christine E.,0,0,50,50
1748420610885,PH 120,A00,922392,McMenamin; Sara B,0,0,50,50
1748420611916,PH 120R,A00,922393,McMenamin; Sara B,0,0,50,50
1748420612950,PH 130,A00,922441,Kayser; Georgia Lyn,0,0,60,60
1748420613981,PH 157,A00,922444,Campbell; Chadwick Karl,29,0,50,21
1748420615010,PH 161,A00,922445,Zoumas-Morse; Christine E.,0,0,50,50
1748420616041,PH 193,A00,922468,Zoumas-Morse; Christine E.,0,0,0,0
1748420617069,PH 231,A00,970937,Hurst; Samantha,12,0,12,0
1748420618104,PH 258,A00,960659,Bazzi; Angela Robertson,15,0,15,0
1748420619135,PH 259,A00,960660,Bandoli; Gretchen,10,0,10,0
1748420620161,PH 275,A00,922474,Groessl; Erik Joseph,10,0,10,0
1748420621193,PH 280,A00,960661,Strong; David R & Skaathun; Britt Paige,10,0,10,0
1748420622227,PHAR 219,A00,954131,Ross; Camille,0,0,0,0
1748420623257,PHAR 236,A00,934403,Chen; Shu-Juan,10,0,10,0
1748420624284,PHAR 295,A00,934404,Joiner; William J.,14,0,15,1
1748420625312,PHB 221,A00,922708,Zou; Jingjing,22,0,39,17
1748420626344,PHB 224,A00,922793,Jain; Sonia,9,0,30,21
1748420627373,PHB 227,A00,922796,Liu; Lin,14,0,37,23
1748420628400,PHB 241,A00,970723,Vaida; Florin,9998,0,9999,1
1748420629428,PHB 243A,A01,922822,Tu; Xin,20,0,45,25
1748420630456,PHB 244A,A00,922870,Zhang; Xinlian,20,0,35,15
1748420631484,PHB 280,A00,922875,Messer; Karen Sue,69,0,70,1
1748420632514,PHB 281,A00,923029,Staff,62,0,65,3
1748420633545,PHIL 1,A00,934405,Sher; Gila,38,0,40,2
1748420634574,PHIL 10,A01,934409,Rudolph; Rachel Etta,34,0,39,5
1748420634574,PHIL 10,A02,934410,Rudolph; Rachel Etta,32,0,40,8
1748420634574,PHIL 10,A03,934414,Rudolph; Rachel Etta,31,0,40,9
1748420634574,PHIL 10,A04,934415,Rudolph; Rachel Etta,39,0,40,1
1748420634574,PHIL 10,A05,934416,Rudolph; Rachel Etta,35,0,40,5
1748420634574,PHIL 10,A06,934417,Rudolph; Rachel Etta,39,0,40,1
1748420635603,PHIL 12,A01,934419,Harrell; Maralee Mae,0,0,0,0
1748420635603,PHIL 12,A02,934422,Harrell; Maralee Mae,0,0,0,0
1748420635603,PHIL 12,A03,934423,Harrell; Maralee Mae,30,0,35,5
1748420635603,PHIL 12,A04,934425,Harrell; Maralee Mae,32,0,35,3
1748420636631,PHIL 13,A01,934427,Lamey; Andy M.,32,0,34,2
1748420636631,PHIL 13,A02,934429,Lamey; Andy M.,31,0,34,3
1748420636631,PHIL 13,A03,934430,Lamey; Andy M.,31,0,34,3
1748420636631,PHIL 13,A04,934432,Lamey; Andy M.,34,0,34,0
1748420637658,PHIL 25,A00,934434,Chen; Keming,66,0,70,4
1748420638693,PHIL 27,A01,934442,Brandt; Reuven A,0,0,33,33
1748420638693,PHIL 27,A02,934443,Brandt; Reuven A,7,0,33,26
1748420638693,PHIL 27,A03,934444,Brandt; Reuven A,10,0,33,23
1748420638693,PHIL 27,A04,934448,Brandt; Reuven A,0,0,33,33
1748420638693,PHIL 27,A05,934450,Brandt; Reuven A,19,0,33,14
1748420638693,PHIL 27,A06,934452,Brandt; Reuven A,0,0,33,33
1748420638693,PHIL 27,A07,934499,Brandt; Reuven A,0,0,33,33
1748420638693,PHIL 27,A08,934500,Brandt; Reuven A,6,0,33,27
1748420639726,PHIL 28,A01,934502,Brink; David O.,26,0,33,7
1748420639726,PHIL 28,A02,934506,Brink; David O.,26,0,33,7
1748420639726,PHIL 28,A03,934507,Brink; David O.,27,0,33,6
1748420639726,PHIL 28,A04,934512,Brink; David O.,8,0,33,25
1748420639726,PHIL 28,A05,934517,Brink; David O.,20,0,33,13
1748420639726,PHIL 28,A06,934518,Brink; David O.,0,0,33,33
1748420639726,PHIL 28,A07,934519,Brink; David O.,17,0,33,16
1748420639726,PHIL 28,A08,934520,Brink; David O.,27,0,33,6
1748420640753,PHIL 35,A00,934521,Vargas; Manuel Rogelio,138,0,140,2
1748420641780,PHIL 50,A00,934524,Nelkin; Dana Kay,124,0,140,16
1748420642807,PHIL 65,A00,934526,Rudolph; Rachel Etta,37,0,40,3
1748420643835,PHIL 110,A00,934529,Shields; Christopher John,38,0,42,4
1748420644862,PHIL 115,A00,934530,Nelkin; Dana Kay,15,0,20,5
1748420645892,PHIL 120,A00,934533,Kocurek; Alexander William,45,0,60,15
1748420646919,PHIL 125,A00,934534,Carr; Jennifer Rose,38,0,40,2
1748420647946,PHIL 138,A00,934535,Brink; David O.,29,0,40,11
1748420648978,PHIL 143,A00,934579,Cohen; Jonathan David,40,0,40,0
1748420650009,PHIL 148,A00,934580,Callender; Craig Adam,126,0,140,14
1748420651036,PHIL 149,A00,934581,Fulkerson; Matthew Todd,37,0,70,33
1748420652067,PHIL 158,A00,934593,Chen; Keming,20,0,40,20
1748420653093,PHIL 166,A00,934675,Lamey; Andy M.,27,0,40,13
1748420654120,PHIL 180,A00,934688,Hardimon; Michael O.,32,0,40,8
1748420655150,PHIL 200,A00,934719,Kovaka; Karenc,20,0,20,0
1748420656179,PHIL 201A,A00,934736,Shields; Christopher John,18,0,20,2
1748420657206,PHIL 209A,A00,934772,McKenzie; Kerry V.,10,0,10,0
1748420658236,PHIL 209C,A00,934787,McKenzie; Kerry V.,10,0,10,0
1748420659266,PHIL 222,A00,934789,Kocurek; Alexander William & Carr; Jennifer Rose,19,0,20,1
1748420660292,PHIL 260,A00,934791,Bazargan-Forward; Saba,18,0,20,2
1748420661322,PHIL 271,A00,934793,Vargas; Manuel Rogelio & Nelkin; Dana Kay & Fulkerson; Matthew Todd,9999,0,9999,0
1748420662353,PHIL 275,A00,934819,Watkins; Eric,9998,0,9999,1
1748420663378,PHIL 277,A00,934820,Tolley; Clinton,9997,0,9999,2
1748420664408,PHIL 278,A00,934821,Cohen; Jonathan David & Fulkerson; Matthew Todd,9999,0,9999,0
1748420665434,PHIL 280,A00,934827,Kovaka; Karenc,9999,0,9999,0
1748420666460,PHIL 281,A00,934828,Tolley; Clinton,9999,0,9999,0
1748420667489,PHIL 282,A00,934869,Bazargan-Forward; Saba,9999,0,9999,0
1748420668519,PHIL 283,A00,934870,Vargas; Manuel Rogelio & Tolley; Clinton,9999,0,9999,0
1748420669547,PHIL 286,A00,934871,Callender; Craig Adam & Chen; Keming,9999,0,9999,0
1748420670575,PHIL 287,A00,934872,Shields; Christopher John,9999,0,9999,0
1748420671630,PHIL 290,001,963258,Bazargan-Forward; Saba,9999,0,9999,0
1748420671630,PHIL 290,002,963281,Brandt; Reuven A,9999,0,9999,0
1748420671630,PHIL 290,003,963724,Brink; David O.,9999,0,9999,0
1748420671630,PHIL 290,004,963726,Callender; Craig Adam,9999,0,9999,0
1748420671630,PHIL 290,005,963740,Carr; Jennifer Rose,9999,0,9999,0
1748420671630,PHIL 290,006,963878,Cartwright; Nancy D.,9999,0,9999,0
1748420671630,PHIL 290,007,963888,Chen; Keming,9999,0,9999,0
1748420671630,PHIL 290,008,963889,Cohen; Jonathan David,9999,0,9999,0
1748420671630,PHIL 290,009,964028,Danks; David J,9999,0,9999,0
1748420671630,PHIL 290,010,964036,Fulkerson; Matthew Todd,9999,0,9999,0
1748420671630,PHIL 290,011,964044,Hardimon; Michael O.,9999,0,9999,0
1748420671630,PHIL 290,012,964084,Harrell; Maralee Mae,9999,0,9999,0
1748420671630,PHIL 290,013,964086,Johnson; Monte,9999,0,9999,0
1748420671630,PHIL 290,014,964093,Kocurek; Alexander William,9999,0,9999,0
1748420671630,PHIL 290,015,964101,Kovaka; Karenc,9999,0,9999,0
1748420671630,PHIL 290,016,964107,Lamey; Andy M.,9999,0,9999,0
1748420671630,PHIL 290,017,964113,Marechal; Patricia,9999,0,9999,0
1748420671630,PHIL 290,018,964125,McKenzie; Kerry V.,9999,0,9999,0
1748420671630,PHIL 290,019,964131,Nelkin; Dana Kay,9999,0,9999,0
1748420671630,PHIL 290,020,964132,Rickless; Samuel Charles,9999,0,9999,0
1748420671630,PHIL 290,021,964133,Rudolph; Rachel Etta,9999,0,9999,0
1748420671630,PHIL 290,022,964141,Sher; Gila,9999,0,9999,0
1748420671630,PHIL 290,023,964142,Shields; Christopher John,9999,0,9999,0
1748420671630,PHIL 290,024,964181,Tolley; Clinton,9999,0,9999,0
1748420671630,PHIL 290,025,964182,Vargas; Manuel Rogelio,9999,0,9999,0
1748420671630,PHIL 290,026,964232,Watkins; Eric,9999,0,9999,0
1748420671630,PHIL 290,027,964233,Yuan; Yuan,9999,0,9999,0
1748420672658,PHIL 295,001,964259,Bazargan-Forward; Saba,9999,0,9999,0
1748420672658,PHIL 295,002,964262,Brandt; Reuven A,9999,0,9999,0
1748420672658,PHIL 295,003,964263,Brink; David O.,9999,0,9999,0
1748420672658,PHIL 295,004,964264,Callender; Craig Adam,9999,0,9999,0
1748420672658,PHIL 295,005,964265,Carr; Jennifer Rose,9999,0,9999,0
1748420672658,PHIL 295,006,964266,Cartwright; Nancy D.,9999,0,9999,0
1748420672658,PHIL 295,007,964267,Chen; Keming,9999,0,9999,0
1748420672658,PHIL 295,008,964268,Cohen; Jonathan David,9999,0,9999,0
1748420672658,PHIL 295,009,964269,Danks; David J,9999,0,9999,0
1748420672658,PHIL 295,010,964270,Fulkerson; Matthew Todd,9999,0,9999,0
1748420672658,PHIL 295,011,964271,Hardimon; Michael O.,9999,0,9999,0
1748420672658,PHIL 295,012,964272,Harrell; Maralee Mae,9999,0,9999,0
1748420672658,PHIL 295,013,964273,Johnson; Monte,9999,0,9999,0
1748420672658,PHIL 295,014,964274,Kocurek; Alexander William,9999,0,9999,0
1748420672658,PHIL 295,015,964275,Kovaka; Karenc,9999,0,9999,0
1748420672658,PHIL 295,016,964276,Lamey; Andy M.,9999,0,9999,0
1748420672658,PHIL 295,017,964277,Marechal; Patricia,9999,0,9999,0
1748420672658,PHIL 295,018,964278,McKenzie; Kerry V.,9999,0,9999,0
1748420672658,PHIL 295,019,964279,Nelkin; Dana Kay,9999,0,9999,0
1748420672658,PHIL 295,020,964280,Rickless; Samuel Charles,9999,0,9999,0
1748420672658,PHIL 295,021,964281,Rudolph; Rachel Etta,9999,0,9999,0
1748420672658,PHIL 295,022,964282,Sher; Gila,9999,0,9999,0
1748420672658,PHIL 295,023,964283,Shields; Christopher John,9999,0,9999,0
1748420672658,PHIL 295,024,964284,Tolley; Clinton,9999,0,9999,0
1748420672658,PHIL 295,025,964285,Vargas; Manuel Rogelio,9999,0,9999,0
1748420672658,PHIL 295,026,964286,Watkins; Eric,9999,0,9999,0
1748420672658,PHIL 295,027,964287,Yuan; Yuan,9999,0,9999,0
1748420673689,PHYS 1A,A00,935435,Groisman; Alexander,434,0,589,155
1748420673689,PHYS 1A,B00,935437,Groisman; Alexander,456,0,600,144
1748420674738,PHYS 1AL,001,935439,Bal; Gurleen K & Frano Pereira; Alex M,18,0,30,12
1748420674738,PHYS 1AL,002,935440,Bal; Gurleen K & Frano Pereira; Alex M,25,0,30,5
1748420674738,PHYS 1AL,003,935443,Bal; Gurleen K & Frano Pereira; Alex M,0,0,30,30
1748420674738,PHYS 1AL,004,935445,Bal; Gurleen K & Frano Pereira; Alex M,0,0,30,30
1748420674738,PHYS 1AL,005,935448,Bal; Gurleen K & Frano Pereira; Alex M,0,0,30,30
1748420674738,PHYS 1AL,006,935449,Bal; Gurleen K & Frano Pereira; Alex M,0,0,30,30
1748420674738,PHYS 1AL,007,935451,Bal; Gurleen K & Frano Pereira; Alex M,0,0,30,30
1748420674738,PHYS 1AL,008,935452,Bal; Gurleen K & Frano Pereira; Alex M,1,0,30,29
1748420674738,PHYS 1AL,009,935454,Bal; Gurleen K & Frano Pereira; Alex M,9,0,30,21
1748420674738,PHYS 1AL,010,935589,Bal; Gurleen K & Frano Pereira; Alex M,17,0,30,13
1748420674738,PHYS 1AL,011,935590,Bal; Gurleen K & Frano Pereira; Alex M,15,0,19,4
1748420674738,PHYS 1AL,012,935591,Bal; Gurleen K & Frano Pereira; Alex M,29,0,30,1
1748420674738,PHYS 1AL,013,935652,Bal; Gurleen K & Frano Pereira; Alex M,0,0,30,30
1748420674738,PHYS 1AL,014,935675,Bal; Gurleen K & Frano Pereira; Alex M,0,0,30,30
1748420674738,PHYS 1AL,015,935680,Bal; Gurleen K & Frano Pereira; Alex M,0,0,30,30
1748420674738,PHYS 1AL,016,935703,Bal; Gurleen K & Frano Pereira; Alex M,1,0,30,29
1748420674738,PHYS 1AL,017,935704,Bal; Gurleen K & Frano Pereira; Alex M,8,0,30,22
1748420674738,PHYS 1AL,018,935729,Bal; Gurleen K & Frano Pereira; Alex M,12,0,30,18
1748420674738,PHYS 1AL,019,935825,Bal; Gurleen K & Frano Pereira; Alex M,23,0,30,7
1748420674738,PHYS 1AL,020,935826,Bal; Gurleen K & Frano Pereira; Alex M,27,0,30,3
1748420674738,PHYS 1AL,021,935946,Bal; Gurleen K & Frano Pereira; Alex M,28,0,30,2
1748420674738,PHYS 1AL,022,935947,Bal; Gurleen K & Frano Pereira; Alex M,30,0,30,0
1748420674738,PHYS 1AL,023,936029,Bal; Gurleen K & Frano Pereira; Alex M,4,0,30,26
1748420674738,PHYS 1AL,024,936031,Bal; Gurleen K & Frano Pereira; Alex M,12,0,30,18
1748420674738,PHYS 1AL,025,936033,Bal; Gurleen K & Frano Pereira; Alex M,19,0,30,11
1748420674738,PHYS 1AL,026,936034,Bal; Gurleen K & Frano Pereira; Alex M,19,0,30,11
1748420674738,PHYS 1AL,027,936036,Bal; Gurleen K & Frano Pereira; Alex M,6,0,30,24
1748420674738,PHYS 1AL,028,936038,Bal; Gurleen K & Frano Pereira; Alex M,22,0,30,8
1748420674738,PHYS 1AL,029,936044,Bal; Gurleen K & Frano Pereira; Alex M,20,0,30,10
1748420674738,PHYS 1AL,030,936045,Bal; Gurleen K & Frano Pereira; Alex M,27,0,30,3
1748420674738,PHYS 1AL,031,936054,Bal; Gurleen K & Frano Pereira; Alex M,28,0,30,2
1748420674738,PHYS 1AL,032,936056,Bal; Gurleen K & Frano Pereira; Alex M,28,0,30,2
1748420674738,PHYS 1AL,033,936057,Bal; Gurleen K & Frano Pereira; Alex M,0,0,30,30
1748420674738,PHYS 1AL,034,936059,Bal; Gurleen K & Frano Pereira; Alex M,1,0,30,29
1748420674738,PHYS 1AL,035,936060,Bal; Gurleen K & Frano Pereira; Alex M,11,0,30,19
1748420674738,PHYS 1AL,036,936063,Bal; Gurleen K & Frano Pereira; Alex M,21,0,30,9
1748420674738,PHYS 1AL,037,960551,Bal; Gurleen K & Frano Pereira; Alex M,25,0,30,5
1748420674738,PHYS 1AL,038,960592,Bal; Gurleen K & Frano Pereira; Alex M,28,0,30,2
1748420674738,PHYS 1AL,039,960618,Bal; Gurleen K & Frano Pereira; Alex M,29,0,30,1
1748420674738,PHYS 1AL,040,960644,Bal; Gurleen K & Frano Pereira; Alex M,30,0,30,0
1748420675764,PHYS 1B,A00,936064,Staff,217,0,360,143
1748420676802,PHYS 1BL,001,936066,Bal; Gurleen K & Frano Pereira; Alex M,1,0,29,28
1748420676802,PHYS 1BL,002,936067,Bal; Gurleen K & Frano Pereira; Alex M,0,0,30,30
1748420676802,PHYS 1BL,003,936068,Bal; Gurleen K & Frano Pereira; Alex M,5,0,30,25
1748420676802,PHYS 1BL,004,936072,Bal; Gurleen K & Frano Pereira; Alex M,0,0,30,30
1748420676802,PHYS 1BL,005,936074,Bal; Gurleen K & Frano Pereira; Alex M,0,0,30,30
1748420676802,PHYS 1BL,006,936075,Bal; Gurleen K & Frano Pereira; Alex M,0,0,30,30
1748420676802,PHYS 1BL,007,936116,Bal; Gurleen K & Frano Pereira; Alex M,7,0,30,23
1748420676802,PHYS 1BL,008,936125,Bal; Gurleen K & Frano Pereira; Alex M,14,0,30,16
1748420676802,PHYS 1BL,009,936128,Bal; Gurleen K & Frano Pereira; Alex M,12,0,30,18
1748420676802,PHYS 1BL,010,936145,Bal; Gurleen K & Frano Pereira; Alex M,15,0,30,15
1748420676802,PHYS 1BL,011,936146,Bal; Gurleen K & Frano Pereira; Alex M,0,0,30,30
1748420676802,PHYS 1BL,012,936147,Bal; Gurleen K & Frano Pereira; Alex M,6,0,30,24
1748420677835,PHYS 1C,A00,936148,Tsai; Philbert S,220,0,360,140
1748420678872,PHYS 1CL,001,936149,Bal; Gurleen K & Frano Pereira; Alex M,0,0,30,30
1748420678872,PHYS 1CL,002,936150,Bal; Gurleen K & Frano Pereira; Alex M,0,0,30,30
1748420678872,PHYS 1CL,003,936152,Bal; Gurleen K & Frano Pereira; Alex M,0,0,30,30
1748420678872,PHYS 1CL,004,936153,Bal; Gurleen K & Frano Pereira; Alex M,0,0,30,30
1748420678872,PHYS 1CL,005,936154,Bal; Gurleen K & Frano Pereira; Alex M,0,0,30,30
1748420678872,PHYS 1CL,006,936156,Bal; Gurleen K & Frano Pereira; Alex M,0,0,24,24
1748420678872,PHYS 1CL,007,936157,Bal; Gurleen K & Frano Pereira; Alex M,22,0,30,8
1748420678872,PHYS 1CL,008,936158,Bal; Gurleen K & Frano Pereira; Alex M,0,0,30,30
1748420678872,PHYS 1CL,009,936159,Bal; Gurleen K & Frano Pereira; Alex M,0,0,30,30
1748420678872,PHYS 1CL,010,936160,Bal; Gurleen K & Frano Pereira; Alex M,0,0,30,30
1748420678872,PHYS 1CL,011,936161,Bal; Gurleen K & Frano Pereira; Alex M,0,0,30,30
1748420678872,PHYS 1CL,012,936162,Bal; Gurleen K & Frano Pereira; Alex M,0,0,30,30
1748420679900,PHYS 2A,A01,936165,Shotwell; Brian,30,0,30,0
1748420679900,PHYS 2A,A02,936167,Shotwell; Brian,28,0,30,2
1748420679900,PHYS 2A,A03,936168,Shotwell; Brian,25,0,30,5
1748420679900,PHYS 2A,A04,936169,Shotwell; Brian,30,0,30,0
1748420679900,PHYS 2A,A05,936170,Shotwell; Brian,16,0,25,9
1748420679900,PHYS 2A,A06,936171,Shotwell; Brian,26,0,30,4
1748420679900,PHYS 2A,A07,936172,Shotwell; Brian,18,0,30,12
1748420679900,PHYS 2A,A08,936174,Shotwell; Brian,24,0,30,6
1748420679900,PHYS 2A,A09,936175,Shotwell; Brian,25,0,30,5
1748420679900,PHYS 2A,A10,936176,Shotwell; Brian,25,0,30,5
1748420679900,PHYS 2A,A11,936177,Shotwell; Brian,21,0,30,9
1748420679900,PHYS 2A,A12,936179,Shotwell; Brian,25,0,30,5
1748420680933,PHYS 2B,A01,936182,Barreiro Guerrero; Julio,13,0,30,17
1748420680933,PHYS 2B,A02,936183,Barreiro Guerrero; Julio,20,0,30,10
1748420680933,PHYS 2B,A03,936184,Barreiro Guerrero; Julio,20,0,30,10
1748420680933,PHYS 2B,A04,936185,Barreiro Guerrero; Julio,26,0,29,3
1748420680933,PHYS 2B,A05,936187,Barreiro Guerrero; Julio,27,0,30,3
1748420680933,PHYS 2B,A06,936217,Barreiro Guerrero; Julio,26,0,30,4
1748420680933,PHYS 2B,A07,936219,Barreiro Guerrero; Julio,23,0,30,7
1748420680933,PHYS 2B,A08,936220,Barreiro Guerrero; Julio,26,0,30,4
1748420680933,PHYS 2B,A09,936221,Barreiro Guerrero; Julio,29,0,30,1
1748420680933,PHYS 2B,A10,936224,Barreiro Guerrero; Julio,29,0,30,1
1748420680933,PHYS 2B,A11,936229,Barreiro Guerrero; Julio,28,0,30,2
1748420680933,PHYS 2B,A12,936231,Barreiro Guerrero; Julio,27,0,30,3
1748420681960,PHYS 2C,A01,936235,Tan; Tzer Han,23,0,30,7
1748420681960,PHYS 2C,A02,936236,Tan; Tzer Han,27,0,30,3
1748420681960,PHYS 2C,A03,936237,Tan; Tzer Han,22,0,30,8
1748420681960,PHYS 2C,A04,936246,Tan; Tzer Han,17,0,30,13
1748420681960,PHYS 2C,A05,936292,Tan; Tzer Han,16,0,28,12
1748420681960,PHYS 2C,A06,936300,Tan; Tzer Han,19,0,30,11
1748420681960,PHYS 2C,A07,936301,Tan; Tzer Han,8,0,30,22
1748420681960,PHYS 2C,A08,936302,Tan; Tzer Han,20,0,30,10
1748420681960,PHYS 2C,A09,936303,Tan; Tzer Han,26,0,30,4
1748420681960,PHYS 2C,A10,936304,Tan; Tzer Han,26,0,30,4
1748420681960,PHYS 2C,A11,936305,Tan; Tzer Han,12,0,30,18
1748420681960,PHYS 2C,A12,936332,Tan; Tzer Han,27,0,30,3
1748420681960,PHYS 2C,B01,936337,Tan; Tzer Han,0,0,30,30
1748420681960,PHYS 2C,B02,936470,Tan; Tzer Han,1,0,30,29
1748420681960,PHYS 2C,B03,936503,Tan; Tzer Han,21,0,30,9
1748420681960,PHYS 2C,B04,936533,Tan; Tzer Han,22,0,30,8
1748420681960,PHYS 2C,B05,936534,Tan; Tzer Han,20,0,30,10
1748420681960,PHYS 2C,B06,936535,Tan; Tzer Han,23,0,30,7
1748420681960,PHYS 2C,B07,936536,Tan; Tzer Han,25,0,30,5
1748420681960,PHYS 2C,B08,936537,Tan; Tzer Han,22,0,30,8
1748420681960,PHYS 2C,B09,936539,Tan; Tzer Han,26,0,30,4
1748420681960,PHYS 2C,B10,936540,Tan; Tzer Han,27,0,30,3
1748420681960,PHYS 2C,B11,936544,Tan; Tzer Han,28,0,30,2
1748420681960,PHYS 2C,B12,936548,Tan; Tzer Han,28,0,30,2
1748420682989,PHYS 2CL,A01,936555,Ni; Kaixuan,0,0,28,28
1748420682989,PHYS 2CL,A02,936556,Ni; Kaixuan,0,0,28,28
1748420682989,PHYS 2CL,A03,936557,Ni; Kaixuan,0,0,28,28
1748420682989,PHYS 2CL,A04,936559,Ni; Kaixuan,0,0,28,28
1748420682989,PHYS 2CL,A05,936566,Ni; Kaixuan,0,0,28,28
1748420682989,PHYS 2CL,A06,936582,Ni; Kaixuan,0,0,28,28
1748420682989,PHYS 2CL,A07,936583,Ni; Kaixuan,0,0,28,28
1748420684026,PHYS 2D,A01,936615,Sharma; Vivek A.,0,0,27,27
1748420685054,PHYS 2DL,A01,936627,Butov; Leonid,14,0,17,3
1748420685054,PHYS 2DL,A02,936628,Butov; Leonid,0,0,17,17
1748420685054,PHYS 2DL,A03,936629,Butov; Leonid,3,0,15,12
1748420685054,PHYS 2DL,A04,936630,Butov; Leonid,10,0,17,7
1748420685054,PHYS 2DL,A05,936631,Butov; Leonid,17,0,17,0
1748420685054,PHYS 2DL,A06,936632,Butov; Leonid,7,0,17,10
1748420685054,PHYS 2DL,A07,936633,Butov; Leonid,8,0,18,10
1748420686081,PHYS 4C,A01,936635,Chivukula; Raja S,22,0,43,21
1748420686081,PHYS 4C,A02,936636,Chivukula; Raja S,33,0,45,12
1748420686081,PHYS 4C,A03,936637,Chivukula; Raja S,38,0,45,7
1748420686081,PHYS 4C,A04,936638,Chivukula; Raja S,44,0,45,1
1748420687109,PHYS 12,A01,936640,Branson; James G,187,0,192,5
1748420688137,PHYS 87,A00,936641,Grinstein; Benjamin,20,0,20,0
1748420689171,PHYS 100A,A01,936643,Green; Daniel Richard,111,0,146,35
1748420690203,PHYS 110A,A01,936645,Dudko; Olga,107,0,146,39
1748420691287,PHYS 116,A00,936646,Diamond; Patrick H & Vergassola; Massimo,12,0,15,3
1748420692320,PHYS 130B,A01,936648,Keating; Brian,56,0,60,4
1748420693346,PHYS 133,A00,936649,Allen; Monica T,20,0,32,12
1748420694378,PHYS 136,A00,936650,Grinstein; Benjamin,42,0,50,8
1748420695411,PHYS 139,A00,936651,Hirsch; Jorge Eduardo,13,0,15,2
1748420695411,PHYS 139,B00,936663,Duarte; Javier Mauricio,0,0,0,10
1748420696439,PHYS 140A,A01,936723,Parker; Daniel E,54,0,60,6
1748420697471,PHYS 161,A01,936727,Fuller; George Michael,53,0,60,7
1748420698499,PHYS 175,A00,936728,Koslover; Elena F,11,0,15,4
1748420699525,PHYS 191,A00,936730,Yang; Liang,68,0,75,7
1748420700552,PHYS 200A,A01,936733,Di Ventra; Massimiliano,20,0,30,10
1748420701580,PHYS 201,A01,936736,Vergassola; Massimo,23,0,30,7
1748420702611,PHYS 210B,A00,936737,McGreevy; John A.,29,0,30,1
1748420703642,PHYS 211A,A00,936740,Butov; Leonid,28,0,30,2
1748420704674,PHYS 212A,A01,936873,Fogler; Michael M.,38,0,50,12
1748420705702,PHYS 215A,A00,936878,Shotwell; Brian,30,0,30,0
1748420706729,PHYS 216,A00,936879,Diamond; Patrick H & Vergassola; Massimo,15,0,15,0
1748420707757,PHYS 219,A00,936903,Allen; Monica T,5,0,5,0
1748420708784,PHYS 220,A01,936910,Arovas; Daniel P,30,0,30,0
1748420709812,PHYS 225A,A00,936911,Flauger; Raphael M,28,0,30,2
1748420710845,PHYS 239,A00,937172,Hirsch; Jorge Eduardo,14,0,15,1
1748420710845,PHYS 239,B00,937176,Duarte; Javier Mauricio,15,0,15,0
1748420710845,PHYS 239,C00,959883,Intriligator; Kenneth Arthur,30,0,30,0
1748420711871,PHYS 250,A00,937178,Hirsch; Jorge Eduardo,14,0,15,1
1748420712897,PHYS 251,A00,937182,Grinstein; Benjamin,15,0,15,0
1748420713928,PHYS 252,A00,937183,Diamond; Patrick H,15,0,15,0
1748420714958,PHYS 253,A00,937184,Fuller; George Michael,15,0,15,0
1748420715985,PHYS 254,A00,937185,Serra; Mattia,15,0,15,0
1748420717012,PHYS 255,A00,937186,Hwa; Terence T.,14,0,15,1
1748420718043,PHYS 260,A00,937187,Shpyrko; Oleg,49,0,50,1
1748420719069,PHYS 275,A00,937190,Koslover; Elena F,15,0,15,0
1748420720105,PHYS 279,A01,946429,Silva; Gabriel,0,0,0,0
1748420721133,PHYS 282,A00,937194,Hwa; Terence T.,20,0,20,0
1748420722165,POLI 5D,A01,937210,Staff,4,0,5,1
1748420722165,POLI 5D,B01,937219,Staff,5,0,5,0
1748420722165,POLI 5D,C01,937225,Dai; Yinlin,0,0,5,5
1748420723192,POLI 10D,A01,937228,Noble; Benjamin S,20,0,28,8
1748420723192,POLI 10D,A02,937229,Noble; Benjamin S,24,0,28,4
1748420723192,POLI 10D,A03,937230,Noble; Benjamin S,25,0,27,2
1748420723192,POLI 10D,A04,937231,Noble; Benjamin S,25,0,27,2
1748420723192,POLI 10D,A05,937238,Noble; Benjamin S,27,0,28,1
1748420723192,POLI 10D,A06,937243,Noble; Benjamin S,26,0,28,2
1748420724225,POLI 11D,A01,937360,Desposato; Scott,20,0,29,9
1748420724225,POLI 11D,A02,937430,Desposato; Scott,22,0,29,7
1748420724225,POLI 11D,A03,937445,Desposato; Scott,25,0,29,4
1748420724225,POLI 11D,A04,937446,Desposato; Scott,29,0,29,0
1748420724225,POLI 11D,A05,937447,Desposato; Scott,27,0,29,2
1748420724225,POLI 11D,A06,937463,Desposato; Scott,27,0,29,2
1748420725259,POLI 12D,A01,937472,Roeder; Philip G,17,0,20,3
1748420725259,POLI 12D,A02,937475,Roeder; Philip G,17,0,20,3
1748420725259,POLI 12D,A03,937485,Roeder; Philip G,17,0,19,2
1748420725259,POLI 12D,A04,937490,Roeder; Philip G,17,0,20,3
1748420725259,POLI 12D,A05,937500,Roeder; Philip G,19,0,20,1
1748420725259,POLI 12D,A06,937507,Roeder; Philip G,20,0,20,0
1748420726284,POLI 30D,A01,937510,Desposato; Scott,0,0,23,23
1748420726284,POLI 30D,A02,937530,Desposato; Scott,0,0,23,23
1748420726284,POLI 30D,A03,937531,Desposato; Scott,11,0,23,12
1748420726284,POLI 30D,A04,937532,Desposato; Scott,18,0,23,5
1748420726284,POLI 30D,A05,937591,Desposato; Scott,5,0,23,18
1748420726284,POLI 30D,A06,937592,Desposato; Scott,19,0,23,4
1748420727315,POLI 100H,A00,937593,Stout; Christopher Timothy,114,0,183,69
1748420728346,POLI 100I,A00,937594,Gause; LaGina,47,0,56,9
1748420729371,POLI 100V,A00,937596,Gause; LaGina,56,0,68,12
1748420730401,POLI 101A,A00,937597,Stout; Christopher Timothy,84,0,115,31
1748420731429,POLI 104A,A00,937598,Smith; Glenn Chatmas,207,0,290,83
1748420732457,POLI 104N,A00,937599,Stephens; Mattheus E,168,0,245,77
1748420733485,POLI 110A,A00,937600,Wiens; David,61,0,70,9
1748420734512,POLI 118,A00,937601,Wiens; David,69,0,94,25
1748420735539,POLI 122D,A00,937602,Strom; Kaare,15,0,70,55
1748420736567,POLI 125B,A00,937603,Naoi; Megumi,128,0,158,30
1748420737596,POLI 125D,A00,937604,Nichter; Simeon C,103,0,158,55
1748420738627,POLI 126,A00,937607,Nichter; Simeon C,44,0,120,76
1748420739654,POLI 133A,A00,937608,Naoi; Megumi,202,0,216,14
1748420740686,POLI 134D,A00,937609,Saiegh; Sebastian,62,0,75,13
1748420741713,POLI 143A,A00,937610,Slantchev; Branislav,147,0,158,11
1748420742741,POLI 145C,A00,937611,Fisk; David Lee,153,0,190,37
1748420743768,POLI 154,A00,937612,Fisk; David Lee,29,0,90,61
1748420744806,POLI 163,A00,937613,Saiegh; Sebastian,103,0,120,17
1748420745834,POLI 176,A00,968071,Roberts; Margaret Earling,23,0,45,22
1748420746864,POLI 191A,A00,937617,Stout; Christopher Timothy & Saiegh; Sebastian,25,0,25,0
1748420747892,POLI 194,A00,954111,Hill; Seth J,9999,0,9999,0
1748420748920,POLI 204A,A00,937618,Schneider; Christina,20,0,25,5
1748420749952,POLI 204B,A00,937619,Desposato; Scott,7,0,12,5
1748420750982,POLI 220B,A00,937621,Strom; Kaare,20,0,25,5
1748420752008,POLI 225,A00,937622,Thomas; Jakana,18,0,25,7
1748420753037,POLI 251,A00,937623,Noble; Benjamin S,24,0,25,1
1748420754070,POLI 252,A00,937624,Hajnal; Zoltan Lloyd,24,0,25,1
1748420756129,POLI 270,A00,973288,Roberts; Margaret Earling,24,0,25,1
1748420757159,POLI 279,A00,937626,Staff,8,0,12,4
1748420758187,POLI 280,A00,937628,Hafner-Burton; Emilie,21,0,25,4
1748420759240,POLI 281,A00,937629,Stout; Christopher Timothy,13,0,15,2
1748420760267,POLI 282,A00,937630,Roeder; Philip G,20,0,25,5
1748420761292,POLI 283,A00,937631,Slantchev; Branislav,18,0,25,7
1748420762324,POLI 285,A00,937632,Wiens; David,12,0,12,0
1748420763350,PSYC 1,A00,937633,Hurwitz; Ethan Scott,175,0,200,25
1748420764385,PSYC 2,A00,937634,Rose; Fred E.,133,0,150,17
1748420765410,PSYC 3R,A00,937693,Pilegard; Celeste Cristine,195,0,200,5
1748420766436,PSYC 6,A00,937694,McCullough; Michael E,142,0,150,8
1748420767472,PSYC 60,A01,957947,Lowe; Angela Beth,10,0,25,15
1748420767472,PSYC 60,A02,957948,Lowe; Angela Beth,17,0,25,8
1748420767472,PSYC 60,A03,957949,Lowe; Angela Beth,18,0,25,7
1748420767472,PSYC 60,A04,957950,Lowe; Angela Beth,24,0,25,1
1748420767472,PSYC 60,A05,957951,Lowe; Angela Beth,22,0,25,3
1748420767472,PSYC 60,A06,957952,Lowe; Angela Beth,22,0,25,3
1748420767472,PSYC 60,A07,957953,Lowe; Angela Beth,24,0,25,1
1748420767472,PSYC 60,B01,957954,Rickard; Timothy C.,24,0,25,1
1748420767472,PSYC 60,B02,957955,Rickard; Timothy C.,24,0,25,1
1748420767472,PSYC 60,B03,957956,Rickard; Timothy C.,25,0,25,0
1748420767472,PSYC 60,B04,957957,Rickard; Timothy C.,25,0,25,0
1748420767472,PSYC 60,B05,957958,Rickard; Timothy C.,24,0,25,1
1748420767472,PSYC 60,B06,957959,Rickard; Timothy C.,22,0,25,3
1748420767472,PSYC 60,B07,957960,Rickard; Timothy C.,22,0,25,3
1748420768498,PSYC 70,A01,957961,Pilegard; Celeste Cristine,6,0,25,19
1748420768498,PSYC 70,A02,957962,Pilegard; Celeste Cristine,19,0,25,6
1748420768498,PSYC 70,A03,957963,Pilegard; Celeste Cristine,19,0,25,6
1748420768498,PSYC 70,A04,957964,Pilegard; Celeste Cristine,21,0,25,4
1748420768498,PSYC 70,A05,957965,Pilegard; Celeste Cristine,24,0,25,1
1748420768498,PSYC 70,A06,957966,Pilegard; Celeste Cristine,23,0,25,2
1748420769534,PSYC 71,A01,937700,Geller; Emma Harlan,0,0,30,30
1748420769534,PSYC 71,A02,937701,Geller; Emma Harlan,0,0,30,30
1748420769534,PSYC 71,B01,937704,Steiner; Eric Tomas,0,0,25,25
1748420769534,PSYC 71,B02,937705,Steiner; Eric Tomas,0,0,25,25
1748420770560,PSYC 88,A00,937706,Dobkins; Karen R.,49,0,65,16
1748420771588,PSYC 100,A00,937707,Dickenson; Janna Alene,0,0,175,175
1748420772618,PSYC 101,A00,937709,Heyman; Gail D.,0,0,170,170
1748420773647,PSYC 104,A00,937711,Staff,0,0,175,175
1748420774672,PSYC 105,A00,937712,Geller; Emma Harlan,17,0,170,153
1748420775708,PSYC 106,A00,937713,Gremel; Christina M,90,0,170,80
1748420776734,PSYC 108,A00,937714,Adrian; Julia Anna,145,0,170,25
1748420777760,PSYC 114,A01,937720,Winkielman; Piotr,0,0,50,50
1748420778786,PSYC 122,A00,937724,Moranton; Nirelia Melbina-,241,0,250,9
1748420779819,PSYC 124,A00,937726,Chapman; Eddie Nathaniel,276,0,348,72
1748420780846,PSYC 137,A00,937727,Jolly; Eshin,249,0,295,46
1748420781882,PSYC 145,A00,937732,Lau; Aubrey,277,0,295,18
1748420782908,PSYC 154,A00,937734,Lacefield; Katharine I,18,0,300,282
1748420783938,PSYC 155,A00,937735,Dickenson; Janna Alene,139,0,295,156
1748420784963,PSYC 167,A00,937750,Walker; Caren Michelle,0,0,25,25
1748420785992,PSYC 169,A00,937751,Staff,213,0,250,37
1748420787024,PSYC 171,A00,937752,Mukku; Dhananjaya,149,0,216,67
1748420788050,PSYC 174,A00,937784,Staff,141,0,146,5
1748420789082,PSYC 178,A00,937788,Glaser; Dale,100,0,146,46
1748420790114,PSYC 181,A00,937814,Anagnostaras; Stephan,140,0,300,160
1748420791140,PSYC 184,A00,937816,Staff,267,0,295,28
1748420792167,PSYC 189,A00,937868,Gentner; Tim,14,0,55,41
1748420793202,PSYC 193,A00,937897,Chapman; Eddie Nathaniel,27,0,35,8
1748420793202,PSYC 193,B00,937917,Gorman; Michael R.,35,0,35,0
1748420793202,PSYC 193,C00,937918,Powell; Lindsey Jane,22,0,24,2
1748420794236,PSYC 193L,A01,937930,Brown; Sandra A,64,0,65,1
1748420794236,PSYC 193L,B01,937939,Lacefield; Katharine I,194,0,216,22
1748420795315,PSYC 194A,A01,937949,Heyman; Gail D.,35,0,35,0
1748420796342,PSYC 201A,A01,937954,Long; Bria,8,0,15,7
1748420797375,PSYC 205,A00,937976,Harris; Christine Renee,12,0,20,8
1748420798402,PSYC 217,A00,937977,Barner; David A.,16,0,20,4
1748420799427,PSYC 221,A00,937979,Dobkins; Karen R.,16,0,20,4
1748420800454,PSYC 224,A00,938013,Mukku; Dhananjaya,28,0,30,2
1748420801480,PSYC 242,A00,938016,Powell; Lindsey Jane,26,0,30,4
1748420802518,PSYC 244,A00,938017,Ferreira; Victor,15,0,20,5
1748420803549,PSYC 269,A00,938024,Schachner; Adena,19,0,20,1
1748420804575,PSYC 270A,A00,938028,Dobkins; Karen R.,13,0,20,7
1748420805603,PSYC 272,A00,938029,Lin; Chujun,14,0,20,6
1748420805603,PSYC 272,B00,938039,Wixted; John T,18,0,20,2
1748420806630,PSYC 274,A00,938042,McCullough; Michael E,26,0,30,4
1748420807657,PSYC 275,A00,938043,Brady; Timothy Francis,28,0,30,2
1748420808684,PSYC 280,A00,938055,Serences; John Thomas,70,0,80,10
1748420809719,PSYC 296,001,952632,Anagnostaras; Stephan,9999,0,9999,0
1748420809719,PSYC 296,002,952633,Aron; Adam,9999,0,9999,0
1748420809719,PSYC 296,003,952634,Mukku; Dhananjaya,9999,0,9999,0
1748420809719,PSYC 296,004,952635,Barner; David A.,9999,0,9999,0
1748420809719,PSYC 296,005,952636,Schachner; Adena,9999,0,9999,0
1748420809719,PSYC 296,006,952637,Brady; Timothy Francis,9999,0,9999,0
1748420809719,PSYC 296,007,952639,Brashier; Nadia Marie,9999,0,9999,0
1748420809719,PSYC 296,008,952640,Brown; Sandra A,9999,0,9999,0
1748420809719,PSYC 296,009,952641,Carver; Leslie J.,9998,0,9999,1
1748420809719,PSYC 296,010,952642,Chapman; Eddie Nathaniel,9999,0,9999,0
1748420809719,PSYC 296,011,952643,Dickenson; Janna Alene,9999,0,9999,0
1748420809719,PSYC 296,012,952644,Dobkins; Karen R.,9997,0,9999,2
1748420809719,PSYC 296,013,952646,Ferreira; Victor,9999,0,9999,0
1748420809719,PSYC 296,014,952647,Geller; Emma Harlan,9999,0,9999,0
1748420809719,PSYC 296,015,952648,Gentner; Tim,9999,0,9999,0
1748420809719,PSYC 296,016,952650,Gorman; Michael R.,9999,0,9999,0
1748420809719,PSYC 296,017,952651,Gremel; Christina M,9999,0,9999,0
1748420809719,PSYC 296,018,952652,Harris; Christine Renee,9999,0,9999,0
1748420809719,PSYC 296,019,952654,Heyman; Gail D.,9999,0,9999,0
1748420809719,PSYC 296,020,952655,Lin; Chujun,9999,0,9999,0
1748420809719,PSYC 296,021,952659,Long; Bria,9999,0,9999,0
1748420809719,PSYC 296,022,952660,McCullough; Michael E,9999,0,9999,0
1748420809719,PSYC 296,023,952661,Mc Kenzie; Craig R.M.,9999,0,9999,0
1748420809719,PSYC 296,024,952663,Miller; Cory T.,9998,0,9999,1
1748420809719,PSYC 296,025,952664,Oesch; Nicholas W,9999,0,9999,0
1748420809719,PSYC 296,026,952665,Pilegard; Celeste Cristine,9999,0,9999,0
1748420809719,PSYC 296,027,952666,Powell; Lindsey Jane,9999,0,9999,0
1748420809719,PSYC 296,028,952667,Rickard; Timothy C.,9999,0,9999,0
1748420809719,PSYC 296,029,952668,Serences; John Thomas,9999,0,9999,0
1748420809719,PSYC 296,030,952669,Walker; Caren Michelle,9998,0,9999,1
1748420809719,PSYC 296,031,952670,Winkielman; Piotr,9999,0,9999,0
1748420809719,PSYC 296,032,952671,Wixted; John T,9998,0,9999,1
1748420809719,PSYC 296,033,952673,Jolly; Eshin,9998,0,9999,1
1748420810756,REV 20,A00,946356,Yu; Paul K L,30,0,30,0
1748420810756,REV 20,B00,946357,Yu; Paul K L,30,0,30,0
1748420811789,REV 87,B00,969668,Rodriguez; Bretton Sigfred,20,0,20,0
1748420812817,SE 1,A01,938060,Van Den Einde; Yael Dahlia,0,0,9,9
1748420812817,SE 1,A02,938076,Van Den Einde; Yael Dahlia,0,0,8,8
1748420812817,SE 1,A03,938077,Van Den Einde; Yael Dahlia,0,0,8,8
1748420812817,SE 1,B01,938097,Van Den Einde; Yael Dahlia,0,0,9,9
1748420812817,SE 1,B02,938098,Van Den Einde; Yael Dahlia,0,0,8,8
1748420812817,SE 1,B03,938109,Van Den Einde; Yael Dahlia,0,0,8,8
1748420813845,SE 101A,A01,938120,Morrison; Machel Leigh,165,0,250,85
1748420814872,SE 101C,A01,938148,Zhu; Qiang,178,0,250,72
1748420815906,SE 105,A01,938153,Qiao; Yu,78,0,120,42
1748420816934,SE 125,A01,938218,Conte; Joel P,166,0,210,44
1748420817960,SE 130A,A00,938219,Loh; Kenneth J. H.,69,0,165,96
1748420818987,SE 131B,A01,938221,Krysl; Petr,119,0,210,91
1748420820015,SE 142,A01,938223,Kim; Hyonny,20,0,27,7
1748420820015,SE 142,A02,938236,Kim; Hyonny,23,0,27,4
1748420820015,SE 142,A03,938237,Kim; Hyonny,19,0,27,8
1748420820015,SE 142,A04,938238,Kim; Hyonny,19,0,22,3
1748420821042,SE 163,A01,938240,Lanza Di Scalea; Francesco,17,0,19,2
1748420821042,SE 163,A02,938241,Lanza Di Scalea; Francesco,16,0,19,3
1748420821042,SE 163,A03,938254,Lanza Di Scalea; Francesco,16,0,17,1
1748420822076,SE 180,A00,938255,Elgamal; Ahmed,142,0,170,28
1748420823106,SE 181,A01,938280,McCartney; John Scott,1,0,24,23
1748420823106,SE 181,A02,938281,McCartney; John Scott,6,0,24,18
1748420823106,SE 181,A03,938296,McCartney; John Scott,0,0,24,24
1748420823106,SE 181,A04,938297,McCartney; John Scott,0,0,24,24
1748420823106,SE 181,A05,938299,McCartney; John Scott,20,0,24,4
1748420823106,SE 181,A06,938320,McCartney; John Scott,22,0,24,2
1748420823106,SE 181,A07,938324,McCartney; John Scott,9,0,24,15
1748420824136,SE 201A,A00,938329,Mosqueda; Gilberto,35,0,65,30
1748420825164,SE 203A,A00,938331,Tsampras; Georgios,32,0,65,33
1748420826195,SE 212,A00,938332,Uang; Chia-Ming,28,0,68,40
1748420827228,SE 220,A00,965249,Mosqueda; Gilberto,28,0,36,8
1748420828259,SE 223,A00,969767,Staff,19,0,25,6
1748420829296,SE 233,A00,938555,Krysl; Petr,19,0,50,31
1748420830325,SE 241,A00,938333,Elgamal; Ahmed,0,0,20,20
1748420831350,SE 244,A00,938334,Elgamal; Ahmed,39,0,40,1
1748420832378,SE 248,A00,938363,McCartney; John Scott,20,0,30,10
1748420833405,SE 253A,A01,938448,Kim; Hyonny,2,0,5,3
1748420833405,SE 253A,A02,938451,Kim; Hyonny,3,0,5,2
1748420833405,SE 253A,A03,938452,Kim; Hyonny,3,0,5,2
1748420833405,SE 253A,A04,938453,Kim; Hyonny,2,0,2,0
1748420834430,SE 263,A01,938460,Lanza Di Scalea; Francesco,15,0,17,2
1748420834430,SE 263,A02,938461,Lanza Di Scalea; Francesco,11,0,17,6
1748420834430,SE 263,A03,938462,Lanza Di Scalea; Francesco,10,0,16,6
1748420835456,SE 271,A00,938464,Asaro; Robert J,25,0,32,7
1748420836486,SE 276A,A00,938465,Chen; Jiun-Shyan,18,0,35,17
1748420837517,SE 285,A00,938466,Kim; Hyunsun Alicia,18,0,20,2
1748420838548,SE 286,A00,938523,Kim; Hyunsun Alicia,13,0,20,7
1748420839573,SE 290,A00,938524,Lanza Di Scalea; Francesco,41,0,100,59
1748420840623,SE 296,001,953990,Asaro; Robert J,9999,0,9999,0
1748420840623,SE 296,002,953992,Chen; Jiun-Shyan,9999,0,9999,0
1748420840623,SE 296,003,953998,Conte; Joel P,9999,0,9999,0
1748420840623,SE 296,004,953999,Elgamal; Ahmed,9999,0,9999,0
1748420840623,SE 296,005,954001,Hutchinson; Tara,9999,0,9999,0
1748420840623,SE 296,006,954003,Jandaghi Semnani; Shabnam,9999,0,9999,0
1748420840623,SE 296,007,954004,Kim; Hyonny,9999,0,9999,0
1748420840623,SE 296,008,954005,Kim; Hyunsun Alicia,9999,0,9999,0
1748420840623,SE 296,009,954007,Kosmatka; John B,9999,0,9999,0
1748420840623,SE 296,010,954009,Krysl; Petr,9999,0,9999,0
1748420840623,SE 296,011,954011,Kuester; Falko,9999,0,9999,0
1748420840623,SE 296,012,954014,Lanza Di Scalea; Francesco,9999,0,9999,0
1748420840623,SE 296,013,954015,Loh; Kenneth J. H.,9999,0,9999,0
1748420840623,SE 296,014,954021,McCartney; John Scott,9999,0,9999,0
1748420840623,SE 296,015,954023,Morrison; Machel Leigh,9999,0,9999,0
1748420840623,SE 296,016,954024,Mosqueda; Gilberto,9999,0,9999,0
1748420840623,SE 296,017,954028,Qiao; Yu,9999,0,9999,0
1748420840623,SE 296,018,954030,Shing; P. Benson,9999,0,9999,0
1748420840623,SE 296,019,954031,Todd; Michael,9998,0,9999,1
1748420840623,SE 296,020,954033,Tomac; Ingrid,9999,0,9999,0
1748420840623,SE 296,021,954037,Tsampras; Georgios,9999,0,9999,0
1748420840623,SE 296,022,954040,Uang; Chia-Ming,9999,0,9999,0
1748420840623,SE 296,023,954043,Van Den Einde; Yael Dahlia,9999,0,9999,0
1748420840623,SE 296,024,954044,Zhu; Qiang,9999,0,9999,0
1748420840623,SE 296,025,954046,Tehrani; Mehran,9999,0,9999,0
1748420840623,SE 296,026,954047,Palermo; Alessandro,9999,0,9999,0
1748420840623,SE 296,027,954049,Chadha; Mayank,9999,0,9999,0
1748420841651,SIO 3,A01,938657,Hetherington; Elizabeth Dorsey,33,0,37,4
1748420841651,SIO 3,A02,938665,Hetherington; Elizabeth Dorsey,36,0,37,1
1748420842682,SIO 15,A00,938667,Laske; Gabi,294,0,348,54
1748420843708,SIO 20R,A01,938679,Russell; Lynn M.,145,0,200,55
1748420844741,SIO 25,A01,938684,Hildebrand; John A,33,0,40,7
1748420844741,SIO 25,A02,938685,Hildebrand; John A,39,0,40,1
1748420844741,SIO 25,A03,938963,Hildebrand; John A,40,0,40,0
1748420844741,SIO 25,A04,939110,Hildebrand; John A,40,0,40,0
1748420844741,SIO 25,A05,939116,Hildebrand; John A,40,0,40,0
1748420844741,SIO 25,A06,939149,Hildebrand; John A,40,0,40,0
1748420844741,SIO 25,A07,939158,Hildebrand; John A,40,0,40,0
1748420844741,SIO 25,A08,939173,Hildebrand; John A,40,0,40,0
1748420844741,SIO 25,A09,939180,Hildebrand; John A,40,0,40,0
1748420844741,SIO 25,A10,939228,Hildebrand; John A,40,0,40,0
1748420845770,SIO 30,A01,939230,Aluwihare; Lihini & Gille; Sarah T,33,0,37,4
1748420845770,SIO 30,A02,939231,Aluwihare; Lihini & Baumann-Pickering ; Simone,37,0,37,0
1748420845770,SIO 30,A03,939232,Aluwihare; Lihini & Gille; Sarah T,34,0,37,3
1748420845770,SIO 30,A04,939233,Aluwihare; Lihini & Gille; Sarah T,31,0,37,6
1748420845770,SIO 30,A05,939234,Aluwihare; Lihini & Gille; Sarah T,38,0,38,0
1748420845770,SIO 30,A06,939235,Aluwihare; Lihini & Gille; Sarah T,37,0,38,1
1748420845770,SIO 30,A07,939236,Aluwihare; Lihini & Gille; Sarah T,36,0,38,2
1748420845770,SIO 30,A08,939237,Aluwihare; Lihini & Gille; Sarah T,36,0,38,2
1748420846799,SIO 50,A01,939239,Cook; Geoffrey W,8,0,20,12
1748420846799,SIO 50,A02,939240,Cook; Geoffrey W,11,0,20,9
1748420847831,SIO 87,A00,939242,Norris; Joel Roland,20,0,20,0
1748420847831,SIO 87,B00,939306,Cook; Geoffrey W,20,0,20,0
1748420847831,SIO 87,C00,939327,Cook; Geoffrey W,20,0,20,0
1748420848860,SIO 100,A00,939328,Odlum; Margaret Larkin,0,0,30,30
1748420849895,SIO 101,A01,939330,Aluwihare; Lihini & Decima; Moira R.,0,0,35,35
1748420849895,SIO 101,A02,939331,Aluwihare; Lihini & Decima; Moira R.,12,0,35,23
1748420850926,SIO 103,A01,939371,Parnell-Turner; Ross Ernes,6,0,20,14
1748420851953,SIO 105,A00,939372,Driscoll; Neal W.,8,0,20,12
1748420852985,SIO 117,A01,939375,Keeling; Ralph F.,14,0,25,11
1748420854010,SIO 122,A01,939377,Lyons; Deirdre Colleen,6,0,30,24
1748420855038,SIO 124,A00,961131,Lukowski; April Lynn,34,0,65,31
1748420856072,SIO 132,A01,939379,Kacev; David & Hechinger; Ryan F.,9,0,34,25
1748420856072,SIO 132,A02,939380,Kacev; David & Hechinger; Ryan F.,28,0,34,6
1748420856072,SIO 132,A03,939381,Kacev; David & Hechinger; Ryan F.,19,0,34,15
1748420856072,SIO 132,A04,939480,Kacev; David & Hechinger; Ryan F.,26,0,34,8
1748420856072,SIO 132,A05,939481,Kacev; David & Hechinger; Ryan F.,18,0,34,16
1748420856072,SIO 132,A06,939482,Kacev; David & Hechinger; Ryan F.,25,0,34,9
1748420857100,SIO 136,A01,939562,Kacev; David & Shipp; Lauren Elizabeth,6,0,34,28
1748420857100,SIO 136,A02,939563,Kacev; David & Shipp; Lauren Elizabeth,24,0,34,10
1748420858132,SIO 147,A01,939566,Betancur Rodriguez; Ricard,0,0,30,30
1748420859158,SIO 166,A00,939567,Jimenez Cano; Nayeli Guada,13,0,30,17
1748420860189,SIO 167,A01,939569,Dunseth; Zachary Clark,9,0,10,1
1748420861219,SIO 170,A00,939571,Cook; Geoffrey W,39,0,45,6
1748420862250,SIO 171,A01,939573,Rudnick; Daniel Lars,44,0,50,6
1748420863277,SIO 177,A00,939574,Becker; Janet Maria,19,0,20,1
1748420864304,SIO 179,A01,939611,Martz; Todd R.,2,0,15,13
1748420865334,SIO 189,A00,939616,Staff,0,0,0,0
1748420866365,SIO 194,A00,954130,Hill; Seth J,9999,0,9999,0
1748420867391,SIOB 218,A01,960525,Staff,13,0,20,7
1748420868420,SIOB 262,A00,939617,Lukowski; April Lynn,15,0,20,5
1748420869447,SIOB 273,A00,939618,Leichter; James J.,9,0,15,6
1748420870474,SIOB 274,A01,939679,Leichter; James J.,15,0,20,5
1748420871501,SIOB 276,A01,939703,Sugihara; George,19,0,20,1
1748420872527,SIOB 279,A00,939717,Barton; Andrew David,19,0,25,6
1748420873554,SIOB 280,A00,939722,Allen; Andrew Ellis & Baumann-Pickering ; Simone,54,0,70,16
1748420874583,SIOB 296,A00,939790,Lyons; Deirdre Colleen,0,0,0,0
1748420875612,SIOB 297,A00,939795,Allen; Eric,57,0,65,8
1748420876643,SIOC 200A,A00,939821,Lin; Ying-Tsong,16,0,20,4
1748420877673,SIOC 203A,A00,939827,Becker; Janet Maria,18,0,20,2
1748420878704,SIOC 207A,A01,939909,Meyer; Florian,12,0,20,8
1748420879736,SIOC 208,A00,939913,Merrifield; Mark A,11,0,20,9
1748420880764,SIOC 210,A00,939917,Purkey; Sarah Michelle G.,25,0,35,10
1748420880764,SIOC 210,B00,939973,Purkey; Sarah Michelle G.,31,0,35,4
1748420881797,SIOC 217A,A00,940015,Evan; Amato Tomas,18,0,25,7
1748420882825,SIOC 221A,A00,940020,Alford; Matthew Hudson,16,0,20,4
1748420883850,SIOG 200C,A00,940290,Fan; Wenyuan,23,0,25,2
1748420884890,SIOG 223A,A00,940333,Constable; Catherine G,22,0,25,3
1748420885917,SIOG 225,A00,940334,Fialko; Yuri A.,19,0,20,1
1748420886942,SIOG 228,A00,940338,Diaz; Julia Michelle,15,0,40,25
1748420887969,SIOG 238,A00,940339,May; David Alexander,20,0,20,0
1748420888997,SIOG 239,A00,940340,Fan; Wenyuan,20,0,20,0
1748420888997,SIOG 239,B00,940342,Sandwell; David T,19,0,20,1
1748420890024,SIOG 240,A00,940409,Parnell-Turner; Ross Ernes,34,0,40,6
1748420891055,SIOG 249,A00,940442,Norris; Richard D.,25,0,25,0
1748420892081,SIOG 267,A01,940444,Martz; Todd R.,15,0,15,0
1748420893110,SIOG 288,A01,940446,Diaz; Julia Michelle,22,0,25,3
1748420894137,SOCE 194,A00,954128,Hill; Seth J,9999,0,9999,0
1748420895165,SOCG 200,A00,935260,Rona-Tas; Akos,2,0,12,10
1748420896192,SOCG 201,A00,935264,Shafir; Gershon,0,0,12,12
1748420897220,SOCG 203,A00,935265,Gong; Neil M,0,0,10,10
1748420898247,SOCG 207,A00,935267,Navon; Daniel,0,0,10,10
1748420899337,SOCG 208A,A00,935269,Blair-Loy; Mary,2,0,12,10
1748420900363,SOCG 226,A00,935302,Skrentny; John David,0,0,10,10
1748420901389,SOCG 227,A00,935303,Jules-Rosette; Bennetta W.,7,0,10,3
1748420902437,SOCG 244,A00,935305,Ribas Norris; Janet Vanesa,0,0,10,10
1748420903463,SOCG 252,A00,935307,Turner; Christena L.,2,0,10,8
1748420904490,SOCG 253,A00,935313,Evans; John Hyde,7,0,10,3
1748420905525,SOCG 255A,A00,934873,McKenzie; Kerry V.,10,0,10,0
1748420906554,SOCG 255C,A00,934874,McKenzie; Kerry V.,9,0,10,1
1748420907581,SOCG 271,A00,935434,Estefan; Michel,4,0,10,6
1748420908610,SOCI 1,A01,934878,Skrentny; John David,20,0,22,2
1748420908610,SOCI 1,A02,934879,Skrentny; John David,21,0,22,1
1748420908610,SOCI 1,A03,934880,Skrentny; John David,22,0,23,1
1748420908610,SOCI 1,A04,934881,Skrentny; John David,12,0,23,11
1748420908610,SOCI 1,A05,934883,Skrentny; John David,23,0,23,0
1748420908610,SOCI 1,A06,934884,Skrentny; John David,23,0,23,0
1748420908610,SOCI 1,A07,934885,Skrentny; John David,22,0,23,1
1748420908610,SOCI 1,A08,934886,Skrentny; John David,22,0,23,1
1748420908610,SOCI 1,A09,934887,Skrentny; John David,22,0,23,1
1748420909643,SOCI 30,A01,934889,Ruiz; Jonathan Joseph,18,0,20,2
1748420909643,SOCI 30,A02,934890,Ruiz; Jonathan Joseph,15,0,20,5
1748420910676,SOCI 60,A01,934892,Ribas Norris; Janet Vanesa,6,0,17,11
1748420910676,SOCI 60,A02,934896,Ribas Norris; Janet Vanesa,17,0,17,0
1748420910676,SOCI 60,A03,934965,Ribas Norris; Janet Vanesa,12,0,17,5
1748420910676,SOCI 60,A04,934974,Ribas Norris; Janet Vanesa,17,0,17,0
1748420911704,SOCI 70,A01,934984,Payne; Christine Anna,4,0,15,11
1748420911704,SOCI 70,A02,934988,Payne; Christine Anna,14,0,15,1
1748420911704,SOCI 70,A03,935006,Payne; Christine Anna,11,0,15,4
1748420911704,SOCI 70,A04,935047,Payne; Christine Anna,15,0,15,0
1748420912731,SOCI 88,A00,935058,Estefan; Michel,0,0,20,20
1748420913762,SOCI 100,A01,935065,Estefan; Michel,6,0,15,9
1748420913762,SOCI 100,A02,935068,Estefan; Michel,4,0,15,11
1748420913762,SOCI 100,A03,935069,Estefan; Michel,5,0,15,10
1748420913762,SOCI 100,A04,935071,Estefan; Michel,0,0,15,15
1748420914797,SOCI 103M,A00,935073,Kilpatrick; Kevin,22,0,30,8
1748420915824,SOCI 104,A00,935077,Arnal; Maud Marie Leonie,18,0,30,12
1748420916851,SOCI 104Q,A00,935079,Rogers; Julia,20,0,30,10
1748420917877,SOCI 105,A01,935083,Jules-Rosette; Bennetta W.,20,0,25,5
1748420918909,SOCI 109,A00,935084,Kilpatrick; Kevin,25,0,30,5
1748420919935,SOCI 112,A00,935085,Pitt; Richard Norris,61,0,65,4
1748420920960,SOCI 113,A00,935086,Rogers; Julia,68,0,75,7
1748420921990,SOCI 117,A01,935151,Jones; Makeba,0,0,13,13
1748420921990,SOCI 117,A02,935153,Jones; Makeba,4,0,13,9
1748420921990,SOCI 117,A03,935155,Jones; Makeba,11,0,12,1
1748420921990,SOCI 117,A04,935156,Jones; Makeba,10,0,12,2
1748420921990,SOCI 117,B01,935158,Jones; Gabrielle Anastasia,7,0,15,8
1748420921990,SOCI 117,B02,935159,Jones; Gabrielle Anastasia,15,0,15,0
1748420921990,SOCI 117,B03,935161,Jones; Gabrielle Anastasia,15,0,15,0
1748420921990,SOCI 117,B04,935162,Jones; Gabrielle Anastasia,15,0,15,0
1748420923018,SOCI 122,A00,935166,Lewis; Kevin Michael,101,0,120,19
1748420924045,SOCI 129,A00,935167,Pitt; Richard Norris,50,0,65,15
1748420925091,SOCI 135,A00,935170,Payne; Christine Anna,112,0,120,8
1748420926121,SOCI 136F,A00,935171,Gong; Neil M,52,0,56,4
1748420927148,SOCI 137,A00,935173,Crofts; Christine,53,0,100,47
1748420928176,SOCI 138,A00,935174,Navon; Daniel,111,0,135,24
1748420929203,SOCI 140,A00,935175,Ng; Kwai,47,0,65,18
1748420930235,SOCI 140K,A00,935176,Ng; Kwai,39,0,56,17
1748420931261,SOCI 142,A00,935177,Crofts; Christine,24,0,75,51
1748420932288,SOCI 143V,A00,935222,Lewis; Kevin Michael,99,0,140,41
1748420933318,SOCI 148,A00,935227,Shafir; Gershon,115,0,120,5
1748420934344,SOCI 148E,A00,935231,Calderon-Zaks; Michael Aar,44,0,56,12
1748420935371,SOCI 150,A00,935232,Victoria Torres; Pablo,14,0,50,36
1748420936401,SOCI 153,A00,935233,Ruiz; Jonathan Joseph,46,0,50,4
1748420937432,SOCI 166,A00,935243,Lampland; Martha,34,0,35,1
1748420938462,SOCI 170,A00,935247,Lampland; Martha,29,0,30,1
1748420939488,SOCI 172,A00,935249,Rona-Tas; Akos,40,0,45,5
1748420940517,SOCI 173,A00,935252,Arnal; Maud Marie Leonie,67,0,75,8
1748420941549,SOCI 180,A00,935253,Calderon-Zaks; Michael Aar,46,0,56,10
1748420942576,SOCI 184,A00,935254,Victoria Torres; Pablo,21,0,56,35
1748420943603,SOCI 196A,A00,935256,Turner; Christena L.,20,0,20,0
1748420944631,SPPS 200B,A00,959322,Luli; Alex J,99,0,99,0
1748420945658,SPPS 201,A00,959324,Mnatzaganian; Christina L,99,0,99,0
1748420946692,SPPS 202A,A00,959400,Tsunoda; Shirley M.,99,0,99,0
1748420947719,SPPS 204,A01,959405,Jones; John,99,0,99,0
1748420948746,SPPS 206,A00,959406,Bounthavong; Mark,80,0,80,0
1748420949778,SPPS 212A,A01,959408,Feist; Ashley,81,0,99,18
1748420950805,SPPS 213A,A00,959409,Namba; Jennifer Mariko,82,0,99,17
1748420951833,SPPS 219,A00,959410,Ma; Joseph David,81,0,99,18
1748420952863,SPPS 221,A01,959412,Siegel; Dionicio R.,80,0,80,0
1748420953890,SPPS 231,A00,959413,Penny; William F.,79,0,99,20
1748420954917,SPPS 232,A00,959415,Simonson; Tatum Sasha Summ,79,0,99,20
1748420955943,SPPS 233,A00,959417,Eckmann; Lars,79,0,99,20
1748420956975,SPPS 247,A00,959419,Brandl; Katharina,79,0,99,20
1748420958003,SPPS 251,A00,959420,Chen; Timothy,99,0,99,0
1748420959030,SPPS 264A,A00,959421,Tsunoda; Shirley M.,99,0,99,0
1748420961087,SPPS 267,A01,959426,Tsunoda; Shirley M.,25,0,25,0
1748420962113,SPPS 269,A00,959427,Atayee; Rabia Samady,29,0,30,1
1748420963140,SPPS 270A,A00,959430,Fricovsky; Eduardo Santiago,99,0,99,0
1748420964166,SPPS 271,A00,959432,Tsunoda; Shirley M.,99,0,99,0
1748420965192,SPPS 278,A00,959433,Fricovsky; Eduardo Santiago,98,0,99,1
1748420966219,SPPS 279,A00,959434,Painter; Nathan A.,99,0,99,0
1748420967256,SYN 2,001,946469,Girard; Gabrielle,3,0,20,17
1748420967256,SYN 2,002,946470,Girard; Gabrielle,0,0,20,20
1748420967256,SYN 2,003,946471,Rock; Martin,0,0,20,20
1748420967256,SYN 2,004,946472,Rock; Martin,0,0,20,20
1748420967256,SYN 2,005,946473,Iatarola; Briana Marie,0,0,20,20
1748420967256,SYN 2,006,946474,Tawater; Hanna Jean,0,0,20,20
1748420967256,SYN 2,007,946475,Browne; Emily,6,0,20,14
1748420967256,SYN 2,008,946476,Browne; Emily,0,0,20,20
1748420967256,SYN 2,009,946477,Staff,0,0,20,20
1748420967256,SYN 2,010,946478,Staff,10,0,20,10
1748420967256,SYN 2,012,946480,Deavenport; James Cary,0,0,20,20
1748420967256,SYN 2,013,946481,Deavenport; James Cary,0,0,20,20
1748420967256,SYN 2,014,946482,Staff,0,0,20,20
1748420967256,SYN 2,015,946483,Staff,0,0,20,20
1748420967256,SYN 2,016,946484,Staff,0,0,20,20
1748420967256,SYN 2,017,946485,Staff,5,0,20,15
1748420967256,SYN 2,019,946487,Atkinson; Arthur Laird,0,0,20,20
1748420967256,SYN 2,020,946488,Staff,0,0,20,20
1748420967256,SYN 2,021,946489,Staff,0,0,20,20
1748420967256,SYN 2,030,946498,Iatarola; Briana Marie,0,0,20,20
1748420967256,SYN 2,036,946587,Bishop; Graham,0,0,20,20
1748420968283,SYN 2R,001,946588,Bishop; Graham,0,0,20,20
1748420969317,SYN 100,A01,946594,Rock; Martin,0,0,15,15
1748420969317,SYN 100,A02,946595,Rock; Martin,0,0,15,15
1748420969317,SYN 100,B01,946598,Browne; Emily,0,0,15,15
1748420969317,SYN 100,B02,946600,Browne; Emily,0,0,15,15
1748420969317,SYN 100,C01,946606,Tawater; Hanna Jean,0,0,15,15
1748420969317,SYN 100,C02,946607,Tawater; Hanna Jean,0,0,15,15
1748420969317,SYN 100,D01,946610,Tawater; Hanna Jean,0,0,15,15
1748420969317,SYN 100,D02,946613,Tawater; Hanna Jean,0,0,15,15
1748420969317,SYN 100,E01,946617,Vega; Adrian,0,0,24,24
1748420969317,SYN 100,G01,946714,Iatarola; Briana Marie,0,0,15,15
1748420969317,SYN 100,G02,946721,Iatarola; Briana Marie,0,0,15,15
1748420969317,SYN 100,I01,946735,Gormally; Brenna,0,0,15,15
1748420969317,SYN 100,I02,946736,Gormally; Brenna,0,0,15,15
1748420969317,SYN 100,J01,946738,Hom; Kirstyn Courtney,0,0,15,15
1748420969317,SYN 100,J02,946739,Hom; Kirstyn Courtney,0,0,15,15
1748420969317,SYN 100,K01,946741,Hom; Kirstyn Courtney,0,0,15,15
1748420969317,SYN 100,K02,946742,Hom; Kirstyn Courtney,0,0,15,15
1748420969317,SYN 100,L01,946745,Difruscio; Mark,0,0,15,15
1748420969317,SYN 100,L02,946746,Difruscio; Mark,0,0,15,15
1748420969317,SYN 100,M01,946748,Difruscio; Mark,0,0,15,15
1748420969317,SYN 100,M02,946749,Difruscio; Mark,0,0,15,15
1748420969317,SYN 100,P01,946759,Atkinson; Arthur Laird,0,0,15,15
1748420969317,SYN 100,P02,946760,Atkinson; Arthur Laird,0,0,15,15
1748420969317,SYN 100,Q01,946763,Bishop; Graham,0,0,15,15
1748420969317,SYN 100,Q02,946764,Bishop; Graham,0,0,15,15
1748420969317,SYN 100,R01,946766,Deavenport; James Cary,0,0,15,15
1748420969317,SYN 100,R02,946767,Deavenport; James Cary,0,0,15,15
1748420970354,SYN 150,001,946771,Gladstein; Jill M,19,0,20,1
1748420970354,SYN 150,002,946772,Lagapa; Jason,17,0,20,3
1748420970354,SYN 150,003,946773,Fish; Gwendolyn Anne,19,0,20,1
1748420970354,SYN 150,004,946774,Fish; Gwendolyn Anne,20,0,20,0
1748420970354,SYN 150,006,946782,Lagapa; Jason,18,0,20,2
1748420970354,SYN 150,007,946783,Lagapa; Jason,19,0,20,1
1748420970354,SYN 150,008,946784,Fish; Gwendolyn Anne,19,0,20,1
1748420971382,SYN 150R,001,946786,Vega; Adrian,19,0,20,1
1748420972410,TDAC 1,A00,946788,Walsh; Kim C.,0,0,12,12
1748420972410,TDAC 1,B00,946789,Walsh; Kim C.,0,0,12,12
1748420972410,TDAC 1,C00,946790,Walsh; Kim C.,0,0,12,12
1748420972410,TDAC 1,D00,946791,Walsh; Kim C.,0,0,12,12
1748420972410,TDAC 1,E00,946792,Walsh; Kim C.,0,0,12,12
1748420972410,TDAC 1,F00,946793,Walsh; Kim C.,0,0,12,12
1748420973438,TDAC 101,A00,946887,Harting; Carla Kelso,3,0,12,9
1748420973438,TDAC 101,B00,946970,Salovey; Todd,9,0,12,3
1748420973438,TDAC 101,C00,946977,Walsh; Kim C.,10,0,12,2
1748420974470,TDAC 102,A00,946979,Celik; Aysan Karagasli,7,0,15,8
1748420975500,TDAC 104,A00,946994,Meyer; Ursula,14,0,15,1
1748420976528,TDAC 107,A00,946997,Stalling; Vanessa,0,0,0,0
1748420977562,TDAC 108,A00,947021,Basso; Beatrice,19,0,20,1
1748420977562,TDAC 108,B00,947025,Caban; Andrea Chudnow,12,0,20,8
1748420977562,TDAC 108,C00,968049,Buescher; Stephen W.,16,0,20,4
1748420978593,TDAC 115,A00,947050,Buescher; Stephen W.,14,0,20,6
1748420979619,TDAC 122,A00,947091,Stalling; Vanessa,30,0,30,0
1748420979619,TDAC 122,B00,947092,Perry; Lamar,30,0,30,0
1748420980646,TDAC 123,A00,947093,Castro; Robert Jess,30,0,30,0
1748420981677,TDDE 1,A01,946795,Guirguis; Mark C,10,0,11,1
1748420981677,TDDE 1,A02,946796,Guirguis; Mark C,10,0,11,1
1748420981677,TDDE 1,A03,946797,Guirguis; Mark C,7,0,11,4
1748420981677,TDDE 1,A04,946798,Guirguis; Mark C,8,0,11,3
1748420981677,TDDE 1,A05,946799,Guirguis; Mark C,11,0,11,0
1748420982704,TDDE 130,A00,947094,Guirguis; Mark C,20,0,20,0
1748420983731,TDDE 131,A00,947095,Guirguis; Mark C,17,0,20,3
1748420984758,TDDE 132,A00,947096,Guirguis; Mark C,20,0,20,0
1748420985786,TDDE 141,A00,947097,McElver; Robert Harrison,20,0,20,0
1748420986818,TDDM 1,A00,946800,Johnston; Holly,7,0,18,11
1748420987845,TDDM 100,A00,947098,Brown; Bernard Joseph,28,0,30,2
1748420988873,TDDR 101,A00,947099,Powell; Lora,4,0,20,16
1748420989901,TDDR 102,A00,947100,Powell; Lora,19,0,20,1
1748420990930,TDDR 111,A00,947101,Castro; Robert Jess,12,0,15,3
1748420991958,TDDR 190,A00,947102,Stalling; Vanessa,35,0,35,0
1748420992987,TDGE 1,A01,946802,Salovey; Todd,12,0,12,0
1748420992987,TDGE 1,A02,946803,Salovey; Todd,11,0,12,1
1748420992987,TDGE 1,A03,946804,Salovey; Todd,12,0,12,0
1748420992987,TDGE 1,A04,946806,Salovey; Todd,12,0,12,0
1748420992987,TDGE 1,A05,946807,Salovey; Todd,10,0,12,2
1748420992987,TDGE 1,A06,946808,Salovey; Todd,12,0,12,0
1748420994015,TDGE 10,A00,946810,Havis; Allan,208,0,225,17
1748420995042,TDGE 11,A00,946811,Fulton; Julia,205,0,245,40
1748420996070,TDGE 25,A00,946812,Harting; Carla Kelso,1,0,20,19
1748420996070,TDGE 25,B00,946813,Harting; Carla Kelso,5,0,20,15
1748420996070,TDGE 25,C00,946814,Harting; Carla Kelso,10,0,20,10
1748420996070,TDGE 25,D00,946815,Harting; Carla Kelso,12,0,20,8
1748420997097,TDGE 124,A00,947103,Fulton; Julia,190,0,245,55
1748420998123,TDGE 133,A00,947104,Brill; Robert L.,19,0,20,1
1748420999152,TDGR 201,A00,947268,Newcomb; James,8,0,8,0
1748421000180,TDGR 210A,A00,947269,Staff,8,0,8,0
1748421001208,TDGR 211A,A00,947270,Caban; Andrea Chudnow,8,0,8,0
1748421002236,TDGR 212,A00,947271,Meyer; Ursula,17,0,17,0
1748421002236,TDGR 212,B00,947272,Caban; Andrea Chudnow,17,0,17,0
1748421003327,TDGR 213A,A00,947273,Buescher; Stephen W.,8,0,8,0
1748421004355,TDGR 214A,A00,947274,Meyer; Ursula,8,0,8,0
1748421005380,TDGR 219,A00,947276,Stalling; Vanessa,3,0,5,2
1748421006410,TDGR 229,A00,947277,Meyer; Ursula,7,0,7,0
1748421007438,TDGR 231A,A00,947278,Meyer; Ursula,9,0,9,0
1748421008468,TDGR 233,A00,947279,Richard; Keiana Nikole,9,0,9,0
1748421009496,TDGR 235,A00,947280,Blair; Kyle Adam,9,0,9,0
1748421010527,TDGR 239,A00,947281,Staff,8,0,8,0
1748421010527,TDGR 239,B00,947282,Meyer; Ursula,9,0,9,0
1748421010527,TDGR 239,C00,947283,Staff,9,0,9,0
1748421011554,TDGR 240,A00,947284,Stalling; Vanessa,3,0,5,2
1748421012587,TDGR 244,A00,947285,Iizuka; Naomi Hisako,19,0,20,1
1748421013614,TDGR 245,A00,947287,Stalling; Vanessa,4,0,5,1
1748421014641,TDGR 250,A00,947289,Stein; Deborah Isobel,5,0,5,0
1748421015666,TDGR 251,A00,947296,Iizuka; Naomi Hisako,5,0,5,0
1748421015666,TDGR 251,B00,947355,Stein; Deborah Isobel,5,0,5,0
1748421016692,TDGR 274,A00,947358,Brill; Robert L.,19,0,20,1
1748421017718,TDGR 275,A00,947361,Staff,10,0,10,0
1748421018749,TDGR 276,A00,947362,Bokovikova; Alina V,10,0,10,0
1748421019784,TDGR 278,A00,947363,Petrovich; Victoria A.,12,0,12,0
1748421019784,TDGR 278,B00,947366,Staff,9,0,10,1
1748421020817,TDGR 279,A00,947367,Petrovich; Victoria A.,3,0,3,0
1748421020817,TDGR 279,B00,947368,Brill; Robert L.,2,0,3,1
1748421020817,TDGR 279,C00,947369,McElver; Robert Harrison,3,0,3,0
1748421020817,TDGR 279,D00,967973,Staff,0,0,0,0
1748421020817,TDGR 279,E00,967974,Bokovikova; Alina V,0,0,0,0
1748421021843,TDGR 282,A00,947370,McElver; Robert Harrison,10,0,10,0
1748421022870,TDGR 289,A00,947371,Power; Jade Yukana,10,0,10,0
1748421023899,TDGR 289C,A00,947373,Burelle; Julie Sara Veronique,10,0,10,0
1748421024925,TDGR 289D,A00,947374,Anderson; Mysia Anyse,5,0,5,0
1748421025957,TDGR 292,A00,947375,Yapp; Hentyle T,14,0,15,1
1748421026983,TDGR 295,A00,947376,Celik; Aysan Karagasli,8,0,8,0
1748421028012,TDGR 296,A00,947379,Powell; Lora,5,0,5,0
1748421029039,TDGR 297,001,947381,Meyer; Ursula,9,0,9,0
1748421030067,TDHT 10,A00,946817,Burelle; Julie Sara Veronique,23,0,25,2
1748421031094,TDHT 21,A02,946821,Power; Jade Yukana,11,0,15,4
1748421031094,TDHT 21,A03,946822,Power; Jade Yukana,8,0,15,7
1748421032128,TDHT 101,A00,947106,Perry; Lamar,19,0,25,6
1748421033156,TDHT 103,A00,947107,Yapp; Hentyle T,8,0,25,17
1748421034183,TDHT 115,A00,947108,Portes; Elizabeth Marie,16,0,25,9
1748421035212,TDMV 1,A00,946823,Arcidiacono; Kristin,18,0,30,12
1748421036239,TDMV 2,A00,946824,Wilson; Terry A.,24,0,30,6
1748421036239,TDMV 2,B00,946825,Brown; Bernard Joseph,23,0,30,7
1748421037267,TDMV 3,A00,946826,Mack; Kara Shanai',23,0,40,17
1748421038297,TDMV 11,A00,946827,Arcidiacono; Kristin,36,0,40,4
1748421038297,TDMV 11,B00,946828,Fyall; Daunte Edward,28,0,30,2
1748421039325,TDMV 20,A00,946830,Alvarez; Ana Maria,38,0,40,2
1748421039325,TDMV 20,B00,946831,Smith; Alison D,20,0,20,0
1748421040354,TDMV 110,A00,947109,Smith; Alison D,25,0,30,5
1748421041380,TDMV 120,A00,947110,Weinberg; Sadie,17,0,18,1
1748421041380,TDMV 120,B00,964374,Johnston; Holly,18,0,18,0
1748421042416,TDMV 123,A00,947111,Duran; Marcos Antonio,29,0,30,1
1748421043443,TDMV 138,A00,947113,Jun; Grace Shin Hae,4,0,40,36
1748421044471,TDMV 140,A00,947114,Corrales; Joseph Bernales,29,0,30,1
1748421044471,TDMV 140,B00,947138,Lima; Paulo Henrique,30,0,30,0
1748421044471,TDMV 140,C00,947139,Staff,25,0,30,5
1748421045498,TDMV 141,A00,947140,Caligagan; Tony,29,0,30,1
1748421046524,TDMV 142,A00,947225,Alvarez; Ana Maria,28,0,40,12
1748421046524,TDMV 142,B00,947226,Blanco; Juan Carlos,27,0,30,3
1748421047551,TDMV 143,A00,947227,Fyall; Daunte Edward,28,0,30,2
1748421048578,TDMV 144,A00,947261,Camaya; Michelle Ann,28,0,30,2
1748421048578,TDMV 144,B00,947262,Patnaik; Shibani,28,0,30,2
1748421049607,TDMV 146,A00,947263,Caligagan; Tony,30,0,30,0
1748421050633,TDPF 160,A00,947264,Mack; Kara Shanai',40,0,40,0
1748421051662,TDPR 6,A01,946869,Guirguis; Mark C,25,0,25,0
1748421051662,TDPR 6,A02,946870,Guirguis; Mark C,25,0,25,0
1748421052692,TDPR 102,A00,947265,Guirguis; Mark C,20,0,20,0
1748421053720,TDPR 104,A00,947266,Powell; Lora,15,0,15,0
1748421054751,TDPW 1,A00,946873,Stein; Deborah Isobel,6,0,10,4
1748421054751,TDPW 1,B00,946878,Stein; Deborah Isobel,10,0,10,0
1748421054751,TDPW 1,C00,946879,Stein; Deborah Isobel,10,0,10,0
1748421054751,TDPW 1,D00,946880,Stein; Deborah Isobel,7,0,10,3
1748421054751,TDPW 1,E00,946882,Stein; Deborah Isobel,7,0,10,3
1748421055777,TDPW 104,A00,947267,Loo; Eric James,13,0,20,7
1748421056807,TDTR 10,A00,946883,Wilson; Terry A.,14,0,20,6
1748421057836,TDTR 15,A00,946885,Smith; Alison D,30,0,30,0
1748421058867,TDTR 20,A00,946886,Duran; Marcos Antonio,25,0,30,5
1748421059900,USP 1,A01,943915,Garcia; Guadalupe,23,0,23,0
1748421059900,USP 1,A02,943916,Garcia; Guadalupe,19,0,23,4
1748421059900,USP 1,A03,943927,Garcia; Guadalupe,23,0,23,0
1748421059900,USP 1,A04,943933,Garcia; Guadalupe,22,0,23,1
1748421059900,USP 1,A05,943942,Garcia; Guadalupe,23,0,23,0
1748421059900,USP 1,A06,943951,Garcia; Guadalupe,22,0,23,1
1748421060927,USP 2,A01,943956,Pezzoli; Keith,15,0,23,8
1748421060927,USP 2,A02,943958,Pezzoli; Keith,20,0,22,2
1748421061960,USP 4,A00,943961,Schwaller; Nora Louise,2,0,18,16
1748421061960,USP 4,B00,943966,Schwaller; Nora Louise,12,0,18,6
1748421062991,USP 5,A01,943968,Boomhower; Matthew Charles,16,0,20,4
1748421062991,USP 5,A02,943969,Boomhower; Matthew Charles,16,0,20,4
1748421064026,USP 15,A01,943971,Anderson; William Raymond,18,0,20,2
1748421064026,USP 15,A02,944015,Anderson; William Raymond,19,0,20,1
1748421065053,USP 25,A00,944021,Shenkman; Michael Thomas,16,0,25,9
1748421066085,USP 50,A00,944025,Sun; Feiyang,3,0,30,27
1748421067120,USP 60,A01,944056,Wali; Behram,26,0,30,4
1748421068152,USP 105,A00,944057,Ruiz; Jonathan Joseph,9,0,15,6
1748421069184,USP 108,A00,944058,Pezzoli; Keith,10,0,21,11
1748421070216,USP 124,A00,944060,Devereux; Christina Schopp,16,0,35,19
1748421071246,USP 125,A00,944063,Lerner; Amy M,21,0,28,7
1748421072275,USP 136,A00,944064,Staff,27,0,35,8
1748421073303,USP 141A,A00,960658,Lewis; Leslie R,0,0,0,0
1748421074331,USP 143,A00,944065,Hinds; Juli Beth,200,0,250,50
1748421075362,USP 144,A00,944066,Chowdhury; Muhammed Zohir,94,0,100,6
1748421076391,USP 150,A00,944067,Devereux; Christina Schopp,68,0,75,7
1748421077417,USP 151,A00,944068,Clark; Christopher N,58,0,70,12
1748421078447,USP 152B,A00,944069,Moeder; Nathan L,14,0,25,11
1748421079474,USP 153,A00,944070,Shenkman; Michael Thomas,19,0,35,16
1748421080501,USP 161,A00,944071,Wartell; Julie Dara,27,0,35,8
1748421081528,USP 165C,A00,944072,Wali; Behram,25,0,30,5
1748421082554,USP 170,A00,944142,Entezam; Maryam,60,0,70,10
1748421083585,USP 171,A00,944153,Lerner; Amy M,24,0,65,41
1748421084612,USP 175,A00,944172,Peerson; Susan,0,0,25,25
1748421085641,USP 177A,A00,944173,Peerson; Susan,0,0,23,23
1748421087705,USP 185A,A01,944198,Boomhower; Matthew Charles,26,0,40,14
1748421087705,USP 185A,B01,944201,Sun; Feiyang,0,0,40,40
1748421088733,USP 186,A01,944255,Bussell; Mirle Rabinowitz,28,0,38,10
1748421088733,USP 186,A02,944262,Bussell; Mirle Rabinowitz,11,0,37,26
1748421089760,USP 189,A00,944269,Garcia; Guadalupe,35,0,35,0
1748421090791,USP 191A,A00,944270,McTague; Sarah,13,0,30,17
1748421091824,USP 193,A00,944271,Shilon; Mor,10,0,23,13
1748421092866,USP 194,A00,954112,Hill; Seth J,9999,0,9999,0
1748421093893,USP 265C,A00,944277,Wali; Behram,3,0,4,1
1748421094918,USP 271,A00,944280,Lerner; Amy M,5,0,5,0
1748421095954,VIS 1,A01,944283,Staff,4,0,12,8
1748421095954,VIS 1,A02,944284,Staff,0,0,12,12
1748421095954,VIS 1,A03,944286,Staff,0,0,12,12
1748421095954,VIS 1,A04,944288,Staff,0,0,12,12
1748421095954,VIS 1,A05,944290,Staff,0,0,12,12
1748421095954,VIS 1,A06,944292,Staff,1,0,12,11
1748421095954,VIS 1,A07,944293,Staff,9,0,12,3
1748421095954,VIS 1,A08,944300,Staff,0,0,12,12
1748421095954,VIS 1,A09,944302,Staff,12,0,12,0
1748421095954,VIS 1,A10,944303,Staff,0,0,12,12
1748421095954,VIS 1,A11,944307,Staff,0,0,12,12
1748421095954,VIS 1,A12,944309,Staff,0,0,12,12
1748421095954,VIS 1,A13,944310,Staff,0,0,12,12
1748421095954,VIS 1,A14,944312,Staff,0,0,12,12
1748421095954,VIS 1,A15,944316,Staff,7,0,12,5
1748421095954,VIS 1,A16,944319,Staff,0,0,12,12
1748421096990,VIS 20,A01,944323,Woods; Ann,14,0,16,2
1748421096990,VIS 20,A02,944325,Woods; Ann,15,0,16,1
1748421096990,VIS 20,A03,944326,Woods; Ann,14,0,16,2
1748421096990,VIS 20,A04,944328,Woods; Ann,14,0,16,2
1748421096990,VIS 20,A05,944330,Woods; Ann,16,0,16,0
1748421096990,VIS 20,A06,944334,Woods; Ann,16,0,16,0
1748421096990,VIS 20,A07,944336,Woods; Ann,14,0,16,2
1748421096990,VIS 20,A08,944337,Woods; Ann,16,0,16,0
1748421096990,VIS 20,A09,944338,Woods; Ann,15,0,16,1
1748421096990,VIS 20,A10,944339,Woods; Ann,16,0,16,0
1748421096990,VIS 20,A11,944340,Woods; Ann,15,0,16,1
1748421096990,VIS 20,A12,944342,Woods; Ann,15,0,16,1
1748421098020,VIS 23,A00,944343,Rose; Jordan M,0,0,5,5
1748421099047,VIS 30,A01,944346,Stone; Patricia,11,0,11,0
1748421099047,VIS 30,A02,944351,Stone; Patricia,0,0,11,11
1748421099047,VIS 30,A03,944353,Stone; Patricia,7,0,11,4
1748421099047,VIS 30,A04,944354,Stone; Patricia,9,0,11,2
1748421099047,VIS 30,A05,944356,Stone; Patricia,10,0,11,1
1748421099047,VIS 30,A06,944359,Stone; Patricia,6,0,11,5
1748421100075,VIS 41,A01,944391,D'Elena-Tweed; Jessica Erin,10,0,12,2
1748421100075,VIS 41,A02,944392,D'Elena-Tweed; Jessica Erin,11,0,12,1
1748421100075,VIS 41,A03,944393,D'Elena-Tweed; Jessica Erin,12,0,12,0
1748421100075,VIS 41,A04,944396,D'Elena-Tweed; Jessica Erin,9,0,12,3
1748421100075,VIS 41,A05,944397,D'Elena-Tweed; Jessica Erin,12,0,12,0
1748421100075,VIS 41,A06,944399,D'Elena-Tweed; Jessica Erin,8,0,12,4
1748421100075,VIS 41,A07,944405,D'Elena-Tweed; Jessica Erin,10,0,12,2
1748421100075,VIS 41,A08,944411,D'Elena-Tweed; Jessica Erin,10,0,12,2
1748421100075,VIS 41,A09,944412,D'Elena-Tweed; Jessica Erin,12,0,12,0
1748421100075,VIS 41,A10,944415,D'Elena-Tweed; Jessica Erin,10,0,12,2
1748421100075,VIS 41,A11,944428,D'Elena-Tweed; Jessica Erin,12,0,12,0
1748421100075,VIS 41,A12,944430,D'Elena-Tweed; Jessica Erin,11,0,12,1
1748421101103,VIS 42,A00,969576,Twomey; Robert Daniel,86,0,100,14
1748421102136,VIS 60,A01,944432,Sepuya; Paul Mpagi,10,0,12,2
1748421102136,VIS 60,A02,944434,Sepuya; Paul Mpagi,12,0,12,0
1748421102136,VIS 60,A03,944436,Sepuya; Paul Mpagi,12,0,12,0
1748421102136,VIS 60,A04,944438,Sepuya; Paul Mpagi,12,0,12,0
1748421103167,VIS 70N,A01,944456,Garnett; Mariah J,11,0,11,0
1748421103167,VIS 70N,A02,944461,Garnett; Mariah J,9,0,11,2
1748421103167,VIS 70N,A03,944462,Garnett; Mariah J,8,0,11,3
1748421103167,VIS 70N,A04,944500,Garnett; Mariah J,10,0,11,1
1748421103167,VIS 70N,A05,944501,Garnett; Mariah J,11,0,11,0
1748421103167,VIS 70N,A06,944502,Garnett; Mariah J,11,0,11,0
1748421103167,VIS 70N,A07,944503,Garnett; Mariah J,11,0,11,0
1748421103167,VIS 70N,A08,944507,Garnett; Mariah J,11,0,11,0
1748421104195,VIS 80,A01,944513,Adler; Amy,12,0,12,0
1748421104195,VIS 80,A02,944515,Adler; Amy,9,0,12,3
1748421104195,VIS 80,A03,944517,Adler; Amy,10,0,12,2
1748421104195,VIS 80,A04,944518,Adler; Amy,10,0,12,2
1748421104195,VIS 80,A05,944519,Adler; Amy,12,0,12,0
1748421104195,VIS 80,A06,944520,Adler; Amy,11,0,12,1
1748421104195,VIS 80,A07,944525,Adler; Amy,11,0,12,1
1748421104195,VIS 80,A08,944526,Adler; Amy,9,0,12,3
1748421105228,VIS 85A,A01,944694,Staff,18,0,18,0
1748421105228,VIS 85A,A02,944695,Staff,18,0,18,0
1748421105228,VIS 85A,A03,944696,Staff,17,0,18,1
1748421105228,VIS 85A,A04,944697,Staff,17,0,18,1
1748421105228,VIS 85A,A05,968082,Staff,17,0,18,1
1748421105228,VIS 85A,A06,968084,Staff,18,0,18,0
1748421105228,VIS 85A,A07,968085,Staff,17,0,18,1
1748421105228,VIS 85A,A08,968087,Staff,17,0,18,1
1748421106262,VIS 100,A00,944698,Cruz; Edwin Teddy,125,0,146,21
1748421107343,VIS 100A,A00,944699,D'Elena-Tweed; Jessica Erin,0,0,15,15
1748421108373,VIS 103D,A00,944767,Cartwright; Lisa,72,0,75,3
1748421109400,VIS 105A,A00,944769,Staff,9,0,30,21
1748421109400,VIS 105A,B00,944770,Staff,20,0,30,10
1748421110426,VIS 105B,A00,944773,Staff,16,0,30,14
1748421111453,VIS 105C,A00,944774,Ortiz-Torres; Ruben,1,0,15,14
1748421112479,VIS 106A,A00,944775,Staff,10,0,25,15
1748421113506,VIS 106B,A00,944776,Staff,0,0,25,25
1748421114534,VIS 107A,A00,944777,Staff,2,0,25,23
1748421115564,VIS 107C,A00,944780,Iglesias; Janelle Ann,11,0,15,4
1748421116591,VIS 108,A00,944781,Staff,0,0,15,15
1748421117627,VIS 110A,A00,944782,Staff,11,0,15,4
1748421118657,VIS 110G,A00,963093,Staff,14,0,15,1
1748421119683,VIS 113CN,A00,944783,Welchman; John C.,11,0,15,4
1748421120714,VIS 120A,A00,944784,Woods; Ann,118,0,146,28
1748421121746,VIS 121C,A00,944789,Tronzo; William,68,0,75,7
1748421122774,VIS 126F,A00,944793,Wardwell; Mariana Razo,74,0,75,1
1748421123805,VIS 128C,A00,944794,Staff,71,0,75,4
1748421124834,VIS 129A,A00,944799,Staff,7,0,15,8
1748421125860,VIS 132,A00,944800,Miller; Nicole L,6,0,15,9
1748421126892,VIS 133,A01,944806,Staff,32,0,34,2
1748421126892,VIS 133,A02,944809,Staff,34,0,34,0
1748421127923,VIS 133A,A00,944854,Staff,0,0,15,15
1748421128952,VIS 141A,A01,944856,Stalbaum; Brett,16,0,25,9
1748421128952,VIS 141A,A02,944858,Stalbaum; Brett,17,0,25,8
1748421128952,VIS 141A,A03,944859,Stalbaum; Brett,11,0,25,14
1748421128952,VIS 141A,A04,944861,Stalbaum; Brett,23,0,25,2
1748421129997,VIS 142,A01,944864,Stalbaum; Brett,11,0,15,4
1748421129997,VIS 142,A02,944865,Stalbaum; Brett,0,0,15,15
1748421129997,VIS 142,A03,944869,Stalbaum; Brett,11,0,15,4
1748421129997,VIS 142,A04,944873,Stalbaum; Brett,5,0,15,10
1748421129997,VIS 142,A05,944876,Stalbaum; Brett,15,0,15,0
1748421129997,VIS 142,A06,944878,Stalbaum; Brett,7,0,15,8
1748421131025,VIS 143,A00,969275,Akten; Mehmet,0,0,15,15
1748421132050,VIS 145B,A00,944879,Akten; Mehmet,0,0,15,15
1748421133078,VIS 146B,A00,944880,Twomey; Robert Daniel,14,0,15,1
1748421134109,VIS 147A,A01,944883,Staff,21,0,22,1
1748421134109,VIS 147A,A02,944923,Staff,12,0,22,10
1748421134109,VIS 147A,A03,944924,Staff,15,0,22,7
1748421134109,VIS 147A,A04,944925,Staff,17,0,22,5
1748421135139,VIS 147B,A00,944926,Staff,0,0,15,15
1748421135139,VIS 147B,B00,944927,Staff,1,0,15,14
1748421136167,VIS 149,A00,944928,Bratton; Benjamin H.,12,0,15,3
1748421136167,VIS 149,B00,944929,Crandall; Jordan,7,0,15,8
1748421137195,VIS 152D,A01,944931,Wardwell; Mariana Razo,19,0,24,5
1748421137195,VIS 152D,A02,945003,Wardwell; Mariana Razo,23,0,24,1
1748421137195,VIS 152D,A03,945007,Wardwell; Mariana Razo,24,0,24,0
1748421137195,VIS 152D,A04,945097,Wardwell; Mariana Razo,22,0,24,2
1748421138224,VIS 157,A01,945131,Cartwright; Lisa,23,0,24,1
1748421138224,VIS 157,A02,945167,Cartwright; Lisa,5,0,24,19
1748421139256,VIS 162,A00,945168,Bratton; Benjamin H.,6,0,15,9
1748421140283,VIS 163,A00,945169,Stone; Patricia,72,0,75,3
1748421141314,VIS 164,A00,945170,Sepuya; Paul Mpagi,19,0,22,3
1748421142345,VIS 165A,A00,945208,Staff,10,0,22,12
1748421143371,VIS 167,A00,945235,Staff,11,0,22,11
1748421144399,VIS 171,A00,945258,Staff,18,0,22,4
1748421145427,VIS 174,A00,945285,Cross; Brian R,0,0,22,22
1748421146451,VIS 175,A00,945286,Staff,18,0,22,4
1748421147478,VIS 179,A00,945287,Erdmann; Dean,20,0,22,2
1748421148504,VIS 180A,A00,945322,Cross; Brian R,9,0,22,13
1748421149543,VIS 180B,A00,945324,Gaines; Malik Julian,17,0,22,5
1748421150568,VIS 183B,A00,945329,Staff,4,0,22,18
1748421151594,VIS 203,A00,945331,Cruz; Edwin Teddy,4,0,15,11
1748421152620,VIS 204,A00,945333,Gaines; Malik Julian,11,0,15,4
1748421153649,VIS 205,A00,945334,Ortiz-Torres; Ruben,14,0,15,1
1748421154677,VIS 207,A00,971577,Staff,13,0,15,2
1748421155710,VIS 209,A00,945337,Welchman; John C.,10,0,15,5
1748421156736,VIS 243,A00,945340,Rose; Jordan M,8,0,15,7
1748421157765,VIS 255,A00,945342,Staff,9,0,15,6
1748421158809,VIS 295,001,971694,Miller; Nicole L,0,0,0,0
1748421158809,VIS 295,002,971695,Cruz; Edwin Teddy,0,0,0,0
1748421158809,VIS 295,003,971696,Segade; Alexandro Abraham,0,0,0,0
1748421158809,VIS 295,004,971697,Vangenderen; Monique Luise,0,0,0,0
1748421158809,VIS 295,005,971725,Sepuya; Paul Mpagi,0,0,0,0
1748421158809,VIS 295,006,971763,Sepuya; Paul Mpagi,0,0,0,0
1748421158809,VIS 295,007,971764,Mostajo; Lorena,0,0,0,0
1748421158809,VIS 295,008,971765,Akten; Mehmet,0,0,0,0
1748421159845,WCWP 10A,001,947782,Escobar; Jordan Christophe,20,0,20,0
1748421159845,WCWP 10A,002,947791,Escobar; Jordan Christophe,20,0,20,0
1748421159845,WCWP 10A,003,947792,Gagnon; Jeffrey C,0,0,0,0
1748421159845,WCWP 10A,004,947793,Escobar; Jordan Christophe,19,0,20,1
1748421159845,WCWP 10A,005,947794,Merryman; Walter,19,0,20,1
1748421159845,WCWP 10A,006,947840,Merryman; Walter,20,0,20,0
1748421159845,WCWP 10A,007,947841,Staff,0,0,0,0
1748421159845,WCWP 10A,008,947842,Staff,0,0,0,0
1748421159845,WCWP 10A,009,947843,Martiniuk; Jill,18,0,20,2
1748421159845,WCWP 10A,010,947844,Staff,0,0,0,0
1748421159845,WCWP 10A,011,947845,Martiniuk; Jill,19,0,20,1
1748421159845,WCWP 10A,012,947861,Martiniuk; Jill,20,0,20,0
1748421159845,WCWP 10A,013,947862,Staff,0,0,0,0
1748421159845,WCWP 10A,014,947863,Staff,0,0,0,0
1748421159845,WCWP 10A,015,947867,Staff,0,0,0,0
1748421159845,WCWP 10A,016,947868,Susi; Natalie,19,0,20,1
1748421159845,WCWP 10A,017,947869,Susi; Natalie,19,0,20,1
1748421159845,WCWP 10A,018,947870,Holloway Ii; Mathew,20,0,20,0
1748421159845,WCWP 10A,019,947912,Welji; Haleema Nazir,0,0,0,0
1748421159845,WCWP 10A,020,947941,Holloway Ii; Mathew,19,0,20,1
1748421159845,WCWP 10A,021,947954,Holloway Ii; Mathew,20,0,20,0
1748421159845,WCWP 10A,022,960902,Windham; Emily,19,0,20,1
1748421159845,WCWP 10A,023,960903,Windham; Emily,16,0,20,4
1748421159845,WCWP 10A,024,960904,Windham; Emily,18,0,20,2
1748421160874,WCWP 10B,001,948038,Dhir; Simrita,17,0,20,3
1748421160874,WCWP 10B,002,948042,Dhir; Simrita,14,0,20,6
1748421160874,WCWP 10B,003,948043,Uriarte; Emma,0,0,20,20
1748421160874,WCWP 10B,004,948044,Dhir; Simrita,12,0,20,8
1748421160874,WCWP 10B,005,948045,Uriarte; Emma,13,0,20,7
1748421160874,WCWP 10B,006,948046,Uriarte; Emma,13,0,20,7
1748421160874,WCWP 10B,007,948047,Staff,0,0,0,0
1748421160874,WCWP 10B,008,948075,Staff,0,0,0,0
1748421160874,WCWP 10B,009,948076,Ornelas; Tricia,15,0,20,5
1748421160874,WCWP 10B,010,948077,Staff,0,0,0,0
1748421160874,WCWP 10B,011,948096,Staff,0,0,0,0
1748421160874,WCWP 10B,012,948103,Staff,0,0,0,0
1748421160874,WCWP 10B,016,948169,Staff,0,0,0,0
1748421160874,WCWP 10B,017,948192,Ornelas; Tricia,12,0,20,8
1748421160874,WCWP 10B,018,948194,Ornelas; Tricia,14,0,20,6
1748421160874,WCWP 10B,019,948195,Staff,0,0,0,0
1748421161903,WCWP 100,A00,948196,McCleary; Keith Long,14,0,20,6
1748421161903,WCWP 100,B00,948198,McCleary; Keith Long,20,0,20,0
1748421161903,WCWP 100,C00,948199,McCleary; Keith Long,20,0,20,0
1748421161903,WCWP 100,D00,948200,Twohig; Niall Ivan,18,0,20,2
1748421161903,WCWP 100,E00,948201,Twohig; Niall Ivan,19,0,20,1
1748421161903,WCWP 100,F00,948202,Twohig; Niall Ivan,17,0,20,3
1748421161903,WCWP 100,G00,948203,Young; Mark T,18,0,20,2
1748421161903,WCWP 100,H00,948204,Young; Mark T,19,0,20,1
1748421161903,WCWP 100,I00,948205,Young; Mark T,19,0,20,1
1748421162929,WES 237C,A00,948206,Staff,15,0,15,0
1748421163960,WES 267,A00,948207,Staff,25,0,25,0
1748421164990,WES 268A,A01,948209,Staff,15,0,15,0
1748421167316,AAPI 87,A00,911745,Solomon; Amanda Lee Albaniel,20,0,20,0
1748421168345,AAS 10R,A01,912566,Butler; Elizabeth Annette,15,0,34,19
1748421168345,AAS 10R,A02,912567,Butler; Elizabeth Annette,20,0,34,14
1748421169371,AAS 170R,A00,912568,Butler; Elizabeth Annette,29,0,32,3
1748421170399,ANAR 104,A01,911408,Shtienberg; Gilad,11,0,20,9
1748421171431,ANAR 120,A00,911411,Staff,22,0,30,8
1748421172458,ANAR 166,A00,911412,Jimenez Cano; Nayeli Guada,21,0,30,9
1748421173485,ANAR 167,A01,911414,Dunseth; Zachary Clark,0,0,10,10
1748421174514,ANBI 100,A00,911416,Marchetto; Maria Carolina,36,0,40,4
1748421174514,ANBI 100,B00,961136,Staff,66,0,80,14
1748421175543,ANBI 112,A00,911417,Marchetto; Maria Carolina,0,0,20,20
1748421176577,ANBI 117,A01,961211,Fox; Patrick Keolu Ozer,33,0,40,7
1748421177604,ANBI 135,A01,911419,Non; Amy L,4,0,15,11
1748421178630,ANBI 141,A00,911420,Gagneux; Pascal,170,0,196,26
1748421179662,ANSC 108,A00,911460,Pedersen; David,38,0,40,2
1748421180689,ANSC 121,A00,911472,Sloane; Julia Kathryn,53,0,60,7
1748421181720,ANSC 124,A00,911473,Bialecki; Jon Anthony,32,0,40,8
1748421182747,ANSC 142,A00,911474,Stone; Annika Britt,31,0,40,9
1748421183773,ANSC 148,A00,911475,Walkover; Lillian B,46,0,46,0
1748421184800,ANSC 149,A00,911476,Varma; Saiba,56,0,60,4
1748421185827,ANSC 152,A00,961212,Staff,40,0,40,0
1748421186859,ANSC 190,A00,911479,Jassal; Aftab,41,0,50,9
1748421187889,ANTH 1,A00,910717,Jassal; Aftab,146,0,150,4
1748421188918,ANTH 2,A01,910719,Wilder; Linnea Lorene,31,0,36,5
1748421188918,ANTH 2,A02,910720,Wilder; Linnea Lorene,36,0,36,0
1748421188918,ANTH 2,A03,910722,Wilder; Linnea Lorene,32,0,36,4
1748421188918,ANTH 2,A04,910723,Wilder; Linnea Lorene,35,0,36,1
1748421188918,ANTH 2,A05,910724,Wilder; Linnea Lorene,35,0,36,1
1748421188918,ANTH 2,A06,910725,Wilder; Linnea Lorene,35,0,36,1
1748421188918,ANTH 2,A07,910726,Wilder; Linnea Lorene,33,0,34,1
1748421189944,ANTH 10,A00,910727,Stewart; Alexander B,148,0,175,27
1748421190979,ANTH 21,A01,910730,Stone; Annika Britt,35,0,36,1
1748421190979,ANTH 21,A02,910731,Stone; Annika Britt,34,0,36,2
1748421190979,ANTH 21,A03,910732,Stone; Annika Britt,34,0,36,2
1748421190979,ANTH 21,A04,910733,Stone; Annika Britt,30,0,36,6
1748421190979,ANTH 21,A05,910734,Stone; Annika Britt,35,0,36,1
1748421190979,ANTH 21,A06,910735,Stone; Annika Britt,30,0,36,6
1748421190979,ANTH 21,A07,910736,Stone; Annika Britt,24,0,34,10
1748421190979,ANTH 21,B01,910738,Kang; Byung Chu,36,0,36,0
1748421190979,ANTH 21,B02,910740,Kang; Byung Chu,36,0,36,0
1748421190979,ANTH 21,B03,910781,Kang; Byung Chu,34,0,36,2
1748421190979,ANTH 21,B04,910782,Kang; Byung Chu,34,0,36,2
1748421190979,ANTH 21,B05,910821,Kang; Byung Chu,36,0,36,0
1748421190979,ANTH 21,B06,910826,Kang; Byung Chu,34,0,36,2
1748421190979,ANTH 21,B07,910834,Kang; Byung Chu,34,0,34,0
1748421192022,ANTH 23,A01,910896,Stewart; Alexander B,25,0,25,0
1748421192022,ANTH 23,A02,910916,Stewart; Alexander B,25,0,25,0
1748421192022,ANTH 23,A03,910932,Stewart; Alexander B,25,0,25,0
1748421192022,ANTH 23,A04,910933,Stewart; Alexander B,24,0,25,1
1748421192022,ANTH 23,A05,910938,Stewart; Alexander B,25,0,25,0
1748421192022,ANTH 23,A06,911043,Stewart; Alexander B,25,0,25,0
1748421192022,ANTH 23,A07,911141,Stewart; Alexander B,24,0,25,1
1748421193056,ANTH 87,A00,911153,Jordan; David K.,20,0,20,0
1748421193056,ANTH 87,B00,911392,Jordan; David K.,20,0,20,0
1748421193056,ANTH 87,C00,911404,Varma; Saiba,20,0,20,0
1748421194082,ANTH 101,A01,911481,Staff,27,0,30,3
1748421194082,ANTH 101,A02,911482,Staff,15,0,30,15
1748421194082,ANTH 101,A03,911483,Staff,24,0,30,6
1748421194082,ANTH 101,A04,911484,Staff,17,0,30,13
1748421195113,ANTH 105,A00,911486,Staff,69,0,80,11
1748421196140,ANTH 108,A00,911487,Sloane; Julia Kathryn,31,0,35,4
1748421197171,ANTH 196A,A00,911488,Staff,14,0,15,1
1748421198197,ANTH 200,A00,911489,Non; Amy L,12,0,15,3
1748421199224,ANTH 203,A00,911490,Gagneux; Pascal,20,0,20,0
1748421200249,ANTH 208,A00,911491,Kang; Byung Chu,8,0,12,4
1748421201277,ANTH 268,A00,911492,McKenzie; Kerry V.,10,0,10,0
1748421202303,ANTH 273,A00,911493,McKenzie; Kerry V.,10,0,10,0
1748421203332,ANTH 281A,A00,911494,Pedersen; David,10,0,10,0
1748421204362,ANTH 285,A00,911495,Algaze; Guillermo,7,0,10,3
1748421205390,ASTR 1,A01,911506,Wright; Shelley Adams,282,0,300,18
1748421206422,ASTR 18,A01,911508,Arnold; Kam S,35,0,37,2
1748421207452,ASTR 20A,A01,911510,Theissen; Christopher Alexander,48,0,56,8
1748421208479,ASTR 65,A01,911512,Trumbo; Samantha Kathleen,49,0,50,1
1748421209506,ASTR 101,A01,911514,Burgasser; Adam Jonathan,25,0,32,7
1748421210534,ASTR 104,A01,911516,Lee; Eve Jihyun,29,0,32,3
1748421211615,ASTR 120,A01,911518,Tytler; David Robert,29,0,37,8
1748421212647,ASTR 124,A01,911520,Konopacky; Quinn Morgan,33,0,37,4
1748421213675,ASTR 150,A01,911522,Hosseinzadeh; Griffin Alex,34,0,40,6
1748421214701,ASTR 200,A00,911523,Sandstrom; Karin Marie,29,0,30,1
1748421215728,ASTR 201,A00,911524,Broekgaarden; Floor Suzan,30,0,30,0
1748421216754,ASTR 213,A00,911525,Keres; Dusan,28,0,30,2
1748421217783,ASTR 250,A00,911526,Theissen; Christopher Alexander & Hosseinzadeh; Griffin Alex,27,0,30,3
1748421218809,ASTR 251,A00,911527,Theissen; Christopher Alexander & Hosseinzadeh; Griffin Alex,27,0,30,3
1748421219883,AWP 3,001,910489,Staff,12,0,12,0
1748421219883,AWP 3,002,910490,Staff,12,0,12,0
1748421219883,AWP 3,003,910491,Staff,12,0,12,0
1748421219883,AWP 3,004,910492,Staff,12,0,12,0
1748421219883,AWP 3,005,910493,Staff,12,0,12,0
1748421219883,AWP 3,006,910495,Staff,12,0,12,0
1748421219883,AWP 3,007,910498,Staff,12,0,12,0
1748421219883,AWP 3,008,910509,Staff,12,0,12,0
1748421219883,AWP 3,009,910516,Staff,12,0,12,0
1748421219883,AWP 3,010,910525,Staff,12,0,12,0
1748421219883,AWP 3,011,910531,Staff,12,0,12,0
1748421219883,AWP 3,012,910532,Staff,12,0,12,0
1748421219883,AWP 3,013,910533,Staff,12,0,12,0
1748421219883,AWP 3,014,910534,Staff,12,0,12,0
1748421219883,AWP 3,015,910535,Staff,12,0,12,0
1748421219883,AWP 3,016,910536,Staff,12,0,12,0
1748421219883,AWP 3,017,910537,Staff,12,0,12,0
1748421219883,AWP 3,018,910538,Staff,12,0,12,0
1748421219883,AWP 3,019,910539,Staff,0,0,0,0
1748421219883,AWP 3,020,910540,Staff,0,0,0,0
1748421219883,AWP 3,021,910541,Staff,12,0,12,0
1748421219883,AWP 3,022,910542,Staff,0,0,0,0
1748421219883,AWP 3,023,910543,Staff,12,0,12,0
1748421219883,AWP 3,024,910545,Staff,12,0,12,0
1748421219883,AWP 3,025,910546,Staff,12,0,12,0
1748421219883,AWP 3,026,910547,Staff,12,0,12,0
1748421219883,AWP 3,027,910548,Staff,12,0,12,0
1748421219883,AWP 3,028,910549,Staff,12,0,12,0
1748421219883,AWP 3,029,910550,Staff,0,0,0,0
1748421219883,AWP 3,030,910551,Staff,0,0,0,0
1748421219883,AWP 3,031,910552,Staff,12,0,12,0
1748421219883,AWP 3,032,910553,Staff,12,0,12,0
1748421219883,AWP 3,033,910554,Staff,12,0,12,0
1748421219883,AWP 3,034,910555,Staff,12,0,12,0
1748421219883,AWP 3,035,910557,Staff,12,0,12,0
1748421219883,AWP 3,036,910558,Staff,12,0,12,0
1748421219883,AWP 3,037,910559,Staff,12,0,12,0
1748421219883,AWP 3,038,910560,Staff,12,0,12,0
1748421219883,AWP 3,039,910561,Staff,12,0,12,0
1748421219883,AWP 3,040,910562,Staff,12,0,12,0
1748421219883,AWP 3,041,910563,Staff,12,0,12,0
1748421219883,AWP 3,042,910564,Staff,12,0,12,0
1748421219883,AWP 3,043,910565,Staff,12,0,12,0
1748421219883,AWP 3,044,910566,Staff,12,0,12,0
1748421219883,AWP 3,045,910567,Staff,12,0,12,0
1748421219883,AWP 3,046,910568,Staff,12,0,12,0
1748421219883,AWP 3,047,910569,Staff,12,0,12,0
1748421219883,AWP 3,048,910570,Staff,12,0,12,0
1748421219883,AWP 3,049,910571,Staff,12,0,12,0
1748421219883,AWP 3,050,910576,Staff,12,0,12,0
1748421219883,AWP 3,051,910629,Staff,12,0,12,0
1748421219883,AWP 3,052,910630,Staff,12,0,12,0
1748421219883,AWP 3,053,910632,Staff,12,0,12,0
1748421219883,AWP 3,054,910633,Staff,12,0,12,0
1748421219883,AWP 3,055,910635,Staff,12,0,12,0
1748421219883,AWP 3,056,910636,Staff,12,0,12,0
1748421219883,AWP 3,057,910638,Staff,12,0,12,0
1748421219883,AWP 3,058,910640,Staff,0,0,0,0
1748421219883,AWP 3,059,910641,Staff,12,0,12,0
1748421219883,AWP 3,060,910645,Staff,12,0,12,0
1748421219883,AWP 3,061,910646,Staff,12,0,12,0
1748421219883,AWP 3,062,910648,Staff,12,0,12,0
1748421219883,AWP 3,063,910649,Staff,12,0,12,0
1748421219883,AWP 3,064,910653,Staff,12,0,12,0
1748421219883,AWP 3,065,910654,Staff,12,0,12,0
1748421219883,AWP 3,066,910656,Staff,12,0,12,0
1748421219883,AWP 3,067,910657,Staff,12,0,12,0
1748421219883,AWP 3,068,910659,Staff,15,0,15,0
1748421219883,AWP 3,069,910660,Staff,0,0,0,0
1748421219883,AWP 3,070,910662,Staff,12,0,12,0
1748421219883,AWP 3,071,910665,Staff,0,0,0,0
1748421219883,AWP 3,072,910667,Staff,12,0,12,0
1748421219883,AWP 3,073,970938,Staff,12,0,12,0
1748421219883,AWP 3,074,970939,Staff,12,0,12,0
1748421219883,AWP 3,075,970940,Staff,0,0,0,0
1748421219883,AWP 3,076,970941,Staff,12,0,12,0
1748421219883,AWP 3,077,970942,Staff,12,0,12,0
1748421219883,AWP 3,078,970943,Staff,0,0,0,0
1748421219883,AWP 3,079,970944,Staff,12,0,12,0
1748421219883,AWP 3,080,970945,Staff,0,0,0,0
1748421219883,AWP 3,081,971140,Staff,0,0,0,0
1748421219883,AWP 3,082,971141,Staff,0,0,0,0
1748421219883,AWP 3,083,971142,Staff,0,0,0,0
1748421219883,AWP 3,084,971152,Staff,0,0,0,0
1748421219883,AWP 3,085,971315,Staff,0,0,0,0
1748421220911,AWP 4B,B00,910682,Staff,0,0,0,0
1748421220911,AWP 4B,C00,910701,Staff,0,0,0,1
1748421221938,BENG 1,A01,911565,Khojah; Reem I,26,0,30,4
1748421221938,BENG 1,A02,911567,Khojah; Reem I,30,0,30,0
1748421221938,BENG 1,A03,911568,Khojah; Reem I,29,0,30,1
1748421222966,BENG 2,A00,911569,Khojah; Reem I,28,0,30,2
1748421223993,BENG 98,001,969809,Sah; Robert Lie-Yuan,9999,0,9999,0
1748421225019,BENG 99,001,969810,Sah; Robert Lie-Yuan,9999,0,9999,0
1748421226046,BENG 100,A01,911579,Taylor Amos; Alyssa C,35,0,50,15
1748421227074,BENG 110,A01,911582,Mc Culloch; Andrew Douglas,5,0,30,25
1748421227074,BENG 110,A02,911584,Mc Culloch; Andrew Douglas,17,0,30,13
1748421228104,BENG 122A,A01,958030,Cauwenberghs; Gert,54,0,70,16
1748421229132,BENG 133,A01,911589,Mali; Prashant Gulab Ram,33,0,40,7
1748421230163,BENG 135,A01,911653,Staff,32,0,40,8
1748421231189,BENG 141,A01,911674,Staff,29,0,40,11
1748421232217,BENG 161A,A01,911676,Fraley; Stephanie I.,16,0,35,19
1748421232217,BENG 161A,A02,957945,Fraley; Stephanie I.,29,0,35,6
1748421233244,BENG 162,A01,911682,Mali; Prashant Gulab Ram,0,0,30,30
1748421233244,BENG 162,A02,911683,Mali; Prashant Gulab Ram,25,0,30,5
1748421234271,BENG 166A,A02,911685,Sah; Robert Lie-Yuan,11,0,35,24
1748421235298,BENG 183,A01,911688,Zhong; Sheng,35,0,120,85
1748421236331,BENG 187B,A00,911689,Taylor Amos; Alyssa C,52,0,120,68
1748421237361,BENG 188A,A01,911691,Taylor Amos; Alyssa C,131,0,170,39
1748421238387,BENG 196,A00,911692,Cabrales; Pedro,5,0,5,0
1748421239412,BENG 197,A00,911693,Cabrales; Pedro,9999,0,9999,0
1748421240437,BENG 198,001,969812,Sah; Robert Lie-Yuan,9999,0,9999,0
1748421241469,BENG 211,A00,911720,Smarr; Benjamin,2,0,30,28
1748421242496,BENG 216,A01,911722,Cauwenberghs; Gert,1,0,40,39
1748421243529,BENG 219,A00,911723,Schoeneberg; Johannes,0,0,0,0
1748421244562,BENG 221,A00,911724,Valdez-Jasso; Daniela,27,0,70,43
1748421245588,BENG 226,A01,911727,Schmid-Schoenbein; Geert W,54,0,120,66
1748421246616,BENG 230A,A00,911728,Huang; Xiaohua,59,0,120,61
1748421247643,BENG 241A,A01,911730,Cyphert; Erika Leah,0,0,50,50
1748421248669,BENG 242,A00,911731,Cai; Shengqiang,16,0,40,24
1748421249698,BENG 247A,A00,911732,Shi; Lingyan,31,0,55,24
1748421250733,BENG 247B,A00,911733,Aran; Kiana,0,0,30,30
1748421251764,BENG 254,A01,911735,Hasty; Jeff M,0,0,20,20
1748421252793,BENG 260,A01,911737,Silva; Gabriel,15,0,45,30
1748421253820,BENG 280A,A00,911738,Liu; Thomas Tao-Ming & McVeigh; Elliot R.,34,0,70,36
1748421254853,BENG 281,A00,911739,Zhong; Sheng,5,0,90,85
1748421255879,BENG 282,A00,911740,Cabrales; Pedro,19,0,100,81
1748421256905,BENG 292,A01,911742,Ross; Camille,20,0,20,0
1748421257932,BENG 294A,A00,911743,King; Kevin R,25,0,50,25
1748421258960,BENG 295,A00,911744,Watson; John Thomas,9999,0,9999,0
1748421259989,BGGN 202,A00,943331,Kadonaga; James T,52,0,60,8
1748421261023,BGGN 204,A00,943332,Shurin; Jonathan,11,0,20,9
1748421262052,BGGN 206A,A00,943343,Bennett; Eric J,50,0,50,0
1748421263080,BGGN 208,A00,943344,Meyer; Justin Raymond & Bennett; Eric J,50,0,50,0
1748421264107,BGGN 213,A00,943349,Grant; Barry J,48,0,48,0
1748421265140,BGGN 214,A00,943351,Suel; Gurol Mehmet,23,0,50,27
1748421266170,BGGN 220,A00,943352,Dickinson; Alexandra Jazz & Pruneda-Paz; Jose L.,24,0,50,26
1748421267199,BGGN 227,A00,943372,Huffaker; Alisa,44,0,50,6
1748421268232,BGGN 249A,A01,969612,Bloodgood; Brenda Laurie,0,0,0,0
1748421268232,BGGN 249A,A02,969639,Bloodgood; Brenda Laurie,0,0,0,0
1748421269259,BGGN 260,A01,946423,Silva; Gabriel,15,0,15,0
1748421270392,BGGN 271,001,967097,Akbari; Omar Sultan,9999,0,9999,0
1748421270392,BGGN 271,002,967098,Allen; Nicola J,9999,0,9999,0
1748421270392,BGGN 271,003,967099,Alperin; Mariann,9999,0,9999,0
1748421270392,BGGN 271,004,967238,Antal; Corina Elena,9998,0,9999,1
1748421270392,BGGN 271,005,967365,Banghart; Matthew Ryan,9999,0,9999,0
1748421270392,BGGN 271,006,967368,Bier; Ethan,9999,0,9999,0
1748421270392,BGGN 271,007,967371,Boss; Gerard R.,9999,0,9999,0
1748421270392,BGGN 271,008,967375,Bouvet; Michael,9999,0,9999,0
1748421270392,BGGN 271,009,967376,Breen; Ellen C.,9999,0,9999,0
1748421270392,BGGN 271,010,967382,Bui; Jack D,9999,0,9999,0
1748421270392,BGGN 271,011,967391,Burnett; Lindsey,9998,0,9999,1
1748421270392,BGGN 271,012,967407,Caffrey; Conor,9999,0,9999,0
1748421270392,BGGN 271,013,967429,Castle; Michael James,9999,0,9999,0
1748421270392,BGGN 271,014,967431,Chang; John Tzu-yu,9999,0,9999,0
1748421270392,BGGN 271,015,967448,Chen; Xu,9999,0,9999,0
1748421270392,BGGN 271,016,967449,Cheng; Christine Shiang-Ling,9999,0,9999,0
1748421270392,BGGN 271,017,967464,Cheresh; David A.,9999,0,9999,0
1748421270392,BGGN 271,018,967496,Cherqui; Stephanie,9999,0,9999,0
1748421270392,BGGN 271,019,967500,Chu; Hiutung,9999,0,9999,0
1748421270392,BGGN 271,020,967559,Church; Kellie Breen,9999,0,9999,0
1748421270392,BGGN 271,021,967560,Cleland; Elsa Eleanor,9999,0,9999,0
1748421270392,BGGN 271,022,967561,Cohen; Shiran,9999,0,9999,0
1748421270392,BGGN 271,023,967562,Coufal; Nicole Gabriele,9999,0,9999,0
1748421270392,BGGN 271,024,967563,Croker; Ben Adam,9999,0,9999,0
1748421270392,BGGN 271,025,967564,Crotty Alexander; Laura E,9999,0,9999,0
1748421270392,BGGN 271,026,967565,Daugherty; Matthew Dorton,9998,0,9999,1
1748421270392,BGGN 271,027,967566,De Silva; Shermin,9999,0,9999,0
1748421270392,BGGN 271,028,967567,Dhar; Debanjan,9999,0,9999,0
1748421270392,BGGN 271,029,967568,Dixon; Jesse,9999,0,9999,0
1748421270392,BGGN 271,030,967569,Doherty; Taylor Alan,9998,0,9999,1
1748421270392,BGGN 271,031,967570,Dore; Kim Bohemie,9999,0,9999,0
1748421270392,BGGN 271,032,967571,Dorrestein; Pieter,9999,0,9999,0
1748421270392,BGGN 271,033,967572,Dulawa; Stephanie Carole,9999,0,9999,0
1748421270392,BGGN 271,034,967573,Fang; Xi,9999,0,9999,0
1748421270392,BGGN 271,035,967575,Farley; Emma Kristen,9998,0,9999,1
1748421270392,BGGN 271,036,967576,Ferguson; Cole John,9999,0,9999,0
1748421270392,BGGN 271,037,967578,Fisch; Kathleen Marie,9999,0,9999,0
1748421270392,BGGN 271,038,967579,George; Olivier,9999,0,9999,0
1748421270392,BGGN 271,039,967580,Ghosh; Pradipta,9998,0,9999,1
1748421270392,BGGN 271,040,967581,Glasgow; Stacey Marie,9999,0,9999,0
1748421270392,BGGN 271,041,967582,Golden; James W,9999,0,9999,0
1748421270392,BGGN 271,042,967583,Gonzalez Gamboa; Ivonne,9999,0,9999,0
1748421270392,BGGN 271,043,967584,Goren; Alon M,9999,0,9999,0
1748421270392,BGGN 271,044,967650,Guatelli; John C,9999,0,9999,0
1748421270392,BGGN 271,045,967651,Guma; Monica,9998,0,9999,1
1748421270392,BGGN 271,046,967652,Gustafsson; Asa Birgitta,9999,0,9999,0
1748421270392,BGGN 271,047,967655,Hamdoun; Amr,9999,0,9999,0
1748421270392,BGGN 271,048,967657,Hao; Nan,9999,0,9999,0
1748421270392,BGGN 271,049,967658,Hasty; Jeff M,9999,0,9999,0
1748421270392,BGGN 271,050,967660,Jiang; Qingfei,9998,0,9999,1
1748421270392,BGGN 271,051,967661,Jin; Chunyu,9999,0,9999,0
1748421270392,BGGN 271,052,967662,Jin; Yishi,9999,0,9999,0
1748421270392,BGGN 271,053,967663,Joshi; Shweta,9998,0,9999,1
1748421270392,BGGN 271,054,967664,Ju; Won-Kyu,9998,0,9999,1
1748421270392,BGGN 271,055,967665,Jun; Suckjoon,9999,0,9999,0
1748421270392,BGGN 271,056,967666,Kaech; Susan Michelle,9999,0,9999,0
1748421270392,BGGN 271,057,967668,Kauffman; Alexander,9998,0,9999,1
1748421270392,BGGN 271,058,967670,Kiger; Amy,9999,0,9999,0
1748421270392,BGGN 271,059,967720,Koloski; Miranda Jane,9998,0,9999,1
1748421270392,BGGN 271,060,967864,Komiyama; Takaki,9999,0,9999,0
1748421270392,BGGN 271,061,967865,Kronenberg; Mitchell E.,9998,0,9999,1
1748421270392,BGGN 271,062,967866,Kufareva; Irina,9999,0,9999,0
1748421270392,BGGN 271,063,967867,Lee; Yun Sok,9999,0,9999,0
1748421270392,BGGN 271,064,967869,Leutgeb; Stefan,9999,0,9999,0
1748421270392,BGGN 271,065,967870,Lewis; Warren G.,9999,0,9999,0
1748421270392,BGGN 271,066,967871,Li; Willis Xiaowei,9998,0,9999,1
1748421270392,BGGN 271,067,967872,Lim; Byungkook,9999,0,9999,0
1748421270392,BGGN 271,068,967873,Lo; Stanley M.,9998,0,9999,1
1748421270392,BGGN 271,069,967874,Lopez Ramirez; Miguel Alej,9999,0,9999,0
1748421270392,BGGN 271,070,967875,Lu; Li-Fan,9998,0,9999,1
1748421270392,BGGN 271,071,967877,Lu; Pengzhe,9999,0,9999,0
1748421270392,BGGN 271,072,967878,Lyons; Deirdre Colleen,9999,0,9999,0
1748421270392,BGGN 271,073,967879,Lyumkis; Dmitry Evgenievich,9999,0,9999,0
1748421270392,BGGN 271,074,967880,Mandyam; Chitra,9999,0,9999,0
1748421270392,BGGN 271,075,967881,McConville; Patrick James,9999,0,9999,0
1748421270392,BGGN 271,076,967882,Mertens; Jerome Stefan,9999,0,9999,0
1748421270392,BGGN 271,077,967884,Morris; Gerald P,9999,0,9999,0
1748421270392,BGGN 271,078,967885,Muroyama; Andrew David,9999,0,9999,0
1748421270392,BGGN 271,079,967886,Murre; Cornelis,9999,0,9999,0
1748421270392,BGGN 271,080,967887,Neal; Sonya E,9999,0,9999,0
1748421270392,BGGN 271,081,967889,Newton; Alexandra C.,9999,0,9999,0
1748421270392,BGGN 271,082,967890,Nieh; James Charles,9999,0,9999,0
1748421270392,BGGN 271,083,967893,Niwa; Maho,9999,0,9999,0
1748421270392,BGGN 271,084,967894,Pantham; Priyadarshini,9999,0,9999,0
1748421270392,BGGN 271,085,967895,Parast; Mana,9999,0,9999,0
1748421270392,BGGN 271,086,967899,Perry; Michael William,9999,0,9999,0
1748421270392,BGGN 271,087,967900,Pillus; Lorraine,9998,0,9999,1
1748421270392,BGGN 271,088,967902,Pogliano; Joseph,9999,0,9999,0
1748421270392,BGGN 271,089,967903,Pruneda-Paz; Jose L.,9999,0,9999,0
1748421270392,BGGN 271,090,967904,Raffatellu; Manuela,9999,0,9999,0
1748421270392,BGGN 271,091,967906,Rana; Tariq,9999,0,9999,0
1748421270392,BGGN 271,092,967907,Rao; Anjana,9998,0,9999,1
1748421270392,BGGN 271,093,967908,Raz; Eyal,9998,0,9999,1
1748421270392,BGGN 271,094,967909,Gaulton; Kyle J,9999,0,9999,0
1748421270392,BGGN 271,095,967910,Rifkin; Scott,9998,0,9999,1
1748421270392,BGGN 271,096,967912,Risbrough; Victoria Blythe,9999,0,9999,0
1748421270392,BGGN 271,097,967916,Rose; Noah Hartmann,9999,0,9999,0
1748421270392,BGGN 271,098,967917,Rouse; Gregory W.,9999,0,9999,0
1748421270392,BGGN 271,099,967918,Saier; Milton H.,9999,0,9999,0
1748421270392,BGGN 271,100,967919,Saltiel; Alan,9998,0,9999,1
1748421270392,BGGN 271,101,967920,Sanchez-Lopez; Elsa,9999,0,9999,0
1748421270392,BGGN 271,102,967921,Schenk; Simon,9999,0,9999,0
1748421270392,BGGN 271,103,967922,Schroeder; Julian I,9998,0,9999,1
1748421270392,BGGN 271,104,967923,Sebat; Lilia Mikhailovna,9999,0,9999,0
1748421270392,BGGN 271,105,967925,Sen; George L,9999,0,9999,0
1748421270392,BGGN 271,106,967926,Shaner; Nathan C.,9999,0,9999,0
1748421270392,BGGN 271,107,967927,Shao; Jianhua,9999,0,9999,0
1748421270392,BGGN 271,108,967928,Shurin; Jonathan,9998,0,9999,1
1748421270392,BGGN 271,109,967929,Sicklick; Jason Keith,9999,0,9999,0
1748421270392,BGGN 271,110,967931,Signer; Robert,9999,0,9999,0
1748421270392,BGGN 271,111,967932,Sigurdson; Christina,9999,0,9999,0
1748421270392,BGGN 271,112,967934,Simonson; Tatum Sasha Summ,9999,0,9999,0
1748421270392,BGGN 271,113,967935,Spitzer; Nicholas,9999,0,9999,0
1748421270392,BGGN 271,114,967936,Steinmetz; Nicole F,9999,0,9999,0
1748421270392,BGGN 271,115,967938,Su; Chih-Ying,9999,0,9999,0
1748421270392,BGGN 271,116,967939,Telese; Francesca,9999,0,9999,0
1748421270392,BGGN 271,117,967942,Towers; Christina Garlingt,9999,0,9999,0
1748421270392,BGGN 271,118,967943,Tye; Kay M,9999,0,9999,0
1748421270392,BGGN 271,119,967945,Wahlin; Karl Jonas,9997,0,9999,2
1748421270392,BGGN 271,120,967947,Wang; Shizhen,9999,0,9999,0
1748421270392,BGGN 271,121,967949,Wang; Jean Yin Jen,9999,0,9999,0
1748421270392,BGGN 271,122,967952,Webster; Nicholas J G,9999,0,9999,0
1748421270392,BGGN 271,123,967953,Weiskopf; Daniela,9998,0,9999,1
1748421270392,BGGN 271,124,967954,Welsbie; Derek,9999,0,9999,0
1748421270392,BGGN 271,125,967956,Wildonger; Jill Cathleen,9999,0,9999,0
1748421270392,BGGN 271,126,967957,Yelon; Deborah,9999,0,9999,0
1748421270392,BGGN 271,127,967958,Yeo; Eugene Wei-Ming,9998,0,9999,1
1748421270392,BGGN 271,128,967959,Ying; Wei,9998,0,9999,1
1748421270392,BGGN 271,129,967960,Young; Jared W.,9999,0,9999,0
1748421270392,BGGN 271,130,967961,Zage; Peter,9999,0,9999,0
1748421270392,BGGN 271,131,967962,Zengler; Karsten B,9999,0,9999,0
1748421270392,BGGN 271,132,967963,Zhang; Jin,9999,0,9999,0
1748421270392,BGGN 271,133,967964,Zhao; Yunde,9999,0,9999,0
1748421270392,BGGN 271,134,967965,Zheng; Ye,9998,0,9999,1
1748421270392,BGGN 271,135,967966,Zhou; Huilin,9998,0,9999,1
1748421270392,BGGN 271,136,967970,Zou; Yimin,9998,0,9999,1
1748421271420,BGGN 272,A00,943373,Lo; Stanley M.,14,0,15,1
1748421272448,BGGN 275,A00,943374,Pogliano; Joseph,0,0,0,0
1748421273481,BGGN 276,A00,943378,Pogliano; Joseph,0,0,0,0
1748421274513,BGJC 204,A00,943407,Lu; Li-Fan & Chang; John Tzu-yu,9998,0,9999,1
1748421275545,BGJC 215,A00,943417,Tour; Ella,9,0,10,1
1748421276657,BGRD 200,001,965406,Akbari; Omar Sultan,9999,0,9999,0
1748421276657,BGRD 200,002,965407,Allen; Eric,9999,0,9999,0
1748421276657,BGRD 200,003,965408,Allen; Nicola J,9998,0,9999,1
1748421276657,BGRD 200,004,965427,Alperin; Mariann,9999,0,9999,0
1748421276657,BGRD 200,005,965428,Amaro; Rommie E,9998,0,9999,1
1748421276657,BGRD 200,006,965429,Antal; Corina Elena,9998,0,9999,1
1748421276657,BGRD 200,007,965731,Asahina; Kenta,9999,0,9999,0
1748421276657,BGRD 200,008,965732,Augustine; Vineet,9999,0,9999,0
1748421276657,BGRD 200,009,965733,Ayres; Janelle Samantha,9998,0,9999,1
1748421276657,BGRD 200,010,965734,Banghart; Matthew Ryan,9999,0,9999,0
1748421276657,BGRD 200,011,965735,Barton; Andrew David,9999,0,9999,0
1748421276657,BGRD 200,012,965736,Bayless; Daniel Wilson,9999,0,9999,0
1748421276657,BGRD 200,013,965737,Benna; Marcus K,9999,0,9999,0
1748421276657,BGRD 200,014,965738,Bennett; Eric J,9999,0,9999,0
1748421276657,BGRD 200,015,965739,Bier; Ethan,9999,0,9999,0
1748421276657,BGRD 200,016,965740,Bloodgood; Brenda Laurie,9999,0,9999,0
1748421276657,BGRD 200,017,965741,Boss; Gerard R.,9999,0,9999,0
1748421276657,BGRD 200,018,966029,Bouvet; Michael,9999,0,9999,0
1748421276657,BGRD 200,019,966054,Breen; Ellen C.,9999,0,9999,0
1748421276657,BGRD 200,020,966072,Bui; Jack D,9999,0,9999,0
1748421276657,BGRD 200,021,966073,Burnett; Lindsey,9998,0,9999,1
1748421276657,BGRD 200,022,966080,Caffrey; Conor,9999,0,9999,0
1748421276657,BGRD 200,023,966082,Callaway; Edward M,9999,0,9999,0
1748421276657,BGRD 200,024,966087,Castle; Michael James,9999,0,9999,0
1748421276657,BGRD 200,025,966089,Chaim; Isaac,9999,0,9999,0
1748421276657,BGRD 200,026,966092,Chang; John Tzu-yu,9999,0,9999,0
1748421276657,BGRD 200,027,966094,Chen; Xu,9999,0,9999,0
1748421276657,BGRD 200,028,966095,Cheng; Christine Shiang-Ling,9999,0,9999,0
1748421276657,BGRD 200,029,966099,Cheresh; David A.,9999,0,9999,0
1748421276657,BGRD 200,030,966103,Cherqui; Stephanie,9999,0,9999,0
1748421276657,BGRD 200,031,966104,Chu; Hiutung,9999,0,9999,0
1748421276657,BGRD 200,032,966107,Church; Kellie Breen,9999,0,9999,0
1748421276657,BGRD 200,033,966108,Cleland; Elsa Eleanor,9997,0,9999,2
1748421276657,BGRD 200,034,966111,Cohen; Shiran,9999,0,9999,0
1748421276657,BGRD 200,035,966112,Cooper; Kimberly Lynn,9999,0,9999,0
1748421276657,BGRD 200,036,966114,Coufal; Nicole Gabriele,9999,0,9999,0
1748421276657,BGRD 200,037,966115,Croker; Ben Adam,9999,0,9999,0
1748421276657,BGRD 200,038,966116,Crotty Alexander; Laura E,9999,0,9999,0
1748421276657,BGRD 200,039,966117,Daugherty; Matthew Dorton,9997,0,9999,2
1748421276657,BGRD 200,040,966118,De Silva; Shermin,9998,0,9999,1
1748421276657,BGRD 200,041,966119,Desai; Arshad,9999,0,9999,0
1748421276657,BGRD 200,042,966120,Dhar; Debanjan,9999,0,9999,0
1748421276657,BGRD 200,043,966121,Dickinson; Alexandra Jazz,9999,0,9999,0
1748421276657,BGRD 200,044,966123,Dixon; Jesse,9999,0,9999,0
1748421276657,BGRD 200,045,966125,Doherty; Taylor Alan,9998,0,9999,1
1748421276657,BGRD 200,046,966128,Dore; Kim Bohemie,9999,0,9999,0
1748421276657,BGRD 200,047,966129,Dorrestein; Pieter,9999,0,9999,0
1748421276657,BGRD 200,048,966130,Dulawa; Stephanie Carole,9999,0,9999,0
1748421276657,BGRD 200,049,966131,Ecker; Joseph R,9999,0,9999,0
1748421276657,BGRD 200,050,966174,Engle; Dannielle D,9998,0,9999,1
1748421276657,BGRD 200,051,966179,Ernst; Andreas,9999,0,9999,0
1748421276657,BGRD 200,052,966182,Esko; Jeffrey D.,9999,0,9999,0
1748421276657,BGRD 200,053,966183,Fang; Xi,9999,0,9999,0
1748421276657,BGRD 200,054,966184,Farley; Emma Kristen,9998,0,9999,1
1748421276657,BGRD 200,055,966187,Ferguson; Cole John,9999,0,9999,0
1748421276657,BGRD 200,056,966190,Fisch; Kathleen Marie,9999,0,9999,0
1748421276657,BGRD 200,057,966193,Gage; Fred H,9999,0,9999,0
1748421276657,BGRD 200,058,966194,George; Monique Leana,9998,0,9999,1
1748421276657,BGRD 200,059,966196,George; Olivier,9999,0,9999,0
1748421276657,BGRD 200,060,966202,Ghosh; Pradipta,9998,0,9999,1
1748421276657,BGRD 200,061,966203,Glasgow; Stacey Marie,9999,0,9999,0
1748421276657,BGRD 200,062,966204,Glass; Christopher,9999,0,9999,0
1748421276657,BGRD 200,063,966226,Golden; James W,9999,0,9999,0
1748421276657,BGRD 200,064,966231,Goldrath; Ananda,9999,0,9999,0
1748421276657,BGRD 200,065,966232,Gonzalez Gamboa; Ivonne,9999,0,9999,0
1748421276657,BGRD 200,066,966233,Goren; Alon M,9999,0,9999,0
1748421276657,BGRD 200,067,966245,Guatelli; John C,9999,0,9999,0
1748421276657,BGRD 200,068,966247,Guma; Monica,9998,0,9999,1
1748421276657,BGRD 200,069,966253,Gustafsson; Asa Birgitta,9999,0,9999,0
1748421276657,BGRD 200,070,966255,Gutkind; Jorge Silvio,9998,0,9999,1
1748421276657,BGRD 200,071,966260,Hamdoun; Amr,9999,0,9999,0
1748421276657,BGRD 200,072,966262,Hampton; Randolph Y.,9998,0,9999,1
1748421276657,BGRD 200,073,966263,Hao; Nan,9999,0,9999,0
1748421276657,BGRD 200,074,966265,Hargreaves; Diana Clare,9997,0,9999,2
1748421276657,BGRD 200,075,966268,Hasty; Jeff M,9999,0,9999,0
1748421276657,BGRD 200,076,966270,Hollern; Daniel Patrick,9999,0,9999,0
1748421276657,BGRD 200,077,966271,Holway; David A.,9998,0,9999,1
1748421276657,BGRD 200,078,966272,Huffaker; Alisa,9999,0,9999,0
1748421276657,BGRD 200,079,966273,Hui; Enfu,9999,0,9999,0
1748421276657,BGRD 200,080,966275,Hwa; Terence T.,9999,0,9999,0
1748421276657,BGRD 200,081,966276,Jackrel; Sara,9998,0,9999,1
1748421276657,BGRD 200,082,966277,Jiang; Qingfei,9998,0,9999,1
1748421276657,BGRD 200,083,966281,Jin; Chunyu,9999,0,9999,0
1748421276657,BGRD 200,084,966283,Jin; Yishi,9999,0,9999,0
1748421276657,BGRD 200,085,966287,Joshi; Shweta,9999,0,9999,0
1748421276657,BGRD 200,086,966290,Ju; Won-Kyu,9998,0,9999,1
1748421276657,BGRD 200,087,966291,Jun; Suckjoon,9999,0,9999,0
1748421276657,BGRD 200,088,966292,Kadonaga; James T,9999,0,9999,0
1748421276657,BGRD 200,089,966293,Kaech; Susan Michelle,9999,0,9999,0
1748421276657,BGRD 200,090,966295,Kauffman; Alexander,9998,0,9999,1
1748421276657,BGRD 200,091,966301,Kendrick; Agnieszka Anasta,9999,0,9999,0
1748421276657,BGRD 200,092,966302,Kiger; Amy,9999,0,9999,0
1748421276657,BGRD 200,093,966314,Knight; Robin,9999,0,9999,0
1748421276657,BGRD 200,094,966315,Koloski; Miranda Jane,9998,0,9999,1
1748421276657,BGRD 200,095,966339,Komiyama; Takaki,9998,0,9999,1
1748421276657,BGRD 200,096,966351,Kosuri; Pallav,9999,0,9999,0
1748421276657,BGRD 200,097,966361,Kronenberg; Mitchell E.,9999,0,9999,0
1748421276657,BGRD 200,098,966374,Kryazhimskiy; Sergey A,9999,0,9999,0
1748421276657,BGRD 200,099,966377,Kufareva; Irina,9999,0,9999,0
1748421276657,BGRD 200,100,966380,Lee; Christopher Tingkuang,9999,0,9999,0
1748421276657,BGRD 200,101,966383,Lee; Kuo Fen,9999,0,9999,0
1748421276657,BGRD 200,102,966387,Lee; Yun Sok,9999,0,9999,0
1748421276657,BGRD 200,103,966397,Leutgeb; Jill K.,9999,0,9999,0
1748421276657,BGRD 200,104,966446,Leutgeb; Stefan,9998,0,9999,1
1748421276657,BGRD 200,105,966478,Lewis; Warren G.,9999,0,9999,0
1748421276657,BGRD 200,106,966490,Li; Willis Xiaowei,9998,0,9999,1
1748421276657,BGRD 200,107,966491,Lim; Byungkook,9998,0,9999,1
1748421276657,BGRD 200,108,966494,Lo; Stanley M.,9998,0,9999,1
1748421276657,BGRD 200,109,966499,Looger; Loren Lee,9998,0,9999,1
1748421276657,BGRD 200,110,966500,Lopez Ramirez; Miguel Alej,9999,0,9999,0
1748421276657,BGRD 200,111,966510,Lovett-Barron; Matthew Rod,9998,0,9999,1
1748421276657,BGRD 200,112,966513,Lu; Li-Fan,9998,0,9999,1
1748421276657,BGRD 200,113,966515,Lu; Pengzhe,9999,0,9999,0
1748421276657,BGRD 200,114,966522,Lykke-Andersen; Jens,9999,0,9999,0
1748421276657,BGRD 200,115,966526,Lyons; Deirdre Colleen,9999,0,9999,0
1748421276657,BGRD 200,116,966528,Lyumkis; Dmitry Evgenievich,9999,0,9999,0
1748421276657,BGRD 200,117,966531,Mandyam; Chitra,9999,0,9999,0
1748421276657,BGRD 200,118,966537,Manor; Uri,9999,0,9999,0
1748421276657,BGRD 200,119,966538,Mayfield; Stephen P.,9998,0,9999,1
1748421276657,BGRD 200,120,966539,McConville; Patrick James,9999,0,9999,0
1748421276657,BGRD 200,121,966546,Mertens; Jerome Stefan,9999,0,9999,0
1748421276657,BGRD 200,122,966586,Meyer; Justin Raymond,9999,0,9999,0
1748421276657,BGRD 200,123,966587,Morris; Gerald P,9999,0,9999,0
1748421276657,BGRD 200,124,966588,Mueller; Lena,9998,0,9999,1
1748421276657,BGRD 200,125,966590,Muroyama; Andrew David,9999,0,9999,0
1748421276657,BGRD 200,126,966591,Murre; Cornelis,9999,0,9999,0
1748421276657,BGRD 200,127,966593,Neal; Sonya E,9998,0,9999,1
1748421276657,BGRD 200,128,966594,Newton; Alexandra C.,9999,0,9999,0
1748421276657,BGRD 200,129,966596,Nieh; James Charles,9999,0,9999,0
1748421276657,BGRD 200,130,966597,Niwa; Maho,9999,0,9999,0
1748421276657,BGRD 200,131,966605,Nizet; Victor F.,9999,0,9999,0
1748421276657,BGRD 200,132,966606,Oegema; Karen,9999,0,9999,0
1748421276657,BGRD 200,133,966608,Panda; Satchidananda,9998,0,9999,1
1748421276657,BGRD 200,134,966610,Pantham; Priyadarshini,9999,0,9999,0
1748421276657,BGRD 200,135,966612,Parast; Mana,9999,0,9999,0
1748421276657,BGRD 200,136,966613,Pasquinelli; Amy,9999,0,9999,0
1748421276657,BGRD 200,137,966615,Pekkurnaz Banghart; Gulcin,9999,0,9999,0
1748421276657,BGRD 200,138,966639,Perry; Michael William,9998,0,9999,1
1748421276657,BGRD 200,139,966640,Pillus; Lorraine,9998,0,9999,1
1748421276657,BGRD 200,140,966654,Pogliano; Joseph,9999,0,9999,0
1748421276657,BGRD 200,141,966700,Pogliano; Kit J.,9999,0,9999,0
1748421276657,BGRD 200,142,966701,Pruneda-Paz; Jose L.,9999,0,9999,0
1748421276657,BGRD 200,143,966744,Raffatellu; Manuela,9999,0,9999,0
1748421276657,BGRD 200,144,966745,Ramanan; Deepshika,9998,0,9999,1
1748421276657,BGRD 200,145,966746,Rana; Tariq,9999,0,9999,0
1748421276657,BGRD 200,146,966747,Rao; Anjana,9999,0,9999,0
1748421276657,BGRD 200,147,966811,Raz; Eyal,9998,0,9999,1
1748421276657,BGRD 200,149,966817,Gaulton; Kyle J,9999,0,9999,0
1748421276657,BGRD 200,150,966824,Rennison; Diana,9999,0,9999,0
1748421276657,BGRD 200,151,966828,Reyes De Barboza; Nabora S,9999,0,9999,0
1748421276657,BGRD 200,152,966837,Rifkin; Scott,9998,0,9999,1
1748421276657,BGRD 200,153,966839,Risbrough; Victoria Blythe,9999,0,9999,0
1748421276657,BGRD 200,154,966846,Rivera; Fabian Chavez,9999,0,9999,0
1748421276657,BGRD 200,155,966851,Rohner; Patrick Thomas,9999,0,9999,0
1748421276657,BGRD 200,156,966859,Rose; Noah Hartmann,9999,0,9999,0
1748421276657,BGRD 200,157,966874,Rosenfeld; Michael G,9999,0,9999,0
1748421276657,BGRD 200,158,966882,Rouse; Gregory W.,9999,0,9999,0
1748421276657,BGRD 200,159,966885,Saier; Milton H.,9999,0,9999,0
1748421276657,BGRD 200,160,966923,Saltiel; Alan,9998,0,9999,1
1748421276657,BGRD 200,161,966926,Sanchez-Lopez; Elsa,9999,0,9999,0
1748421276657,BGRD 200,162,966927,Saphire; Erica Ollmann,9999,0,9999,0
1748421276657,BGRD 200,163,966931,Schenk; Simon,9999,0,9999,0
1748421276657,BGRD 200,164,966938,Schroeder; Julian I,9999,0,9999,0
1748421276657,BGRD 200,165,966966,Sebat; Lilia Mikhailovna,9999,0,9999,0
1748421276657,BGRD 200,166,966978,Sen; George L,9999,0,9999,0
1748421276657,BGRD 200,167,966981,Shah; Sameer B,9999,0,9999,0
1748421276657,BGRD 200,168,966982,Shaner; Nathan C.,9999,0,9999,0
1748421276657,BGRD 200,169,966983,Shao; Jianhua,9999,0,9999,0
1748421276657,BGRD 200,170,966984,Sharpee; Tatyana,9999,0,9999,0
1748421276657,BGRD 200,171,966985,Shaw; Reuben,9999,0,9999,0
1748421276657,BGRD 200,172,966986,Shurin; Jonathan,9997,0,9999,2
1748421276657,BGRD 200,173,966987,Sicklick; Jason Keith,9999,0,9999,0
1748421276657,BGRD 200,174,966988,Signer; Robert,9999,0,9999,0
1748421276657,BGRD 200,175,966989,Sigurdson; Christina,9999,0,9999,0
1748421276657,BGRD 200,176,966991,Simonson; Tatum Sasha Summ,9999,0,9999,0
1748421276657,BGRD 200,177,966992,Soncin; Francesca,9999,0,9999,0
1748421276657,BGRD 200,178,966993,Spitzer; Nicholas,9999,0,9999,0
1748421276657,BGRD 200,179,966994,Steinmetz; Nicole F,9999,0,9999,0
1748421276657,BGRD 200,180,966995,Su; Chih-Ying,9999,0,9999,0
1748421276657,BGRD 200,181,966996,Suel; Gurol Mehmet,9998,0,9999,1
1748421276657,BGRD 200,182,966997,Sun; Xin,9998,0,9999,1
1748421276657,BGRD 200,183,966998,Telese; Francesca,9998,0,9999,1
1748421276657,BGRD 200,184,966999,Towers; Christina Garlingt,9999,0,9999,0
1748421276657,BGRD 200,185,967000,Traver; David,9999,0,9999,0
1748421276657,BGRD 200,186,967001,Troemel; Emily Ruth,9998,0,9999,1
1748421276657,BGRD 200,187,967002,Tye; Kay M,9999,0,9999,0
1748421276657,BGRD 200,188,967003,Vijayanand; Pandurangan,9999,0,9999,0
1748421276657,BGRD 200,189,967004,Villa Rodriguez; Elizabeth,9999,0,9999,0
1748421276657,BGRD 200,190,967005,Wahlin; Karl Jonas,9997,0,9999,2
1748421276657,BGRD 200,191,967009,Wang; Shizhen,9999,0,9999,0
1748421276657,BGRD 200,192,967010,Wang; Jean Yin Jen,9999,0,9999,0
1748421276657,BGRD 200,193,967011,Webster; Nicholas J G,9999,0,9999,0
1748421276657,BGRD 200,194,967016,Weiskopf; Daniela,9998,0,9999,1
1748421276657,BGRD 200,195,967020,Welsbie; Derek,9999,0,9999,0
1748421276657,BGRD 200,196,967022,Wildonger; Jill Cathleen,9998,0,9999,1
1748421276657,BGRD 200,197,967027,Winzeler; Elizabeth A,9998,0,9999,1
1748421276657,BGRD 200,198,967029,Wodarz; Dominik Franz Xave,9999,0,9999,0
1748421276657,BGRD 200,199,967033,Yelon; Deborah,9998,0,9999,1
1748421276657,BGRD 200,200,967034,Yeo; Eugene Wei-Ming,9998,0,9999,1
1748421276657,BGRD 200,201,967040,Ying; Wei,9998,0,9999,1
1748421276657,BGRD 200,202,967052,Young; Jared W.,9999,0,9999,0
1748421276657,BGRD 200,203,967057,Zage; Peter,9999,0,9999,0
1748421276657,BGRD 200,204,967070,Zengler; Karsten B,9998,0,9999,1
1748421276657,BGRD 200,206,967081,Zhang; Jin,9999,0,9999,0
1748421276657,BGRD 200,207,967083,Zhao; Yunde,9999,0,9999,0
1748421276657,BGRD 200,208,967086,Zheng; Binhai,9999,0,9999,0
1748421276657,BGRD 200,209,967091,Zheng; Ye,9999,0,9999,0
1748421276657,BGRD 200,210,967093,Zhou; Huilin,9999,0,9999,0
1748421276657,BGRD 200,211,967095,Zou; Yimin,9998,0,9999,1
1748421276657,BGRD 200,212,967096,Zuniga; Elina I,9999,0,9999,0
1748421276657,BGRD 200,213,967978,Biering; Scott,9999,0,9999,0
1748421277685,BGSE 200,A00,943418,Tour; Ella & Petrie; Katherine Lynn,9999,0,9999,0
1748421278718,BGSE 205,A00,943419,Muroyama; Andrew David,46,0,50,4
1748421278718,BGSE 205,C00,943420,Russell; Alistair B,44,0,50,6
1748421278718,BGSE 205,D00,943421,Villa Rodriguez; Elizabeth,41,0,50,9
1748421278718,BGSE 205,E00,960271,Lim; Byungkook,45,0,50,5
1748421279759,BIBC 100,A01,959758,Flagg; Matthew Paul,0,0,38,38
1748421279759,BIBC 100,A02,959759,Flagg; Matthew Paul,0,0,38,38
1748421279759,BIBC 100,A03,959760,Flagg; Matthew Paul,0,0,38,38
1748421279759,BIBC 100,A04,959761,Flagg; Matthew Paul,0,0,36,36
1748421280803,BIBC 102,A01,959209,Pekkurnaz Banghart; Gulcin,0,0,34,34
1748421280803,BIBC 102,A02,959258,Pekkurnaz Banghart; Gulcin,0,0,34,34
1748421280803,BIBC 102,A03,959300,Pekkurnaz Banghart; Gulcin,0,0,35,35
1748421280803,BIBC 102,A04,959302,Pekkurnaz Banghart; Gulcin,0,0,34,34
1748421280803,BIBC 102,B01,959307,Pekkurnaz Banghart; Gulcin,0,0,34,34
1748421280803,BIBC 102,B02,959309,Pekkurnaz Banghart; Gulcin,0,0,34,34
1748421280803,BIBC 102,B03,959310,Pekkurnaz Banghart; Gulcin,0,0,33,33
1748421280803,BIBC 102,B04,959311,Pekkurnaz Banghart; Gulcin,0,0,34,34
1748421281851,BIBC 103,A01,942080,Grossman; Emily N,0,0,24,24
1748421281851,BIBC 103,A02,942081,Grossman; Emily N,0,0,24,24
1748421281851,BIBC 103,B01,942083,Grossman; Emily N,0,0,24,24
1748421281851,BIBC 103,B02,942129,Grossman; Emily N,0,0,24,24
1748421281851,BIBC 103,C01,942131,Burg; Michael,0,0,24,24
1748421281851,BIBC 103,C02,942152,Burg; Michael,0,0,24,24
1748421281851,BIBC 103,D01,942169,Burg; Michael,0,0,24,24
1748421281851,BIBC 103,D02,942170,Burg; Michael,0,0,24,24
1748421282886,BICD 100,A01,959831,Day; Christopher D,53,0,61,8
1748421282886,BICD 100,A02,959832,Day; Christopher D,48,0,61,13
1748421282886,BICD 100,A03,959833,Day; Christopher D,43,0,61,18
1748421282886,BICD 100,A04,959834,Day; Christopher D,58,0,61,3
1748421282886,BICD 100,B01,959749,McDonnell; Lisa Marie,0,0,61,61
1748421282886,BICD 100,B02,959750,McDonnell; Lisa Marie,0,0,61,61
1748421282886,BICD 100,B03,959751,McDonnell; Lisa Marie,0,0,61,61
1748421282886,BICD 100,B04,959752,McDonnell; Lisa Marie,37,0,61,24
1748421282886,BICD 100,C01,959835,Yelon; Deborah,0,0,61,61
1748421282886,BICD 100,C02,959836,Yelon; Deborah,54,0,61,7
1748421282886,BICD 100,C03,959837,Yelon; Deborah,61,0,61,0
1748421282886,BICD 100,C04,959838,Yelon; Deborah,57,0,61,4
1748421283914,BICD 110,A01,959312,Kiger; Amy,59,0,123,64
1748421283914,BICD 110,A02,959315,Kiger; Amy,94,0,122,28
1748421284942,BICD 130,A01,942207,Perry; Michael William,0,0,48,48
1748421284942,BICD 130,A02,942208,Perry; Michael William,37,0,48,11
1748421284942,BICD 130,A03,942209,Perry; Michael William,29,0,48,19
1748421284942,BICD 130,A04,942236,Perry; Michael William,19,0,48,29
1748421286011,BICD 140,A01,942372,Zuniga; Elina I,42,0,49,7
1748421286011,BICD 140,A02,942492,Zuniga; Elina I,45,0,49,4
1748421286011,BICD 140,A03,942493,Zuniga; Elina I,48,0,49,1
1748421286011,BICD 140,A04,942494,Zuniga; Elina I,46,0,49,3
1748421287039,BIEB 102,A01,942496,Butler; Shannon Rhey,182,0,248,66
1748421288069,BIEB 121,A00,942497,Holway; David A.,0,0,32,32
1748421288069,BIEB 121,B00,942498,Butler; Shannon Rhey,0,0,32,32
1748421289099,BIEB 141,A01,942500,Kryazhimskiy; Sergey A,23,0,40,17
1748421290130,BIEB 146,A01,942502,Petrie; Katherine Lynn,41,0,89,48
1748421290130,BIEB 146,A02,942503,Petrie; Katherine Lynn,0,0,88,88
1748421290130,BIEB 146,A03,942504,Petrie; Katherine Lynn,2,0,88,86
1748421290130,BIEB 146,A04,942505,Petrie; Katherine Lynn,21,0,89,68
1748421291162,BIEB 150,A01,942507,Rennison; Diana,28,0,41,13
1748421291162,BIEB 150,A02,942508,Rennison; Diana,32,0,41,9
1748421291162,BIEB 150,A03,942509,Rennison; Diana,36,0,41,5
1748421291162,BIEB 150,A04,942510,Rennison; Diana,6,0,40,34
1748421292193,BIEB 174,A01,942512,Cleland; Elsa Eleanor & Barton; Andrew David,9,0,41,32
1748421292193,BIEB 174,A02,942513,Cleland; Elsa Eleanor & Barton; Andrew David,37,0,41,4
1748421292193,BIEB 174,A03,942514,Cleland; Elsa Eleanor & Barton; Andrew David,35,0,41,6
1748421292193,BIEB 174,A04,942515,Cleland; Elsa Eleanor & Barton; Andrew David,30,0,40,10
1748421293226,BILD 1,A01,959729,Ochoa Mikrut; Stacy Daniel,50,0,60,10
1748421293226,BILD 1,A02,959730,Ochoa Mikrut; Stacy Daniel,47,0,59,12
1748421293226,BILD 1,A03,959731,Ochoa Mikrut; Stacy Daniel,48,0,59,11
1748421293226,BILD 1,A04,959732,Ochoa Mikrut; Stacy Daniel,50,0,59,9
1748421293226,BILD 1,B01,959733,Cooper; Andrew Michael,46,0,60,14
1748421293226,BILD 1,B02,959734,Cooper; Andrew Michael,58,0,59,1
1748421293226,BILD 1,B03,959735,Cooper; Andrew Michael,54,0,59,5
1748421293226,BILD 1,B04,959736,Cooper; Andrew Michael,50,0,59,9
1748421293226,BILD 1,C01,959737,Rusert; Jessica Marie,58,0,60,2
1748421293226,BILD 1,C02,959738,Rusert; Jessica Marie,59,0,59,0
1748421293226,BILD 1,C03,959739,Rusert; Jessica Marie,49,0,59,10
1748421293226,BILD 1,C04,959740,Rusert; Jessica Marie,55,0,59,4
1748421294259,BILD 2,A01,959013,Reyes Gonzalez; Catalina,28,0,57,29
1748421294259,BILD 2,A02,959016,Reyes Gonzalez; Catalina,51,0,57,6
1748421294259,BILD 2,A03,959017,Reyes Gonzalez; Catalina,46,0,56,10
1748421294259,BILD 2,A04,959018,Reyes Gonzalez; Catalina,51,0,55,4
1748421294259,BILD 2,B01,959078,Reyes Gonzalez; Catalina,42,0,57,15
1748421294259,BILD 2,B02,959095,Reyes Gonzalez; Catalina,50,0,57,7
1748421294259,BILD 2,B03,959165,Reyes Gonzalez; Catalina,55,0,56,1
1748421294259,BILD 2,B04,959169,Reyes Gonzalez; Catalina,54,0,55,1
1748421295289,BILD 3,A01,959741,Stockwell; Sarah R,56,0,60,4
1748421295289,BILD 3,A02,959742,Stockwell; Sarah R,57,0,59,2
1748421295289,BILD 3,A03,959743,Stockwell; Sarah R,59,0,59,0
1748421295289,BILD 3,A04,959744,Stockwell; Sarah R,55,0,59,4
1748421295289,BILD 3,B01,959745,Stockwell; Sarah R,55,0,60,5
1748421295289,BILD 3,B02,959746,Stockwell; Sarah R,59,0,59,0
1748421295289,BILD 3,B03,959747,Stockwell; Sarah R,56,0,59,3
1748421295289,BILD 3,B04,959748,Stockwell; Sarah R,58,0,59,1
1748421295289,BILD 3,C01,959823,Hammond; LaTisha Marie,47,0,60,13
1748421295289,BILD 3,C02,959824,Hammond; LaTisha Marie,48,0,59,11
1748421295289,BILD 3,C03,959825,Hammond; LaTisha Marie,56,0,59,3
1748421295289,BILD 3,C04,959826,Hammond; LaTisha Marie,58,0,59,1
1748421295289,BILD 3,D01,959827,Hammond; LaTisha Marie,43,0,60,17
1748421295289,BILD 3,D02,959828,Hammond; LaTisha Marie,49,0,59,10
1748421295289,BILD 3,D03,959829,Hammond; LaTisha Marie,52,0,59,7
1748421295289,BILD 3,D04,959830,Hammond; LaTisha Marie,56,0,59,3
1748421296329,BILD 4,A01,940749,Gonzalez Gamboa; Ivonne,0,0,0,0
1748421296329,BILD 4,A02,940750,Gonzalez Gamboa; Ivonne,0,0,0,0
1748421296329,BILD 4,A03,940909,Gonzalez Gamboa; Ivonne,0,0,0,0
1748421296329,BILD 4,A04,940922,Gonzalez Gamboa; Ivonne,0,0,0,0
1748421296329,BILD 4,A05,940925,Gonzalez Gamboa; Ivonne,0,0,0,0
1748421296329,BILD 4,A06,941008,Gonzalez Gamboa; Ivonne,0,0,0,0
1748421296329,BILD 4,A07,941009,Gonzalez Gamboa; Ivonne,0,0,0,0
1748421296329,BILD 4,A08,941114,Gonzalez Gamboa; Ivonne,0,0,0,0
1748421296329,BILD 4,B01,941116,Reuther; Keefe,0,0,0,0
1748421296329,BILD 4,B02,941119,Reuther; Keefe,0,0,0,0
1748421296329,BILD 4,B03,941120,Reuther; Keefe,0,0,0,0
1748421296329,BILD 4,B04,941143,Reuther; Keefe,0,0,0,0
1748421296329,BILD 4,B05,941182,Reuther; Keefe,0,0,0,0
1748421296329,BILD 4,B06,941183,Reuther; Keefe,0,0,0,0
1748421296329,BILD 4,B07,941184,Reuther; Keefe,0,0,0,0
1748421296329,BILD 4,B08,941202,Reuther; Keefe,0,0,0,0
1748421296329,BILD 4,C01,941209,Lo; Stanley M.,0,0,0,0
1748421296329,BILD 4,C02,941226,Lo; Stanley M.,0,0,0,0
1748421296329,BILD 4,C03,941228,Lo; Stanley M.,0,0,0,0
1748421296329,BILD 4,C04,941284,Lo; Stanley M.,0,0,0,0
1748421296329,BILD 4,C05,941394,Lo; Stanley M.,0,0,0,0
1748421296329,BILD 4,C06,941473,Lo; Stanley M.,0,0,0,0
1748421296329,BILD 4,C07,941905,Lo; Stanley M.,0,0,0,0
1748421296329,BILD 4,C08,941906,Lo; Stanley M.,0,0,0,0
1748421296329,BILD 4,D01,941908,Lo; Stanley M.,0,0,0,0
1748421296329,BILD 4,D02,941925,Lo; Stanley M.,0,0,0,0
1748421296329,BILD 4,D03,941926,Lo; Stanley M.,0,0,0,0
1748421296329,BILD 4,D04,941927,Lo; Stanley M.,0,0,0,0
1748421296329,BILD 4,D05,941928,Lo; Stanley M.,0,0,0,0
1748421296329,BILD 4,D06,941943,Lo; Stanley M.,0,0,0,0
1748421296329,BILD 4,D07,941944,Lo; Stanley M.,0,0,0,0
1748421296329,BILD 4,D08,941973,Lo; Stanley M.,0,0,0,0
1748421297364,BILD 5,A01,959177,Mueller; Liam O'Connor,0,0,0,0
1748421297364,BILD 5,A02,959178,Mueller; Liam O'Connor,0,0,0,0
1748421297364,BILD 5,A03,959179,Mueller; Liam O'Connor,0,0,0,0
1748421297364,BILD 5,A04,959181,Mueller; Liam O'Connor,0,0,0,0
1748421297364,BILD 5,B01,959183,Mueller; Liam O'Connor,0,0,0,0
1748421297364,BILD 5,B02,959184,Mueller; Liam O'Connor,0,0,0,0
1748421297364,BILD 5,B03,959188,Mueller; Liam O'Connor,0,0,0,0
1748421297364,BILD 5,B04,959189,Mueller; Liam O'Connor,0,0,0,0
1748421297364,BILD 5,C01,959190,Reuther; Keefe,0,0,0,0
1748421297364,BILD 5,C02,959191,Reuther; Keefe,0,0,0,0
1748421297364,BILD 5,C03,959196,Reuther; Keefe,0,0,0,0
1748421297364,BILD 5,C04,959199,Reuther; Keefe,0,0,0,0
1748421298394,BILD 10,A01,942020,Ochoa Mikrut; Stacy Daniel,40,0,40,0
1748421298394,BILD 10,A02,942033,Ochoa Mikrut; Stacy Daniel,35,0,39,4
1748421298394,BILD 10,A03,942045,Ochoa Mikrut; Stacy Daniel,32,0,39,7
1748421298394,BILD 10,A04,942046,Ochoa Mikrut; Stacy Daniel,30,0,39,9
1748421299427,BILD 87,A00,942047,Saier; Milton H.,20,0,20,0
1748421299427,BILD 87,B00,942060,Saier; Milton H.,20,0,20,0
1748421300460,BIMM 100,A01,959797,Lykke-Andersen; Jens,37,0,50,13
1748421300460,BIMM 100,A02,959798,Lykke-Andersen; Jens,5,0,50,45
1748421300460,BIMM 100,A03,959799,Lykke-Andersen; Jens,0,0,50,50
1748421300460,BIMM 100,A04,959800,Lykke-Andersen; Jens,3,0,50,47
1748421300460,BIMM 100,B01,959807,Pruneda-Paz; Jose L.,1,0,50,49
1748421300460,BIMM 100,B02,959808,Pruneda-Paz; Jose L.,0,0,50,50
1748421300460,BIMM 100,B03,959809,Pruneda-Paz; Jose L.,7,0,50,43
1748421300460,BIMM 100,B04,959810,Pruneda-Paz; Jose L.,37,0,50,13
1748421300460,BIMM 100,C01,959762,Pasquinelli; Amy,0,0,54,54
1748421300460,BIMM 100,C02,959763,Pasquinelli; Amy,20,0,54,34
1748421300460,BIMM 100,C03,959764,Pasquinelli; Amy,32,0,54,22
1748421300460,BIMM 100,C04,959765,Pasquinelli; Amy,47,0,54,7
1748421301505,BIMM 101,A01,942520,Meaders; Clara Leigh,0,0,24,24
1748421301505,BIMM 101,A02,942521,Meaders; Clara Leigh,0,0,24,24
1748421301505,BIMM 101,B01,942523,Meaders; Clara Leigh,0,0,24,24
1748421301505,BIMM 101,B02,942524,Meaders; Clara Leigh,0,0,24,24
1748421301505,BIMM 101,C01,942690,McDonnell; Lisa Marie,0,0,24,24
1748421301505,BIMM 101,C02,942755,McDonnell; Lisa Marie,0,0,24,24
1748421301505,BIMM 101,D01,942757,Day; Christopher D,0,0,24,24
1748421301505,BIMM 101,D02,942758,Day; Christopher D,12,0,24,12
1748421301505,BIMM 101,E01,942760,Cooper; Andrew Michael,0,0,24,24
1748421301505,BIMM 101,E02,942761,Cooper; Andrew Michael,0,0,24,24
1748421301505,BIMM 101,F01,942763,Rusert; Jessica Marie,14,0,24,10
1748421301505,BIMM 101,F02,942764,Rusert; Jessica Marie,19,0,24,5
1748421302543,BIMM 120,A01,942766,Saier; Milton H.,40,0,48,8
1748421302543,BIMM 120,A02,942767,Saier; Milton H.,40,0,48,8
1748421302543,BIMM 120,A03,942768,Saier; Milton H.,15,0,48,33
1748421302543,BIMM 120,A04,942769,Saier; Milton H.,0,0,48,48
1748421303586,BIMM 121,A01,942771,Gustafson-Brown; Cindy,0,0,24,24
1748421303586,BIMM 121,A02,942772,Gustafson-Brown; Cindy,0,0,24,24
1748421303586,BIMM 121,B01,942774,Gustafson-Brown; Cindy,0,0,24,24
1748421303586,BIMM 121,B02,942775,Gustafson-Brown; Cindy,5,0,24,19
1748421303586,BIMM 121,C01,942777,Pirino; Giorgia,0,0,24,24
1748421303586,BIMM 121,C02,942778,Pirino; Giorgia,0,0,24,24
1748421303586,BIMM 121,D01,942780,Pirino; Giorgia,0,0,24,24
1748421303586,BIMM 121,D02,942781,Pirino; Giorgia,0,0,24,24
1748421304620,BIMM 122,A01,942783,Russell; Alistair B,19,0,44,25
1748421304620,BIMM 122,A02,942784,Russell; Alistair B,29,0,44,15
1748421304620,BIMM 122,A03,942785,Russell; Alistair B,35,0,44,9
1748421304620,BIMM 122,A04,942786,Russell; Alistair B,30,0,44,14
1748421305647,BIMM 128,A01,942788,Hao; Nan,0,0,30,30
1748421305647,BIMM 128,A02,942789,Hao; Nan,0,0,31,31
1748421305647,BIMM 128,A03,942790,Hao; Nan,0,0,31,31
1748421305647,BIMM 128,A04,942791,Hao; Nan,0,0,31,31
1748421306681,BIMM 143,A01,942793,Grant; Barry J,13,0,40,27
1748421306681,BIMM 143,B01,942795,Bozinovic; Goran,21,0,40,19
1748421307714,BIMM 143R,A01,942797,Bozinovic; Goran,0,0,40,40
1748421308757,BIMM 194,A00,942798,Golden; Susan S.,5,0,32,27
1748421308757,BIMM 194,B00,942799,Golden; James W,21,0,32,11
1748421308757,BIMM 194,C00,942800,Karlseder; Jan & Saghatelian; Alan,0,0,32,32
1748421309786,BIOM 200A,A00,911746,Gordts; Philip,30,0,30,0
1748421310812,BIOM 200B,A00,911747,Gordts; Philip,35,0,35,0
1748421311843,BIOM 201,A00,911749,Daneman; Richard,35,0,35,0
1748421312872,BIOM 202,A01,911753,Corbett; Kevin Daniel,35,0,35,0
1748421313900,BIOM 203A,A00,911755,Corbett; Kevin Daniel,35,0,35,0
1748421314927,BIOM 218,A00,911756,Gagneux; Pascal,11,0,12,1
1748421316029,BIOM 219,A00,911757,Ross; Camille,20,0,20,0
1748421317063,BIOM 242,A00,911758,Hamilton; Bruce Alan,19,0,20,1
1748421318089,BIOM 293,A00,911759,Gustafsson; Asa Birgitta,35,0,35,0
1748421319116,BIOM 295,A00,911760,Joiner; William J.,0,0,0,0
1748421320142,BIOM 296,A00,911761,Yaksh; Tony L.,35,0,35,0
1748421321188,BIPN 100,A01,959801,Leutgeb; Stefan,0,0,36,36
1748421321188,BIPN 100,A02,959802,Leutgeb; Stefan,0,0,36,36
1748421321188,BIPN 100,A03,959803,Leutgeb; Stefan,3,0,36,33
1748421321188,BIPN 100,A04,959804,Leutgeb; Stefan,0,0,36,36
1748421321188,BIPN 100,B01,959766,Cooke; James Edward,33,0,41,8
1748421321188,BIPN 100,B02,959767,Cooke; James Edward,39,0,41,2
1748421321188,BIPN 100,B03,959768,Cooke; James Edward,37,0,40,3
1748421321188,BIPN 100,B04,959769,Cooke; James Edward,37,0,40,3
1748421321188,BIPN 100,C01,959770,Cooke; James Edward,35,0,41,6
1748421321188,BIPN 100,C02,959771,Cooke; James Edward,40,0,41,1
1748421321188,BIPN 100,C03,959772,Cooke; James Edward,37,0,40,3
1748421321188,BIPN 100,C04,959773,Cooke; James Edward,38,0,40,2
1748421321188,BIPN 100,D01,959811,Yang; Mingyu,0,0,41,41
1748421321188,BIPN 100,D02,959812,Yang; Mingyu,0,0,41,41
1748421321188,BIPN 100,D03,959813,Yang; Mingyu,0,0,40,40
1748421321188,BIPN 100,D04,959814,Yang; Mingyu,0,0,40,40
1748421322220,BIPN 103,A01,942981,Yang; Mingyu,0,0,48,48
1748421323253,BIPN 105,A01,942983,Armour; Jon Christopher,0,0,21,21
1748421323253,BIPN 105,A02,942984,Armour; Jon Christopher,0,0,21,21
1748421323253,BIPN 105,B01,942989,Armour; Jon Christopher,0,0,21,21
1748421323253,BIPN 105,B02,942990,Armour; Jon Christopher,0,0,21,21
1748421324283,BIPN 118,A01,960886,Banghart; Matthew Ryan,23,0,30,7
1748421324283,BIPN 118,A02,960889,Banghart; Matthew Ryan,24,0,30,6
1748421324283,BIPN 118,A03,960891,Banghart; Matthew Ryan,23,0,30,7
1748421324283,BIPN 118,A04,960892,Banghart; Matthew Ryan,27,0,30,3
1748421325318,BIPN 140,A01,942992,Owens; Melinda Tsao-Ying,8,0,32,24
1748421325318,BIPN 140,A02,942994,Owens; Melinda Tsao-Ying,0,0,32,32
1748421325318,BIPN 140,A03,942995,Owens; Melinda Tsao-Ying,1,0,32,31
1748421325318,BIPN 140,A04,942996,Owens; Melinda Tsao-Ying,9,0,30,21
1748421325318,BIPN 140,B01,942998,Owens; Melinda Tsao-Ying,4,0,32,28
1748421325318,BIPN 140,B02,942999,Owens; Melinda Tsao-Ying,3,0,32,29
1748421325318,BIPN 140,B03,943000,Owens; Melinda Tsao-Ying,18,0,32,14
1748421325318,BIPN 140,B04,943001,Owens; Melinda Tsao-Ying,23,0,30,7
1748421326347,BIPN 145,A01,943083,Maita; Isabella Vincenza,0,0,42,42
1748421326347,BIPN 145,B01,943085,Marino; Marc J,13,0,42,29
1748421326347,BIPN 145,C01,943108,Marino; Marc J,0,0,42,42
1748421327401,BIPN 148,A01,943119,Leutgeb; Jill K.,15,0,39,24
1748421327401,BIPN 148,A02,943120,Leutgeb; Jill K.,16,0,39,23
1748421327401,BIPN 148,A03,943121,Leutgeb; Jill K.,33,0,39,6
1748421327401,BIPN 148,A04,943201,Leutgeb; Jill K.,27,0,39,12
1748421328434,BIPN 189,A00,943247,Gentner; Tim,0,0,25,25
1748421329463,BISP 182,A00,943255,Pogliano; Joseph,9999,0,9999,0
1748421330493,BISP 194,A00,943261,Wertheim; Joel Okrent,0,0,32,32
1748421331521,BNFO 281,A00,961454,Gaasterland; Theresa,13,0,40,27
1748421332554,BNFO 283,A00,961457,Benner; Christopher William,69,0,100,31
1748421333582,BNFO 294,A01,961499,Ross; Camille,39,0,50,11
1748421334646,CAT 1,A01,915666,Bronstein; Phoebe Malan,13,0,16,3
1748421334646,CAT 1,A02,915673,Bronstein; Phoebe Malan,15,0,16,1
1748421334646,CAT 1,A03,915727,Bronstein; Phoebe Malan,16,0,16,0
1748421334646,CAT 1,A04,915728,Bronstein; Phoebe Malan,16,0,16,0
1748421334646,CAT 1,A05,915729,Bronstein; Phoebe Malan,16,0,16,0
1748421334646,CAT 1,A06,915730,Bronstein; Phoebe Malan,13,0,16,3
1748421334646,CAT 1,A07,915731,Bronstein; Phoebe Malan,16,0,16,0
1748421334646,CAT 1,A08,915732,Bronstein; Phoebe Malan,16,0,16,0
1748421334646,CAT 1,A09,915733,Bronstein; Phoebe Malan,14,0,16,2
1748421334646,CAT 1,A10,915734,Bronstein; Phoebe Malan,16,0,16,0
1748421334646,CAT 1,A11,915751,Bronstein; Phoebe Malan,16,0,16,0
1748421334646,CAT 1,A12,915752,Bronstein; Phoebe Malan,15,0,16,1
1748421334646,CAT 1,A13,915753,Bronstein; Phoebe Malan,15,0,16,1
1748421334646,CAT 1,A14,915754,Bronstein; Phoebe Malan,16,0,16,0
1748421334646,CAT 1,A15,915755,Bronstein; Phoebe Malan,16,0,16,0
1748421334646,CAT 1,A16,915756,Bronstein; Phoebe Malan,16,0,16,0
1748421334646,CAT 1,B01,915763,Bronstein; Phoebe Malan,15,0,16,1
1748421334646,CAT 1,B02,915764,Bronstein; Phoebe Malan,15,0,16,1
1748421334646,CAT 1,B03,915765,Bronstein; Phoebe Malan,14,0,16,2
1748421334646,CAT 1,B04,915766,Bronstein; Phoebe Malan,16,0,16,0
1748421334646,CAT 1,B05,915767,Bronstein; Phoebe Malan,12,0,16,4
1748421334646,CAT 1,B06,915768,Bronstein; Phoebe Malan,16,0,16,0
1748421334646,CAT 1,B07,915769,Bronstein; Phoebe Malan,16,0,16,0
1748421334646,CAT 1,B08,915770,Bronstein; Phoebe Malan,16,0,16,0
1748421334646,CAT 1,B09,915771,Bronstein; Phoebe Malan,16,0,16,0
1748421334646,CAT 1,B10,915772,Bronstein; Phoebe Malan,16,0,16,0
1748421334646,CAT 1,B11,915773,Bronstein; Phoebe Malan,16,0,16,0
1748421334646,CAT 1,B12,915774,Bronstein; Phoebe Malan,15,0,16,1
1748421334646,CAT 1,B13,915775,Bronstein; Phoebe Malan,16,0,16,0
1748421334646,CAT 1,B14,915776,Bronstein; Phoebe Malan,15,0,16,1
1748421334646,CAT 1,B15,915777,Bronstein; Phoebe Malan,14,0,16,2
1748421334646,CAT 1,B16,915778,Bronstein; Phoebe Malan,16,0,16,0
1748421334646,CAT 1,C01,915780,Algaze; Guillermo,11,0,16,5
1748421334646,CAT 1,C02,915781,Algaze; Guillermo,16,0,16,0
1748421334646,CAT 1,C03,915782,Algaze; Guillermo,15,0,16,1
1748421334646,CAT 1,C04,915783,Algaze; Guillermo,16,0,16,0
1748421334646,CAT 1,C05,915784,Algaze; Guillermo,16,0,16,0
1748421334646,CAT 1,C06,915785,Algaze; Guillermo,16,0,16,0
1748421334646,CAT 1,C07,915786,Algaze; Guillermo,16,0,16,0
1748421334646,CAT 1,C08,915787,Algaze; Guillermo,15,0,16,1
1748421334646,CAT 1,C09,915788,Algaze; Guillermo,16,0,16,0
1748421334646,CAT 1,C10,915790,Algaze; Guillermo,16,0,16,0
1748421334646,CAT 1,C11,915791,Algaze; Guillermo,16,0,16,0
1748421334646,CAT 1,C12,915792,Algaze; Guillermo,16,0,16,0
1748421334646,CAT 1,C13,915793,Algaze; Guillermo,16,0,16,0
1748421334646,CAT 1,C14,915794,Algaze; Guillermo,16,0,16,0
1748421334646,CAT 1,D01,915796,Marchisotto; Jennifer Anne,16,0,16,0
1748421334646,CAT 1,D02,915797,Marchisotto; Jennifer Anne,15,0,16,1
1748421334646,CAT 1,D03,915798,Marchisotto; Jennifer Anne,16,0,16,0
1748421334646,CAT 1,D04,915799,Marchisotto; Jennifer Anne,12,0,16,4
1748421334646,CAT 1,D05,915800,Marchisotto; Jennifer Anne,16,0,16,0
1748421334646,CAT 1,D06,915801,Marchisotto; Jennifer Anne,16,0,16,0
1748421334646,CAT 1,D07,915802,Marchisotto; Jennifer Anne,15,0,16,1
1748421334646,CAT 1,D08,915803,Marchisotto; Jennifer Anne,16,0,16,0
1748421334646,CAT 1,D09,915804,Marchisotto; Jennifer Anne,16,0,16,0
1748421334646,CAT 1,D10,915805,Marchisotto; Jennifer Anne,16,0,16,0
1748421334646,CAT 1,D11,915806,Marchisotto; Jennifer Anne,15,0,16,1
1748421334646,CAT 1,D12,915807,Marchisotto; Jennifer Anne,16,0,16,0
1748421334646,CAT 1,D13,915808,Marchisotto; Jennifer Anne,15,0,16,1
1748421334646,CAT 1,D14,915809,Marchisotto; Jennifer Anne,15,0,16,1
1748421335673,CAT 88,A00,969796,Popko; Elizabeth Ashley,0,0,0,0
1748421336706,CAT 90,A00,915812,Geibel; William,7,0,15,8
1748421337740,CAT 124,A01,915814,Rose; Becca Rae,0,0,20,20
1748421337740,CAT 124,B01,961453,Geibel; William,14,0,20,6
1748421338775,CAT 125,001,915815,Delaville; Romain,18,0,20,2
1748421338775,CAT 125,003,915817,Bigham; David Joseph,12,0,20,8
1748421338775,CAT 125,004,915818,Bigham; David Joseph,3,0,20,17
1748421338775,CAT 125,005,915819,Marchisotto; Jennifer Anne,11,0,20,9
1748421338775,CAT 125,006,915820,Marchisotto; Jennifer Anne,0,0,20,20
1748421338775,CAT 125,007,915821,Morales; Celeste Georgianna,12,0,20,8
1748421338775,CAT 125,008,915822,Morales; Celeste Georgianna,15,0,20,5
1748421338775,CAT 125,009,915823,Morales; Celeste Georgianna,18,0,20,2
1748421338775,CAT 125,010,915824,Irwin; Matthew Joseph,18,0,20,2
1748421338775,CAT 125,011,915825,Irwin; Matthew Joseph,15,0,20,5
1748421338775,CAT 125,012,915826,Irwin; Matthew Joseph,15,0,20,5
1748421338775,CAT 125,013,915827,Vanderschuit; Maya Alysia,16,0,20,4
1748421338775,CAT 125,014,915828,Vanderschuit; Maya Alysia,18,0,20,2
1748421338775,CAT 125,015,915829,Vanderschuit; Maya Alysia,15,0,20,5
1748421338775,CAT 125,016,915830,Rose; Becca Rae,5,0,20,15
1748421338775,CAT 125,017,915831,Rose; Becca Rae,4,0,20,16
1748421338775,CAT 125,018,915832,Hyland; Tina Mae,13,0,20,7
1748421338775,CAT 125,019,915833,Hyland; Tina Mae,17,0,20,3
1748421339805,CAT 125R,A00,915834,Hyland; Tina Mae,0,0,20,20
1748421339805,CAT 125R,B00,915835,Hyland; Tina Mae,0,0,20,20
1748421339805,CAT 125R,C00,915836,Hyland; Tina Mae,0,0,20,20
1748421339805,CAT 125R,D00,915837,Tosun; Adriana,0,0,20,20
1748421339805,CAT 125R,E00,915838,Smith; Lauryn Alissa,0,0,20,20
1748421339805,CAT 125R,F00,915839,Smith; Lauryn Alissa,0,0,20,20
1748421339805,CAT 125R,G00,915840,Smith; Lauryn Alissa,0,0,20,20
1748421340832,CAT 200,A00,915841,Popko; Elizabeth Ashley,17,0,20,3
1748421341864,CCE 1,A00,915063,Bigley; Michele Heather,30,0,40,10
1748421341864,CCE 1,B00,915064,Bigley; Michele Heather,36,0,40,4
1748421342906,CCE 2,001,915067,Santos; Vabianna Daria,0,0,20,20
1748421342906,CCE 2,002,915068,Santos; Vabianna Daria,0,0,20,20
1748421342906,CCE 2,003,915069,Santos; Vabianna Daria,18,0,20,2
1748421342906,CCE 2,004,915070,Staff,17,0,20,3
1748421342906,CCE 2,005,915071,Staff,15,0,20,5
1748421342906,CCE 2,006,915072,Staff,8,0,20,12
1748421342906,CCE 2,007,915073,Staff,10,0,20,10
1748421342906,CCE 2,008,915074,Staff,0,0,20,20
1748421342906,CCE 2,009,915090,Staff,5,0,20,15
1748421342906,CCE 2,010,915104,Merryman; Ashley,0,0,20,20
1748421342906,CCE 2,011,915114,Merryman; Ashley,0,0,20,20
1748421342906,CCE 2,012,915136,Merryman; Ashley,0,0,20,20
1748421342906,CCE 2,013,915176,Staff,13,0,20,7
1748421342906,CCE 2,014,915177,Staff,20,0,20,0
1748421342906,CCE 2,015,915178,Staff,17,0,20,3
1748421342906,CCE 2,016,915179,Staff,16,0,20,4
1748421343945,CCE 3,001,915194,Labat Ii; Michael Luis,13,0,20,7
1748421343945,CCE 3,002,915195,Labat Ii; Michael Luis,17,0,20,3
1748421343945,CCE 3,003,915196,Labat Ii; Michael Luis,17,0,20,3
1748421343945,CCE 3,004,915197,Lee; Kassandra,16,0,20,4
1748421343945,CCE 3,005,915198,Lee; Kassandra,6,0,20,14
1748421343945,CCE 3,006,915199,Lee; Kassandra,10,0,20,10
1748421343945,CCE 3,007,915200,Garcia; Kathryn Mary,0,0,20,20
1748421343945,CCE 3,008,915201,Garcia; Kathryn Mary,2,0,20,18
1748421344993,CCE 120,A01,915203,Quijada; David,26,0,30,4
1748421344993,CCE 120,B01,915205,Quijada; David,17,0,30,13
1748421344993,CCE 120,C01,915207,Williams; Danielle,21,0,30,9
1748421344993,CCE 120,D01,915275,Crawford; James,26,0,30,4
1748421344993,CCE 120,E01,915323,Kenley; Nicole,0,0,30,30
1748421344993,CCE 120,F01,915325,Kenley; Nicole,5,0,30,25
1748421346029,CENG 4,A01,913054,Li; Yanran,35,0,36,1
1748421346029,CENG 4,A02,913055,Li; Yanran,36,0,36,0
1748421346029,CENG 4,A03,913058,Li; Yanran,36,0,36,0
1748421346029,CENG 4,A04,913060,Li; Yanran,36,0,36,0
1748421347059,CENG 15,A01,913087,Lubarda; Vlado,69,0,70,1
1748421348085,CENG 100,A00,913088,Powell; Alyssa,108,0,120,12
1748421349113,CENG 101A,A00,913089,Opatkiewicz; Justin Paul,107,0,146,39
1748421350144,CENG 110,A01,913091,Powell; Alyssa,15,0,24,9
1748421351170,CENG 120,A00,913092,Opatkiewicz; Justin Paul,96,0,146,50
1748421352201,CENG 122,A00,913093,Li; Wan-Lu,120,0,140,20
1748421353233,CENG 170,A01,913196,Drews; Aaron,7,0,25,18
1748421353233,CENG 170,A02,913202,Drews; Aaron,4,0,25,21
1748421353233,CENG 170,A03,913204,Drews; Aaron,5,0,30,25
1748421354260,CENG 175,A00,913205,Steinmetz; Nicole F,14,0,35,21
1748421355288,CENG 205,A00,913207,Jahed Motlagh; Zeinab,54,0,70,16
1748421356316,CENG 210A,A00,913209,Shah; Nisarg,50,0,50,0
1748421357349,CENG 211,A00,913211,Sirbuly; Donald,23,0,25,2
1748421358376,CENG 213,A00,913213,Fenning; David,25,0,25,0
1748421359402,CENG 221A,A00,913214,Liu; Ping,38,0,50,12
1748421360434,CENG 252,A00,913215,Chen; Zheng,42,0,50,8
1748421361463,CGS 2A,A01,915347,Martin Sandino; Amanda Maria Yoland,11,0,15,4
1748421361463,CGS 2A,A02,915348,Martin Sandino; Amanda Maria Yoland,12,0,15,3
1748421361463,CGS 2A,A03,915375,Martin Sandino; Amanda Maria Yoland,11,0,15,4
1748421361463,CGS 2A,A04,915376,Martin Sandino; Amanda Maria Yoland,15,0,15,0
1748421362493,CGS 100A,A00,915379,Perez; Roy,16,0,31,15
1748421363520,CGS 109,A00,915458,Cuong; Marisol,36,0,40,4
1748421364562,CGS 110,A00,915463,Cuong; Marisol,27,0,30,3
1748421365592,CGS 113,A00,915465,Martin Sandino; Amanda Maria Yoland,8,0,16,8
1748421366622,CGS 134,A00,915498,Chatti; Deepti,17,0,32,15
1748421367652,CGS 150,A00,915508,Taylor-Garcia; Daphne,13,0,16,3
1748421368678,CGS 187,A00,915515,Martin Sandino; Amanda Maria Yoland,13,0,16,3
1748421369706,CGS 190,A00,915516,Taylor-Garcia; Daphne,7,0,7,0
1748421370732,CGS 208,A00,915517,Kang; Byung Chu,1,0,1,0
1748421371764,CHEM 4,A01,958051,Brydges; Stacey,39,0,40,1
1748421371764,CHEM 4,A02,958052,Brydges; Stacey,38,0,40,2
1748421371764,CHEM 4,A03,958053,Brydges; Stacey,37,0,40,3
1748421371764,CHEM 4,A04,958054,Brydges; Stacey,39,0,40,1
1748421371764,CHEM 4,A05,958055,Brydges; Stacey,40,0,40,0
1748421371764,CHEM 4,A06,958056,Brydges; Stacey,38,0,40,2
1748421371764,CHEM 4,A07,958057,Brydges; Stacey,40,0,40,0
1748421371764,CHEM 4,A08,958058,Brydges; Stacey,40,0,40,0
1748421371764,CHEM 4,B01,958059,Brydges; Stacey,40,0,40,0
1748421371764,CHEM 4,B02,958060,Brydges; Stacey,40,0,40,0
1748421371764,CHEM 4,B03,958061,Brydges; Stacey,40,0,40,0
1748421371764,CHEM 4,B04,958062,Brydges; Stacey,36,0,40,4
1748421371764,CHEM 4,B05,958063,Brydges; Stacey,38,0,40,2
1748421371764,CHEM 4,B06,958064,Brydges; Stacey,39,0,40,1
1748421371764,CHEM 4,B07,958065,Brydges; Stacey,40,0,40,0
1748421371764,CHEM 4,B08,958066,Brydges; Stacey,40,0,40,0
1748421372820,CHEM 6A,A01,958094,Stallings; Dontarie M,5,0,8,3
1748421372820,CHEM 6A,A02,958095,Stallings; Dontarie M,4,0,8,4
1748421372820,CHEM 6A,A03,958096,Stallings; Dontarie M,7,0,8,1
1748421372820,CHEM 6A,A04,958097,Stallings; Dontarie M,8,0,8,0
1748421372820,CHEM 6A,A05,958098,Stallings; Dontarie M,8,0,8,0
1748421372820,CHEM 6A,A06,958099,Stallings; Dontarie M,8,0,8,0
1748421372820,CHEM 6A,A07,958100,Stallings; Dontarie M,8,0,8,0
1748421372820,CHEM 6A,A08,958101,Stallings; Dontarie M,8,0,8,0
1748421372820,CHEM 6A,A09,958102,Stallings; Dontarie M,0,0,0,0
1748421372820,CHEM 6A,B01,958136,Stallings; Dontarie M,0,0,8,8
1748421372820,CHEM 6A,B02,958137,Stallings; Dontarie M,5,0,8,3
1748421372820,CHEM 6A,B03,958138,Stallings; Dontarie M,8,0,8,0
1748421372820,CHEM 6A,B04,958139,Stallings; Dontarie M,7,0,8,1
1748421372820,CHEM 6A,B05,958140,Stallings; Dontarie M,0,0,8,8
1748421372820,CHEM 6A,B06,958141,Stallings; Dontarie M,3,0,8,5
1748421372820,CHEM 6A,B07,958143,Stallings; Dontarie M,2,0,8,6
1748421372820,CHEM 6A,B08,958144,Stallings; Dontarie M,8,0,8,0
1748421372820,CHEM 6A,B09,958145,Stallings; Dontarie M,0,0,0,0
1748421372820,CHEM 6A,C01,958146,Schurmeier; Kimberly,6,0,8,2
1748421372820,CHEM 6A,C02,958147,Schurmeier; Kimberly,7,0,8,1
1748421372820,CHEM 6A,C03,958148,Schurmeier; Kimberly,8,0,8,0
1748421372820,CHEM 6A,C04,958149,Schurmeier; Kimberly,8,0,8,0
1748421372820,CHEM 6A,C05,958150,Schurmeier; Kimberly,8,0,8,0
1748421372820,CHEM 6A,C06,958151,Schurmeier; Kimberly,6,0,8,2
1748421372820,CHEM 6A,C07,958152,Schurmeier; Kimberly,8,0,8,0
1748421372820,CHEM 6A,C08,958153,Schurmeier; Kimberly,7,0,8,1
1748421372820,CHEM 6A,C09,958154,Schurmeier; Kimberly,0,0,0,0
1748421372820,CHEM 6A,D01,958155,Schurmeier; Kimberly,3,0,8,5
1748421372820,CHEM 6A,D02,958156,Schurmeier; Kimberly,3,0,8,5
1748421372820,CHEM 6A,D03,958157,Schurmeier; Kimberly,4,0,8,4
1748421372820,CHEM 6A,D04,958158,Schurmeier; Kimberly,6,0,8,2
1748421372820,CHEM 6A,D05,958159,Schurmeier; Kimberly,7,0,8,1
1748421372820,CHEM 6A,D06,958160,Schurmeier; Kimberly,7,0,8,1
1748421372820,CHEM 6A,D07,958161,Schurmeier; Kimberly,8,0,8,0
1748421372820,CHEM 6A,D08,958162,Schurmeier; Kimberly,8,0,8,0
1748421372820,CHEM 6A,D09,958195,Schurmeier; Kimberly,0,0,0,0
1748421372820,CHEM 6A,E01,958203,Zid; Brian M,0,0,8,8
1748421372820,CHEM 6A,E02,958206,Zid; Brian M,6,0,8,2
1748421372820,CHEM 6A,E03,958207,Zid; Brian M,7,0,8,1
1748421372820,CHEM 6A,E04,958350,Zid; Brian M,8,0,8,0
1748421372820,CHEM 6A,E05,958361,Zid; Brian M,7,0,8,1
1748421372820,CHEM 6A,E06,958373,Zid; Brian M,2,0,8,6
1748421372820,CHEM 6A,E07,958394,Zid; Brian M,7,0,8,1
1748421372820,CHEM 6A,E08,958395,Zid; Brian M,1,0,8,7
1748421372820,CHEM 6A,E09,958396,Zid; Brian M,0,0,0,0
1748421372820,CHEM 6A,F01,958397,Ortony; Julia Helen,8,0,8,0
1748421372820,CHEM 6A,F02,958407,Ortony; Julia Helen,0,0,8,8
1748421372820,CHEM 6A,F03,958409,Ortony; Julia Helen,2,0,8,6
1748421372820,CHEM 6A,F04,958417,Ortony; Julia Helen,6,0,8,2
1748421372820,CHEM 6A,F05,958422,Ortony; Julia Helen,8,0,8,0
1748421372820,CHEM 6A,F06,958425,Ortony; Julia Helen,8,0,8,0
1748421372820,CHEM 6A,F07,958428,Ortony; Julia Helen,7,0,8,1
1748421372820,CHEM 6A,F08,958442,Ortony; Julia Helen,8,0,8,0
1748421372820,CHEM 6A,F09,958488,Ortony; Julia Helen,0,0,0,0
1748421372820,CHEM 6A,G01,958489,Ortony; Julia Helen,7,0,8,1
1748421372820,CHEM 6A,G02,958490,Ortony; Julia Helen,8,0,8,0
1748421372820,CHEM 6A,G03,958491,Ortony; Julia Helen,3,0,8,5
1748421372820,CHEM 6A,G04,958499,Ortony; Julia Helen,2,0,8,6
1748421372820,CHEM 6A,G05,958500,Ortony; Julia Helen,4,0,8,4
1748421372820,CHEM 6A,G06,958501,Ortony; Julia Helen,8,0,8,0
1748421372820,CHEM 6A,G07,958502,Ortony; Julia Helen,8,0,8,0
1748421372820,CHEM 6A,G08,958636,Ortony; Julia Helen,8,0,8,0
1748421372820,CHEM 6A,G09,958637,Ortony; Julia Helen,0,0,0,0
1748421373851,CHEM 6B,A01,958638,Bussey; Thomas J,15,0,22,7
1748421373851,CHEM 6B,A02,958641,Bussey; Thomas J,0,0,22,22
1748421373851,CHEM 6B,A03,958646,Bussey; Thomas J,0,0,22,22
1748421373851,CHEM 6B,A04,958648,Bussey; Thomas J,11,0,22,11
1748421373851,CHEM 6B,A05,958650,Bussey; Thomas J,7,0,22,15
1748421373851,CHEM 6B,A06,958652,Bussey; Thomas J,18,0,22,4
1748421373851,CHEM 6B,A07,958653,Bussey; Thomas J,20,0,22,2
1748421373851,CHEM 6B,A08,958654,Bussey; Thomas J,19,0,22,3
1748421373851,CHEM 6B,A09,958710,Bussey; Thomas J,21,0,22,1
1748421373851,CHEM 6B,A10,958713,Bussey; Thomas J,21,0,22,1
1748421374878,CHEM 6C,A01,958743,Yuen Zhou; Joel,24,0,38,14
1748421374878,CHEM 6C,A02,958744,Yuen Zhou; Joel,20,0,38,18
1748421374878,CHEM 6C,A03,958745,Yuen Zhou; Joel,28,0,38,10
1748421374878,CHEM 6C,A04,958746,Yuen Zhou; Joel,30,0,38,8
1748421374878,CHEM 6C,A05,958747,Yuen Zhou; Joel,36,0,38,2
1748421374878,CHEM 6C,A06,958748,Yuen Zhou; Joel,23,0,38,15
1748421374878,CHEM 6C,A07,958749,Yuen Zhou; Joel,22,0,38,16
1748421374878,CHEM 6C,A08,958750,Yuen Zhou; Joel,12,0,38,26
1748421374878,CHEM 6C,A09,958751,Yuen Zhou; Joel,28,0,38,10
1748421375908,CHEM 7L,A01,912668,Leigh; Brian,0,0,24,24
1748421375908,CHEM 7L,A02,912669,Leigh; Brian,0,0,24,24
1748421375908,CHEM 7L,A03,912670,Leigh; Brian,0,0,24,24
1748421375908,CHEM 7L,A04,912671,Leigh; Brian,0,0,24,24
1748421375908,CHEM 7L,A05,912672,Leigh; Brian,0,0,24,24
1748421375908,CHEM 7L,A06,912673,Leigh; Brian,0,0,20,20
1748421375908,CHEM 7L,A07,912674,Leigh; Brian,0,0,24,24
1748421375908,CHEM 7L,A08,912675,Leigh; Brian,0,0,24,24
1748421375908,CHEM 7L,A09,912676,Leigh; Brian,0,0,24,24
1748421375908,CHEM 7L,A10,912677,Leigh; Brian,0,0,24,24
1748421375908,CHEM 7L,B01,912680,Leigh; Brian,0,0,24,24
1748421375908,CHEM 7L,B02,912681,Leigh; Brian,0,0,24,24
1748421375908,CHEM 7L,B03,912682,Leigh; Brian,0,0,24,24
1748421375908,CHEM 7L,B04,912683,Leigh; Brian,0,0,24,24
1748421375908,CHEM 7L,B05,912684,Leigh; Brian,0,0,24,24
1748421375908,CHEM 7L,B06,912685,Leigh; Brian,0,0,24,24
1748421375908,CHEM 7L,B07,912686,Leigh; Brian,0,0,24,24
1748421375908,CHEM 7L,B08,912687,Leigh; Brian,0,0,24,24
1748421375908,CHEM 7L,B09,912688,Leigh; Brian,0,0,24,24
1748421375908,CHEM 7L,B10,912689,Leigh; Brian,0,0,24,24
1748421376942,CHEM 40A,A01,958809,Bertrand; Guy,0,0,34,34
1748421376942,CHEM 40A,A02,958811,Bertrand; Guy,0,0,29,29
1748421376942,CHEM 40A,A03,958812,Bertrand; Guy,0,0,34,34
1748421376942,CHEM 40A,A04,958813,Bertrand; Guy,0,0,34,34
1748421376942,CHEM 40A,A05,958814,Bertrand; Guy,0,0,34,34
1748421376942,CHEM 40A,A06,958816,Bertrand; Guy,0,0,34,34
1748421376942,CHEM 40A,A07,958822,Bertrand; Guy,0,0,34,34
1748421376942,CHEM 40A,A08,958824,Bertrand; Guy,0,0,34,34
1748421376942,CHEM 40A,B01,958825,Bertrand; Guy,0,0,34,34
1748421376942,CHEM 40A,B02,958826,Bertrand; Guy,0,0,34,34
1748421376942,CHEM 40A,B03,958828,Bertrand; Guy,0,0,34,34
1748421376942,CHEM 40A,B04,958829,Bertrand; Guy,0,0,34,34
1748421376942,CHEM 40A,B05,958898,Bertrand; Guy,0,0,34,34
1748421376942,CHEM 40A,B06,958899,Bertrand; Guy,0,0,34,34
1748421376942,CHEM 40A,B07,958900,Bertrand; Guy,0,0,34,34
1748421376942,CHEM 40A,B08,958901,Bertrand; Guy,0,0,34,34
1748421376942,CHEM 40A,C01,958086,Yang; Jerry,29,0,34,5
1748421376942,CHEM 40A,C02,958087,Yang; Jerry,32,0,34,2
1748421376942,CHEM 40A,C03,958088,Yang; Jerry,31,0,34,3
1748421376942,CHEM 40A,C04,958089,Yang; Jerry,34,0,34,0
1748421376942,CHEM 40A,C05,958090,Yang; Jerry,34,0,34,0
1748421376942,CHEM 40A,C06,958091,Yang; Jerry,27,0,34,7
1748421376942,CHEM 40A,C07,958092,Yang; Jerry,29,0,34,5
1748421376942,CHEM 40A,C08,958093,Yang; Jerry,27,0,34,7
1748421376942,CHEM 40A,D01,958113,Albizati; Kim F.,0,0,34,34
1748421376942,CHEM 40A,D02,958114,Albizati; Kim F.,0,0,34,34
1748421376942,CHEM 40A,D03,958115,Albizati; Kim F.,0,0,34,34
1748421376942,CHEM 40A,D04,958116,Albizati; Kim F.,0,0,34,34
1748421376942,CHEM 40A,D05,958117,Albizati; Kim F.,0,0,34,34
1748421376942,CHEM 40A,D06,958118,Albizati; Kim F.,0,0,34,34
1748421376942,CHEM 40A,D07,958119,Albizati; Kim F.,0,0,34,34
1748421376942,CHEM 40A,D08,958120,Albizati; Kim F.,0,0,34,34
1748421377971,CHEM 40B,A01,958752,Molinski; Tadeusz,0,0,31,31
1748421377971,CHEM 40B,A02,958754,Molinski; Tadeusz,0,0,32,32
1748421377971,CHEM 40B,A03,958755,Molinski; Tadeusz,0,0,32,32
1748421377971,CHEM 40B,A04,958756,Molinski; Tadeusz,0,0,32,32
1748421377971,CHEM 40B,A05,958757,Molinski; Tadeusz,0,0,32,32
1748421377971,CHEM 40B,A06,958758,Molinski; Tadeusz,0,0,32,32
1748421377971,CHEM 40B,A07,958759,Molinski; Tadeusz,0,0,32,32
1748421377971,CHEM 40B,A08,958760,Molinski; Tadeusz,2,0,32,30
1748421377971,CHEM 40B,A09,958761,Molinski; Tadeusz,32,0,32,0
1748421379008,CHEM 41A,A01,958071,Klosterman; Jeremy K,0,0,22,22
1748421379008,CHEM 41A,A02,958072,Klosterman; Jeremy K,1,0,36,35
1748421379008,CHEM 41A,A03,958073,Klosterman; Jeremy K,16,0,36,20
1748421379008,CHEM 41A,A04,958074,Klosterman; Jeremy K,32,0,36,4
1748421379008,CHEM 41A,A05,958075,Klosterman; Jeremy K,0,0,0,0
1748421379008,CHEM 41A,A06,958076,Klosterman; Jeremy K,24,0,36,12
1748421379008,CHEM 41A,A07,958077,Klosterman; Jeremy K,3,0,36,33
1748421379008,CHEM 41A,A08,958078,Klosterman; Jeremy K,0,0,36,36
1748421379008,CHEM 41A,A09,958079,Klosterman; Jeremy K,36,0,36,0
1748421380035,CHEM 41C,A01,958105,Tor; Yitzhak,0,0,38,38
1748421380035,CHEM 41C,A02,958106,Tor; Yitzhak,0,0,40,40
1748421381067,CHEM 43A,A01,912711,Lam; Tin Yiu,0,0,24,24
1748421381067,CHEM 43A,A02,912712,Lam; Tin Yiu,0,0,24,24
1748421381067,CHEM 43A,A03,912713,Lam; Tin Yiu,0,0,24,24
1748421381067,CHEM 43A,A04,912714,Lam; Tin Yiu,0,0,24,24
1748421381067,CHEM 43A,A05,912715,Lam; Tin Yiu,0,0,24,24
1748421381067,CHEM 43A,A06,912716,Lam; Tin Yiu,0,0,24,24
1748421381067,CHEM 43A,A07,912717,Lam; Tin Yiu,0,0,24,24
1748421381067,CHEM 43A,A08,912718,Lam; Tin Yiu,0,0,24,24
1748421381067,CHEM 43A,A09,912719,Lam; Tin Yiu,0,0,24,24
1748421381067,CHEM 43A,A10,912720,Lam; Tin Yiu,0,0,24,24
1748421381067,CHEM 43A,B01,912722,Lam; Tin Yiu,0,0,24,24
1748421381067,CHEM 43A,B02,912723,Lam; Tin Yiu,0,0,24,24
1748421381067,CHEM 43A,B03,912724,Lam; Tin Yiu,0,0,19,19
1748421381067,CHEM 43A,B04,912725,Lam; Tin Yiu,0,0,24,24
1748421381067,CHEM 43A,B05,912726,Lam; Tin Yiu,0,0,24,24
1748421381067,CHEM 43A,B06,912727,Lam; Tin Yiu,0,0,24,24
1748421381067,CHEM 43A,B07,912728,Lam; Tin Yiu,0,0,24,24
1748421381067,CHEM 43A,B08,912729,Lam; Tin Yiu,0,0,24,24
1748421381067,CHEM 43A,B09,912730,Lam; Tin Yiu,0,0,24,24
1748421381067,CHEM 43A,B10,912731,Lam; Tin Yiu,0,0,24,24
1748421382094,CHEM 96,A00,960251,Bussey; Thomas J,15,0,20,5
1748421383126,CHEM 100A,A01,912734,Leigh; Brian,0,0,24,24
1748421383126,CHEM 100A,A02,912735,Leigh; Brian,0,0,24,24
1748421383126,CHEM 100A,A03,912736,Leigh; Brian,0,0,24,24
1748421383126,CHEM 100A,A04,912737,Leigh; Brian,0,0,24,24
1748421383126,CHEM 100A,A05,912738,Leigh; Brian,0,0,24,24
1748421383126,CHEM 100A,A06,912739,Leigh; Brian,0,0,24,24
1748421384153,CHEM 108,A01,912741,Ghosh; Gourisankar,0,0,24,24
1748421384153,CHEM 108,A02,912742,Ghosh; Gourisankar,0,0,24,24
1748421384153,CHEM 108,A03,912743,Ghosh; Gourisankar,13,0,24,11
1748421384153,CHEM 108,A04,912744,Ghosh; Gourisankar,23,0,24,1
1748421385185,CHEM 109,A01,912746,Muller; Ulrich K.,0,0,24,24
1748421385185,CHEM 109,A02,912747,Muller; Ulrich K.,0,0,24,24
1748421385185,CHEM 109,A03,912748,Muller; Ulrich K.,0,0,24,24
1748421385185,CHEM 109,A04,912749,Muller; Ulrich K.,15,0,24,9
1748421386229,CHEM 114A,A01,958067,Toor; Navtej,23,0,30,7
1748421386229,CHEM 114A,A02,958068,Toor; Navtej,18,0,30,12
1748421386229,CHEM 114A,A03,958069,Toor; Navtej,15,0,30,15
1748421386229,CHEM 114A,A04,958070,Toor; Navtej,0,0,30,30
1748421386229,CHEM 114A,B01,958080,Guseman; Alex,0,0,30,30
1748421386229,CHEM 114A,B02,958081,Guseman; Alex,0,0,30,30
1748421386229,CHEM 114A,B03,958082,Guseman; Alex,20,0,30,10
1748421386229,CHEM 114A,B04,958083,Guseman; Alex,24,0,30,6
1748421387258,CHEM 114D,A00,912752,Ghosh; Gourisankar,11,0,20,9
1748421388287,CHEM 116,A01,958121,Godula; Kamil,35,0,50,15
1748421388287,CHEM 116,A02,958122,Godula; Kamil,29,0,50,21
1748421389312,CHEM 117,A00,912754,Jones; Lisa Michelle,89,0,100,11
1748421390340,CHEM 126A,A01,958126,Schoeneberg; Johannes,14,0,35,21
1748421390340,CHEM 126A,A02,958127,Schoeneberg; Johannes,4,0,35,31
1748421390340,CHEM 126A,A03,958128,Schoeneberg; Johannes,0,0,35,35
1748421390340,CHEM 126A,A04,958129,Schoeneberg; Johannes,1,0,35,34
1748421390340,CHEM 126A,A05,958130,Schoeneberg; Johannes,34,0,35,1
1748421390340,CHEM 126A,A06,958131,Schoeneberg; Johannes,25,0,35,10
1748421391374,CHEM 130,A01,958084,Sinha; Amitabha,6,0,35,29
1748421391374,CHEM 130,A02,958085,Sinha; Amitabha,21,0,35,14
1748421392415,CHEM 142,A00,912758,Godula; Kamil,112,0,135,23
1748421393442,CHEM 143C,A01,912760,Klosterman; Jeremy K,8,0,24,16
1748421393442,CHEM 143C,A02,912761,Klosterman; Jeremy K,11,0,24,13
1748421394467,CHEM 152,A00,912762,Schmidt; Valerie A,18,0,30,12
1748421395496,CHEM 163,A00,912763,Jones; Lisa Michelle,1,0,10,9
1748421396522,CHEM 171,A01,958103,Slade; Jonathan,30,0,40,10
1748421396522,CHEM 171,A02,958104,Slade; Jonathan,36,0,40,4
1748421397556,CHEM 204,A00,912765,Ghosh; Partho,29,0,30,1
1748421398585,CHEM 209,A00,912766,Toor; Navtej,36,0,40,4
1748421399616,CHEM 213A,A00,912767,Guseman; Alex,46,0,50,4
1748421400642,CHEM 214,A00,912768,Ghosh; Gourisankar,18,0,20,2
1748421401671,CHEM 216,A00,912769,Godula; Kamil,28,0,30,2
1748421402703,CHEM 219A,A00,912770,Zid; Brian M,43,0,45,2
1748421403733,CHEM 222,A00,912771,Graeve; Olivia A,4,0,5,1
1748421404764,CHEM 224,A00,912772,Rinehart; Jeffrey Dennis,19,0,20,1
1748421405793,CHEM 227,A00,912773,Schimpf; Alina M,28,0,30,2
1748421407855,CHEM 231,A00,912775,Yong; Haiwang,20,0,20,0
1748421408887,CHEM 232A,A00,963071,Yuen Zhou; Joel,15,0,15,0
1748421409918,CHEM 234,A00,912776,Pun; Andrew Brian,39,0,40,1
1748421410946,CHEM 242,A00,912777,Godula; Kamil,22,0,25,3
1748421411971,CHEM 252,A00,912778,Schmidt; Valerie A,27,0,30,3
1748421412996,CHEM 263,A00,912779,Jones; Lisa Michelle,28,0,30,2
1748421414023,CHEM 291,A00,912780,Staff,20,0,20,0
1748421415053,CHEM 294,A00,912781,Staff,49,0,50,1
1748421416088,CHIN 10AD,A01,913381,Liu; Mingming,10,0,12,2
1748421416088,CHIN 10AD,A02,913382,Liu; Mingming,10,0,12,2
1748421417122,CHIN 10AM,A01,913384,Chen; Pei-Chia,9,0,12,3
1748421417122,CHIN 10AM,A02,913385,Chen; Pei-Chia,10,0,12,2
1748421418159,CHIN 10AN,A01,913387,Xu; Li,10,0,10,0
1748421418159,CHIN 10AN,A02,913388,Xu; Li,10,0,10,0
1748421418159,CHIN 10AN,B01,913390,Xu; Li,9,0,10,1
1748421418159,CHIN 10AN,B02,913391,Xu; Li,8,0,10,2
1748421418159,CHIN 10AN,C01,913393,Xu; Li,12,0,12,0
1748421418159,CHIN 10AN,C02,913394,Xu; Li,11,0,12,1
1748421419191,CHIN 20AD,A01,913396,Liu; Mingming,12,0,14,2
1748421419191,CHIN 20AD,A02,913397,Liu; Mingming,13,0,14,1
1748421420273,CHIN 20AM,A01,913399,Wang; Xiao,11,0,12,1
1748421420273,CHIN 20AM,A02,913400,Wang; Xiao,9,0,12,3
1748421420273,CHIN 20AM,B01,913402,Wang; Xiao,12,0,12,0
1748421420273,CHIN 20AM,B02,913403,Wang; Xiao,12,0,12,0
1748421421309,CHIN 20AN,A01,913405,Anderson; Qin-Hong,8,0,12,4
1748421421309,CHIN 20AN,A02,913406,Anderson; Qin-Hong,7,0,12,5
1748421421309,CHIN 20AN,B01,913408,Anderson; Qin-Hong,6,0,12,6
1748421421309,CHIN 20AN,B02,913409,Anderson; Qin-Hong,9,0,12,3
1748421421309,CHIN 20AN,C01,913411,Anderson; Qin-Hong,11,0,12,1
1748421422336,CHIN 100AM,A00,913412,Wang; Xiao,12,0,15,3
1748421423364,CHIN 100AN,A00,913413,Chen; Pei-Chia,8,0,15,7
1748421424396,CHIN 185A,A00,913414,Liu; Mingming,15,0,15,0
1748421425421,CLIN 294A,A00,914822,Weingarten; Amanda Gooding,10,0,10,0
1748421426454,CLIN 296,A00,914825,Moore; David Joseph,100,0,100,0
1748421426454,CLIN 296,B00,914826,Brookman; Lauren Irene,5,0,5,0
1748421427487,CLIN 297,A00,914827,Wall; Tamara Lynn,100,0,100,0
1748421428514,CLRE 254,A00,914830,Vaida; Florin,9997,0,9999,2
1748421429541,CLRE 255,A01,914832,Cuomo; Raphael Eduardo,9997,0,9999,2
1748421430576,CLRE 256,A01,914835,Morris; Sheldon,9996,0,9999,3
1748421431603,CLRE 257,A00,914836,Mehta; Ravindra L.,9997,0,9999,2
1748421432633,CLRE 258,A00,914839,Mehta; Ravindra L.,9997,0,9999,2
1748421433662,CLRE 260,A00,914840,Cuomo; Raphael Eduardo,9999,0,9999,0
1748421434688,CLRE 295A,A00,914845,Cuomo; Raphael Eduardo,9999,0,9999,0
1748421435718,CLRE 297,001,914847,Cuomo; Raphael Eduardo,9999,0,9999,0
1748421436745,CLX 87,A00,913379,Castro; Robert Jess,20,0,20,0
1748421437772,COGR 200A,A00,914800,Dewaard; Andrew Michael,5,0,5,0
1748421438799,COGR 200C,A00,914801,Irani; Lilly C,5,0,5,0
1748421439828,COGR 225A,A00,914803,McKenzie; Kerry V.,10,0,10,0
1748421440854,COGR 225C,A00,914804,McKenzie; Kerry V.,9,0,10,1
1748421441882,COGR 275,A00,914805,Jack; Caroline Sarah,9,0,10,1
1748421441882,COGR 275,B00,914807,Zilberg; Elana,9,0,10,1
1748421441882,COGR 275,C00,914809,Goldfarb; Brian,7,0,10,3
1748421442913,COGS 1,A01,913420,Beatty-Martinez; Anne,47,0,56,9
1748421442913,COGS 1,A02,913421,Beatty-Martinez; Anne,39,0,56,17
1748421442913,COGS 1,A03,913422,Beatty-Martinez; Anne,51,0,55,4
1748421442913,COGS 1,A04,913423,Beatty-Martinez; Anne,46,0,50,4
1748421442913,COGS 1,A05,913424,Beatty-Martinez; Anne,41,0,50,9
1748421442913,COGS 1,A06,913425,Beatty-Martinez; Anne,44,0,50,6
1748421442913,COGS 1,A07,913426,Beatty-Martinez; Anne,48,0,50,2
1748421442913,COGS 1,A08,913427,Beatty-Martinez; Anne,45,0,50,5
1748421443945,COGS 2,A01,913429,Boyle; Mary E. T.,49,0,50,1
1748421443945,COGS 2,A02,913430,Boyle; Mary E. T.,47,0,50,3
1748421443945,COGS 2,A03,913431,Boyle; Mary E. T.,46,0,50,4
1748421443945,COGS 2,A04,913432,Boyle; Mary E. T.,49,0,50,1
1748421443945,COGS 2,A05,913433,Boyle; Mary E. T.,47,0,50,3
1748421444971,COGS 3,A01,913435,Boyle; Mary E. T.,48,0,60,12
1748421444971,COGS 3,A02,913436,Boyle; Mary E. T.,52,0,60,8
1748421445999,COGS 9,A01,913439,Khosla; Meenakshi,48,0,50,2
1748421445999,COGS 9,A02,913440,Khosla; Meenakshi,49,0,50,1
1748421445999,COGS 9,A03,913441,Khosla; Meenakshi,48,0,50,2
1748421445999,COGS 9,A04,913442,Khosla; Meenakshi,46,0,50,4
1748421445999,COGS 9,A05,913443,Khosla; Meenakshi,44,0,50,6
1748421445999,COGS 9,A06,913444,Khosla; Meenakshi,46,0,50,4
1748421447025,COGS 10,A01,913446,Staff,42,0,50,8
1748421447025,COGS 10,A02,913447,Staff,46,0,50,4
1748421447025,COGS 10,A03,913448,Staff,47,0,50,3
1748421447025,COGS 10,A04,913449,Staff,47,0,50,3
1748421447025,COGS 10,A05,913450,Staff,50,0,50,0
1748421447025,COGS 10,A06,913451,Staff,45,0,50,5
1748421448052,COGS 11,A01,913453,Boroditsky; Lera,142,0,149,7
1748421449093,COGS 14A,A01,913455,Creel; Sarah,29,0,50,21
1748421449093,COGS 14A,A02,913456,Creel; Sarah,37,0,50,13
1748421449093,COGS 14A,A03,913457,Creel; Sarah,42,0,50,8
1748421449093,COGS 14A,A04,913458,Creel; Sarah,45,0,50,5
1748421449093,COGS 14A,A05,913459,Creel; Sarah,47,0,50,3
1748421449093,COGS 14A,A06,913460,Creel; Sarah,48,0,50,2
1748421449093,COGS 14A,A07,913461,Creel; Sarah,46,0,50,4
1748421450129,COGS 14B,A01,913463,Barrera; Steven James,32,0,50,18
1748421450129,COGS 14B,A02,913464,Barrera; Steven James,45,0,50,5
1748421450129,COGS 14B,A03,913465,Barrera; Steven James,40,0,50,10
1748421450129,COGS 14B,A04,913466,Barrera; Steven James,46,0,50,4
1748421450129,COGS 14B,A05,913467,Barrera; Steven James,40,0,50,10
1748421451160,COGS 15,A01,913469,Bergen; Benjamin,57,0,60,3
1748421451160,COGS 15,A02,913470,Bergen; Benjamin,57,0,60,3
1748421452188,COGS 17,A01,913472,Johnson; Christine M.,38,0,50,12
1748421452188,COGS 17,A02,913473,Johnson; Christine M.,47,0,50,3
1748421452188,COGS 17,A03,913474,Johnson; Christine M.,39,0,50,11
1748421452188,COGS 17,A04,913475,Johnson; Christine M.,42,0,50,8
1748421452188,COGS 17,A05,913476,Johnson; Christine M.,48,0,50,2
1748421452188,COGS 17,A06,913477,Johnson; Christine M.,48,0,50,2
1748421452188,COGS 17,A07,913478,Johnson; Christine M.,50,0,54,4
1748421452188,COGS 17,A08,913479,Johnson; Christine M.,43,0,56,13
1748421453217,COGS 18,A01,913481,Morgan; Eric,27,0,35,8
1748421453217,COGS 18,A02,913482,Morgan; Eric,30,0,35,5
1748421453217,COGS 18,A03,913483,Morgan; Eric,29,0,35,6
1748421453217,COGS 18,A04,913484,Morgan; Eric,32,0,35,3
1748421453217,COGS 18,A05,913485,Morgan; Eric,31,0,35,4
1748421453217,COGS 18,A06,913486,Morgan; Eric,31,0,35,4
1748421453217,COGS 18,A07,913487,Morgan; Eric,30,0,35,5
1748421453217,COGS 18,A08,913488,Morgan; Eric,31,0,35,4
1748421453217,COGS 18,A09,913520,Morgan; Eric,28,0,35,7
1748421453217,COGS 18,B01,968089,Morgan; Eric,34,0,35,1
1748421453217,COGS 18,B02,968090,Morgan; Eric,35,0,35,0
1748421453217,COGS 18,B03,968091,Morgan; Eric,35,0,35,0
1748421453217,COGS 18,B04,968092,Morgan; Eric,35,0,35,0
1748421453217,COGS 18,B05,968093,Morgan; Eric,35,0,35,0
1748421453217,COGS 18,B06,968094,Morgan; Eric,35,0,35,0
1748421453217,COGS 18,B07,968095,Morgan; Eric,35,0,35,0
1748421453217,COGS 18,B08,968096,Morgan; Eric,34,0,35,1
1748421453217,COGS 18,B09,968097,Morgan; Eric,34,0,35,1
1748421454245,COGS 100,A01,913580,Staff,58,0,60,2
1748421454245,COGS 100,A02,913581,Staff,55,0,60,5
1748421454245,COGS 100,A03,913621,Staff,55,0,60,5
1748421454245,COGS 100,A04,913622,Staff,55,0,60,5
1748421454245,COGS 100,A05,913663,Staff,54,0,60,6
1748421455271,COGS 101A,A01,913705,Barrera; Steven James,37,0,50,13
1748421455271,COGS 101A,A02,913709,Barrera; Steven James,35,0,50,15
1748421455271,COGS 101A,A03,913713,Barrera; Steven James,18,0,50,32
1748421455271,COGS 101A,A04,913715,Barrera; Steven James,25,0,50,25
1748421455271,COGS 101A,A05,913718,Barrera; Steven James,44,0,50,6
1748421455271,COGS 101A,A06,913721,Barrera; Steven James,36,0,50,14
1748421455271,COGS 101A,A07,913722,Barrera; Steven James,41,0,50,9
1748421456297,COGS 101B,A01,913725,Hoffman; Drew Ellen,26,0,50,24
1748421456297,COGS 101B,A02,913726,Hoffman; Drew Ellen,44,0,50,6
1748421456297,COGS 101B,A03,913727,Hoffman; Drew Ellen,47,0,50,3
1748421456297,COGS 101B,A04,913730,Hoffman; Drew Ellen,50,0,50,0
1748421457330,COGS 102A,A01,968009,Staff,41,0,48,7
1748421457330,COGS 102A,A02,968010,Staff,36,0,48,12
1748421457330,COGS 102A,A03,968011,Staff,47,0,50,3
1748421458363,COGS 107A,A01,913748,Rangel; Lara M,44,0,56,12
1748421458363,COGS 107A,A02,913750,Rangel; Lara M,43,0,54,11
1748421458363,COGS 107A,A03,913751,Rangel; Lara M,31,0,50,19
1748421458363,COGS 107A,A04,913754,Rangel; Lara M,22,0,50,28
1748421458363,COGS 107A,A05,913755,Rangel; Lara M,27,0,50,23
1748421458363,COGS 107A,A06,913756,Rangel; Lara M,0,0,50,50
1748421459390,COGS 107B,A01,968098,Staff,0,0,50,50
1748421459390,COGS 107B,A02,968099,Staff,6,0,50,44
1748421459390,COGS 107B,A03,968102,Staff,37,0,49,12
1748421460428,COGS 108,A01,913846,Fleischer; Jason G,0,0,56,56
1748421460428,COGS 108,A02,913847,Fleischer; Jason G,17,0,56,39
1748421460428,COGS 108,A03,913858,Fleischer; Jason G,20,0,50,30
1748421460428,COGS 108,A04,913899,Fleischer; Jason G,44,0,55,11
1748421460428,COGS 108,A05,913984,Fleischer; Jason G,29,0,50,21
1748421460428,COGS 108,A06,914035,Fleischer; Jason G,31,0,50,19
1748421460428,COGS 108,A07,914036,Fleischer; Jason G,36,0,50,14
1748421460428,COGS 108,A08,914037,Fleischer; Jason G,44,0,50,6
1748421460428,COGS 108,B01,914039,Fleischer; Jason G,38,0,50,12
1748421460428,COGS 108,B02,914040,Fleischer; Jason G,48,0,50,2
1748421460428,COGS 108,B03,914172,Fleischer; Jason G,32,0,50,18
1748421460428,COGS 108,B04,914182,Fleischer; Jason G,36,0,50,14
1748421460428,COGS 108,B05,914185,Fleischer; Jason G,28,0,50,22
1748421460428,COGS 108,B06,914188,Fleischer; Jason G,19,0,50,31
1748421460428,COGS 108,B07,914209,Fleischer; Jason G,39,0,54,15
1748421460428,COGS 108,B08,914210,Fleischer; Jason G,49,0,56,7
1748421461462,COGS 109,A01,968106,Mukamel; Eran A,30,0,48,18
1748421461462,COGS 109,A02,968107,Mukamel; Eran A,39,0,49,10
1748421461462,COGS 109,A03,968108,Mukamel; Eran A,47,0,49,2
1748421462495,COGS 111,A01,914261,Hoffman; Drew Ellen,34,0,50,16
1748421462495,COGS 111,A02,914262,Hoffman; Drew Ellen,49,0,50,1
1748421462495,COGS 111,A03,914263,Hoffman; Drew Ellen,46,0,50,4
1748421462495,COGS 111,A04,914264,Hoffman; Drew Ellen,28,0,50,22
1748421463522,COGS 115,A01,914266,Deak; Gedeon O.,35,0,70,35
1748421464556,COGS 116,A01,914268,Greene; Deanna Jacquelyn,49,0,70,21
1748421465583,COGS 118A,A01,914270,Tu; Zhuowen,30,0,50,20
1748421465583,COGS 118A,A02,914271,Tu; Zhuowen,31,0,50,19
1748421465583,COGS 118A,A03,914272,Tu; Zhuowen,7,0,50,43
1748421465583,COGS 118A,A04,914273,Tu; Zhuowen,6,0,50,44
1748421466616,COGS 118B,A01,969817,De Sa; Virginia,32,0,49,17
1748421466616,COGS 118B,A02,969818,De Sa; Virginia,34,0,49,15
1748421466616,COGS 118B,A03,969819,De Sa; Virginia,31,0,49,18
1748421466616,COGS 118B,A04,969822,De Sa; Virginia,43,0,49,6
1748421467646,COGS 125,A00,968043,Klemmer; Scott R,48,0,50,2
1748421468673,COGS 128,A01,914278,Staff,16,0,50,34
1748421468673,COGS 128,A02,914279,Staff,0,0,50,50
1748421469711,COGS 143,A01,914284,Johnson; Christine M.,16,0,40,24
1748421470744,COGS 150,A01,968112,Staff,36,0,50,14
1748421470744,COGS 150,A02,968113,Staff,44,0,49,5
1748421470744,COGS 150,A03,968114,Staff,43,0,48,5
1748421471774,COGS 151,A00,968044,Coulson; Seana M,48,0,50,2
1748421472801,COGS 160,A00,914286,Kirsh; David Joel,25,0,25,0
1748421473829,COGS 165,A01,914291,Kiyonaga; Anastasia,0,0,50,50
1748421474857,COGS 187A,A01,914293,Kirsh; David Joel,0,0,50,50
1748421474857,COGS 187A,A02,914294,Kirsh; David Joel,0,0,50,50
1748421474857,COGS 187A,A03,914295,Kirsh; David Joel,16,0,49,33
1748421475884,COGS 189,A00,914296,De Sa; Virginia,119,0,200,81
1748421476911,COGS 190A,A00,914297,Staff,9999,0,9999,0
1748421477939,COGS 194,A00,914298,Hill; Seth J,9999,0,9999,0
1748421478967,COGS 203,A00,914326,Zettersten; Martin,11,0,20,9
1748421480007,COGS 210A,001,914327,Kirsh; David Joel,9999,0,9999,0
1748421480007,COGS 210A,002,914328,Greene; Deanna Jacquelyn,9998,0,9999,1
1748421480007,COGS 210A,003,914329,Xia; Haijun,9998,0,9999,1
1748421480007,COGS 210A,004,914330,Nitz; Douglas A.,9999,0,9999,0
1748421480007,COGS 210A,005,914331,Hollan; James D.,9999,0,9999,0
1748421480007,COGS 210A,006,914332,De Sa; Virginia,9998,0,9999,1
1748421480007,COGS 210A,007,914333,Rossano; Federico,9999,0,9999,0
1748421480007,COGS 210A,008,914334,Kiyonaga; Anastasia,9999,0,9999,0
1748421480007,COGS 210A,009,914335,Coulson; Seana M,9998,0,9999,1
1748421481038,COGS 211A,A00,914336,Boroditsky; Lera,9995,0,9999,4
1748421482066,COGS 230,A00,914337,Munyaka; Imani N. S.,3,0,15,12
1748421483094,COGS 234,A00,970720,Xia; Haijun,4,0,20,16
1748421484122,COGS 260,A00,914340,Voytek; Bradley Thomas,9994,0,9999,5
1748421485151,COMM 10,A01,914366,Whitworth-Smith; Andrew C,6,0,10,4
1748421485151,COMM 10,A02,914367,Whitworth-Smith; Andrew C,7,0,10,3
1748421485151,COMM 10,A03,914368,Whitworth-Smith; Andrew C,9,0,10,1
1748421485151,COMM 10,A04,914369,Whitworth-Smith; Andrew C,6,0,10,4
1748421485151,COMM 10,A05,914370,Whitworth-Smith; Andrew C,10,0,10,0
1748421485151,COMM 10,A06,914371,Whitworth-Smith; Andrew C,9,0,10,1
1748421485151,COMM 10,A07,914372,Whitworth-Smith; Andrew C,9,0,10,1
1748421485151,COMM 10,A08,914373,Whitworth-Smith; Andrew C,7,0,10,3
1748421485151,COMM 10,A09,914374,Whitworth-Smith; Andrew C,9,0,10,1
1748421485151,COMM 10,A10,914375,Whitworth-Smith; Andrew C,10,0,10,0
1748421485151,COMM 10,A11,914376,Whitworth-Smith; Andrew C,6,0,10,4
1748421485151,COMM 10,A12,914377,Whitworth-Smith; Andrew C,10,0,10,0
1748421486176,COMM 20,A01,914385,Hill; Erin Truesdell,75,0,75,0
1748421487203,COMM 40,A00,914386,Jack; Caroline Sarah,61,0,75,14
1748421488230,COMM 50,A00,914387,Staff,21,0,25,4
1748421489261,COMM 80,A01,914389,Staff,77,0,80,3
1748421490289,COMM 100A,A01,914391,Harb; Anthony Joseph,1,0,10,9
1748421490289,COMM 100A,A02,914392,Harb; Anthony Joseph,0,0,10,10
1748421490289,COMM 100A,A03,914393,Harb; Anthony Joseph,0,0,10,10
1748421490289,COMM 100A,A04,914394,Harb; Anthony Joseph,0,0,10,10
1748421490289,COMM 100A,A05,914395,Harb; Anthony Joseph,0,0,10,10
1748421490289,COMM 100A,A06,914396,Harb; Anthony Joseph,0,0,10,10
1748421490289,COMM 100A,A07,914397,Harb; Anthony Joseph,1,0,10,9
1748421490289,COMM 100A,A08,914398,Harb; Anthony Joseph,6,0,10,4
1748421490289,COMM 100A,A09,914399,Harb; Anthony Joseph,7,0,10,3
1748421490289,COMM 100A,A10,914400,Harb; Anthony Joseph,7,0,10,3
1748421491318,COMM 101,A01,914404,Martinico; Daniel J,8,0,15,7
1748421491318,COMM 101,A02,914405,Martinico; Daniel J,2,0,15,13
1748421491318,COMM 101,A03,914406,Martinico; Daniel J,1,0,15,14
1748421491318,COMM 101,A04,914407,Martinico; Daniel J,13,0,15,2
1748421492349,COMM 101K,A00,914408,Staff,0,0,0,0
1748421493377,COMM 101M,A00,914409,Halm; Gavin Patrick,10,0,18,8
1748421494406,COMM 101N,A00,914410,Martinico; Daniel J,4,0,16,12
1748421495434,COMM 101T,A00,914411,Davis; Zeinabu I.,12,0,18,6
1748421496461,COMM 102C,A01,914417,Campion; Camille E,0,0,6,6
1748421496461,COMM 102C,A02,914423,Campion; Camille E,0,0,6,6
1748421496461,COMM 102C,A03,914432,Campion; Camille E,0,0,6,6
1748421497488,COMM 106,A00,914439,Kidman; Shawna F,54,0,70,16
1748421498513,COMM 106F,A00,914442,Hill; Erin Truesdell,23,0,42,19
1748421499578,COMM 106N,A00,914480,Hallin; Daniel C,46,0,70,24
1748421500607,COMM 108D,A00,914491,Goldfarb; Brian,45,0,46,1
1748421501646,COMM 113T,A00,914493,Dominguez Rubio; Fernando,43,0,46,3
1748421502673,COMM 114E,A00,914767,Pavon Aramburu; Maria Laur,41,0,44,3
1748421503705,COMM 114I,A00,914768,Rojo Solis; Juan Jose,39,0,44,5
1748421504736,COMM 115,A00,914769,Alac; Morana,35,0,46,11
1748421505767,COMM 119,A01,914771,Staff,50,0,50,0
1748421506792,COMM 120M,A00,914773,Abuelhiga; Soraya Jill,37,0,44,7
1748421507823,COMM 127,A00,914774,Abuelhiga; Soraya Jill,33,0,44,11
1748421508856,COMM 133,A00,914775,Dewey; Matthew D,35,0,44,9
1748421509887,COMM 134,A00,914777,Kidman; Shawna F,31,0,44,13
1748421510913,COMM 135,A00,914778,Davis; Zeinabu I.,43,0,46,3
1748421511938,COMM 142,A00,914779,McKenna; Denise,22,0,44,22
1748421512971,COMM 146,A00,914780,Halm; Gavin Patrick,34,0,44,10
1748421512971,COMM 146,B00,968068,Ybarra; Megan,41,0,44,3
1748421514003,COMM 148,A00,914785,Staff,0,0,0,0
1748421515029,COMM 164,A00,914786,Dominguez Rubio; Fernando,9,0,25,16
1748421516054,COMM 173,A00,914787,Alac; Morana,4,0,25,21
1748421517085,COMM 177,A00,914788,Rojo Solis; Juan Jose,2,0,25,23
1748421518112,COMM 185,A00,914792,Boateng; Boatema,21,0,25,4
1748421519144,COMM 190,B00,914793,Staff,0,0,23,23
1748421519144,COMM 190,C00,914794,Staff,10,0,23,13
1748421519144,COMM 190,D00,914795,Hassanpour; Anvar,4,0,23,19
1748421520172,COMM 194,A00,954115,Hill; Seth J,9999,0,9999,0
1748421521198,COMM 196A,A00,914796,Dewaard; Andrew Michael,0,0,0,1
1748421522230,CSE 3,A50,914849,Alvarado; Christine J.,49,0,50,1
1748421522230,CSE 3,A51,914850,Alvarado; Christine J.,49,0,50,1
1748421522230,CSE 3,A52,914852,Alvarado; Christine J.,46,0,46,0
1748421523259,CSE 6R,A01,914856,Soosai Raj; Adalbert Geral,238,0,250,12
1748421524342,CSE 8A,A50,914860,Soosai Raj; Adalbert Geral,2,0,3,1
1748421524342,CSE 8A,A51,914868,Soosai Raj; Adalbert Geral,0,0,3,3
1748421524342,CSE 8A,A52,914870,Soosai Raj; Adalbert Geral,1,0,3,2
1748421524342,CSE 8A,A53,914871,Soosai Raj; Adalbert Geral,1,0,3,2
1748421524342,CSE 8A,A54,914872,Soosai Raj; Adalbert Geral,2,0,3,1
1748421524342,CSE 8A,A55,914873,Soosai Raj; Adalbert Geral,2,0,3,1
1748421524342,CSE 8A,A56,914875,Soosai Raj; Adalbert Geral,3,0,3,0
1748421524342,CSE 8A,A57,914876,Soosai Raj; Adalbert Geral,1,0,3,2
1748421525370,CSE 11,A01,958990,Cao; Yingjun,0,0,50,50
1748421525370,CSE 11,B01,959775,Ochoa; Benjamin Lawrence,103,0,115,12
1748421526399,CSE 12,A01,958991,Cao; Yingjun,0,0,100,100
1748421527426,CSE 20,A01,959784,Jones; Miles E,0,0,25,25
1748421527426,CSE 20,A02,968053,Jones; Miles E,1,0,25,24
1748421528460,CSE 21,A01,959776,Jones; Miles E,0,0,30,30
1748421528460,CSE 21,A02,968059,Jones; Miles E,3,0,30,27
1748421529489,CSE 29,A50,914888,Politz; Joseph Gibbs,0,0,10,10
1748421529489,CSE 29,A51,914889,Politz; Joseph Gibbs,0,0,10,10
1748421529489,CSE 29,A52,914891,Politz; Joseph Gibbs,0,0,10,10
1748421529489,CSE 29,A53,914892,Politz; Joseph Gibbs,0,0,10,10
1748421529489,CSE 29,B50,914897,Shalev; Aaron D,0,0,10,10
1748421529489,CSE 29,B51,914898,Shalev; Aaron D,0,0,10,10
1748421529489,CSE 29,B52,914900,Shalev; Aaron D,0,0,10,10
1748421529489,CSE 29,B53,914901,Shalev; Aaron D,0,0,10,10
1748421530522,CSE 30,A01,959778,Eldon; John,0,0,15,15
1748421531555,CSE 87,A00,914904,Moshiri; Niema,20,0,20,0
1748421532586,CSE 89,A00,914906,Minnes Kemp; Mor Mia,100,0,100,0
1748421532586,CSE 89,B00,969276,Minnes Kemp; Mor Mia,100,0,100,0
1748421533612,CSE 95,A00,914907,Cao; Yingjun,100,0,100,0
1748421534642,CSE 100,A01,959787,Moshiri; Niema,0,0,75,75
1748421535669,CSE 100R,A01,914911,Moshiri; Niema,0,0,125,125
1748421536696,CSE 101,A01,958995,Impagliazzo; Russell,0,0,30,30
1748421536696,CSE 101,A02,958998,Impagliazzo; Russell,0,0,30,30
1748421536696,CSE 101,A03,959000,Impagliazzo; Russell,0,0,30,30
1748421536696,CSE 101,B01,959777,Liu; Qipeng,94,0,175,81
1748421537728,CSE 103,A01,959001,Freund; Yoav,69,0,96,27
1748421538760,CSE 105,A01,959785,Lovett; Shachar,0,0,45,45
1748421539789,CSE 107,A01,959002,Bellare; Mihir,81,0,96,15
1748421540818,CSE 110,A50,914923,Coblenz; Michael J,10,0,50,40
1748421540818,CSE 110,A51,914925,Coblenz; Michael J,18,0,50,32
1748421540818,CSE 110,A52,914926,Coblenz; Michael J,44,0,50,6
1748421540818,CSE 110,A53,914928,Coblenz; Michael J,33,0,50,17
1748421540818,CSE 110,A54,914930,Coblenz; Michael J,42,0,50,8
1748421540818,CSE 110,A55,914931,Coblenz; Michael J,36,0,45,9
1748421541845,CSE 118,A50,914934,Weibel; Nadir,16,0,25,9
1748421542872,CSE 120,A01,959780,Voelker; Geoffrey M.,130,0,295,165
1748421543905,CSE 127,A01,959795,Savage; Stefan,88,0,192,104
1748421544938,CSE 130,A01,959003,Polikarpova; Nadezhda,118,0,145,27
1748421545968,CSE 131,A01,914941,Politz; Joseph Gibbs,33,0,50,17
1748421546994,CSE 132A,A01,959790,Gupta; Amarnath,141,0,196,55
1748421548021,CSE 134B,A01,959005,Powell; Thomas Allan,115,0,146,31
1748421549049,CSE 140,A01,914947,Orailoglu; Alex,124,0,146,22
1748421550076,CSE 140L,A01,914949,Orailoglu; Alex,112,0,146,34
1748421551103,CSE 141,A01,959006,Pannuto; Patrick William,79,0,146,67
1748421552132,CSE 141L,A01,961134,Eldon; John,75,0,146,71
1748421553163,CSE 142,A01,959781,Swanson; Steven James,250,0,295,45
1748421554194,CSE 150A,A01,959774,Bonjour; Trevor,101,0,225,124
1748421555225,CSE 150B,A01,959791,Solares; Edwin A,187,0,196,9
1748421556253,CSE 151A,A01,959782,Dasgupta; Sanjoy,187,0,250,63
1748421556253,CSE 151A,B01,959783,Dasgupta; Sanjoy,226,0,250,24
1748421557283,CSE 152A,A01,959792,Su; Hao,0,0,0,0
1748421558311,CSE 158,A01,959793,McAuley; Julian John,100,0,196,96
1748421559343,CSE 158R,A01,914961,McAuley; Julian John,449,0,550,101
1748421559343,CSE 158R,B01,968064,McAuley; Julian John,100,0,100,0
1748421560376,CSE 167,A01,959796,Li; Tzumao,110,0,192,82
1748421561406,CSE 170,A01,914965,Vaccaro; Kristen Marie,13,0,20,7
1748421561406,CSE 170,A02,914967,Vaccaro; Kristen Marie,0,0,20,20
1748421561406,CSE 170,A03,914968,Vaccaro; Kristen Marie,17,0,20,3
1748421561406,CSE 170,A04,914969,Vaccaro; Kristen Marie,15,0,20,5
1748421561406,CSE 170,A05,914970,Vaccaro; Kristen Marie,17,0,20,3
1748421561406,CSE 170,A06,914971,Vaccaro; Kristen Marie,18,0,20,2
1748421561406,CSE 170,A07,914972,Vaccaro; Kristen Marie,16,0,19,3
1748421561406,CSE 170,A08,914973,Vaccaro; Kristen Marie,1,0,19,18
1748421561406,CSE 170,A09,914974,Vaccaro; Kristen Marie,8,0,19,11
1748421561406,CSE 170,A10,969577,Vaccaro; Kristen Marie,18,0,19,1
1748421562433,CSE 190,A00,914975,Vaccaro; Kristen Marie,146,0,146,0
1748421563458,CSE 191,A00,914976,Minnes Kemp; Mor Mia,9999,0,9999,0
1748421564484,CSE 193,A01,959007,Bonjour; Trevor,50,0,50,0
1748421565519,CSE 194,A01,959009,Munyaka; Imani N. S.,6,0,60,54
1748421566545,CSE 197,001,914980,Minnes Kemp; Mor Mia,9999,0,9999,0
1748421567577,CSE 202,A00,914981,Liu; Qipeng,0,0,0,0
1748421568606,CSE 206A,A00,914982,Micciancio; Daniele,0,0,0,0
1748421569634,CSE 207B,A00,914983,Heninger; Nadia A,0,0,0,0
1748421570661,CSE 209A,A00,914984,Impagliazzo; Russell,0,0,0,0
1748421571691,CSE 209B,A00,914985,Bellare; Mihir,0,0,0,0
1748421572718,CSE 210,A00,914986,Powell; Thomas Allan,0,0,0,0
1748421573752,CSE 216,A00,914987,Munyaka; Imani N. S.,0,0,0,0
1748421574778,CSE 221,A00,914988,Ousterhout; Amy,0,0,0,0
1748421575806,CSE 227,A00,914989,Fernandes; Earlence T,0,0,0,0
1748421576837,CSE 229A,A00,914990,Snoeren; Alex C.,0,0,0,0
1748421577864,CSE 229C,A00,914993,Fernandes; Earlence T,0,0,0,0
1748421578892,CSE 237C,A00,914994,Kastner; Ryan Charles,0,0,0,0
1748421579922,CSE 239B,A00,914996,D'Antoni; Loris,0,0,0,0
1748421580950,CSE 240A,A00,914997,Tullsen; Dean Michael,0,0,0,0
1748421581977,CSE 249E,A00,914998,Pannuto; Patrick William,0,0,0,0
1748421583010,CSE 250A,A00,914999,Bonjour; Trevor,0,0,0,0
1748421584036,CSE 252A,A00,915000,Ochoa; Benjamin Lawrence,0,0,0,0
1748421585071,CSE 258,A01,959794,McAuley; Julian John,0,0,0,0
1748421586099,CSE 258R,A01,915004,McAuley; Julian John,0,0,0,0
1748421587125,CSE 259,A00,915005,Prithviraj; Ammanabrolu,0,0,0,0
1748421588151,CSE 260,A01,959011,Chin; Bryan W.,0,0,0,0
1748421589179,CSE 270,A01,959012,Chern; Albert Ren-Haur,0,0,0,0
1748421590209,CSE 276A,A00,915009,Christensen; Henrik I,0,0,0,0
1748421591247,CSE 290,A00,915013,Bafna; Vineet,0,0,0,0
1748421591247,CSE 290,B00,915014,Nakashole; Ndapandula,0,0,0,0
1748421591247,CSE 290,C00,915015,Ramamoorthi; Ravi,0,0,0,0
1748421591247,CSE 290,D00,915017,Tullsen; Dean Michael,0,0,0,0
1748421591247,CSE 290,F00,915020,Vaccaro; Kristen Marie,0,0,0,0
1748421592278,CSE 291A,A00,915021,Yu; Qi,0,0,0,0
1748421592278,CSE 291A,B00,915022,Weibel; Nadir,0,0,0,0
1748421592278,CSE 291A,C00,915049,Munyaka; Imani N. S.,0,0,0,0
1748421592278,CSE 291A,D00,968730,Zhang; Yiying,0,0,0,0
1748421593311,CSE 291P,A00,915050,D'Antoni; Loris,0,0,0,0
1748421593311,CSE 291P,B00,915051,Ding; Yufei,0,0,0,0
1748421594340,CSE 291T,A00,915052,Grier; Daniel T,0,0,0,0
1748421594340,CSE 291T,B00,915053,Heninger; Nadia A,0,0,0,0
1748421595370,CSE 291Y,A00,915054,Fernandes; Earlence T,0,0,0,0
1748421596396,CSE 292,A00,968504,Ousterhout; Amy,0,0,0,0
1748421597492,CSE 293,001,968115,Bafna; Vineet,9999,0,9999,0
1748421597492,CSE 293,002,968116,Bellare; Mihir,9999,0,9999,0
1748421597492,CSE 293,003,968122,Berg-Kirkpatrick; Taylor D,9999,0,9999,0
1748421597492,CSE 293,004,968298,Chandraker; Manmohan Krishna,9999,0,9999,0
1748421597492,CSE 293,005,968317,Cheng; Chung Kuan,9999,0,9999,0
1748421597492,CSE 293,006,968334,Christensen; Henrik I,9999,0,9999,0
1748421597492,CSE 293,007,968339,Coblenz; Michael J,9999,0,9999,0
1748421597492,CSE 293,008,968345,Cottrell; Garrison W,9999,0,9999,0
1748421597492,CSE 293,009,968346,Deutsch; Alin Bernard,9999,0,9999,0
1748421597492,CSE 293,010,968357,Esmaeilzadeh; Hadi,9999,0,9999,0
1748421597492,CSE 293,011,968359,Freund; Yoav,9999,0,9999,0
1748421597492,CSE 293,012,968427,Griswold; William G.,9999,0,9999,0
1748421597492,CSE 293,013,968472,Gymrek; Melissa Ann,9999,0,9999,0
1748421597492,CSE 293,014,968473,Heninger; Nadia A,9999,0,9999,0
1748421597492,CSE 293,015,968480,Impagliazzo; Russell,9999,0,9999,0
1748421597492,CSE 293,016,968489,Jhala; Ranjit,9999,0,9999,0
1748421597492,CSE 293,017,968490,Kahng; Andrew Byun,9999,0,9999,0
1748421597492,CSE 293,018,968494,Kane; Daniel Mertz,9999,0,9999,0
1748421597492,CSE 293,019,968495,Kriegman; David J,9999,0,9999,0
1748421597492,CSE 293,020,968496,Kumar; Arun Kumar,9999,0,9999,0
1748421597492,CSE 293,021,968497,Lerner; Sorin,9999,0,9999,0
1748421597492,CSE 293,022,968498,Lovett; Shachar,9999,0,9999,0
1748421597492,CSE 293,023,968499,McAuley; Julian John,9999,0,9999,0
1748421597492,CSE 293,024,968501,Micciancio; Daniele,9999,0,9999,0
1748421597492,CSE 293,025,968502,Orailoglu; Alex,9999,0,9999,0
1748421597492,CSE 293,026,968503,Pannuto; Patrick William,9999,0,9999,0
1748421597492,CSE 293,027,968505,Paturi; Ramamohan,9999,0,9999,0
1748421597492,CSE 293,028,968506,Polikarpova; Nadezhda,9999,0,9999,0
1748421597492,CSE 293,029,968507,Politz; Joseph Gibbs,9999,0,9999,0
1748421597492,CSE 293,030,968508,Porter; George M,9999,0,9999,0
1748421597492,CSE 293,031,968509,Porter; Leonard Emerson,9999,0,9999,0
1748421597492,CSE 293,032,968510,Ramamoorthi; Ravi,9999,0,9999,0
1748421597492,CSE 293,033,968511,Riek; Laurel D,9999,0,9999,0
1748421597492,CSE 293,034,968512,Sahoo; Debashis,9999,0,9999,0
1748421597492,CSE 293,035,968513,Saul; Lawrence,9999,0,9999,0
1748421597492,CSE 293,036,968514,Savage; Stefan,9999,0,9999,0
1748421597492,CSE 293,037,968515,Schulze; Jurgen P.,9999,0,9999,0
1748421597492,CSE 293,038,968516,Snoeren; Alex C.,9999,0,9999,0
1748421597492,CSE 293,039,968517,Shang; Jingbo,9999,0,9999,0
1748421597492,CSE 293,040,968575,Stefan; Deian,9999,0,9999,0
1748421597492,CSE 293,041,968580,Su; Hao,9999,0,9999,0
1748421597492,CSE 293,042,968589,Swanson; Steven James,9999,0,9999,0
1748421597492,CSE 293,043,968639,Tullsen; Dean Michael,9999,0,9999,0
1748421597492,CSE 293,044,968674,Vaccaro; Kristen Marie,9999,0,9999,0
1748421597492,CSE 293,045,968681,Voelker; Geoffrey M.,9999,0,9999,0
1748421597492,CSE 293,046,968692,Zhao; Jishen,9999,0,9999,0
1748421597492,CSE 293,047,968694,Zhou; Yuan-Yuan,9999,0,9999,0
1748421597492,CSE 293,048,968702,Gao; Sicun,9999,0,9999,0
1748421597492,CSE 293,049,968703,Weibel; Nadir,9999,0,9999,0
1748421597492,CSE 293,050,968704,Gupta; Rajesh K.,9999,0,9999,0
1748421597492,CSE 293,051,968705,Soosai Raj; Adalbert Geral,9999,0,9999,0
1748421598522,CSE 294,A00,915055,Orailoglu; Alex,0,0,0,0
1748421599554,CSS 1,A01,958041,Staff,31,0,41,10
1748421599554,CSS 1,A02,958042,Staff,41,0,41,0
1748421599554,CSS 1,A03,958043,Staff,33,0,41,8
1748421599554,CSS 1,A04,958044,Staff,39,0,41,2
1748421600581,CSS 120,A01,915059,Staff,0,0,0,0
1748421601612,CSS 204,A01,915061,Long; Bria,0,0,0,0
1748421602642,CSS 209,A00,915062,Staff,14,0,40,26
1748421603677,DDPM 200,A00,919742,Ma; Joseph David,35,0,35,0
1748421604707,DDPM 201,A00,919743,Ma; Joseph David,35,0,35,0
1748421605738,DDPM 202,A00,919761,Reed; Chantal,35,0,35,0
1748421606766,DDPM 203,A00,963085,Momper; Jeremiah D,40,0,40,0
1748421607813,DOC 1,A01,916077,Staff,4,0,4,0
1748421607813,DOC 1,A02,916080,Staff,1,0,4,3
1748421607813,DOC 1,A03,916081,Staff,1,0,4,3
1748421607813,DOC 1,A04,916082,Staff,3,0,4,1
1748421607813,DOC 1,A05,916083,Staff,2,0,4,2
1748421607813,DOC 1,A06,916084,Staff,4,0,4,0
1748421607813,DOC 1,A07,916085,Staff,4,0,4,0
1748421607813,DOC 1,A08,916096,Staff,4,0,4,0
1748421607813,DOC 1,A09,916097,Staff,4,0,4,0
1748421607813,DOC 1,A10,916099,Staff,4,0,4,0
1748421607813,DOC 1,A11,916170,Staff,0,0,0,0
1748421607813,DOC 1,A12,916186,Staff,0,0,0,0
1748421607813,DOC 1,A13,916203,Staff,4,0,4,0
1748421607813,DOC 1,A14,916222,Staff,4,0,4,0
1748421607813,DOC 1,A15,916223,Staff,4,0,4,0
1748421607813,DOC 1,A16,916224,Staff,4,0,4,0
1748421607813,DOC 1,B01,916279,Staff,4,0,4,0
1748421607813,DOC 1,B02,916281,Staff,2,0,4,2
1748421607813,DOC 1,B03,916282,Staff,3,0,4,1
1748421607813,DOC 1,B04,916283,Staff,3,0,4,1
1748421607813,DOC 1,B05,916284,Staff,2,0,4,2
1748421607813,DOC 1,B06,916285,Staff,3,0,4,1
1748421607813,DOC 1,B07,916287,Staff,4,0,4,0
1748421607813,DOC 1,B08,916288,Staff,3,0,4,1
1748421607813,DOC 1,B09,916289,Staff,0,0,0,0
1748421607813,DOC 1,B10,916290,Staff,0,0,0,0
1748421607813,DOC 1,B11,916349,Staff,4,0,4,0
1748421607813,DOC 1,B12,916375,Staff,4,0,4,0
1748421607813,DOC 1,B13,916381,Staff,3,0,4,1
1748421607813,DOC 1,B14,916382,Staff,2,0,4,2
1748421607813,DOC 1,B15,916383,Staff,4,0,4,0
1748421607813,DOC 1,B16,916384,Staff,3,0,4,1
1748421607813,DOC 1,C01,916386,Staff,4,0,4,0
1748421607813,DOC 1,C02,916387,Staff,4,0,4,0
1748421607813,DOC 1,C03,916388,Staff,4,0,4,0
1748421607813,DOC 1,C04,916389,Staff,0,0,4,4
1748421607813,DOC 1,C05,916390,Staff,2,0,4,2
1748421607813,DOC 1,C06,916391,Staff,2,0,4,2
1748421607813,DOC 1,C07,916392,Staff,4,0,4,0
1748421607813,DOC 1,C08,916417,Staff,4,0,4,0
1748421607813,DOC 1,C09,916418,Staff,0,0,0,0
1748421607813,DOC 1,C10,916426,Staff,0,0,0,0
1748421607813,DOC 1,C11,916497,Staff,4,0,4,0
1748421607813,DOC 1,C12,916506,Staff,3,0,4,1
1748421607813,DOC 1,C13,916507,Staff,3,0,4,1
1748421607813,DOC 1,C14,916508,Staff,3,0,4,1
1748421607813,DOC 1,C15,916509,Staff,4,0,4,0
1748421607813,DOC 1,C16,916510,Staff,4,0,4,0
1748421607813,DOC 1,D01,916512,Staff,4,0,4,0
1748421607813,DOC 1,D02,916513,Staff,4,0,4,0
1748421607813,DOC 1,D03,916514,Staff,4,0,4,0
1748421607813,DOC 1,D04,916515,Staff,4,0,4,0
1748421607813,DOC 1,D05,916516,Staff,1,0,4,3
1748421607813,DOC 1,D06,916555,Staff,4,0,4,0
1748421607813,DOC 1,D07,916581,Staff,4,0,4,0
1748421607813,DOC 1,D08,916582,Staff,4,0,4,0
1748421607813,DOC 1,D09,916583,Staff,0,0,0,0
1748421607813,DOC 1,D10,916584,Staff,0,0,0,0
1748421607813,DOC 1,D11,916585,Staff,4,0,4,0
1748421607813,DOC 1,D12,916586,Staff,4,0,4,0
1748421607813,DOC 1,D13,916587,Staff,4,0,4,0
1748421607813,DOC 1,D14,916588,Staff,4,0,4,0
1748421607813,DOC 1,D15,916589,Staff,3,0,4,1
1748421607813,DOC 1,D16,916590,Staff,4,0,4,0
1748421608849,DOC 100D,A00,916591,Pass; Natalye,22,0,25,3
1748421608849,DOC 100D,B00,916838,Pass; Natalye,22,0,25,3
1748421609886,DSC 10,A01,915848,Tiefenbruck; Janine LoBue,0,0,0,0
1748421609886,DSC 10,B01,915851,Tiefenbruck; Janine LoBue,0,0,0,0
1748421609886,DSC 10,C01,915854,Tiefenbruck; Janine LoBue,0,0,0,0
1748421610914,DSC 20,A01,915857,Langlois; Marina,87,0,90,3
1748421611941,DSC 30,A01,915859,Liao; Soohyun Nam,175,0,180,5
1748421612967,DSC 40A,A01,915861,Mishne; Gal,167,0,180,13
1748421613998,DSC 40B,A01,915863,Langlois; Marina,126,0,149,23
1748421615024,DSC 80,A01,915865,Eldridge; Justin Matthew,117,0,145,28
1748421615024,DSC 80,B01,915867,Eldridge; Justin Matthew,140,0,145,5
1748421616050,DSC 95,A01,915869,Langlois; Marina,50,0,50,0
1748421617080,DSC 100,A01,915871,Shannon; Kyle Michael,97,0,150,53
1748421618107,DSC 102,A01,915890,Kolovos; Alexandros,128,0,150,22
1748421619136,DSC 106,A01,915892,Lau; Samuel Ethan,74,0,90,16
1748421619136,DSC 106,B01,915894,Lau; Samuel Ethan,53,0,90,37
1748421620165,DSC 140A,A01,915896,Ustun; Tevfik Berk,135,0,150,15
1748421621192,DSC 161,A00,968072,Roberts; Margaret Earling,24,0,25,1
1748421622225,DSC 180A,A01,915898,Bellur; Umesh,0,0,0,0
1748421622225,DSC 180A,A02,969828,Bellur; Umesh,0,0,0,0
1748421622225,DSC 180A,A03,969829,Bellur; Umesh,0,0,0,0
1748421622225,DSC 180A,A04,969830,Bellur; Umesh,0,0,0,0
1748421622225,DSC 180A,A05,969831,Bellur; Umesh,0,0,0,0
1748421622225,DSC 180A,A06,969833,Bellur; Umesh,0,0,0,0
1748421622225,DSC 180A,A07,969835,Bellur; Umesh,0,0,0,0
1748421622225,DSC 180A,A08,969836,Bellur; Umesh,0,0,0,0
1748421622225,DSC 180A,A09,969978,Bellur; Umesh,0,0,0,0
1748421622225,DSC 180A,A10,969985,Bellur; Umesh,0,0,0,0
1748421622225,DSC 180A,A11,969986,Bellur; Umesh,0,0,0,0
1748421622225,DSC 180A,A12,970002,Bellur; Umesh,0,0,0,0
1748421622225,DSC 180A,A13,970008,Bellur; Umesh,0,0,0,0
1748421622225,DSC 180A,A14,970011,Bellur; Umesh,0,0,0,0
1748421622225,DSC 180A,A15,970014,Bellur; Umesh,0,0,0,0
1748421622225,DSC 180A,A16,970019,Bellur; Umesh,0,0,0,0
1748421622225,DSC 180A,A17,970020,Bellur; Umesh,0,0,0,0
1748421622225,DSC 180A,B01,915901,Bellur; Umesh,0,0,0,0
1748421622225,DSC 180A,B02,915902,Bellur; Umesh,0,0,0,0
1748421622225,DSC 180A,B03,970021,Bellur; Umesh,0,0,0,0
1748421622225,DSC 180A,B04,970024,Bellur; Umesh,0,0,0,0
1748421622225,DSC 180A,B05,970025,Bellur; Umesh,0,0,0,0
1748421622225,DSC 180A,B06,970028,Bellur; Umesh,0,0,0,0
1748421622225,DSC 180A,B07,970030,Bellur; Umesh,0,0,0,0
1748421622225,DSC 180A,B08,970031,Bellur; Umesh,0,0,0,0
1748421622225,DSC 180A,B09,970034,Bellur; Umesh,0,0,0,0
1748421622225,DSC 180A,B10,970035,Bellur; Umesh,0,0,0,0
1748421622225,DSC 180A,B11,970042,Bellur; Umesh,0,0,0,0
1748421622225,DSC 180A,B12,970043,Bellur; Umesh,0,0,0,0
1748421622225,DSC 180A,B13,970047,Bellur; Umesh,0,0,0,0
1748421622225,DSC 180A,B14,970049,Bellur; Umesh,0,0,0,0
1748421622225,DSC 180A,B15,970050,Bellur; Umesh,0,0,0,0
1748421622225,DSC 180A,B16,970052,Bellur; Umesh,0,0,0,0
1748421622225,DSC 180A,B17,970057,Bellur; Umesh,0,0,0,0
1748421622225,DSC 180A,B18,970060,Bellur; Umesh,0,0,0,0
1748421622225,DSC 180A,B19,970063,Bellur; Umesh,0,0,0,0
1748421622225,DSC 180A,B20,970068,Bellur; Umesh,0,0,0,0
1748421622225,DSC 180A,B21,970070,Bellur; Umesh,0,0,0,0
1748421622225,DSC 180A,B22,970071,Bellur; Umesh,0,0,0,0
1748421622225,DSC 180A,B23,970075,Bellur; Umesh,0,0,0,0
1748421622225,DSC 180A,B24,970076,Bellur; Umesh,0,0,0,0
1748421622225,DSC 180A,B25,970083,Bellur; Umesh,0,0,0,0
1748421622225,DSC 180A,B26,970072,Bellur; Umesh,0,0,0,0
1748421623255,DSC 190,A01,915904,Schwartzman; Armin,176,0,200,24
1748421623255,DSC 190,C01,915908,Ma; Yian,48,0,60,12
1748421624287,DSC 197,001,971692,Eldridge; Justin Matthew,9999,0,9999,0
1748421625315,DSC 200,A00,915909,Watson-Parris; Duncan,0,0,100,100
1748421626342,DSC 204A,A00,915910,Zhang; Hao,65,0,90,25
1748421627373,DSC 207R,A01,915912,Soosai Raj; Adalbert Geral,99,0,100,1
1748421628456,DSC 209R,A01,915922,Lau; Samuel Ethan,34,0,75,41
1748421629486,DSC 210,A00,915979,Weng; Tsui-Wei (lily),0,0,100,100
1748421630517,DSC 212,A00,915984,Mazumdar; Arya,0,0,90,90
1748421631594,DSC 215R,A01,916032,Saab; Rayan,99,0,100,1
1748421633648,DSC 241,A00,916052,Aoi; Mikio C,81,0,90,9
1748421634676,DSC 256R,A01,916054,McAuley; Julian John,42,0,100,58
1748421635707,DSC 257R,A01,916057,Dasgupta; Sanjoy,50,0,75,25
1748421636736,DSC 261,A00,916058,Salimi; Babak,0,0,90,90
1748421637764,DSC 291,A00,916059,Rahman; Tauhidur,0,0,60,60
1748421637764,DSC 291,B00,916060,Wang; Yuxiang,0,0,60,60
1748421637764,DSC 291,C00,916061,Li; Aobo,0,0,40,40
1748421638793,DSC 293,A00,916062,Ustun; Tevfik Berk,9983,0,9999,16
1748421639834,DSC 294,001,970730,Danks; David J,9999,0,9999,0
1748421639834,DSC 294,002,970731,Hu; Zhiting,9999,0,9999,0
1748421639834,DSC 294,003,970732,Schwartzman; Armin,9999,0,9999,0
1748421639834,DSC 294,004,970739,Salimi; Babak,9999,0,9999,0
1748421639834,DSC 294,005,970742,Wang; Yuxiang,9999,0,9999,0
1748421639834,DSC 294,006,970749,Huang; Biwei,9999,0,9999,0
1748421639834,DSC 294,007,970751,Amariuta-Bartell; Tiffany,9999,0,9999,0
1748421639834,DSC 294,008,970754,Smarr; Benjamin,9999,0,9999,0
1748421639834,DSC 294,009,970755,Jin; Haojian,9999,0,9999,0
1748421639834,DSC 294,010,970758,Ma; Yian,9999,0,9999,0
1748421639834,DSC 294,011,970763,Warstadt; Alexander Scott,9999,0,9999,0
1748421639834,DSC 294,012,970764,Wang; Yusu,9999,0,9999,0
1748421639834,DSC 294,013,970766,Lau; Samuel Ethan,9999,0,9999,0
1748421639834,DSC 294,014,970771,Politis; Dimitris,9999,0,9999,0
1748421640862,DSE 200,A00,915842,Staff,30,0,30,0
1748421641891,DSE 203,A00,915844,Staff,20,0,20,0
1748421642919,DSE 220,A00,915845,Staff,20,0,20,0
1748421643945,DSE 290,A00,915846,Staff,30,0,30,0
1748421644979,DSGN 1,A01,913417,Meyer; Michael Wayne,0,0,50,50
1748421644979,DSGN 1,A02,913418,Meyer; Michael Wayne,15,0,50,35
1748421647040,DSGN 118,A01,914325,Xia; Haijun,0,0,50,50
1748421648067,DSGN 201,A00,970721,Eikey; Elizabeth Victoria,10,0,20,10
1748421649105,ECE 5,A01,917741,Morris; Karcher William,0,0,0,0
1748421649105,ECE 5,A02,917742,Morris; Karcher William,0,0,0,0
1748421649105,ECE 5,A03,917775,Morris; Karcher William,0,0,0,0
1748421649105,ECE 5,A04,917804,Morris; Karcher William,0,0,0,0
1748421649105,ECE 5,A05,917811,Morris; Karcher William,0,0,0,0
1748421649105,ECE 5,A06,917816,Morris; Karcher William,0,0,0,0
1748421650137,ECE 15,A01,917850,Schurgers; Curt,0,0,0,0
1748421650137,ECE 15,A02,917851,Schurgers; Curt,0,0,0,0
1748421651168,ECE 17,A01,917878,Sahay; Rajeev,61,0,65,4
1748421652198,ECE 18,A01,917886,Sahay; Rajeev,42,0,50,8
1748421653227,ECE 25,A50,917898,Liu; Zhaowei,0,0,0,0
1748421653227,ECE 25,A51,917900,Liu; Zhaowei,0,0,0,0
1748421653227,ECE 25,A52,917904,Liu; Zhaowei,0,0,0,0
1748421653227,ECE 25,A53,969573,Liu; Zhaowei,0,0,0,0
1748421654256,ECE 30,A50,917909,Mir Arabbaygi; Siavash,11,0,30,19
1748421654256,ECE 30,A51,917910,Mir Arabbaygi; Siavash,21,0,30,9
1748421654256,ECE 30,A52,917912,Mir Arabbaygi; Siavash,29,0,30,1
1748421655298,ECE 35,A50,917993,Schurgers; Curt,0,0,0,0
1748421655298,ECE 35,A51,917994,Schurgers; Curt,0,0,0,0
1748421655298,ECE 35,A52,918000,Schurgers; Curt,0,0,0,0
1748421655298,ECE 35,A53,918001,Schurgers; Curt,0,0,0,0
1748421655298,ECE 35,A54,918072,Schurgers; Curt,0,0,0,0
1748421655298,ECE 35,A55,918078,Schurgers; Curt,0,0,0,0
1748421655298,ECE 35,B50,918131,Schurgers; Curt,0,0,0,0
1748421655298,ECE 35,B51,918135,Schurgers; Curt,0,0,0,0
1748421655298,ECE 35,B52,918146,Schurgers; Curt,0,0,0,0
1748421655298,ECE 35,B53,918147,Schurgers; Curt,0,0,0,0
1748421655298,ECE 35,B54,918148,Schurgers; Curt,0,0,0,0
1748421655298,ECE 35,B55,918149,Schurgers; Curt,0,0,0,0
1748421656330,ECE 45,A01,918151,Zeger; Kenneth A.,94,0,120,26
1748421657365,ECE 65,A50,918356,Baghdadchi; Saharnaz,1,0,30,29
1748421657365,ECE 65,A51,918470,Baghdadchi; Saharnaz,17,0,30,13
1748421657365,ECE 65,A52,918477,Baghdadchi; Saharnaz,25,0,30,5
1748421658394,ECE 100,A01,918485,Baghdadchi; Saharnaz,0,0,30,30
1748421658394,ECE 100,A02,918486,Baghdadchi; Saharnaz,1,0,30,29
1748421658394,ECE 100,A03,918488,Baghdadchi; Saharnaz,1,0,30,29
1748421658394,ECE 100,A04,918490,Baghdadchi; Saharnaz,22,0,30,8
1748421659426,ECE 101,A01,918495,Zheng; Yang,22,0,75,53
1748421659426,ECE 101,A02,918497,Zheng; Yang,51,0,75,24
1748421660455,ECE 102,A00,918499,Hsueh; Tzu-Chien,52,0,100,48
1748421661482,ECE 103,A01,918621,Ng; Tse Nga,45,0,60,15
1748421662510,ECE 107,A01,918642,Fullerton; Eric E,31,0,70,39
1748421663543,ECE 108,A01,918661,Turakhia; Yatish Girish,6,0,70,64
1748421664577,ECE 109,A01,918758,Poveda Fonseca; Jorge,122,0,149,27
1748421665608,ECE 111,A01,918766,Koushanfar; Farinaz,46,0,75,29
1748421666645,ECE 121A,A50,918857,Esmaili; Gholamreza,11,0,24,13
1748421666645,ECE 121A,A51,918888,Esmaili; Gholamreza,15,0,24,9
1748421666645,ECE 121A,A52,918889,Esmaili; Gholamreza,2,0,24,22
1748421667671,ECE 128A,A00,918911,Esmaili; Gholamreza,53,0,75,22
1748421668698,ECE 135A,A01,918931,Kuzum; Duygu,24,0,40,16
1748421669725,ECE 143,A00,918936,Staff,0,0,0,3
1748421670751,ECE 148,A01,918940,Silberman; Jack,14,0,24,10
1748421671782,ECE 155,A01,919022,Gonzalez Prelcic; Nuria,20,0,25,5
1748421672817,ECE 158A,A01,919041,Javidi; Tara,58,0,70,12
1748421673844,ECE 161A,A01,919070,Meyer; Florian,65,0,80,15
1748421674872,ECE 164,A00,919098,Hall; Drew A.,100,0,146,46
1748421675901,ECE 166,A50,919250,Rebeiz; Gabriel,0,0,30,30
1748421675901,ECE 166,A51,919254,Rebeiz; Gabriel,23,0,30,7
1748421675901,ECE 166,A52,919262,Rebeiz; Gabriel,29,0,30,1
1748421675901,ECE 166,A53,919316,Rebeiz; Gabriel,28,0,30,2
1748421676933,ECE 171B,A01,919338,Shi; Yuanyuan,36,0,50,14
1748421677964,ECE 174,A01,919371,Wang; Jun-Kun,77,0,100,23
1748421678995,ECE 180,A00,968047,Fainman; Yeshaiahu,30,0,30,0
1748421680022,ECE 182,A01,962444,Fainman; Yeshaiahu,24,0,30,6
1748421681053,ECE 197,001,919379,Mercier; Patrick Philip,9999,0,9999,0
1748421682081,ECE 198,001,919418,Nguyen; Truong Quang,9999,0,9999,0
1748421683109,ECE 201,A00,919420,Lo; Yu-Hwa,0,0,0,0
1748421684140,ECE 203,A01,919506,Mercier; Patrick Philip,0,0,0,0
1748421685167,ECE 207A,A00,919507,Liu; Thomas Tao-Ming & McVeigh; Elliot R.,0,0,0,0
1748421686194,ECE 212AN,A00,919508,Nomura; Kenji,0,0,0,0
1748421687222,ECE 222A,A00,919524,Rebeiz; Gabriel,0,0,0,0
1748421688249,ECE 225A,A00,919525,Orlitsky; Alon,0,0,0,0
1748421689274,ECE 230A,A00,919526,Nomura; Kenji,0,0,0,0
1748421690303,ECE 238A,A00,919540,Luo; Jian,0,0,0,0
1748421691330,ECE 240A,A00,919541,Ndao; Abdoulaye,0,0,0,0
1748421692363,ECE 247A,A00,919553,Shi; Lingyan,0,0,0,0
1748421693389,ECE 247B,A00,919562,Aran; Kiana,0,0,0,0
1748421694415,ECE 250,A00,919563,Naghizadeh Ardabili; Parinaz,0,0,0,0
1748421695443,ECE 251C,A00,919583,Parhi; Rahul,0,0,0,0
1748421696469,ECE 253,A00,919597,Nguyen; Truong Quang,0,0,0,0
1748421697496,ECE 255A,A00,919638,Orlitsky; Alon,0,0,0,0
1748421698529,ECE 257A,A01,919640,Zhang; Xinyu,0,0,0,0
1748421699563,ECE 258A,A00,919653,Heath Jr.; Robert Wendell,0,0,0,0
1748421700595,ECE 260A,A01,919655,Eldon; John,0,0,0,0
1748421701626,ECE 264C,A00,919656,Galton; Ian A,0,0,0,0
1748421702653,ECE 265C,A00,919672,Staff,0,0,0,0
1748421703682,ECE 271A,A00,919673,Vasconcelos; Nuno,0,0,0,0
1748421704709,ECE 276C,A00,919674,Yip; Michael,0,0,0,0
1748421705743,ECE 283,A00,919675,Le; Hanh-Phuc,0,0,0,0
1748421705743,ECE 283,B00,919676,Hall; Drew A.,0,0,0,0
1748421706775,ECE 284,A00,919691,Kang; Mingu,0,0,0,0
1748421707801,ECE 285,A00,919718,Naghizadeh Ardabili; Parinaz,0,0,0,0
1748421708838,ECON 1,A01,917129,Famulari; Melissa,33,0,40,7
1748421708838,ECON 1,A02,917130,Famulari; Melissa,39,0,40,1
1748421708838,ECON 1,A03,917131,Famulari; Melissa,45,0,45,0
1748421708838,ECON 1,B01,917133,Famulari; Melissa,39,0,40,1
1748421708838,ECON 1,B02,917134,Famulari; Melissa,38,0,40,2
1748421708838,ECON 1,B03,917135,Famulari; Melissa,45,0,45,0
1748421708838,ECON 1,C01,917137,Levkoff; Steven B.,53,0,60,7
1748421708838,ECON 1,C02,917138,Levkoff; Steven B.,60,0,60,0
1748421708838,ECON 1,C03,917139,Levkoff; Steven B.,59,0,60,1
1748421708838,ECON 1,C04,917140,Levkoff; Steven B.,60,0,60,0
1748421708838,ECON 1,C05,917141,Levkoff; Steven B.,59,0,60,1
1748421708838,ECON 1,D01,917144,Levkoff; Steven B.,44,0,50,6
1748421708838,ECON 1,D02,917145,Levkoff; Steven B.,50,0,50,0
1748421708838,ECON 1,D03,917146,Levkoff; Steven B.,50,0,50,0
1748421708838,ECON 1,D04,917154,Levkoff; Steven B.,50,0,50,0
1748421709868,ECON 2,A01,917160,Crane; Meredith Helen,35,0,45,10
1748421709868,ECON 2,A02,917164,Crane; Meredith Helen,43,0,45,2
1748421710896,ECON 3,A01,917170,Ma; Alyson Chan,41,0,60,19
1748421711923,ECON 4,A01,917174,Brooks; Marcus Raymond,0,0,0,0
1748421712949,ECON 5,A01,917177,Staff,12,0,30,18
1748421712949,ECON 5,B01,917182,Staff,16,0,30,14
1748421712949,ECON 5,C01,917193,Dai; Yinlin,0,0,30,30
1748421713976,ECON 86,A00,917197,Muendler; Marc,95,0,100,5
1748421715013,ECON 100A,A01,917209,Newhouse; Herbert S,32,0,50,18
1748421715013,ECON 100A,A02,917212,Newhouse; Herbert S,35,0,50,15
1748421715013,ECON 100A,A03,917213,Newhouse; Herbert S,41,0,50,9
1748421715013,ECON 100A,B01,917216,Newhouse; Herbert S,0,0,50,50
1748421715013,ECON 100A,B02,917298,Newhouse; Herbert S,21,0,50,29
1748421715013,ECON 100A,B03,917301,Newhouse; Herbert S,44,0,50,6
1748421716045,ECON 100B,A01,917305,Crane; Meredith Helen,0,0,75,75
1748421716045,ECON 100B,B01,917309,Crane; Meredith Helen,0,0,75,75
1748421717071,ECON 100C,A01,917311,Staff,0,0,25,25
1748421718106,ECON 109,A01,917313,Shishkin; Denis,58,0,65,7
1748421718106,ECON 109,B01,917315,Shishkin; Denis,59,0,75,16
1748421719135,ECON 110A,A01,917336,Jaimovich; Nir,44,0,70,26
1748421719135,ECON 110A,B01,917339,Jaimovich; Nir,19,0,37,18
1748421719135,ECON 110A,B02,917341,Jaimovich; Nir,36,0,38,2
1748421720167,ECON 110B,A01,917388,Trottner; Fabian Gunter We,0,0,50,50
1748421720167,ECON 110B,A02,917389,Trottner; Fabian Gunter We,0,0,50,50
1748421720167,ECON 110B,A03,917390,Trottner; Fabian Gunter We,14,0,50,36
1748421720167,ECON 110B,B01,917396,Trottner; Fabian Gunter We,26,0,50,24
1748421721202,ECON 120A,A01,917401,Dai; Yinlin,21,0,50,29
1748421721202,ECON 120A,A02,917405,Dai; Yinlin,40,0,50,10
1748421721202,ECON 120A,B01,917408,Dai; Yinlin,0,0,40,40
1748421721202,ECON 120A,B02,917409,Dai; Yinlin,0,0,40,40
1748421721202,ECON 120A,B03,917410,Dai; Yinlin,31,0,40,9
1748421722231,ECON 120B,A01,917415,Candido; Maria Teresa,0,0,98,98
1748421722231,ECON 120B,A02,917418,Candido; Maria Teresa,78,0,98,20
1748421722231,ECON 120B,B01,917422,Candido; Maria Teresa,34,0,98,64
1748421722231,ECON 120B,B02,917423,Candido; Maria Teresa,75,0,98,23
1748421723258,ECON 120C,A01,917505,Candido; Maria Teresa,81,0,146,65
1748421724285,ECON 121,A00,917511,Vogl; Tom Saul,68,0,70,2
1748421724285,ECON 121,B00,917516,Vogl; Tom Saul,55,0,70,15
1748421725311,ECON 130,A00,917518,Staff,165,0,190,25
1748421726339,ECON 131,A00,917519,Jacobsen; Mark,56,0,120,64
1748421727364,ECON 139,A00,917520,Arnold; David Hall,21,0,50,29
1748421728391,ECON 152,A00,917523,Fadlon; Yizhak,87,0,90,3
1748421728391,ECON 152,B00,917524,Fadlon; Yizhak,88,0,90,2
1748421729426,ECON 181,A00,965256,Esfahani; Sara,88,0,100,12
1748421730455,ECON 186,A00,917525,Ross; Stephen Geoffrey,80,0,110,30
1748421731484,ECON 191B,A00,917527,Cullen; Julie,20,0,20,0
1748421732566,ECON 200A,A00,917529,Shishkin; Denis,20,0,20,0
1748421733595,ECON 204,A00,917531,Watson; Joel Christopher,25,0,25,0
1748421734625,ECON 205,A00,917532,Du; Songzi,20,0,20,0
1748421735652,ECON 210A,A00,917536,Alon; Titan Michael,20,0,20,0
1748421736679,ECON 220A,A00,917537,Elliott; Graham,20,0,20,0
1748421737714,ECON 220D,A00,917538,Hamilton; James D.,22,0,30,8
1748421738751,ECON 221,A00,960527,Zhu; Ying,20,0,20,0
1748421739779,ECON 232,A00,917539,Fadlon; Yizhak,18,0,20,2
1748421740806,ECON 242,A00,917540,Vogl; Tom Saul & Lee; Munseob,17,0,20,3
1748421741836,ECON 250A,A00,917544,Berman; Eli & Betts; Julian & Arnold; David Hall,21,0,25,4
1748421742862,ECON 262,A00,917546,Trevino; Isabel,20,0,20,0
1748421743888,ECON 268,A00,917547,Boomhower; Judson P,18,0,20,2
1748421744914,ECON 280,A00,917549,Arnold; David Hall,20,0,20,0
1748421745940,ECON 281,A00,917550,Jacobsen; Mark,20,0,20,0
1748421745940,ECON 281,B00,917553,Jaimovich; Nir,15,0,20,5
1748421746967,ECON 285,A00,917554,Bharadwaj; Prashant & Zhu; Ying,24,0,25,1
1748421747996,ECON 286,A00,917556,Ma; Xinwei,20,0,20,0
1748421747996,ECON 286,B00,917558,Eckert; Fabian Paul & Wu; Pak Yeung,20,0,20,0
1748421747996,ECON 286,C00,917559,Bharadwaj; Prashant,20,0,20,0
1748421747996,ECON 286,D00,969571,Cullen; Julie,20,0,20,0
1748421747996,ECON 286,E00,969572,Vespa; Emanuel Ignacio,19,0,20,1
1748421749027,ECON 296,A00,917565,Bharadwaj; Prashant & Zhu; Ying,24,0,25,1
1748421750054,EDS 31,A00,960270,Bussey; Thomas J,5,0,10,5
1748421751079,EDS 88,A00,960441,Bintliff; Amy S.V.,16,0,20,4
1748421752107,EDS 110R,A01,943452,Wishard Guerra; Alison G.,33,0,60,27
1748421752107,EDS 110R,B01,960792,Wishard Guerra; Alison G.,20,0,20,0
1748421753134,EDS 111,A00,969314,Cohen; Shana R,31,0,60,29
1748421754167,EDS 112,A00,969313,Chapman; Thandeka K,32,0,50,18
1748421755197,EDS 114,A01,943493,Eguchi; Emi,19,0,20,1
1748421755197,EDS 114,A02,943494,Eguchi; Emi,18,0,20,2
1748421756226,EDS 115,A00,943495,Jones; Gabrielle Anastasia,46,0,60,14
1748421757255,EDS 117,A01,943675,Jones; Makeba,17,0,37,20
1748421757255,EDS 117,A02,943682,Jones; Makeba,36,0,37,1
1748421757255,EDS 117,A03,943683,Jones; Makeba,33,0,38,5
1748421757255,EDS 117,A04,943691,Jones; Makeba,35,0,38,3
1748421757255,EDS 117,B01,943693,Jones; Gabrielle Anastasia,21,0,30,9
1748421757255,EDS 117,B02,943694,Jones; Gabrielle Anastasia,27,0,30,3
1748421757255,EDS 117,B03,943695,Jones; Gabrielle Anastasia,28,0,30,2
1748421757255,EDS 117,B04,943696,Jones; Gabrielle Anastasia,30,0,30,0
1748421758286,EDS 124AR,A00,943698,Simon; Elizabeth A,129,0,150,21
1748421758286,EDS 124AR,B00,943699,Simon; Elizabeth A,149,0,150,1
1748421758286,EDS 124AR,C00,961307,Simon; Elizabeth A,40,0,40,0
1748421759315,EDS 124BR,A00,943700,Eguchi; Emi,122,0,150,28
1748421759315,EDS 124BR,B00,961276,Eguchi; Emi,20,0,20,0
1748421760341,EDS 125,A00,943701,Jones; Gabrielle Anastasia,49,0,60,11
1748421761369,EDS 129A,A01,943703,Heinzman; Erica M.,48,0,50,2
1748421762399,EDS 130,A01,943705,Staff,6,0,20,14
1748421762399,EDS 130,A02,943706,Staff,18,0,20,2
1748421762399,EDS 130,A03,943707,Staff,20,0,20,0
1748421763425,EDS 131,A01,943709,Staff,8,0,20,12
1748421763425,EDS 131,A02,943710,Staff,17,0,20,3
1748421764453,EDS 133,A01,960443,Bintliff; Amy S.V.,20,0,25,5
1748421764453,EDS 133,A02,960447,Bintliff; Amy S.V.,15,0,15,0
1748421765480,EDS 139,A00,943725,Heinzman; Erica M.,40,0,50,10
1748421765480,EDS 139,B00,943726,Staff,29,0,50,21
1748421765480,EDS 139,C00,943788,Staff,34,0,50,16
1748421765480,EDS 139,E00,943802,Bintliff; Amy S.V.,42,0,50,8
1748421765480,EDS 139,F00,960448,Bintliff; Amy S.V.,40,0,40,0
1748421766509,EDS 149,A00,943814,Black; Alison Michelle,20,0,20,0
1748421767535,EDS 201,A00,943816,Fine; Sarah,44,0,45,1
1748421768565,EDS 203,A01,943818,Eguchi; Emi,44,0,45,1
1748421769596,EDS 205A,A00,943819,Staff,44,0,45,1
1748421770626,EDS 246,A01,943855,Cohen; Shana R,10,0,10,0
1748421771651,EDS 250,A00,943856,Chapman; Thandeka K,49,0,50,1
1748421772678,EDS 251,A00,943862,Wishard Guerra; Alison G.,10,0,10,0
1748421773705,EDS 257,A00,943863,Datnow; Amanda Lee,7,0,10,3
1748421774739,EDS 283,A00,943871,Daly; Alan J.,15,0,15,0
1748421775765,EDS 285,A00,943872,Daly; Alan J.,15,0,15,0
1748421776793,EDS 286,A00,943873,Daly; Alan J.,15,0,15,0
1748421777818,EDS 289D,A00,943874,Hofstetter; Carolyn,15,0,15,0
1748421778844,EDS 292,A00,943876,Hofstetter; Carolyn,15,0,15,0
1748421779877,EDS 296,001,970523,Aragon; Maria Jose,9999,0,9999,0
1748421779877,EDS 296,002,970539,Bintliff; Amy S.V.,9997,0,9999,2
1748421779877,EDS 296,003,970543,Chapman; Thandeka K,9999,0,9999,0
1748421779877,EDS 296,004,970544,Clarke; Sherice Nicole,9999,0,9999,0
1748421779877,EDS 296,005,970587,Cohen; Shana R,9998,0,9999,1
1748421779877,EDS 296,006,970606,Daly; Alan J.,9998,0,9999,1
1748421779877,EDS 296,007,970607,Datnow; Amanda Lee,9997,0,9999,2
1748421779877,EDS 296,008,970608,Eguchi; Emi,9999,0,9999,0
1748421779877,EDS 296,009,970609,Fine; Sarah,9999,0,9999,0
1748421779877,EDS 296,010,970614,Hofstetter; Carolyn,9998,0,9999,1
1748421779877,EDS 296,011,970615,Hopkins; Megan Beth,9998,0,9999,1
1748421779877,EDS 296,012,970616,Jones; Makeba,9999,0,9999,0
1748421779877,EDS 296,013,970631,Jones; Gabrielle Anastasia,9999,0,9999,0
1748421779877,EDS 296,014,970636,Mamas; Christoforos,9998,0,9999,1
1748421779877,EDS 296,015,970649,Phuong; Andrew,9999,0,9999,0
1748421779877,EDS 296,016,970670,Pollock; Mica,9999,0,9999,0
1748421779877,EDS 296,017,970671,Wishard Guerra; Alison G.,9998,0,9999,1
1748421780906,EDS 297,001,972987,Staff,1,0,1,0
1748421781939,ENG 5,A00,916064,Rodriguez; Ruben,70,0,70,0
1748421782969,ENG 10,A00,916066,Evdokimenko; Ekaterina,58,0,60,2
1748421783997,ENG 15,A00,916067,Evdokimenko; Ekaterina,24,0,30,6
1748421785023,ENG 100D,A00,916069,Ngo; Anh-Thu T.,23,0,50,27
1748421786052,ENG 100L,A00,916070,Kleissl; Jan,8,0,8,0
1748421786052,ENG 100L,B00,916071,Bratton; Maryann,8,0,8,0
1748421786052,ENG 100L,C00,916072,Goldberg; Charles G.,8,0,8,0
1748421786052,ENG 100L,D00,916073,de Oliveira; Mauricio,8,0,8,0
1748421786052,ENG 100L,E00,916074,Bratton; Maryann,8,0,8,0
1748421786052,ENG 100L,F00,916075,Boyle; Mary E. T.,8,0,8,0
1748421787082,ENVR 30,A01,959899,Amoa-Bosompem; Michael,17,0,30,13
1748421787082,ENVR 30,A02,959900,Amoa-Bosompem; Michael,27,0,30,3
1748421787082,ENVR 30,A03,959901,Amoa-Bosompem; Michael,26,0,30,4
1748421787082,ENVR 30,A04,959902,Amoa-Bosompem; Michael,28,0,30,2
1748421787082,ENVR 30,A05,959903,Amoa-Bosompem; Michael,29,0,30,1
1748421787082,ENVR 30,A06,959904,Amoa-Bosompem; Michael,30,0,30,0
1748421788110,ENVR 102,A00,960031,Laughing; Cheron,23,0,25,2
1748421789137,ERC 20,A00,921227,Evans; Ivan T,30,0,30,0
1748421789137,ERC 20,B00,921229,Evans; Ivan T,30,0,30,0
1748421790163,ERC 88,A00,961214,Peterson; Johanna L,19,0,20,1
1748421791190,ESYS 101,A01,921233,Taylor; Jennifer Rebecca,21,0,32,11
1748421791190,ESYS 101,A02,921234,Taylor; Jennifer Rebecca,14,0,32,18
1748421791190,ESYS 101,A03,921235,Taylor; Jennifer Rebecca,20,0,32,12
1748421791190,ESYS 101,A04,921241,Taylor; Jennifer Rebecca,26,0,32,6
1748421792218,ESYS 187A,A01,921248,Hetherington; Elizabeth Dorsey,30,0,40,10
1748421792218,ESYS 187A,B01,921250,Shipp; Lauren Elizabeth,27,0,40,13
1748421793258,ETHN 1,A01,919800,Wilson; Brenda K,13,0,15,2
1748421793258,ETHN 1,A02,919843,Wilson; Brenda K,14,0,15,1
1748421793258,ETHN 1,A03,920214,Wilson; Brenda K,15,0,15,0
1748421793258,ETHN 1,A04,920215,Wilson; Brenda K,14,0,15,1
1748421793258,ETHN 1,A05,920223,Wilson; Brenda K,15,0,15,0
1748421793258,ETHN 1,A06,920224,Wilson; Brenda K,15,0,15,0
1748421793258,ETHN 1,A07,920225,Wilson; Brenda K,15,0,15,0
1748421793258,ETHN 1,A08,920226,Wilson; Brenda K,12,0,15,3
1748421793258,ETHN 1,A09,920237,Wilson; Brenda K,15,0,15,0
1748421793258,ETHN 1,A10,920368,Wilson; Brenda K,15,0,15,0
1748421793258,ETHN 1,A11,920402,Wilson; Brenda K,15,0,15,0
1748421793258,ETHN 1,A12,920406,Wilson; Brenda K,15,0,15,0
1748421793258,ETHN 1,A13,920410,Wilson; Brenda K,14,0,15,1
1748421793258,ETHN 1,A14,920441,Wilson; Brenda K,14,0,15,1
1748421794286,ETHN 20R,A01,920461,Sasaki; Christen T,0,0,15,15
1748421794286,ETHN 20R,A02,920467,Sasaki; Christen T,0,0,15,15
1748421794286,ETHN 20R,A03,920468,Sasaki; Christen T,0,0,15,15
1748421794286,ETHN 20R,A04,920470,Sasaki; Christen T,0,0,15,15
1748421795313,ETHN 100A,A00,920489,Patel; Shaista,18,0,35,17
1748421796342,ETHN 101TV,A01,920518,Gallagher-Geurtsen; Tricia Meghan,21,0,25,4
1748421796342,ETHN 101TV,A02,920519,Gallagher-Geurtsen; Tricia Meghan,20,0,25,5
1748421796342,ETHN 101TV,A03,920522,Gallagher-Geurtsen; Tricia Meghan,24,0,25,1
1748421796342,ETHN 101TV,A04,920523,Gallagher-Geurtsen; Tricia Meghan,23,0,25,2
1748421797369,ETHN 110,A00,920528,Klann; Mary Cameron,27,0,35,8
1748421798396,ETHN 116,A00,920529,Cuong; Marisol,29,0,35,6
1748421799424,ETHN 120,A00,920542,Tran; Ly Thi Hai,31,0,35,4
1748421800450,ETHN 122A,A00,920559,Museus; Samuel David,30,0,35,5
1748421801481,ETHN 125R,A00,920694,Sasaki; Christen T,0,0,35,35
1748421802509,ETHN 130,A00,920703,Frank; Ross H.,28,0,30,2
1748421803541,ETHN 139,A00,920704,Ruiz; Ariana,18,0,20,2
1748421804569,ETHN 150,A00,920717,Taylor-Garcia; Daphne,16,0,16,0
1748421805599,ETHN 161,A00,920826,Browne; Errol Tsekani,33,0,35,2
1748421806624,ETHN 174,A00,963091,Staff,15,0,15,0
1748421807655,ETHN 186,A00,959881,Perez; Roy,25,0,30,5
1748421808686,ETHN 187,A00,920860,Martin Sandino; Amanda Maria Yoland,16,0,16,0
1748421809714,ETHN 189,A00,920861,Museus; Samuel David,18,0,20,2
1748421810745,ETHN 200A,A00,920862,Espiritu; Yen,7,0,10,3
1748421811776,ETHN 230,A00,920864,Perreira; Christopher Michael,8,0,10,2
1748421812802,ETIM 289,A00,921224,Patel; Shaista,10,0,10,0
1748421813834,EXPR 100,A00,964355,Staff,9999,0,9999,0
1748421814860,EXPR 105,A00,964356,Staff,9999,0,9999,0
1748421815887,EXPR 201,A00,964357,Staff,9999,0,9999,0
1748421816918,EXPR 205,A00,964358,Staff,9999,0,9999,0
1748421817951,FILM 71,A01,960804,Park; Joanne Moeun,0,0,11,11
1748421817951,FILM 71,B01,960877,Park; Joanne Moeun,3,0,11,8
1748421818980,FILM 72,A01,964349,Kroopf; Jackson Stanford,9,0,11,2
1748421818980,FILM 72,B01,964351,Kroopf; Jackson Stanford,9,0,11,2
1748421820007,FILM 73,A01,964345,Staff,0,0,0,0
1748421820007,FILM 73,B01,964347,Kroopf; Jackson Stanford,7,0,11,4
1748421821039,FMPH 291,A00,969582,Tsuyuki; Kiyomi,10,0,10,0
1748421822075,FPM 291,A00,922036,Rabin; Adrienn Borsika & Stadnick; Nicole & Aarons; Gregory A,12,0,12,0
1748421823111,GLBH 20,A00,921344,Elwardani; Nile Regina,137,0,146,9
1748421824139,GLBH 100,A00,921503,Jenkins; Janis A.,5,0,12,7
1748421824139,GLBH 100,B00,921504,Schonberg; Jeffrey,18,0,20,2
1748421825173,GLBH 111,A01,921733,Burgos; Jose L.,17,0,17,0
1748421825173,GLBH 111,B01,921862,Burgos; Jose L.,17,0,17,0
1748421826205,GLBH 114,A00,921864,Olivas Hernandez; Olga Lid,42,0,50,8
1748421827235,GLBH 116,A00,921865,Villarino; Margarita,41,0,45,4
1748421828263,GLBH 117,A00,921873,Villarino; Margarita,40,0,40,0
1748421829347,GLBH 118,A00,921884,Wilson; Brenda K,25,0,32,7
1748421830379,GLBH 119,A00,921956,Elwardani; Nile Regina,40,0,40,0
1748421831410,GLBH 148,A00,921961,Walkover; Lillian B,75,0,100,25
1748421832437,GLBH 181,A00,921962,Burgos; Jose L.,188,0,216,28
1748421833464,GLBH 200,A00,921963,Schonberg; Jeffrey,15,0,18,3
1748421834490,GLBH 201,A00,921982,Staff,16,0,18,2
1748421835517,GLBH 248,A00,921999,Kaiser; Bronwyn Nicole,16,0,18,2
1748421836603,GPEC 243,A00,946441,McCord; Gordon Carlos,96,0,100,4
1748421837634,GSS 20,A00,923030,Siapno; Jacqueline A,38,0,40,2
1748421837634,GSS 20,B00,923031,Siapno; Jacqueline A,36,0,40,4
1748421838669,HDS 1,A01,923033,Reese; Clarissa Jane,25,0,25,0
1748421838669,HDS 1,A02,923034,Reese; Clarissa Jane,20,0,25,5
1748421838669,HDS 1,A03,923035,Reese; Clarissa Jane,19,0,25,6
1748421838669,HDS 1,A04,923036,Reese; Clarissa Jane,22,0,25,3
1748421838669,HDS 1,A05,923037,Reese; Clarissa Jane,22,0,25,3
1748421838669,HDS 1,A06,923038,Reese; Clarissa Jane,23,0,25,2
1748421838669,HDS 1,A07,923039,Reese; Clarissa Jane,24,0,25,1
1748421839697,HDS 60,A01,923041,Staff,25,0,30,5
1748421839697,HDS 60,A02,923042,Staff,21,0,30,9
1748421840724,HDS 111,A00,923043,Staff,13,0,40,27
1748421841754,HDS 124,A00,923044,Staff,29,0,40,11
1748421842789,HDS 150,A00,923045,Staff,20,0,20,0
1748421843818,HDS 175,A00,923046,Staff,14,0,25,11
1748421844846,HDS 181,A01,923048,Staff,30,0,30,0
1748421845872,HDS 191,A01,923050,Reese; Clarissa Jane,25,0,25,0
1748421846900,HIEA 112,A00,922103,Matsumura; Wendy Y,92,0,115,23
1748421847928,HIEA 153,A00,922106,Henry; Todd A.,43,0,51,8
1748421848961,HIEU 108,A00,922108,Balberg; Mira,29,0,70,41
1748421849994,HIEU 114,A00,959889,Staff,59,0,70,11
1748421851027,HIEU 139,A00,922110,Strasser; Ulrike,40,0,51,11
1748421852055,HIEU 140,A00,922111,Radcliff; Pamela B.,58,0,65,7
1748421853084,HIEU 154,A00,922113,Hansen; Jan Eric,55,0,65,10
1748421854113,HIEU 158,A00,922116,Hertz; Deborah,61,0,70,9
1748421855140,HIEU 171,A00,922117,Hertz; Deborah,15,0,15,0
1748421856171,HIEU 271,A00,922189,Hertz; Deborah,0,0,0,0
1748421857196,HIGR 200,A00,922191,Matsumura; Wendy Y,10,0,10,0
1748421858223,HIGR 210,A00,922221,Muscolino; Micah S,8,0,10,2
1748421859252,HIGR 222,A00,963094,Biess; Frank Peter,10,0,10,0
1748421860283,HIGR 238,A00,922242,McKenzie; Kerry V.,9,0,10,1
1748421861310,HIGR 240,A00,922253,McKenzie; Kerry V.,10,0,10,0
1748421862335,HIGR 267A,A00,922256,Widener; Daniel,8,0,10,2
1748421864393,HILA 114,A00,922118,Cowan; Benjamin A,42,0,65,23
1748421865424,HILA 131,A00,922125,Vitz; Matthew,91,0,99,8
1748421866449,HILA 161,A00,922126,Cowan; Benjamin A,12,0,15,3
1748421867476,HILD 2A,A01,922043,Staff,31,0,32,1
1748421867476,HILD 2A,A02,922044,Staff,31,0,32,1
1748421867476,HILD 2A,A03,922046,Staff,28,0,32,4
1748421867476,HILD 2A,A04,922047,Staff,32,0,32,0
1748421867476,HILD 2A,A05,922051,Staff,30,0,32,2
1748421868514,HILD 7A,A01,922063,Widener; Daniel,31,0,32,1
1748421868514,HILD 7A,A02,922066,Widener; Daniel,31,0,32,1
1748421868514,HILD 7A,A03,922067,Widener; Daniel,32,0,32,0
1748421868514,HILD 7A,A04,922070,Widener; Daniel,28,0,32,4
1748421868514,HILD 7A,A05,922072,Widener; Daniel,32,0,32,0
1748421868514,HILD 7A,A06,922074,Widener; Daniel,32,0,32,0
1748421868514,HILD 7A,A07,922078,Widener; Daniel,29,0,32,3
1748421868514,HILD 7A,A08,922080,Widener; Daniel,32,0,32,0
1748421868514,HILD 7A,A09,922081,Widener; Daniel,32,0,32,0
1748421868514,HILD 7A,A10,922082,Widener; Daniel,32,0,32,0
1748421868514,HILD 7A,A11,922083,Widener; Daniel,32,0,32,0
1748421868514,HILD 7A,A12,922084,Widener; Daniel,32,0,32,0
1748421869540,HILD 10,A01,922089,Muscolino; Micah S,30,0,32,2
1748421869540,HILD 10,A02,922090,Muscolino; Micah S,28,0,32,4
1748421869540,HILD 10,A03,922092,Muscolino; Micah S,31,0,32,1
1748421869540,HILD 10,A04,922095,Muscolino; Micah S,30,0,32,2
1748421870567,HILD 14,A01,959886,Murillo; Dana V.,26,0,32,6
1748421870567,HILD 14,A02,959887,Murillo; Dana V.,32,0,32,0
1748421871595,HINE 144,A00,922132,Provence; Michael,40,0,45,5
1748421872620,HINE 186,A00,922133,Provence; Michael,15,0,15,0
1748421873646,HISA 110,A00,922136,De; Aniket,38,0,45,7
1748421874672,HISA 122,A00,959884,De; Aniket,12,0,15,3
1748421875700,HISC 107,A00,922137,Golan; Tal,41,0,45,4
1748421876729,HISC 131,A00,922148,Golan; Tal,45,0,51,6
1748421877756,HITO 87,A00,922097,Patterson; Patrick H.,0,0,0,0
1748421877756,HITO 87,B00,922098,Patterson; Patrick H.,0,0,0,0
1748421878783,HITO 100,A00,922150,Martinez-Matsuda; Veronica,0,0,17,17
1748421879814,HITO 193,A00,954127,Hill; Seth J,9999,0,9999,0
1748421880852,HITO 194,001,970059,Hertz; Deborah,1,0,1,0
1748421880852,HITO 194,002,970084,Daly; Heather Marie,1,0,1,0
1748421880852,HITO 194,003,970086,Plant; Rebecca Jo,1,0,1,0
1748421880852,HITO 194,004,970093,Henry; Todd A.,1,0,1,0
1748421880852,HITO 194,005,970094,Biess; Frank Peter,1,0,1,0
1748421880852,HITO 194,006,970095,Shafir; Nir,1,0,1,0
1748421880852,HITO 194,007,970099,Martinez-Matsuda; Veronica,1,0,1,0
1748421880852,HITO 194,008,970101,De; Aniket,1,0,1,0
1748421880852,HITO 194,009,970126,Kwak; Nancy,1,0,1,0
1748421880852,HITO 194,010,970128,Muscolino; Micah S,1,0,1,0
1748421880852,HITO 194,011,970129,Hendrickson; Gerald M.,1,0,1,0
1748421880852,HITO 194,012,970132,Balberg; Mira,1,0,1,0
1748421881880,HITO 196,A00,922151,Man; Simeon S,14,0,22,8
1748421882907,HIUS 105,A00,922152,Bermudez; Rosie Cano,22,0,35,13
1748421883935,HIUS 106,A00,922154,Bermudez; Rosie Cano,52,0,65,13
1748421884967,HIUS 144,A00,922156,Daly; Heather Marie,31,0,35,4
1748421886000,HIUS 158,A00,922163,Frank; Ross H.,12,0,20,8
1748421887031,HIUS 181,A00,922187,Daly; Heather Marie,8,0,15,7
1748421888059,HIUS 281,A00,922264,Daly; Heather Marie,0,0,0,0
1748421889090,HUM 1,A01,946360,Markman; Kristina,14,0,15,1
1748421889090,HUM 1,A02,946361,Markman; Kristina,12,0,15,3
1748421889090,HUM 1,A03,946362,Markman; Kristina,14,0,15,1
1748421889090,HUM 1,A04,946363,Markman; Kristina,11,0,15,4
1748421889090,HUM 1,A05,946364,Markman; Kristina,14,0,15,1
1748421889090,HUM 1,A06,946365,Markman; Kristina,14,0,15,1
1748421889090,HUM 1,A07,946366,Markman; Kristina,14,0,15,1
1748421889090,HUM 1,A08,946367,Markman; Kristina,12,0,15,3
1748421889090,HUM 1,A09,946368,Markman; Kristina,13,0,15,2
1748421889090,HUM 1,A10,946369,Markman; Kristina,11,0,15,4
1748421889090,HUM 1,A11,946370,Markman; Kristina,6,0,15,9
1748421889090,HUM 1,A12,946371,Markman; Kristina,15,0,15,0
1748421890139,HUM 3,A01,946373,West; Geoffrey Scott,20,0,28,8
1748421890139,HUM 3,A02,946374,West; Geoffrey Scott,14,0,28,14
1748421890139,HUM 3,A03,946375,West; Geoffrey Scott,13,0,28,15
1748421890139,HUM 3,A04,946376,West; Geoffrey Scott,9,0,28,19
1748421890139,HUM 3,A05,946377,West; Geoffrey Scott,8,0,28,20
1748421890139,HUM 3,A06,946378,West; Geoffrey Scott,22,0,28,6
1748421890139,HUM 3,A07,946379,West; Geoffrey Scott,23,0,28,5
1748421890139,HUM 3,A08,946380,West; Geoffrey Scott,15,0,28,13
1748421890139,HUM 3,A09,946381,West; Geoffrey Scott,0,0,0,0
1748421890139,HUM 3,A10,946382,West; Geoffrey Scott,0,0,0,0
1748421890139,HUM 3,C01,946393,Crum; Matthew Stephen,0,0,0,0
1748421890139,HUM 3,C02,946394,Crum; Matthew Stephen,0,0,0,0
1748421890139,HUM 3,C03,946395,Crum; Matthew Stephen,17,0,28,11
1748421890139,HUM 3,C04,946396,Crum; Matthew Stephen,25,0,28,3
1748421890139,HUM 3,C05,946397,Crum; Matthew Stephen,16,0,28,12
1748421890139,HUM 3,C06,946398,Crum; Matthew Stephen,20,0,28,8
1748421890139,HUM 3,C07,946399,Crum; Matthew Stephen,24,0,28,4
1748421890139,HUM 3,C08,946400,Crum; Matthew Stephen,26,0,28,2
1748421890139,HUM 3,C09,946401,Crum; Matthew Stephen,18,0,28,10
1748421890139,HUM 3,C10,946402,Crum; Matthew Stephen,22,0,28,6
1748421890139,HUM 3,D01,946404,Rodriguez; Bretton Sigfred,4,0,28,24
1748421890139,HUM 3,D02,946405,Rodriguez; Bretton Sigfred,16,0,28,12
1748421890139,HUM 3,D03,946406,Rodriguez; Bretton Sigfred,25,0,28,3
1748421890139,HUM 3,D04,946407,Rodriguez; Bretton Sigfred,12,0,28,16
1748421890139,HUM 3,D05,946408,Rodriguez; Bretton Sigfred,12,0,28,16
1748421890139,HUM 3,D06,946409,Rodriguez; Bretton Sigfred,19,0,28,9
1748421890139,HUM 3,D07,946410,Rodriguez; Bretton Sigfred,0,0,0,0
1748421890139,HUM 3,D08,946411,Rodriguez; Bretton Sigfred,0,0,0,0
1748421890139,HUM 3,D09,946412,Rodriguez; Bretton Sigfred,7,0,28,21
1748421890139,HUM 3,D10,946413,Rodriguez; Bretton Sigfred,20,0,28,8
1748421891166,HUM 88,A00,969578,Markman; Kristina,0,0,0,0
1748421892196,HUM 100,A00,946414,West; Geoffrey Scott,14,0,16,2
1748421892196,HUM 100,B00,946415,West; Geoffrey Scott,15,0,16,1
1748421892196,HUM 100,C00,946416,Zavodny; Tatiana Sophia,13,0,16,3
1748421892196,HUM 100,D00,946417,Zavodny; Tatiana Sophia,15,0,16,1
1748421892196,HUM 100,E00,946419,Zavodny; Tatiana Sophia,15,0,16,1
1748421892196,HUM 100,F00,946420,Crum; Matthew Stephen,0,0,0,0
1748421892196,HUM 100,G00,946421,Crum; Matthew Stephen,0,0,0,0
1748421892196,HUM 100,H00,946422,Crum; Matthew Stephen,16,0,16,0
1748421892196,HUM 100,I00,946424,Staff,0,0,0,0
1748421892196,HUM 100,J00,946425,Crum; Matthew Stephen,16,0,16,0
1748421892196,HUM 100,K00,946426,Staff,0,0,0,0
1748421893224,INTL 100,A01,960908,Feuer; Anna Stagg,9,0,20,11
1748421893224,INTL 100,A02,960964,Feuer; Anna Stagg,16,0,20,4
1748421893224,INTL 100,A03,961088,Feuer; Anna Stagg,15,0,20,5
1748421893224,INTL 100,A04,961091,Feuer; Anna Stagg,17,0,20,3
1748421893224,INTL 100,A05,961100,Feuer; Anna Stagg,16,0,20,4
1748421893224,INTL 100,A06,961130,Feuer; Anna Stagg,19,0,20,1
1748421894258,INTL 101,A01,923053,McIntosh; Justin,1,0,30,29
1748421894258,INTL 101,A02,923055,McIntosh; Justin,8,0,30,22
1748421894258,INTL 101,A03,923127,McIntosh; Justin,5,0,30,25
1748421894258,INTL 101,A04,923140,McIntosh; Justin,0,0,30,30
1748421894258,INTL 101,A05,923148,McIntosh; Justin,9,0,30,21
1748421894258,INTL 101,A06,923186,McIntosh; Justin,10,0,30,20
1748421895285,INTL 102,A01,923194,Prather; Lauren R,3,0,30,27
1748421895285,INTL 102,A02,923195,Prather; Lauren R,4,0,30,26
1748421895285,INTL 102,A03,923199,Prather; Lauren R,13,0,30,17
1748421895285,INTL 102,A04,923202,Prather; Lauren R,8,0,30,22
1748421896313,INTL 190,A00,923203,Segui; Alan S,0,0,0,5
1748421896313,INTL 190,B00,923205,Segui; Alan S,0,0,0,9
1748421896313,INTL 190,C00,923219,Lee; Munseob,0,0,0,5
1748421897340,INTL 190H,A00,923247,Feuer; Anna Stagg,0,0,0,1
1748421898399,JAPN 10A,A01,923258,Kamioka; Sachiko,22,0,23,1
1748421898399,JAPN 10A,B01,923261,Ross; Kayoko F,23,0,23,0
1748421898399,JAPN 10A,C01,923265,Sato; Kyoko,20,0,23,3
1748421898399,JAPN 10A,D01,923268,Inada; Minori,22,0,23,1
1748421898399,JAPN 10A,E01,923270,Tipton; Yuko,9,0,12,3
1748421898399,JAPN 10A,E02,923273,Tipton; Yuko,12,0,12,0
1748421898399,JAPN 10A,F01,923352,Ross; Kayoko F,11,0,12,1
1748421898399,JAPN 10A,F02,923355,Ross; Kayoko F,12,0,12,0
1748421898399,JAPN 10A,G01,923358,McKee; Mayumi Mochizuki,7,0,10,3
1748421898399,JAPN 10A,G02,923360,McKee; Mayumi Mochizuki,6,0,10,4
1748421898399,JAPN 10A,H01,923365,Sato; Kyoko,8,0,12,4
1748421898399,JAPN 10A,H02,923370,Sato; Kyoko,12,0,12,0
1748421898399,JAPN 10A,I01,923373,Inada; Minori,8,0,12,4
1748421898399,JAPN 10A,I02,923374,Inada; Minori,8,0,12,4
1748421898399,JAPN 10A,J01,923376,McKee; Mayumi Mochizuki,11,0,12,1
1748421898399,JAPN 10A,J02,923428,McKee; Mayumi Mochizuki,11,0,12,1
1748421898399,JAPN 10A,K01,923433,Tipton; Yuko,5,0,10,5
1748421898399,JAPN 10A,K02,923437,Tipton; Yuko,9,0,10,1
1748421898399,JAPN 10A,L01,923439,Sato; Kyoko,12,0,12,0
1748421898399,JAPN 10A,L02,923449,Sato; Kyoko,11,0,12,1
1748421898399,JAPN 10A,M01,923455,Kamioka; Sachiko,22,0,23,1
1748421898399,JAPN 10A,N01,923459,McKee; Mayumi Mochizuki,22,0,23,1
1748421899423,JAPN 10AR,A01,923462,Tipton; Yuko,17,0,20,3
1748421900456,JAPN 20A,A01,923470,Takeda; Izumi,21,0,23,2
1748421900456,JAPN 20A,B01,923473,Iwamoto; Naoki,9,0,12,3
1748421900456,JAPN 20A,B02,923475,Iwamoto; Naoki,6,0,12,6
1748421900456,JAPN 20A,C01,923519,Takeda; Izumi,0,0,12,12
1748421900456,JAPN 20A,C02,923520,Takeda; Izumi,5,0,12,7
1748421900456,JAPN 20A,D01,923623,Iwamoto; Naoki,11,0,12,1
1748421900456,JAPN 20A,D02,923625,Iwamoto; Naoki,11,0,12,1
1748421900456,JAPN 20A,E01,923627,Simpson; Junko Tokuda,12,0,20,8
1748421901501,JAPN 130A,A01,923630,Kamioka; Sachiko,14,0,15,1
1748421901501,JAPN 130A,B01,923634,Ross; Kayoko F,11,0,15,4
1748421902531,JAPN 135A,A00,923636,Iwamoto; Naoki,10,0,20,10
1748421903561,JAPN 137A,A00,923638,Simpson; Junko Tokuda,19,0,20,1
1748421904588,JAPN 140A,A00,923640,Takeda; Izumi,18,0,20,2
1748421905616,JWSP 1,A01,921258,Shuster; Alana,19,0,20,1
1748421906642,JWSP 104,A01,921340,Shuster; Alana,15,0,15,0
1748421907672,LATI 10,A01,923694,Kennemore; Amy Michelle,22,0,28,6
1748421907672,LATI 10,A02,923695,Kennemore; Amy Michelle,25,0,28,3
1748421907672,LATI 10,A03,923707,Kennemore; Amy Michelle,25,0,28,3
1748421907672,LATI 10,A04,923713,Kennemore; Amy Michelle,27,0,28,1
1748421907672,LATI 10,A05,923720,Kennemore; Amy Michelle,28,0,28,0
1748421907672,LATI 10,A06,923723,Kennemore; Amy Michelle,30,0,30,0
1748421907672,LATI 10,A07,923745,Kennemore; Amy Michelle,26,0,30,4
1748421908708,LATI 50,A01,923778,Kokinis; Troy Andreas,27,0,30,3
1748421908708,LATI 50,A02,923779,Kokinis; Troy Andreas,28,0,30,2
1748421908708,LATI 50,A03,923780,Kokinis; Troy Andreas,29,0,30,1
1748421908708,LATI 50,A04,923783,Kokinis; Troy Andreas,28,0,30,2
1748421908708,LATI 50,A05,923784,Kokinis; Troy Andreas,30,0,30,0
1748421909735,LATI 166,A00,923785,Kokinis; Troy Andreas,117,0,120,3
1748421910763,LATI 170,A00,923787,Kennemore; Amy Michelle,45,0,60,15
1748421911796,LATI 180,A00,923788,Kennemore; Amy Michelle,52,0,60,8
1748421912823,LATI 184,A00,923790,Jimenez Cano; Nayeli Guada,29,0,30,1
1748421913849,LATI 200,A00,923791,Martin-Cabrera; Luis,7,0,10,3
1748421914876,LIAB 1A,A00,923983,Saab; Dima,12,0,14,2
1748421914876,LIAB 1A,B00,923984,Saab; Dima,8,0,14,6
1748421915903,LIAB 1AX,A00,923992,El Cheddadi; Youniss,25,0,28,3
1748421916931,LIAB 1D,A00,923996,Saab; Dima,7,0,14,7
1748421917957,LIAB 1DX,A00,923998,El Cheddadi; Youniss,10,0,14,4
1748421918985,LIFR 1A,A00,923999,Van Moer; Vinciane G,14,0,14,0
1748421918985,LIFR 1A,B00,924001,Van Moer; Vinciane G,14,0,14,0
1748421918985,LIFR 1A,C00,924003,Van Moer; Vinciane G,13,0,14,1
1748421918985,LIFR 1A,D00,924039,Van Moer; Vinciane G,12,0,14,2
1748421918985,LIFR 1A,E00,924044,Van Moer; Vinciane G,12,0,14,2
1748421918985,LIFR 1A,F00,924100,Van Moer; Vinciane G,10,0,14,4
1748421920020,LIFR 1AX,A00,924134,Van Moer; Vinciane G,26,0,28,2
1748421920020,LIFR 1AX,B00,924138,Van Moer; Vinciane G,24,0,28,4
1748421920020,LIFR 1AX,C00,924196,Van Moer; Vinciane G,26,0,28,2
1748421921052,LIFR 1B,A00,924197,Van Moer; Vinciane G,11,0,14,3
1748421921052,LIFR 1B,B00,924199,Van Moer; Vinciane G,11,0,14,3
1748421922078,LIFR 1BX,A00,924215,Van Moer; Vinciane G,23,0,28,5
1748421923106,LIFR 1D,A00,924216,Van Moer; Vinciane G,11,0,14,3
1748421923106,LIFR 1D,B00,924217,Van Moer; Vinciane G,12,0,14,2
1748421923106,LIFR 1D,C00,924218,Van Moer; Vinciane G,3,0,14,11
1748421924137,LIFR 1DX,A00,924219,Van Moer; Vinciane G,14,0,21,7
1748421924137,LIFR 1DX,B00,924220,Van Moer; Vinciane G,13,0,21,8
1748421925170,LIFR 11,A00,924221,Goodall; Grant Todd,10,0,10,0
1748421926197,LIGM 1A,A00,924222,Fischer-Grunski; Eva K,11,0,14,3
1748421926197,LIGM 1A,B00,924223,Fischer-Grunski; Eva K,13,0,14,1
1748421926197,LIGM 1A,C00,924224,Fischer-Grunski; Eva K,11,0,14,3
1748421926197,LIGM 1A,D00,924227,Fischer-Grunski; Eva K,11,0,14,3
1748421927223,LIGM 1AX,A00,924228,Fischer-Grunski; Eva K,28,0,28,0
1748421927223,LIGM 1AX,B00,924229,Fischer-Grunski; Eva K,19,0,28,9
1748421928250,LIGM 1D,A00,924230,Fischer-Grunski; Eva K,0,0,0,0
1748421928250,LIGM 1D,B00,924231,Fischer-Grunski; Eva K,12,0,14,2
1748421929274,LIGM 1DX,A00,924232,Fischer-Grunski; Eva K,0,0,0,0
1748421930303,LIGM 11,A00,924233,Goodall; Grant Todd,10,0,10,0
1748421931335,LIGN 5,A00,923794,Goodall; Grant Todd,112,0,120,8
1748421932365,LIGN 7,A00,923796,Mayberry; Rachel,115,0,120,5
1748421933392,LIGN 8,A00,923797,McIntosh; Justin,231,0,245,14
1748421934424,LIGN 17,A00,923798,Staff,232,0,245,13
1748421935458,LIGN 101,A01,923929,Bakovic; Eric John,26,0,30,4
1748421935458,LIGN 101,A02,923930,Bakovic; Eric John,26,0,30,4
1748421935458,LIGN 101,A04,923935,Bakovic; Eric John,19,0,30,11
1748421935458,LIGN 101,A05,923940,Bakovic; Eric John,23,0,30,7
1748421936485,LIGN 108,A00,923942,Rose; Sharon,29,0,35,6
1748421937513,LIGN 110,A01,923944,Garellek; Marc,15,0,27,12
1748421937513,LIGN 110,A02,923947,Garellek; Marc,14,0,27,13
1748421937513,LIGN 110,A03,923948,Garellek; Marc,20,0,27,7
1748421937513,LIGN 110,A04,923949,Garellek; Marc,4,0,27,23
1748421938544,LIGN 152,A00,967971,Caballero; Gabriela Hernandez,17,0,30,13
1748421939577,LIGN 160,A00,963083,Dudley; Rachel,39,0,50,11
1748421940672,LIGN 167,A00,923951,Warstadt; Alexander Scott,0,0,90,90
1748421941703,LIGN 179,A00,923955,Kluender; Robert,0,0,35,35
1748421942729,LIGN 188R,A00,923956,Clem; Emily,40,0,40,0
1748421943756,LIGN 200,A00,973075,Staff,0,0,0,0
1748421944789,LIGN 210,A00,923962,Garellek; Marc,10,0,10,0
1748421945816,LIGN 221,A00,923964,Clem; Emily,9,0,10,1
1748421946847,LIGN 236,A00,923965,Clem; Emily,8,0,10,2
1748421947873,LIGN 293,A00,923971,Caballero; Gabriela Hernandez,0,0,0,0
1748421948903,LIGN 296,001,950061,Ackerman; Farrell,10,0,10,0
1748421948903,LIGN 296,002,950062,Bakovic; Eric John,10,0,10,0
1748421948903,LIGN 296,003,950063,Bergen; Leon,10,0,10,0
1748421948903,LIGN 296,004,950064,Caballero; Gabriela Hernandez,10,0,10,0
1748421948903,LIGN 296,005,950065,Caponigro; Ivano,10,0,10,0
1748421948903,LIGN 296,006,950066,Clem; Emily,10,0,10,0
1748421948903,LIGN 296,007,950067,Dudley; Rachel,10,0,10,0
1748421948903,LIGN 296,008,950068,Garellek; Marc,10,0,10,0
1748421948903,LIGN 296,009,950070,Goodall; Grant Todd,9,0,10,1
1748421948903,LIGN 296,010,950071,Kehler; Andrew Scott,10,0,10,0
1748421948903,LIGN 296,011,950072,Kluender; Robert,10,0,10,0
1748421948903,LIGN 296,012,950073,Rose; Sharon,10,0,10,0
1748421948903,LIGN 296,013,950074,Styler; William Francis,10,0,10,0
1748421948903,LIGN 296,014,950075,Caponigro; Ivano,10,0,10,0
1748421949931,LIHL 112F,A00,923972,Pagkalinawan; Leticia Cant,15,0,28,13
1748421950959,LIHL 114F,A00,923973,Nguyen; Hoan Thi,8,0,28,20
1748421951991,LIHL 117F,A00,923974,Sadegholvad; Elham,19,0,20,1
1748421953021,LIHL 118,A00,923975,Chen; Areana Yen,23,0,28,5
1748421954087,LIHL 124F,A00,923976,Nguyen; Hoan Thi,17,0,20,3
1748421955114,LIHL 132F,A00,923978,Pagkalinawan; Leticia Cant,18,0,20,2
1748421956143,LIHL 134F,A00,923980,Nguyen; Hoan Thi,19,0,20,1
1748421957170,LIHL 138,A00,923982,Chen; Areana Yen,28,0,28,0
1748421958197,LIIT 1A,A00,924234,Carnelos; Chiara,11,0,14,3
1748421958197,LIIT 1A,B00,924235,Carnelos; Chiara,11,0,14,3
1748421958197,LIIT 1A,C00,924236,Carnelos; Chiara,13,0,14,1
1748421958197,LIIT 1A,D00,924237,Carnelos; Chiara,12,0,14,2
1748421959222,LIIT 1AX,A00,924238,Carnelos; Chiara,28,0,28,0
1748421959222,LIIT 1AX,B00,924239,Carnelos; Chiara,24,0,28,4
1748421960256,LIPO 1A,A00,924241,Paladini; Denise,13,0,14,1
1748421960256,LIPO 1A,B00,924242,Paladini; Denise,14,0,14,0
1748421961287,LIPO 1AX,A00,924243,De Abreu; Cassia,13,0,14,1
1748421961287,LIPO 1AX,B00,924244,De Abreu; Cassia,14,0,14,0
1748421962314,LIPO 1D,A00,924245,Paladini; Denise,11,0,14,3
1748421963339,LIPO 1DX,A00,924248,De Abreu; Cassia,14,0,14,0
1748421964369,LISL 1A,A00,924249,Lott; Margaret S.,9,0,14,5
1748421964369,LISL 1A,B00,924250,Lott; Margaret S.,11,0,14,3
1748421964369,LISL 1A,C00,924252,Lott; Margaret S.,7,0,14,7
1748421964369,LISL 1A,D00,924253,Lott; Margaret S.,12,0,14,2
1748421964369,LISL 1A,E00,924254,Lott; Margaret S.,4,0,14,10
1748421964369,LISL 1A,F00,924255,Lott; Margaret S.,13,0,14,1
1748421965397,LISL 1AR,A00,924257,Lott; Margaret S.,11,0,15,4
1748421965397,LISL 1AR,B00,924258,Lott; Margaret S.,10,0,15,5
1748421965397,LISL 1AR,C00,924260,Lott; Margaret S.,9,0,15,6
1748421965397,LISL 1AR,D00,968060,Lott; Margaret S.,3,0,3,0
1748421965397,LISL 1AR,E00,968061,Lott; Margaret S.,3,0,3,0
1748421965397,LISL 1AR,F00,968062,Lott; Margaret S.,3,0,3,0
1748421966428,LISL 1AX,A00,924261,Lott; Margaret S.,28,0,28,0
1748421966428,LISL 1AX,B00,924262,Lott; Margaret S.,18,0,28,10
1748421966428,LISL 1AX,C00,924263,Lott; Margaret S.,21,0,28,7
1748421967460,LISL 1B,A00,924264,Lott; Margaret S.,13,0,14,1
1748421967460,LISL 1B,B00,924265,Lott; Margaret S.,6,0,14,8
1748421967460,LISL 1B,C00,924302,Lott; Margaret S.,9,0,14,5
1748421967460,LISL 1B,D00,924304,Lott; Margaret S.,7,0,14,7
1748421967460,LISL 1B,E00,924305,Lott; Margaret S.,10,0,14,4
1748421967460,LISL 1B,F00,964375,Lott; Margaret S.,12,0,14,2
1748421968492,LISL 1BX,A00,924307,Lott; Margaret S.,12,0,28,16
1748421968492,LISL 1BX,B00,924308,Lott; Margaret S.,20,0,28,8
1748421968492,LISL 1BX,C00,924314,Lott; Margaret S.,28,0,28,0
1748421969522,LISL 1D,A00,924316,Lott; Margaret S.,0,0,14,14
1748421969522,LISL 1D,B00,924317,Lott; Margaret S.,0,0,14,14
1748421969522,LISL 1D,C00,924319,Lott; Margaret S.,0,0,14,14
1748421969522,LISL 1D,D00,924321,Lott; Margaret S.,0,0,14,14
1748421970556,LISL 1DX,A00,924323,Lott; Margaret S.,0,0,28,28
1748421970556,LISL 1DX,B00,924365,Lott; Margaret S.,0,0,28,28
1748421971584,LISP 1A,A00,924370,Munoz Sanchez; Alicia,12,0,14,2
1748421971584,LISP 1A,B00,924372,Munoz Sanchez; Alicia,8,0,14,6
1748421971584,LISP 1A,C00,924401,Munoz Sanchez; Alicia,0,0,14,14
1748421971584,LISP 1A,D00,924406,Munoz Sanchez; Alicia,3,0,14,11
1748421971584,LISP 1A,E00,924471,Munoz Sanchez; Alicia,0,0,14,14
1748421971584,LISP 1A,F00,924472,Munoz Sanchez; Alicia,4,0,14,10
1748421971584,LISP 1A,G00,924473,Munoz Sanchez; Alicia,11,0,14,3
1748421971584,LISP 1A,H00,924474,Munoz Sanchez; Alicia,9,0,14,5
1748421972610,LISP 1AX,A00,924478,Munoz Sanchez; Alicia,16,0,28,12
1748421972610,LISP 1AX,B00,924479,Munoz Sanchez; Alicia,26,0,28,2
1748421972610,LISP 1AX,C00,924484,Munoz Sanchez; Alicia,12,0,28,16
1748421972610,LISP 1AX,D00,924491,Munoz Sanchez; Alicia,18,0,28,10
1748421973644,LISP 1B,A00,924492,Munoz Sanchez; Alicia,12,0,14,2
1748421973644,LISP 1B,B00,924493,Munoz Sanchez; Alicia,6,0,14,8
1748421973644,LISP 1B,C00,924498,Munoz Sanchez; Alicia,13,0,14,1
1748421973644,LISP 1B,D00,924501,Munoz Sanchez; Alicia,13,0,14,1
1748421973644,LISP 1B,E00,924505,Munoz Sanchez; Alicia,11,0,14,3
1748421973644,LISP 1B,F00,924506,Munoz Sanchez; Alicia,9,0,14,5
1748421973644,LISP 1B,G00,924507,Munoz Sanchez; Alicia,10,0,14,4
1748421973644,LISP 1B,H00,924549,Munoz Sanchez; Alicia,12,0,14,2
1748421973644,LISP 1B,I00,924566,Munoz Sanchez; Alicia,13,0,14,1
1748421973644,LISP 1B,J00,924572,Munoz Sanchez; Alicia,13,0,14,1
1748421973644,LISP 1B,K00,924576,Munoz Sanchez; Alicia,12,0,14,2
1748421973644,LISP 1B,L00,924577,Munoz Sanchez; Alicia,13,0,14,1
1748421974676,LISP 1BX,A00,924578,Munoz Sanchez; Alicia,26,0,28,2
1748421974676,LISP 1BX,B00,924618,Munoz Sanchez; Alicia,24,0,28,4
1748421974676,LISP 1BX,C00,924619,Munoz Sanchez; Alicia,20,0,28,8
1748421974676,LISP 1BX,D00,924629,Munoz Sanchez; Alicia,24,0,28,4
1748421974676,LISP 1BX,E00,924635,Munoz Sanchez; Alicia,24,0,28,4
1748421974676,LISP 1BX,F00,924640,Munoz Sanchez; Alicia,27,0,28,1
1748421975712,LISP 1D,A00,924641,Munoz Sanchez; Alicia,10,0,14,4
1748421975712,LISP 1D,B00,924649,Munoz Sanchez; Alicia,10,0,14,4
1748421975712,LISP 1D,C00,924654,Munoz Sanchez; Alicia,11,0,14,3
1748421975712,LISP 1D,D00,924660,Munoz Sanchez; Alicia,7,0,14,7
1748421975712,LISP 1D,E00,924671,Munoz Sanchez; Alicia,5,0,14,9
1748421975712,LISP 1D,F00,924722,Munoz Sanchez; Alicia,6,0,14,8
1748421975712,LISP 1D,G00,924724,Munoz Sanchez; Alicia,8,0,14,6
1748421975712,LISP 1D,H00,924726,Munoz Sanchez; Alicia,9,0,14,5
1748421975712,LISP 1D,I00,924728,Munoz Sanchez; Alicia,13,0,14,1
1748421975712,LISP 1D,J00,924732,Munoz Sanchez; Alicia,14,0,14,0
1748421975712,LISP 1D,K00,924739,Munoz Sanchez; Alicia,13,0,14,1
1748421975712,LISP 1D,L00,924745,Munoz Sanchez; Alicia,12,0,14,2
1748421976745,LISP 1DX,A00,924747,Munoz Sanchez; Alicia,23,0,28,5
1748421976745,LISP 1DX,B00,924818,Munoz Sanchez; Alicia,27,0,28,1
1748421976745,LISP 1DX,C00,924819,Munoz Sanchez; Alicia,16,0,28,12
1748421976745,LISP 1DX,D00,924820,Munoz Sanchez; Alicia,23,0,28,5
1748421976745,LISP 1DX,E00,924821,Munoz Sanchez; Alicia,16,0,28,12
1748421976745,LISP 1DX,F00,924822,Munoz Sanchez; Alicia,22,0,28,6
1748421977771,LISP 15,A00,924823,Munoz Sanchez; Alicia,17,0,20,3
1748421978796,LISP 18,A00,924824,Munoz Sanchez; Alicia,14,0,20,6
1748421979824,LTAF 120,A00,925431,Zhiri; Oumelbanine,37,0,40,3
1748421980849,LTAM 100,A00,925432,Villafuerte Vazquez; Nadia,33,0,40,7
1748421981880,LTCH 101,A00,964372,Liao; Ping H,35,0,40,5
1748421982907,LTCO 285,A00,925806,Glaser; Amelia,0,0,0,0
1748421983933,LTCS 10,A00,924830,Bessett; Ryan Matthew,39,0,40,1
1748421984960,LTCS 87,A00,969580,Nguyen; Hoang Tan,20,0,20,0
1748421984960,LTCS 87,B00,969581,Nguyen; Hoang Tan,20,0,20,0
1748421986001,LTCS 130,A00,925434,Kim; Joo Ok,36,0,40,4
1748421987027,LTCS 150,A00,925435,Mendoza; Andrea,36,0,40,4
1748421988053,LTCS 250,A00,925807,Sanchez Cruz; Jorge,9,0,15,6
1748421989079,LTEA 120A,A00,925438,Fiss; Geraldine Anna,16,0,40,24
1748421990153,LTEA 120B,A00,925439,Liao; Ping H,211,0,225,14
1748421991178,LTEA 132,A00,925441,Mendoza; Andrea,66,0,75,9
1748421992209,LTEA 143,A00,925443,Lee; Jin-Kyung,72,0,75,3
1748421993236,LTEA 145,A00,925444,Lee; Jin-Kyung,39,0,40,1
1748421994268,LTEN 21,A01,924832,Vitkus; Daniel J.,23,0,28,5
1748421994268,LTEN 21,A02,924833,Vitkus; Daniel J.,28,0,28,0
1748421995299,LTEN 28,A01,924835,Suzuki; Erin M.,26,0,28,2
1748421995299,LTEN 28,A02,924836,Suzuki; Erin M.,25,0,28,3
1748421995299,LTEN 28,A03,924837,Suzuki; Erin M.,25,0,28,3
1748421995299,LTEN 28,A04,924838,Suzuki; Erin M.,28,0,28,0
1748421995299,LTEN 28,A05,924839,Suzuki; Erin M.,28,0,28,0
1748421995299,LTEN 28,A06,924840,Suzuki; Erin M.,28,0,28,0
1748421995299,LTEN 28,A07,924841,Suzuki; Erin M.,28,0,28,0
1748421995299,LTEN 28,A08,924842,Suzuki; Erin M.,28,0,28,0
1748421996328,LTEN 113,A00,925449,Vitkus; Daniel J.,31,0,40,9
1748421997359,LTEN 152,A00,925450,Staff,13,0,40,27
1748421998386,LTEN 169,A00,925451,Ruiz; Ariana,34,0,40,6
1748421999413,LTEN 180,A00,925452,Ruiz; Ariana,9,0,20,11
1748422000444,LTEN 181,A00,925453,Suzuki; Erin M.,27,0,40,13
1748422001469,LTEN 185,A00,963086,Staff,23,0,25,2
1748422002497,LTEN 189,A00,925458,Vijay; Ameeth Varma,35,0,40,5
1748422003526,LTEN 271,A00,925808,Garofalo; Devin,13,0,15,2
1748422004551,LTEU 140,A00,925459,De Marchi Gherini; Adriana,33,0,40,7
1748422005581,LTEU 154,A00,925461,Morse; Ainsley,25,0,30,5
1748422006607,LTFR 2A,A01,924916,Ploye; Catherine,20,0,25,5
1748422007637,LTFR 2B,A01,924920,Ploye; Catherine,25,0,25,0
1748422008664,LTFR 104,A00,925462,Ploye; Catherine,25,0,25,0
1748422009696,LTGK 1,A00,924923,Murray; Kourtney Kristine,34,0,40,6
1748422010722,LTGK 104,A00,925465,Myerston Santana; Jacobo,29,0,30,1
1748422011748,LTGM 2A,A01,924926,Fischer-Grunski; Eva K,19,0,25,6
1748422012779,LTIT 2A,A01,925054,De Marchi Gherini; Adriana,19,0,25,6
1748422013820,LTKO 1A,A01,925085,Cho; Hye Jin,25,0,28,3
1748422013820,LTKO 1A,B01,925182,Cho; Hye Jin,25,0,28,3
1748422013820,LTKO 1A,C01,925210,Cho; Hye Jin,23,0,28,5
1748422013820,LTKO 1A,D01,925229,Staff,27,0,28,1
1748422013820,LTKO 1A,E01,925246,Staff,25,0,28,3
1748422013820,LTKO 1A,F01,925248,Yim; Nancy,26,0,28,2
1748422013820,LTKO 1A,G01,925323,Yim; Nancy,26,0,28,2
1748422013820,LTKO 1A,H01,925331,Yim; Nancy,25,0,28,3
1748422014855,LTKO 2A,A01,925333,Jung; Ji Yun,14,0,28,14
1748422014855,LTKO 2A,B01,925335,Jung; Ji Yun,24,0,28,4
1748422014855,LTKO 2A,C01,925338,Lee; Jeyseon,26,0,28,2
1748422015881,LTKO 130F,A00,925468,Lee; Jeyseon,22,0,25,3
1748422016911,LTLA 1,A00,925339,Murray; Kourtney Kristine,0,0,20,20
1748422017936,LTLA 100,A00,925470,Murray; Kourtney Kristine,39,0,40,1
1748422018966,LTRU 1A,A01,925342,Wells; Patricia Rebecca,22,0,28,6
1748422019993,LTRU 2A,A01,925345,Wells; Patricia Rebecca,19,0,20,1
1748422021020,LTRU 104B,A01,925473,Wells; Patricia Rebecca,20,0,20,0
1748422022047,LTRU 150,A00,925474,Morse; Ainsley,10,0,10,0
1748422023074,LTSP 2A,A01,925347,Staff,22,0,28,6
1748422023074,LTSP 2A,B01,925349,Staff,24,0,28,4
1748422024101,LTSP 2B,A01,925351,Staff,17,0,28,11
1748422025129,LTSP 2C,A01,925353,Mastromartino; Alexandra L,22,0,28,6
1748422026155,LTSP 2F,A00,925354,Mastromartino; Alexandra L,25,0,25,0
1748422027184,LTSP 3F,A00,925355,Dominguez; Noelia,24,0,25,1
1748422027184,LTSP 3F,B00,925356,Dominguez; Noelia,22,0,25,3
1748422028211,LTSP 87,A00,925357,Bessett; Ryan Matthew,20,0,20,0
1748422029243,LTSP 100A,A00,925595,Dominguez; Noelia,21,0,25,4
1748422030270,LTSP 100F,A00,925621,Bessett; Ryan Matthew,25,0,25,0
1748422030270,LTSP 100F,B00,925623,Bessett; Ryan Matthew,25,0,25,0
1748422030270,LTSP 100F,C00,925626,Martin-Cabrera; Luis,25,0,25,0
1748422031298,LTSP 116,A00,925629,Villafuerte Vazquez; Nadia,35,0,40,5
1748422032325,LTSP 172,A00,925637,Chacon; Gloria Elizabeth,36,0,40,4
1748422033352,LTSP 174,A00,925639,Chacon; Gloria Elizabeth,34,0,40,6
1748422034378,LTTH 210A,A00,925809,Fiss; Geraldine Anna,6,0,15,9
1748422035406,LTWL 10,A00,925358,Garofalo; Devin,40,0,40,0
1748422036436,LTWL 19A,A00,925360,Myerston Santana; Jacobo,39,0,40,1
1748422037461,LTWL 101,A00,925661,Kelting; Edward William,32,0,40,8
1748422038491,LTWL 165,A00,925748,Kim; Joo Ok,40,0,40,0
1748422039518,LTWL 167,A00,964371,Glaser; Amelia,40,0,40,0
1748422040548,LTWL 183,A00,925755,Cohen; Alain J. J.,34,0,40,6
1748422041575,LTWL 194,A00,925757,Vijay; Ameeth Varma,38,0,40,2
1748422042601,LTWR 8A,A01,925362,Springer; Anna Joy,28,0,28,0
1748422042601,LTWR 8A,A02,925363,Springer; Anna Joy,23,0,28,5
1748422042601,LTWR 8A,A03,925364,Springer; Anna Joy,23,0,28,5
1748422042601,LTWR 8A,A04,925365,Springer; Anna Joy,18,0,28,10
1748422043629,LTWR 8B,A01,925368,Lopez; Casandra,18,0,28,10
1748422043629,LTWR 8B,A02,925370,Lopez; Casandra,19,0,28,9
1748422043629,LTWR 8B,A03,925371,Lopez; Casandra,28,0,28,0
1748422043629,LTWR 8B,A04,925372,Lopez; Casandra,26,0,28,2
1748422044710,LTWR 100C,A00,925759,Staff,16,0,30,14
1748422045737,LTWR 100W,A00,925760,Forbes; Camille,0,0,15,15
1748422046766,LTWR 102W,A00,925761,Lopez; Casandra,6,0,15,9
1748422047792,LTWR 104AW,A00,925762,Hoang; Lily Kim,5,0,15,10
1748422048818,LTWR 106C,A00,925764,Ali; Mohammad Kazim,22,0,30,8
1748422049844,LTWR 113C,A00,925765,Wilkinson; Marco,28,0,30,2
1748422050870,LTWR 115C,A00,925766,Ali; Mohammad Kazim,23,0,30,7
1748422051897,LTWR 124C,A00,925801,Morse; Ainsley,29,0,30,1
1748422052923,LTWR 126C,A00,925802,Forbes; Camille,28,0,30,2
1748422053950,LTWR 148,A00,925804,Wilkinson; Marco,27,0,30,3
1748422054977,LTWR 194,A00,925805,Carroll; Amy Sara,30,0,40,10
1748422056004,LTWR 215,A00,925934,Hoang; Lily Kim,13,0,20,7
1748422057033,LTWR 220,A00,925935,Springer; Anna Joy,10,0,15,5
1748422058063,MAE 2,A01,931344,Anderson; Mark Ronald,0,0,1,1
1748422058063,MAE 2,A02,931345,Anderson; Mark Ronald,0,0,1,1
1748422058063,MAE 2,A03,931347,Anderson; Mark Ronald,0,0,1,1
1748422058063,MAE 2,B01,960499,Sadeghizadeh; Zahra,0,0,1,1
1748422058063,MAE 2,B02,960500,Sadeghizadeh; Zahra,0,0,1,1
1748422058063,MAE 2,B03,960501,Sadeghizadeh; Zahra,0,0,1,1
1748422059099,MAE 3,A01,931355,Delson; Nathan Joseph,8,0,11,3
1748422059099,MAE 3,A02,931356,Delson; Nathan Joseph,10,0,11,1
1748422059099,MAE 3,A03,931357,Delson; Nathan Joseph,10,0,11,1
1748422059099,MAE 3,A04,931358,Delson; Nathan Joseph,11,0,11,0
1748422059099,MAE 3,B01,931360,Qi; Huihui,0,0,11,11
1748422059099,MAE 3,B02,931361,Qi; Huihui,6,0,11,5
1748422059099,MAE 3,B03,931362,Qi; Huihui,9,0,11,2
1748422059099,MAE 3,B04,931364,Qi; Huihui,10,0,11,1
1748422060140,MAE 8,A01,931368,Pham; Hieu Tan,90,0,100,10
1748422061166,MAE 11,A00,931369,Nomura; Keiko K.,83,0,180,97
1748422062197,MAE 20,A00,931371,Graeve; Olivia A,79,0,100,21
1748422063233,MAE 21,A01,931373,Cai; Shengqiang,1,0,10,9
1748422063233,MAE 21,A02,931375,Cai; Shengqiang,7,0,10,3
1748422063233,MAE 21,A03,931376,Cai; Shengqiang,1,0,10,9
1748422063233,MAE 21,A04,931377,Cai; Shengqiang,5,0,10,5
1748422063233,MAE 21,A05,931378,Cai; Shengqiang,10,0,10,0
1748422063233,MAE 21,A06,931381,Cai; Shengqiang,10,0,10,0
1748422063233,MAE 21,A07,931382,Cai; Shengqiang,8,0,10,2
1748422063233,MAE 21,A08,931384,Cai; Shengqiang,7,0,10,3
1748422063233,MAE 21,A09,931385,Cai; Shengqiang,8,0,10,2
1748422063233,MAE 21,A10,931386,Cai; Shengqiang,9,0,10,1
1748422064263,MAE 30A,A00,931387,Lubarda; Marko,29,0,70,41
1748422065290,MAE 40,A00,931388,Cortes; Jorge,83,0,146,63
1748422066322,MAE 101A,A00,931389,Sarkar; Sutanu,94,0,150,56
1748422067348,MAE 101C,A00,931390,Seshadri; Kalyanasundaram,175,0,200,25
1748422068375,MAE 104,A00,931391,Pham; Hieu Tan,146,0,160,14
1748422069400,MAE 105,A00,931392,Bandaru; Prabhakar,135,0,180,45
1748422070428,MAE 107,A00,931393,Chen; Renkun,0,0,90,90
1748422070428,MAE 107,B00,931394,McEneaney; William Michael,45,0,90,45
1748422071455,MAE 108,A00,931395,Hao; Xuanting,91,0,120,29
1748422072483,MAE 113,A00,931396,Seshadri; Kalyanasundaram,92,0,130,38
1748422073515,MAE 114,A00,931399,Krasheninnikov; Sergei,37,0,40,3
1748422074543,MAE 120,A00,931400,Krasheninnikov; Sergei,36,0,50,14
1748422075575,MAE 122,A00,931402,Pawlak; Geno Ronald,43,0,70,27
1748422076602,MAE 131A,A00,931403,Lubarda; Marko,46,0,70,24
1748422077630,MAE 142,A00,931404,Anderson; Mark Ronald,21,0,60,39
1748422078660,MAE 143A,A00,931406,Diagne; Mamadou Lamine,98,0,125,27
1748422079691,MAE 148,A01,931409,Silberman; Jack,11,0,30,19
1748422080720,MAE 150,A00,931411,Friend; James Robert,139,0,192,53
1748422081748,MAE 153,A00,931413,Ghazinejad; Maziar,2,0,45,43
1748422082774,MAE 156A,A01,931416,Delson; Nathan Joseph,2,0,12,10
1748422082774,MAE 156A,A02,931417,Delson; Nathan Joseph,9,0,12,3
1748422082774,MAE 156A,A03,931418,Delson; Nathan Joseph,12,0,12,0
1748422082774,MAE 156A,A04,931419,Delson; Nathan Joseph,10,0,12,2
1748422082774,MAE 156A,A05,931420,Delson; Nathan Joseph,2,0,12,10
1748422082774,MAE 156A,A06,931421,Delson; Nathan Joseph,12,0,12,0
1748422083807,MAE 165,A00,931422,Scholtes Acevedo; Claire,19,0,30,11
1748422084837,MAE 170,A01,931424,Evdokimenko; Ekaterina,9,0,30,21
1748422084837,MAE 170,A02,931427,Evdokimenko; Ekaterina,14,0,30,16
1748422084837,MAE 170,A03,931428,Evdokimenko; Ekaterina,0,0,30,30
1748422084837,MAE 170,A04,931429,Evdokimenko; Ekaterina,14,0,30,16
1748422084837,MAE 170,A05,931430,Evdokimenko; Ekaterina,27,0,30,3
1748422084837,MAE 170,A06,931434,Evdokimenko; Ekaterina,23,0,30,7
1748422085866,MAE 180,A00,931436,Sadeghizadeh; Zahra,109,0,140,31
1748422086894,MAE 181,A00,931437,Bahadori; Mohammad Yousef,53,0,80,27
1748422087924,MAE 190,A00,971317,Marinoni; Alessandro & Krasheninnikov; Sergei,19,0,20,1
1748422088952,MAE 191,A01,931442,Qi; Huihui,19,0,20,1
1748422089979,MAE 201,A00,931445,Pawlak; Geno Ronald,36,0,90,54
1748422091005,MAE 202,A00,931452,Poulikakos; Lisa Voula,42,0,90,48
1748422092031,MAE 203,A00,931455,Frazier; Michael,26,0,90,64
1748422093059,MAE 205,A00,931456,Staff,9989,0,9999,10
1748422094085,MAE 208,A00,931457,Marinoni; Alessandro,52,0,150,98
1748422095113,MAE 210A,A00,931458,Saintillan; David,37,0,60,23
1748422096139,MAE 217A,A00,931459,Arefiev; Alexey,13,0,20,7
1748422097165,MAE 221A,A00,931460,Chen; Renkun,26,0,40,14
1748422098197,MAE 232A,A00,931464,Chen; Jiun-Shyan,3,0,35,32
1748422099223,MAE 233A,A00,931466,Luan; Haiwen,29,0,40,11
1748422100254,MAE 235,A00,954132,Krysl; Petr,0,0,0,0
1748422101280,MAE 249,A00,931472,Tolley; Michael Thomas,8,0,50,42
1748422102307,MAE 251,A00,931477,Graeve; Olivia A,12,0,15,3
1748422103335,MAE 257,A00,931478,Cai; Shengqiang,0,0,10,10
1748422104365,MAE 265A,A00,931480,Bandaru; Prabhakar,10,0,15,5
1748422105392,MAE 271A,A00,931481,Luo; Jian,9,0,10,1
1748422106417,MAE 280A,A00,931482,Kramer; Boris,61,0,110,49
1748422107447,MAE 283A,A00,931484,de Callafon; Raymond A,12,0,50,38
1748422108477,MAE 285,A00,931486,Friend; James Robert,30,0,30,0
1748422109502,MAE 287,A00,931488,Diagne; Mamadou Lamine,17,0,30,13
1748422110533,MAE 290A,A00,931490,Lindsey; Stephanie,42,0,70,28
1748422111559,MAE 294A,A00,931491,Becker; Janet Maria,14,0,20,6
1748422112593,MATH 2,A01,929271,Quarfoot; David James,22,0,25,3
1748422112593,MATH 2,B01,929278,Staff,21,0,25,4
1748422113634,MATH 3B,A01,929284,Hammock; Frances H,1,0,2,1
1748422113634,MATH 3B,A02,929312,Hammock; Frances H,1,0,2,1
1748422113634,MATH 3B,A03,967979,Hammock; Frances H,2,0,2,0
1748422113634,MATH 3B,A04,967980,Hammock; Frances H,1,0,2,1
1748422113634,MATH 3B,A05,967983,Hammock; Frances H,1,0,2,1
1748422113634,MATH 3B,A06,967984,Hammock; Frances H,2,0,2,0
1748422113634,MATH 3B,D01,929666,Staff,0,0,2,2
1748422113634,MATH 3B,D02,929667,Staff,0,0,2,2
1748422113634,MATH 3B,D03,929668,Staff,0,0,2,2
1748422113634,MATH 3B,D04,967987,Staff,0,0,2,2
1748422114663,MATH 3C,A01,929670,Staff,0,0,2,2
1748422114663,MATH 3C,A02,929671,Staff,0,0,2,2
1748422114663,MATH 3C,A03,929672,Staff,2,0,2,0
1748422114663,MATH 3C,A04,929673,Staff,2,0,2,0
1748422114663,MATH 3C,A05,967985,Staff,0,0,2,2
1748422114663,MATH 3C,A06,967986,Staff,1,0,2,1
1748422114663,MATH 3C,B01,929675,Staff,0,0,0,2
1748422114663,MATH 3C,B02,929676,Staff,0,0,2,2
1748422114663,MATH 3C,B03,929677,Staff,0,0,2,2
1748422114663,MATH 3C,B04,929679,Staff,0,0,2,2
1748422114663,MATH 3C,B05,967988,Staff,0,0,2,2
1748422114663,MATH 3C,B06,967989,Staff,0,0,2,2
1748422115693,MATH 4C,B01,929698,Anzaldo; Leesa B,0,0,0,2
1748422115693,MATH 4C,B02,929699,Anzaldo; Leesa B,4,0,4,0
1748422115693,MATH 4C,B03,929700,Anzaldo; Leesa B,3,0,4,1
1748422115693,MATH 4C,B04,929701,Anzaldo; Leesa B,4,0,4,0
1748422115693,MATH 4C,D01,929709,Staff,4,0,4,0
1748422115693,MATH 4C,D02,929710,Staff,3,0,4,1
1748422115693,MATH 4C,D03,967990,Staff,4,0,4,0
1748422115693,MATH 4C,D04,967991,Staff,4,0,4,0
1748422116725,MATH 10A,A01,929713,Staff,8,0,12,4
1748422116725,MATH 10A,A02,929715,Staff,12,0,12,0
1748422116725,MATH 10A,A03,929717,Staff,5,0,5,0
1748422116725,MATH 10A,A04,929718,Staff,5,0,5,0
1748422116725,MATH 10A,A05,929719,Staff,5,0,5,0
1748422116725,MATH 10A,A06,929720,Staff,4,0,5,1
1748422116725,MATH 10A,B01,929723,Eggers; John Dietrich,0,0,0,4
1748422116725,MATH 10A,B02,929724,Eggers; John Dietrich,0,0,4,4
1748422116725,MATH 10A,B03,929726,Eggers; John Dietrich,0,0,4,4
1748422116725,MATH 10A,B04,929727,Eggers; John Dietrich,0,0,4,4
1748422116725,MATH 10A,B05,929728,Eggers; John Dietrich,0,0,4,4
1748422116725,MATH 10A,B06,929729,Eggers; John Dietrich,1,0,4,3
1748422116725,MATH 10A,C01,929732,Staff,0,0,0,3
1748422116725,MATH 10A,C02,929734,Staff,0,0,4,4
1748422116725,MATH 10A,C03,929735,Staff,0,0,4,4
1748422116725,MATH 10A,C04,929736,Staff,0,0,4,4
1748422116725,MATH 10A,C05,929737,Staff,0,0,4,4
1748422116725,MATH 10A,C06,929739,Staff,0,0,4,4
1748422116725,MATH 10A,D01,929742,Staff,0,0,4,4
1748422116725,MATH 10A,D02,929743,Staff,0,0,4,4
1748422116725,MATH 10A,D03,929744,Staff,4,0,4,0
1748422116725,MATH 10A,D04,929746,Staff,4,0,4,0
1748422116725,MATH 10A,D05,929747,Staff,3,0,4,1
1748422116725,MATH 10A,D06,929748,Staff,4,0,4,0
1748422116725,MATH 10A,D07,968012,Staff,0,0,4,4
1748422116725,MATH 10A,D08,968013,Staff,3,0,4,1
1748422116725,MATH 10A,D09,968015,Staff,4,0,4,0
1748422116725,MATH 10A,D10,968017,Staff,2,0,4,2
1748422117757,MATH 10B,A01,929759,Bowers; Adam R.,0,0,10,10
1748422117757,MATH 10B,A02,929760,Bowers; Adam R.,0,0,10,10
1748422117757,MATH 10B,A03,929761,Bowers; Adam R.,0,0,10,10
1748422117757,MATH 10B,A04,929762,Bowers; Adam R.,0,0,10,10
1748422117757,MATH 10B,A05,929763,Bowers; Adam R.,0,0,10,10
1748422117757,MATH 10B,A06,929764,Bowers; Adam R.,0,0,10,10
1748422117757,MATH 10B,B01,929767,Staff,0,0,10,10
1748422117757,MATH 10B,B02,929770,Staff,7,0,10,3
1748422117757,MATH 10B,B03,929771,Staff,10,0,10,0
1748422117757,MATH 10B,B04,929772,Staff,9,0,10,1
1748422117757,MATH 10B,B05,929774,Staff,1,0,10,9
1748422117757,MATH 10B,B06,929775,Staff,10,0,10,0
1748422117757,MATH 10B,C01,929778,Huang; Lei,0,0,8,8
1748422117757,MATH 10B,C02,929779,Huang; Lei,0,0,10,10
1748422117757,MATH 10B,C03,929780,Huang; Lei,2,0,10,8
1748422117757,MATH 10B,C04,929781,Huang; Lei,8,0,10,2
1748422117757,MATH 10B,C05,929784,Huang; Lei,0,0,10,10
1748422117757,MATH 10B,C06,929785,Huang; Lei,2,0,10,8
1748422118791,MATH 10C,A01,929788,Staff,0,0,15,15
1748422118791,MATH 10C,A02,929789,Staff,0,0,15,15
1748422118791,MATH 10C,A03,929790,Staff,12,0,15,3
1748422118791,MATH 10C,A04,929791,Staff,13,0,15,2
1748422118791,MATH 10C,A05,929792,Staff,0,0,15,15
1748422118791,MATH 10C,A06,929793,Staff,0,0,15,15
1748422118791,MATH 10C,A07,929795,Staff,3,0,15,12
1748422118791,MATH 10C,A08,929796,Staff,15,0,15,0
1748422118791,MATH 10C,B01,929798,Staff,15,0,15,0
1748422118791,MATH 10C,B02,929799,Staff,0,0,15,15
1748422118791,MATH 10C,B03,929800,Staff,11,0,15,4
1748422118791,MATH 10C,B04,929802,Staff,14,0,15,1
1748422118791,MATH 10C,B05,929803,Staff,14,0,15,1
1748422118791,MATH 10C,B06,929805,Staff,15,0,15,0
1748422119827,MATH 11,A01,929807,Rava; Denise,0,0,25,25
1748422119827,MATH 11,A02,929808,Rava; Denise,0,0,25,25
1748422119827,MATH 11,A03,929809,Rava; Denise,0,0,25,25
1748422119827,MATH 11,A04,929811,Rava; Denise,0,0,25,25
1748422119827,MATH 11,B01,929816,Rava; Denise,0,0,25,25
1748422119827,MATH 11,B02,929817,Rava; Denise,0,0,25,25
1748422119827,MATH 11,B03,929818,Rava; Denise,0,0,25,25
1748422119827,MATH 11,B04,929819,Rava; Denise,0,0,25,25
1748422120871,MATH 18,C01,929841,Peca-Medlin; John Michael,4,0,10,6
1748422120871,MATH 18,C02,929843,Peca-Medlin; John Michael,7,0,10,3
1748422120871,MATH 18,C03,929844,Peca-Medlin; John Michael,3,0,10,7
1748422120871,MATH 18,C04,929845,Peca-Medlin; John Michael,0,0,10,10
1748422120871,MATH 18,C05,929846,Peca-Medlin; John Michael,2,0,10,8
1748422120871,MATH 18,C06,929848,Peca-Medlin; John Michael,0,0,10,10
1748422120871,MATH 18,D01,929852,Anzaldo; Leesa B,0,0,10,10
1748422120871,MATH 18,D02,929855,Anzaldo; Leesa B,0,0,10,10
1748422120871,MATH 18,D03,929856,Anzaldo; Leesa B,0,0,9,9
1748422120871,MATH 18,D04,929857,Anzaldo; Leesa B,0,0,10,10
1748422120871,MATH 18,D05,929858,Anzaldo; Leesa B,0,0,10,10
1748422120871,MATH 18,D06,929859,Anzaldo; Leesa B,0,0,10,10
1748422120871,MATH 18,E01,929862,Ganesan; Priyanga,0,0,10,10
1748422120871,MATH 18,E02,929863,Ganesan; Priyanga,0,0,10,10
1748422120871,MATH 18,E03,929865,Ganesan; Priyanga,0,0,10,10
1748422120871,MATH 18,E04,929866,Ganesan; Priyanga,8,0,10,2
1748422120871,MATH 18,E05,929867,Ganesan; Priyanga,10,0,10,0
1748422120871,MATH 18,E06,929869,Ganesan; Priyanga,10,0,10,0
1748422120871,MATH 18,F01,929872,Ganesan; Priyanga,12,0,20,8
1748422120871,MATH 18,F02,929873,Ganesan; Priyanga,17,0,20,3
1748422120871,MATH 18,F03,929874,Ganesan; Priyanga,19,0,20,1
1748422120871,MATH 18,F04,929875,Ganesan; Priyanga,19,0,20,1
1748422120871,MATH 18,F05,968018,Ganesan; Priyanga,12,0,12,0
1748422120871,MATH 18,F06,968019,Ganesan; Priyanga,11,0,12,1
1748422120871,MATH 18,F07,968020,Ganesan; Priyanga,10,0,12,2
1748422120871,MATH 18,F08,968022,Ganesan; Priyanga,11,0,12,1
1748422121909,MATH 20A,A01,929880,Bowers; Adam R.,23,0,25,2
1748422121909,MATH 20A,A02,929881,Bowers; Adam R.,24,0,25,1
1748422121909,MATH 20A,A03,929883,Bowers; Adam R.,1,0,5,4
1748422121909,MATH 20A,A04,929884,Bowers; Adam R.,4,0,5,1
1748422121909,MATH 20A,B01,929886,Staff,0,0,0,0
1748422121909,MATH 20A,B02,929887,Staff,3,0,5,2
1748422121909,MATH 20A,B03,929888,Staff,5,0,5,0
1748422121909,MATH 20A,B04,929889,Staff,5,0,5,0
1748422121909,MATH 20A,B05,929890,Staff,5,0,5,0
1748422121909,MATH 20A,B06,929891,Staff,5,0,5,0
1748422121909,MATH 20A,B07,967992,Staff,5,0,5,0
1748422121909,MATH 20A,B08,967993,Staff,5,0,5,0
1748422121909,MATH 20A,B09,967994,Staff,5,0,5,0
1748422121909,MATH 20A,B10,967995,Staff,5,0,5,0
1748422122954,MATH 20B,A01,929910,Staff,14,0,15,1
1748422122954,MATH 20B,A02,929911,Staff,15,0,15,0
1748422122954,MATH 20B,A03,929982,Staff,15,0,15,0
1748422122954,MATH 20B,A04,929983,Staff,15,0,15,0
1748422122954,MATH 20B,A05,929984,Staff,15,0,15,0
1748422122954,MATH 20B,A06,929985,Staff,15,0,15,0
1748422122954,MATH 20B,C01,930160,Staff,24,0,25,1
1748422122954,MATH 20B,C02,930186,Staff,25,0,25,0
1748422122954,MATH 20B,C03,930198,Staff,15,0,15,0
1748422122954,MATH 20B,C04,968000,Staff,15,0,15,0
1748422122954,MATH 20B,D01,930241,Chou; Raymond Oliver,13,0,25,12
1748422122954,MATH 20B,D02,930242,Chou; Raymond Oliver,23,0,25,2
1748422122954,MATH 20B,D03,930244,Chou; Raymond Oliver,0,0,15,15
1748422122954,MATH 20B,D04,968002,Chou; Raymond Oliver,0,0,13,13
1748422122954,MATH 20B,E01,930428,Wesley; William J,32,0,35,3
1748422122954,MATH 20B,E02,930529,Wesley; William J,35,0,35,0
1748422122954,MATH 20B,E03,968023,Wesley; William J,15,0,15,0
1748422122954,MATH 20B,E04,968024,Wesley; William J,15,0,15,0
1748422122954,MATH 20B,E05,968025,Wesley; William J,15,0,15,0
1748422122954,MATH 20B,E06,968026,Wesley; William J,15,0,15,0
1748422123998,MATH 20C,A01,930548,Staff,18,0,20,2
1748422123998,MATH 20C,A02,930554,Staff,19,0,20,1
1748422123998,MATH 20C,A03,930584,Staff,19,0,20,1
1748422123998,MATH 20C,A04,930606,Staff,20,0,20,0
1748422123998,MATH 20C,A05,930610,Staff,19,0,20,1
1748422123998,MATH 20C,A06,930641,Staff,20,0,20,0
1748422123998,MATH 20C,A07,968027,Staff,20,0,20,0
1748422123998,MATH 20C,A08,968028,Staff,20,0,20,0
1748422123998,MATH 20C,A09,968029,Staff,19,0,20,1
1748422123998,MATH 20C,A10,968031,Staff,20,0,20,0
1748422123998,MATH 20C,C01,930911,Staff,6,0,20,14
1748422123998,MATH 20C,C02,930940,Staff,16,0,20,4
1748422123998,MATH 20C,C03,930946,Staff,18,0,20,2
1748422123998,MATH 20C,C04,930959,Staff,20,0,20,0
1748422123998,MATH 20C,C05,930966,Staff,19,0,20,1
1748422123998,MATH 20C,C06,930974,Staff,16,0,20,4
1748422123998,MATH 20C,D01,931266,Hammock; Frances H,10,0,20,10
1748422123998,MATH 20C,D02,931267,Hammock; Frances H,14,0,17,3
1748422123998,MATH 20C,D03,931268,Hammock; Frances H,17,0,20,3
1748422123998,MATH 20C,D04,931269,Hammock; Frances H,19,0,20,1
1748422123998,MATH 20C,D05,931270,Hammock; Frances H,20,0,20,0
1748422123998,MATH 20C,D06,931271,Hammock; Frances H,18,0,20,2
1748422123998,MATH 20C,E01,931273,Staff,11,0,20,9
1748422123998,MATH 20C,E02,931274,Staff,19,0,20,1
1748422123998,MATH 20C,E03,931275,Staff,17,0,20,3
1748422123998,MATH 20C,E04,931276,Staff,19,0,20,1
1748422123998,MATH 20C,E05,931278,Staff,20,0,20,0
1748422123998,MATH 20C,E06,931279,Staff,20,0,20,0
1748422123998,MATH 20C,F01,931281,Staff,20,0,25,5
1748422123998,MATH 20C,F02,931282,Staff,22,0,25,3
1748422123998,MATH 20C,F03,931283,Staff,23,0,25,2
1748422123998,MATH 20C,F04,931285,Staff,24,0,25,1
1748422125031,MATH 20D,B01,931293,Upadrashta; Pranav Kumar,0,0,24,25
1748422125031,MATH 20D,B02,931294,Upadrashta; Pranav Kumar,0,0,30,30
1748422125031,MATH 20D,B03,931297,Upadrashta; Pranav Kumar,1,0,30,29
1748422125031,MATH 20D,B04,931298,Upadrashta; Pranav Kumar,8,0,30,22
1748422125031,MATH 20D,B05,931299,Upadrashta; Pranav Kumar,1,0,30,29
1748422125031,MATH 20D,B06,931300,Upadrashta; Pranav Kumar,26,0,30,4
1748422125031,MATH 20D,C01,931305,Upadrashta; Pranav Kumar,15,0,40,25
1748422125031,MATH 20D,C02,931306,Upadrashta; Pranav Kumar,38,0,40,2
1748422125031,MATH 20D,C03,931307,Upadrashta; Pranav Kumar,12,0,30,18
1748422125031,MATH 20D,C04,931308,Upadrashta; Pranav Kumar,26,0,30,4
1748422126061,MATH 20E,A01,931313,Staff,0,0,27,27
1748422126061,MATH 20E,A02,931315,Staff,19,0,27,8
1748422126061,MATH 20E,A03,931316,Staff,27,0,27,0
1748422126061,MATH 20E,A04,931317,Staff,27,0,27,0
1748422126061,MATH 20E,A05,968032,Staff,9,0,27,18
1748422126061,MATH 20E,A06,968033,Staff,24,0,27,3
1748422126061,MATH 20E,A07,968034,Staff,27,0,27,0
1748422126061,MATH 20E,A08,968035,Staff,26,0,27,1
1748422126061,MATH 20E,C01,931327,Staff,0,0,23,23
1748422126061,MATH 20E,C02,931329,Staff,0,0,27,27
1748422126061,MATH 20E,C03,931331,Staff,0,0,27,27
1748422126061,MATH 20E,C04,931332,Staff,0,0,27,27
1748422126061,MATH 20E,C05,931333,Staff,0,0,27,27
1748422126061,MATH 20E,C06,931334,Staff,7,0,27,20
1748422127088,MATH 31AH,A01,931337,Nandi; Achinta Kumar,5,0,5,0
1748422127088,MATH 31AH,A02,931340,Nandi; Achinta Kumar,5,0,5,0
1748422128121,MATH 87,A00,970775,Harel; Guershon,0,0,0,0
1748422128121,MATH 87,B00,970803,Meyer; David A.,0,0,0,0
1748422129151,MATH 88,A00,967999,Seward; Brandon M.,30,0,35,5
1748422130177,MATH 96,A00,931341,Kane; Daniel Mertz,0,0,0,0
1748422131211,MATH 100A,A01,927335,De Vleming; Kristin Elizab,21,0,30,9
1748422131211,MATH 100A,A02,927337,De Vleming; Kristin Elizab,24,0,30,6
1748422131211,MATH 100A,B01,927341,De Vleming; Kristin Elizab,2,0,30,28
1748422131211,MATH 100A,B02,927342,De Vleming; Kristin Elizab,8,0,30,22
1748422132243,MATH 102,B01,927348,Harel; Guershon,2,0,30,28
1748422132243,MATH 102,B02,927349,Harel; Guershon,22,0,30,8
1748422133281,MATH 103A,B01,927370,Staff,16,0,30,14
1748422133281,MATH 103A,B02,927378,Staff,29,0,30,1
1748422133281,MATH 103A,B03,969574,Staff,27,0,30,3
1748422133281,MATH 103A,C01,927381,Staff,13,0,30,17
1748422133281,MATH 103A,C02,927385,Staff,24,0,30,6
1748422133281,MATH 103A,D01,927388,Suk; Andrew Hoon,0,0,30,30
1748422133281,MATH 103A,D02,927389,Suk; Andrew Hoon,0,0,30,30
1748422134309,MATH 105,A01,927391,Ganapathy; Karthik,26,0,35,9
1748422134309,MATH 105,A02,927454,Ganapathy; Karthik,29,0,35,6
1748422135346,MATH 109,B01,927493,Xiao; Ming,0,0,5,5
1748422135346,MATH 109,B02,927494,Xiao; Ming,0,0,5,5
1748422135346,MATH 109,C01,927500,Xiao; Ming,0,0,5,5
1748422135346,MATH 109,C02,927501,Xiao; Ming,0,0,5,5
1748422135346,MATH 109,D01,927516,Buzaglo; Lucas,0,0,5,5
1748422135346,MATH 109,D02,927517,Buzaglo; Lucas,0,0,5,5
1748422135346,MATH 109,E01,927519,Buzaglo; Lucas,0,0,5,5
1748422135346,MATH 109,E02,927552,Buzaglo; Lucas,0,0,5,5
1748422136375,MATH 111A,A01,927559,Meyer; David A.,0,0,35,35
1748422137402,MATH 120A,A01,927572,Eggers; John Dietrich,13,0,30,17
1748422137402,MATH 120A,A02,927574,Eggers; John Dietrich,29,0,30,1
1748422138432,MATH 140A,A01,927580,Spolaor; Luca,0,0,30,30
1748422138432,MATH 140A,A02,927582,Spolaor; Luca,6,0,30,24
1748422138432,MATH 140A,B01,927588,Ioana; Adrian,0,0,30,30
1748422138432,MATH 140A,B02,927599,Ioana; Adrian,0,0,30,30
1748422139465,MATH 142A,B01,927620,Bejenaru; Ioan,0,0,30,30
1748422139465,MATH 142A,B02,927750,Bejenaru; Ioan,13,0,30,17
1748422139465,MATH 142A,C01,927789,Staff,25,0,30,5
1748422139465,MATH 142A,C02,927815,Staff,30,0,30,0
1748422139465,MATH 142A,C03,969575,Staff,25,0,30,5
1748422139465,MATH 142A,D01,927829,Staff,15,0,30,15
1748422139465,MATH 142A,D02,927832,Staff,30,0,30,0
1748422140494,MATH 153,A01,927862,Harel; Guershon,26,0,35,9
1748422141526,MATH 154,A01,928077,Kane; Daniel Mertz,27,0,35,8
1748422141526,MATH 154,A02,928083,Kane; Daniel Mertz,35,0,35,0
1748422141526,MATH 154,A03,928085,Kane; Daniel Mertz,0,0,35,35
1748422141526,MATH 154,A04,928086,Kane; Daniel Mertz,20,0,35,15
1748422142555,MATH 170A,A01,928146,Tian; Xiaochuan,0,0,30,30
1748422142555,MATH 170A,A02,928225,Tian; Xiaochuan,2,0,30,28
1748422142555,MATH 170A,A03,928231,Tian; Xiaochuan,26,0,30,4
1748422142555,MATH 170A,A04,928237,Tian; Xiaochuan,30,0,30,0
1748422142555,MATH 170A,B01,928244,Huang; Lei,23,0,30,7
1748422142555,MATH 170A,B02,928273,Huang; Lei,30,0,30,0
1748422142555,MATH 170A,B03,928274,Huang; Lei,18,0,30,12
1748422142555,MATH 170A,B04,928276,Huang; Lei,28,0,30,2
1748422143586,MATH 173A,A01,928278,Ding; Lijun,0,0,30,30
1748422143586,MATH 173A,A02,928319,Ding; Lijun,0,0,30,30
1748422143586,MATH 173A,A03,928322,Ding; Lijun,0,0,30,30
1748422143586,MATH 173A,A04,928377,Ding; Lijun,0,0,30,30
1748422143586,MATH 173A,B01,928383,Cloninger; Alexander,0,0,30,30
1748422143586,MATH 173A,B02,928384,Cloninger; Alexander,0,0,30,30
1748422143586,MATH 173A,B03,928385,Cloninger; Alexander,0,0,30,30
1748422143586,MATH 173A,B04,928386,Cloninger; Alexander,0,0,30,30
1748422144614,MATH 174,A01,928397,Cheng; Li-Tien,15,0,28,13
1748422144614,MATH 174,A02,928402,Cheng; Li-Tien,23,0,28,5
1748422145644,MATH 180A,A01,928408,Staff,0,0,25,25
1748422145644,MATH 180A,A02,928409,Staff,18,0,25,7
1748422145644,MATH 180A,A03,928416,Staff,23,0,25,2
1748422145644,MATH 180A,A04,928417,Staff,21,0,25,4
1748422145644,MATH 180A,B01,928428,Peca-Medlin; John Michael,0,0,25,25
1748422145644,MATH 180A,B02,928435,Peca-Medlin; John Michael,11,0,25,14
1748422145644,MATH 180A,B03,928436,Peca-Medlin; John Michael,20,0,25,5
1748422145644,MATH 180A,B04,928453,Peca-Medlin; John Michael,21,0,25,4
1748422145644,MATH 180A,C01,928466,Dixit; Rishabh,20,0,25,5
1748422145644,MATH 180A,C02,928467,Dixit; Rishabh,25,0,25,0
1748422145644,MATH 180A,C03,928506,Dixit; Rishabh,22,0,25,3
1748422145644,MATH 180A,C04,928511,Dixit; Rishabh,25,0,25,0
1748422146671,MATH 180C,A01,928520,Schweinsberg; Jason,0,0,35,35
1748422146671,MATH 180C,A02,928527,Schweinsberg; Jason,0,0,35,35
1748422147698,MATH 181B,A01,928538,Lou; Zhipeng,3,0,30,27
1748422147698,MATH 181B,A02,928539,Lou; Zhipeng,21,0,30,9
1748422147698,MATH 181B,A03,928543,Lou; Zhipeng,27,0,30,3
1748422148795,MATH 183,A01,928545,Quarfoot; David James,0,0,22,22
1748422148795,MATH 183,A02,928560,Quarfoot; David James,0,0,22,22
1748422148795,MATH 183,A03,928565,Quarfoot; David James,0,0,22,22
1748422148795,MATH 183,A04,928566,Quarfoot; David James,0,0,22,22
1748422148795,MATH 183,A05,928567,Quarfoot; David James,0,0,22,22
1748422148795,MATH 183,A06,928568,Quarfoot; David James,0,0,22,22
1748422149823,MATH 184,A01,928587,Chou; Raymond Oliver,14,0,35,21
1748422149823,MATH 184,A02,928592,Chou; Raymond Oliver,29,0,35,6
1748422149823,MATH 184,A03,928593,Chou; Raymond Oliver,32,0,35,3
1748422149823,MATH 184,A04,928594,Chou; Raymond Oliver,35,0,35,0
1748422150850,MATH 187A,A01,928609,Ganapathy; Karthik,0,0,25,25
1748422150850,MATH 187A,A02,928614,Ganapathy; Karthik,0,0,25,25
1748422150850,MATH 187A,A03,928615,Ganapathy; Karthik,0,0,25,25
1748422150850,MATH 187A,A04,928616,Ganapathy; Karthik,7,0,25,18
1748422150850,MATH 187A,A05,928617,Ganapathy; Karthik,0,0,25,25
1748422150850,MATH 187A,A06,928618,Ganapathy; Karthik,12,0,25,13
1748422151880,MATH 190A,A01,928685,Roberts; Justin Deritter,15,0,35,20
1748422152908,MATH 197,001,973284,Kedlaya; Kiran S.,9999,0,9999,0
1748422153934,MATH 200A,A00,928693,Salehi Golsefidy; Alireza,20,0,20,0
1748422154964,MATH 201A,A00,928694,Wenzl; Hans G,20,0,20,0
1748422155989,MATH 202A,A00,928732,Novak; Jonathan I,15,0,20,5
1748422157016,MATH 203A,A00,928743,Izadi; Elham,20,0,20,0
1748422158047,MATH 204A,A00,928764,Sorensen; Claus M,19,0,20,1
1748422159075,MATH 208,A00,928765,Staff,10,0,10,0
1748422160103,MATH 209,A00,928766,Staff,10,0,10,0
1748422161129,MATH 210A,A00,928808,Miller; Pearson,19,0,20,1
1748422162159,MATH 211A,A00,928809,Staff,10,0,10,0
1748422163188,MATH 211B,A00,928811,Staff,10,0,10,0
1748422164218,MATH 216A,A00,928812,Webber; Robert Jacobs,12,0,20,8
1748422165247,MATH 218,A00,928828,Staff,9,0,10,1
1748422166278,MATH 220A,A00,928829,Ebenfelt; Peter F,15,0,20,5
1748422167305,MATH 240A,A00,928830,Spolaor; Luca,17,0,20,3
1748422168333,MATH 241A,A00,928831,Zlatos; Andrej,14,0,20,6
1748422169363,MATH 242,A00,928903,Bejenaru; Ioan,16,0,20,4
1748422170391,MATH 243,A00,928911,Staff,10,0,10,0
1748422171420,MATH 248,A00,928919,Staff,10,0,10,0
1748422172445,MATH 251A,A00,928970,Sam; Steven V,18,0,20,2
1748422173472,MATH 258,A00,928973,Staff,10,0,10,0
1748422174501,MATH 259A,A00,929052,Staff,18,0,20,2
1748422175529,MATH 261A,A00,929059,Warnke; Lutz Peter,10,0,20,10
1748422176559,MATH 269,A00,929060,Staff,10,0,10,0
1748422177587,MATH 270A,A00,929061,Dumitriu; Ioana,8,0,20,12
1748422178613,MATH 273A,A00,929063,Leok; Melvin,17,0,20,3
1748422179641,MATH 274,A01,929069,Cheng; Li-Tien,5,0,5,0
1748422179641,MATH 274,A02,929071,Cheng; Li-Tien,5,0,5,0
1748422180668,MATH 277A,A00,929073,Grier; Daniel T,18,0,20,2
1748422180668,MATH 277A,B00,929080,Nie; Jiawang,20,0,20,0
1748422181695,MATH 278A,A00,929092,Staff,10,0,10,0
1748422182722,MATH 278B,A00,929105,Staff,10,0,10,0
1748422183752,MATH 278C,A00,929113,Staff,10,0,10,0
1748422184785,MATH 280A,A00,929117,Ang; Jie Jun,7,0,20,13
1748422185811,MATH 281A,A00,929120,Lou; Zhipeng,9,0,20,11
1748422186841,MATH 282A,A00,929138,Zhang; Danna,4,0,20,16
1748422187869,MATH 283,A00,929153,Tesler; Glenn,0,0,0,17
1748422188895,MATH 287A,A00,967998,Politis; Dimitris,9,0,15,6
1748422189921,MATH 288,A00,929158,Staff,9,0,10,1
1748422190952,MATH 290A,A00,929180,McKernan; James,18,0,20,2
1748422191980,MATH 292,A00,929185,Staff,10,0,10,0
1748422193006,MATH 295,A00,929189,Staff,15,0,15,0
1748422194032,MATH 297,001,929218,Gamst; Anthony Collins,0,0,0,0
1748422195062,MATS 200,A00,927075,Graeve; Olivia A,9983,0,9999,16
1748422196092,MATS 201A,A00,927076,Luo; Jian,36,0,50,14
1748422197118,MATS 202,A00,927102,Staff,37,0,50,13
1748422198150,MATS 227,A00,927103,Graeve; Olivia A,36,0,50,14
1748422199182,MATS 251A,A00,927139,Bandaru; Prabhakar,40,0,50,10
1748422200208,MATS 257,A00,927140,Cai; Shengqiang,8,0,20,12
1748422201234,MATS 295,A00,927151,Graeve; Olivia A,9999,0,9999,0
1748422201234,MATS 295,B00,927152,Kummel; Andrew C,9999,0,9999,0
1748422202293,MCWP 40,001,945345,Guillen; Melinda,3,0,3,0
1748422202293,MCWP 40,002,945347,Guillen; Melinda,0,0,3,3
1748422202293,MCWP 40,003,945348,Guillen; Melinda,0,0,3,3
1748422202293,MCWP 40,004,945379,Wastal; Carrie King,3,0,3,0
1748422202293,MCWP 40,005,945382,Wastal; Carrie King,2,0,3,1
1748422202293,MCWP 40,006,945383,Compas; Sean Matthew,0,0,3,3
1748422202293,MCWP 40,007,945387,Bartulis; Jason Michael,3,0,3,0
1748422202293,MCWP 40,008,945388,Wastal; Carrie King,2,0,3,1
1748422202293,MCWP 40,009,945391,Wastal; Carrie King,3,0,3,0
1748422202293,MCWP 40,011,945394,Bartulis; Jason Michael,3,0,3,0
1748422202293,MCWP 40,012,945395,Carter; Jennifer A,3,0,3,0
1748422202293,MCWP 40,013,945396,Carter; Jennifer A,2,0,3,1
1748422202293,MCWP 40,014,945429,Carter; Jennifer A,2,0,3,1
1748422202293,MCWP 40,015,945432,Smith; Haydee Marie,3,0,3,0
1748422202293,MCWP 40,016,945433,Smith; Haydee Marie,3,0,3,0
1748422202293,MCWP 40,017,945435,Smith; Haydee Marie,3,0,3,0
1748422202293,MCWP 40,018,945436,Pham; Vincent Minhduc,3,0,3,0
1748422202293,MCWP 40,019,945453,Pham; Vincent Minhduc,3,0,3,0
1748422202293,MCWP 40,020,945459,Pham; Vincent Minhduc,3,0,3,0
1748422202293,MCWP 40,023,945469,Montejo; Carolina,3,0,3,0
1748422202293,MCWP 40,024,945472,Montejo; Carolina,3,0,3,0
1748422202293,MCWP 40,026,945708,Compas; Sean Matthew,3,0,3,0
1748422202293,MCWP 40,027,945710,Duru; Nur,2,0,3,1
1748422202293,MCWP 40,028,945714,Duru; Nur,1,0,3,2
1748422202293,MCWP 40,029,945715,Duru; Nur,2,0,3,1
1748422202293,MCWP 40,030,945718,Compas; Sean Matthew,0,0,3,3
1748422203325,MCWP 40R,A00,945742,Miller; Elizabeth Deen,0,0,0,1
1748422203325,MCWP 40R,B00,945743,Miller; Elizabeth Deen,0,0,0,0
1748422203325,MCWP 40R,C00,945744,Miller; Elizabeth Deen,0,0,0,1
1748422204355,MCWP 50,001,945745,Wastal; Carrie King,2,0,15,13
1748422204355,MCWP 50,002,945746,Carter; Andrea L,18,0,20,2
1748422204355,MCWP 50,003,945788,Carter; Andrea L,11,0,20,9
1748422204355,MCWP 50,004,945887,Carter; Andrea L,8,0,20,12
1748422205385,MCWP 125,001,945901,Nies; Laurie Elizabeth,3,0,3,0
1748422205385,MCWP 125,002,945902,Nies; Laurie Elizabeth,3,0,3,0
1748422205385,MCWP 125,003,945904,Redela; Pamela Morgan,3,0,3,0
1748422205385,MCWP 125,004,945930,Redela; Pamela Morgan,3,0,3,0
1748422205385,MCWP 125,005,945931,Redela; Pamela Morgan,3,0,3,0
1748422205385,MCWP 125,006,945932,Silva; Kelly B,3,0,3,0
1748422205385,MCWP 125,007,945933,Silva; Kelly B,3,0,3,0
1748422205385,MCWP 125,009,945935,Krone; Jarret,3,0,3,0
1748422205385,MCWP 125,010,945940,Krone; Jarret,3,0,3,0
1748422205385,MCWP 125,011,945941,Krone; Jarret,3,0,3,0
1748422205385,MCWP 125,012,945942,Morshed; Michael James,3,0,3,0
1748422205385,MCWP 125,013,945943,Morshed; Michael James,3,0,3,0
1748422205385,MCWP 125,014,945944,Morshed; Michael James,3,0,3,0
1748422206413,MGT 3,A00,945992,Wagner; Timothy Ryan,96,0,98,2
1748422207440,MGT 4,A01,945994,Brooks; Marcus Raymond,80,0,90,10
1748422208467,MGT 5,A00,945995,Molloie Jr.; William H,134,0,150,16
1748422209500,MGT 12,A00,945996,Lindenberger; Wade Douglas,63,0,98,35
1748422209500,MGT 12,B00,945997,Pecore; Joseph P.,58,0,98,40
1748422210528,MGT 16,A00,945998,Buchanan; Harold G,96,0,98,2
1748422210528,MGT 16,B00,946005,Buchanan; Harold G,90,0,98,8
1748422210528,MGT 16,C00,946006,Campbell; Robert Harold,92,0,98,6
1748422210528,MGT 16,D00,946007,Campbell; Robert Harold,93,0,98,5
1748422210528,MGT 16,E00,946022,Lindenberger; Wade Douglas,42,0,98,56
1748422211558,MGT 18,A00,946040,McKay; Michael J,95,0,98,3
1748422211558,MGT 18,B00,946041,McKay; Michael J,96,0,98,2
1748422211558,MGT 18,C00,946044,McKay; Michael J,96,0,98,2
1748422211558,MGT 18,D00,946047,Chamberlain; Travis Dean,98,0,98,0
1748422211558,MGT 18,E00,946051,Chamberlain; Travis Dean,96,0,98,2
1748422211558,MGT 18,F00,960148,Chamberlain; Travis Dean,0,0,0,2
1748422212588,MGT 45,A00,946055,Pecore; Joseph P.,80,0,150,70
1748422212588,MGT 45,B00,946057,Pecore; Joseph P.,117,0,150,33
1748422213614,MGT 52,A00,946059,Staff,77,0,98,21
1748422214642,MGT 71,A00,946060,Goodarzi; Shadi,0,0,98,98
1748422214642,MGT 71,B00,946061,Erat; Sanjiv,0,0,98,98
1748422214642,MGT 71,D00,960149,Staff,0,0,98,98
1748422215672,MGT 100,A00,946069,Yavorsky; Daniel Ryan,0,0,98,98
1748422216706,MGT 103,A00,946081,Ehrich; Kristine R,96,0,98,2
1748422216706,MGT 103,C00,946083,Ehrich; Kristine R,75,0,98,23
1748422216706,MGT 103,D00,946084,Ehrich; Kristine R,57,0,98,41
1748422216706,MGT 103,E00,946138,Bates; Kenneth Walter,82,0,98,16
1748422217737,MGT 105,A00,946139,Bates; Kenneth Walter,0,0,98,98
1748422218765,MGT 108R,A00,946141,Amir; On,888,0,999,111
1748422219791,MGT 109,A00,946142,Staff,14,0,98,84
1748422220819,MGT 112,A00,960205,Zimmermann; Carsten,30,0,98,68
1748422221852,MGT 119,A00,946144,Schurr; Amos Shlomo,96,0,98,2
1748422221852,MGT 119,B00,946153,Staff,97,0,98,1
1748422222882,MGT 121A,A00,946154,Wang; Helen Shan,89,0,98,9
1748422222882,MGT 121A,B00,946188,Wang; Helen Shan,96,0,98,2
1748422223908,MGT 127R,A00,946197,Zhu; Kevin Xiaoguo,70,0,98,28
1748422224937,MGT 131A,A00,946227,Brooks; Marcus Raymond,91,0,98,7
1748422225965,MGT 132,A00,946230,Blakley; Bruce,76,0,98,22
1748422226991,MGT 135,A00,946234,Anderson; John Charles,1,0,40,39
1748422228018,MGT 137,A00,960206,Lindenberger; Wade Douglas,0,0,98,98
1748422229044,MGT 151R,A00,946235,Staff,65,0,98,33
1748422230071,MGT 153,A00,946242,Perols; Johan Lars,0,0,90,90
1748422230071,MGT 153,B00,946244,Perols; Johan Lars,0,0,90,90
1748422231099,MGT 158,A00,946247,Bliss; Barbara Ann,85,0,98,13
1748422232128,MGT 160,A00,946265,Johnson; Erik Barry,30,0,90,60
1748422232128,MGT 160,B00,946266,Johnson; Erik Barry,58,0,90,32
1748422233161,MGT 162,A00,946267,Demill; Burritt,85,0,98,13
1748422233161,MGT 162,B00,946269,Demill; Burritt,67,0,98,31
1748422234187,MGT 162R,A00,946270,Gneezy; Uri,0,0,150,150
1748422235217,MGT 164,A00,946271,McKay; Mary A,88,0,98,10
1748422235217,MGT 164,B00,946272,McKay; Mary A,80,0,98,18
1748422235217,MGT 164,C00,946273,McKay; Mary A,88,0,98,10
1748422235217,MGT 164,D00,946274,Meyer; Alison Bloomfield,0,0,98,98
1748422236245,MGT 166,A00,946276,Moran; Cathleen L.,40,0,60,20
1748422236245,MGT 166,B00,946277,Moran; Cathleen L.,84,0,98,14
1748422236245,MGT 166,C00,946278,Moran; Cathleen L.,94,0,98,4
1748422237277,MGT 167,A00,946279,Jacob; Jo Dee C,88,0,98,10
1748422237277,MGT 167,B00,946280,Klaas; Jeffrey David,97,0,98,1
1748422239336,MGT 172,A00,946282,Hedges; Kathleen & Royal; Rebecca,92,0,98,6
1748422239336,MGT 172,B00,946283,Hedges; Kathleen,73,0,98,25
1748422239336,MGT 172,C00,946284,Zimmermann; Carsten,0,0,0,3
1748422240363,MGT 172R,A00,946285,Erat; Sanjiv,134,0,150,16
1748422241388,MGT 173,A00,946286,Hayes; Sherry Lorine,66,0,98,32
1748422242424,MGT 175,A00,946287,Gopal; Christopher S.,81,0,90,9
1748422243451,MGT 180,A00,946288,Bliss; Barbara Ann,96,0,150,54
1748422243451,MGT 180,B00,946289,Buti; Krisztina,140,0,150,10
1748422243451,MGT 180,C00,960207,Buti; Krisztina,142,0,150,8
1748422244482,MGT 181,A00,946290,Buchanan; Harold G,17,0,120,103
1748422245510,MGT 183,A00,960208,Staff,53,0,98,45
1748422246544,MGT 185,A00,946291,Dunn; Louis Jean,70,0,98,28
1748422247570,MGT 187,A00,946292,Dunn; Louis Jean,43,0,98,55
1748422248599,MGT 189,A00,946293,Staff,88,0,98,10
1748422249630,MGT 228,A00,946294,Sadoff; Sally,16,0,20,4
1748422250659,MGT 286,A00,946295,Staff,20,0,20,0
1748422251695,MGT 296,001,969295,Gneezy; Ayelet,2,0,3,1
1748422251695,MGT 296,002,969296,Amir; On,3,0,3,0
1748422251695,MGT 296,003,969297,Amir; On & Karmarkar; Uma R,2,0,3,1
1748422251695,MGT 296,004,969298,Liu; Jun,3,0,3,0
1748422251695,MGT 296,005,969300,Hansen; Karsten T.,2,0,3,1
1748422251695,MGT 296,006,969301,Erat; Sanjiv,2,0,3,1
1748422251695,MGT 296,007,969302,Avenancio-Leon; Carlos,3,0,3,0
1748422251695,MGT 296,008,969303,Engelberg; Joseph Edward,3,0,3,0
1748422251695,MGT 296,009,969304,Zhang; Zhe,3,0,3,0
1748422251695,MGT 296,010,969305,Oveis; Christopher S,3,0,3,0
1748422251695,MGT 296,011,969306,Zhu; Kevin Xiaoguo & Gneezy; Ayelet,3,0,3,0
1748422251695,MGT 296,012,969307,Luo; Danqi,3,0,3,0
1748422251695,MGT 296,013,969309,Oveis; Christopher S & Campbell; Elizabeth L,3,0,3,0
1748422251695,MGT 296,014,969310,Serra Garcia; Marta & Gneezy; Uri,3,0,3,0
1748422251695,MGT 296,015,969311,Rai; Tage S,3,0,3,0
1748422252795,MMW 11,A01,925937,Herbst; Matthew,4,0,4,0
1748422252795,MMW 11,A02,925938,Herbst; Matthew,3,0,4,1
1748422252795,MMW 11,A03,925939,Herbst; Matthew,4,0,4,0
1748422252795,MMW 11,A04,925940,Herbst; Matthew,4,0,4,0
1748422252795,MMW 11,A05,925941,Herbst; Matthew,0,0,0,0
1748422252795,MMW 11,A06,925942,Herbst; Matthew,0,0,0,0
1748422252795,MMW 11,A07,925975,Herbst; Matthew,3,0,4,1
1748422252795,MMW 11,A08,926004,Herbst; Matthew,3,0,4,1
1748422252795,MMW 11,A09,926021,Herbst; Matthew,3,0,4,1
1748422252795,MMW 11,A10,926064,Herbst; Matthew,4,0,4,0
1748422252795,MMW 11,A11,926067,Herbst; Matthew,4,0,4,0
1748422252795,MMW 11,A12,926072,Herbst; Matthew,4,0,4,0
1748422252795,MMW 11,B01,926211,Chang; Edmond Yi-Teh,3,0,4,1
1748422252795,MMW 11,B02,926212,Chang; Edmond Yi-Teh,4,0,4,0
1748422252795,MMW 11,B03,926213,Chang; Edmond Yi-Teh,4,0,4,0
1748422252795,MMW 11,B04,926214,Chang; Edmond Yi-Teh,4,0,4,0
1748422252795,MMW 11,B05,926215,Chang; Edmond Yi-Teh,4,0,4,0
1748422252795,MMW 11,B06,926216,Chang; Edmond Yi-Teh,4,0,4,0
1748422252795,MMW 11,B07,926217,Chang; Edmond Yi-Teh,4,0,4,0
1748422252795,MMW 11,B08,926218,Chang; Edmond Yi-Teh,3,0,4,1
1748422252795,MMW 11,B09,926219,Chang; Edmond Yi-Teh,4,0,4,0
1748422252795,MMW 11,B10,926220,Chang; Edmond Yi-Teh,4,0,4,0
1748422252795,MMW 11,B11,926221,Chang; Edmond Yi-Teh,0,0,0,0
1748422252795,MMW 11,B12,926233,Chang; Edmond Yi-Teh,0,0,0,0
1748422252795,MMW 11,C01,926237,Chang; Edmond Yi-Teh,4,0,4,0
1748422252795,MMW 11,C02,926238,Chang; Edmond Yi-Teh,4,0,4,0
1748422252795,MMW 11,C03,926239,Chang; Edmond Yi-Teh,3,0,4,1
1748422252795,MMW 11,C04,926240,Chang; Edmond Yi-Teh,4,0,4,0
1748422252795,MMW 11,C05,926241,Chang; Edmond Yi-Teh,4,0,4,0
1748422252795,MMW 11,C06,926242,Chang; Edmond Yi-Teh,4,0,4,0
1748422252795,MMW 11,C07,926243,Chang; Edmond Yi-Teh,4,0,4,0
1748422252795,MMW 11,C08,926244,Chang; Edmond Yi-Teh,4,0,4,0
1748422252795,MMW 11,C09,926245,Chang; Edmond Yi-Teh,0,0,0,0
1748422252795,MMW 11,C10,926301,Chang; Edmond Yi-Teh,0,0,0,0
1748422252795,MMW 11,C11,926303,Chang; Edmond Yi-Teh,4,0,4,0
1748422252795,MMW 11,C12,926305,Chang; Edmond Yi-Teh,4,0,4,0
1748422253825,MMW 14,A01,926309,Carreras; Maria Victoria,0,0,0,0
1748422253825,MMW 14,A02,926470,Carreras; Maria Victoria,0,0,0,0
1748422253825,MMW 14,A03,926472,Carreras; Maria Victoria,0,0,28,28
1748422253825,MMW 14,A04,926474,Carreras; Maria Victoria,0,0,28,28
1748422253825,MMW 14,A05,926475,Carreras; Maria Victoria,0,0,28,28
1748422253825,MMW 14,A06,926476,Carreras; Maria Victoria,0,0,28,28
1748422253825,MMW 14,A07,926477,Carreras; Maria Victoria,0,0,28,28
1748422253825,MMW 14,A08,926513,Carreras; Maria Victoria,0,0,28,28
1748422253825,MMW 14,A09,926514,Carreras; Maria Victoria,0,0,0,0
1748422253825,MMW 14,A10,926515,Carreras; Maria Victoria,0,0,0,0
1748422254857,MMW 121,A01,926517,Adamiak; Patrick John,0,0,0,0
1748422254857,MMW 121,A02,926548,Adamiak; Patrick John,0,0,0,0
1748422254857,MMW 121,A03,926549,Adamiak; Patrick John,0,0,4,4
1748422254857,MMW 121,A04,926550,Adamiak; Patrick John,2,0,4,2
1748422254857,MMW 121,A05,926551,Adamiak; Patrick John,0,0,4,4
1748422254857,MMW 121,A06,926552,Adamiak; Patrick John,3,0,4,1
1748422254857,MMW 121,A07,926585,Adamiak; Patrick John,3,0,4,1
1748422254857,MMW 121,A08,926590,Adamiak; Patrick John,3,0,4,1
1748422254857,MMW 121,A09,926641,Adamiak; Patrick John,0,0,0,0
1748422254857,MMW 121,A10,926658,Adamiak; Patrick John,0,0,0,0
1748422254857,MMW 121,B01,926680,Adamiak; Patrick John,0,0,4,4
1748422254857,MMW 121,B02,926691,Adamiak; Patrick John,0,0,4,4
1748422254857,MMW 121,B03,926710,Adamiak; Patrick John,2,0,4,2
1748422254857,MMW 121,B04,926714,Adamiak; Patrick John,4,0,4,0
1748422254857,MMW 121,B05,926750,Adamiak; Patrick John,0,0,4,4
1748422254857,MMW 121,B06,926765,Adamiak; Patrick John,4,0,4,0
1748422254857,MMW 121,B07,926769,Adamiak; Patrick John,3,0,4,1
1748422254857,MMW 121,B08,926953,Adamiak; Patrick John,3,0,4,1
1748422254857,MMW 121,B09,926954,Adamiak; Patrick John,0,0,0,0
1748422254857,MMW 121,B10,926955,Adamiak; Patrick John,0,0,0,0
1748422255883,MSED 295,A00,927153,Staff,5,0,5,0
1748422256910,MSED 296A,A00,927181,Rabin; Jeffrey Mark,13,0,15,2
1748422257938,MUS 1A,A01,931495,Staff,24,0,25,1
1748422257938,MUS 1A,A02,931499,Staff,21,0,25,4
1748422257938,MUS 1A,A03,931502,Staff,21,0,25,4
1748422257938,MUS 1A,A04,931503,Staff,25,0,25,0
1748422257938,MUS 1A,A05,931504,Staff,19,0,25,6
1748422257938,MUS 1A,A06,931505,Staff,22,0,25,3
1748422257938,MUS 1A,B01,931507,Staff,25,0,25,0
1748422257938,MUS 1A,B02,931530,Staff,22,0,25,3
1748422257938,MUS 1A,B03,931534,Staff,23,0,25,2
1748422257938,MUS 1A,B04,931536,Staff,24,0,25,1
1748422257938,MUS 1A,B05,931539,Staff,17,0,25,8
1748422257938,MUS 1A,B06,931541,Staff,13,0,25,12
1748422258965,MUS 2A,A01,931544,Carlson; Erik,40,0,40,0
1748422259997,MUS 2AK,A00,931545,Ohnishi; Takae,15,0,15,0
1748422259997,MUS 2AK,B00,931546,Ohnishi; Takae,15,0,15,0
1748422261026,MUS 4,A01,931551,Staff,24,0,25,1
1748422261026,MUS 4,A02,931552,Staff,25,0,25,0
1748422261026,MUS 4,A03,931553,Staff,24,0,25,1
1748422261026,MUS 4,A04,931554,Staff,25,0,25,0
1748422261026,MUS 4,A05,931558,Staff,24,0,25,1
1748422261026,MUS 4,A06,931561,Staff,25,0,25,0
1748422261026,MUS 4,A07,931562,Staff,25,0,25,0
1748422261026,MUS 4,A08,931563,Staff,25,0,25,0
1748422261026,MUS 4,A09,931564,Staff,25,0,25,0
1748422261026,MUS 4,A10,931566,Staff,25,0,25,0
1748422262055,MUS 6,A01,931573,Freitas Caetano; Marcelo,27,0,30,3
1748422262055,MUS 6,A02,931574,Freitas Caetano; Marcelo,28,0,30,2
1748422262055,MUS 6,A03,931677,Freitas Caetano; Marcelo,28,0,30,2
1748422262055,MUS 6,A04,931696,Freitas Caetano; Marcelo,30,0,30,0
1748422263083,MUS 8,A01,931732,Smythe; Cory Benjamin,12,0,25,13
1748422263083,MUS 8,A02,931737,Smythe; Cory Benjamin,17,0,25,8
1748422263083,MUS 8,A03,931761,Smythe; Cory Benjamin,25,0,25,0
1748422263083,MUS 8,A04,931920,Smythe; Cory Benjamin,23,0,25,2
1748422263083,MUS 8,A05,931925,Smythe; Cory Benjamin,21,0,25,4
1748422263083,MUS 8,A06,931943,Smythe; Cory Benjamin,19,0,25,6
1748422263083,MUS 8,A07,931948,Smythe; Cory Benjamin,22,0,25,3
1748422263083,MUS 8,A08,931955,Smythe; Cory Benjamin,18,0,25,7
1748422263083,MUS 8,A09,931964,Smythe; Cory Benjamin,25,0,25,0
1748422263083,MUS 8,A10,931974,Smythe; Cory Benjamin,24,0,25,1
1748422264111,MUS 13,A01,961328,Guy; Nancy,28,0,30,2
1748422264111,MUS 13,A02,961333,Guy; Nancy,30,0,30,0
1748422264111,MUS 13,A03,961343,Guy; Nancy,28,0,30,2
1748422264111,MUS 13,A04,961351,Guy; Nancy,30,0,30,0
1748422265138,MUS 14,A01,932176,McCormack; Timothy Matthew,29,0,30,1
1748422265138,MUS 14,A02,932183,McCormack; Timothy Matthew,29,0,30,1
1748422265138,MUS 14,A03,932186,McCormack; Timothy Matthew,30,0,30,0
1748422265138,MUS 14,A04,932190,McCormack; Timothy Matthew,29,0,30,1
1748422266173,MUS 15,A01,932270,Lou; Michelle Siulai,28,0,30,2
1748422266173,MUS 15,A02,932315,Lou; Michelle Siulai,29,0,30,1
1748422266173,MUS 15,A03,932316,Lou; Michelle Siulai,28,0,30,2
1748422266173,MUS 15,A04,932323,Lou; Michelle Siulai,30,0,30,0
1748422266173,MUS 15,A05,932325,Lou; Michelle Siulai,27,0,30,3
1748422266173,MUS 15,A06,932326,Lou; Michelle Siulai,27,0,30,3
1748422266173,MUS 15,A07,932327,Lou; Michelle Siulai,30,0,30,0
1748422266173,MUS 15,A08,932328,Lou; Michelle Siulai,28,0,30,2
1748422266173,MUS 15,A09,932366,Lou; Michelle Siulai,29,0,30,1
1748422266173,MUS 15,A10,932380,Lou; Michelle Siulai,25,0,30,5
1748422267203,MUS 17,A01,932416,Staff,0,0,0,0
1748422267203,MUS 17,A02,932423,Staff,0,0,0,0
1748422267203,MUS 17,A03,932437,Staff,0,0,0,0
1748422267203,MUS 17,A04,932447,Staff,0,0,0,0
1748422267203,MUS 17,A05,932460,Staff,0,0,0,0
1748422267203,MUS 17,A06,932466,Staff,0,0,0,0
1748422267203,MUS 17,A07,932475,Staff,0,0,0,0
1748422267203,MUS 17,A08,932479,Staff,0,0,0,0
1748422267203,MUS 17,A09,932480,Staff,0,0,0,0
1748422267203,MUS 17,A10,932481,Staff,0,0,0,0
1748422267203,MUS 17,A11,932487,Staff,0,0,0,9
1748422267203,MUS 17,A12,932490,Staff,0,0,0,1
1748422268234,MUS 19R,A01,932494,Britt; King James,7,0,25,18
1748422268234,MUS 19R,A02,932500,Britt; King James,20,0,25,5
1748422268234,MUS 19R,A03,932503,Britt; King James,24,0,25,1
1748422268234,MUS 19R,A04,932504,Britt; King James,23,0,25,2
1748422268234,MUS 19R,A05,932512,Britt; King James,25,0,25,0
1748422268234,MUS 19R,A06,932513,Britt; King James,17,0,25,8
1748422268234,MUS 19R,A07,932517,Britt; King James,22,0,25,3
1748422268234,MUS 19R,A08,932522,Britt; King James,20,0,25,5
1748422268234,MUS 19R,A09,960795,Britt; King James,25,0,25,0
1748422268234,MUS 19R,A10,960796,Britt; King James,15,0,25,10
1748422268234,MUS 19R,B01,960808,Britt; King James,5,0,5,0
1748422268234,MUS 19R,B02,960810,Britt; King James,4,0,5,1
1748422268234,MUS 19R,B03,960812,Britt; King James,5,0,5,0
1748422268234,MUS 19R,B04,960815,Britt; King James,5,0,5,0
1748422268234,MUS 19R,B05,960861,Britt; King James,5,0,5,0
1748422268234,MUS 19R,B06,960863,Britt; King James,5,0,5,0
1748422268234,MUS 19R,B07,960866,Britt; King James,5,0,5,0
1748422268234,MUS 19R,B08,960870,Britt; King James,5,0,5,0
1748422268234,MUS 19R,B09,960871,Britt; King James,5,0,5,0
1748422268234,MUS 19R,B10,960872,Britt; King James,5,0,5,0
1748422269262,MUS 32,001,931432,Dresser; Mark Stuart,5,0,5,0
1748422269262,MUS 32,002,931433,Smythe; Cory Benjamin,5,0,5,0
1748422269262,MUS 32,003,931438,Kenyatta; Kamau,5,0,5,0
1748422269262,MUS 32,004,931441,Curtis; Charles Rector,5,0,5,0
1748422269262,MUS 32,005,931443,Staff,5,0,5,0
1748422269262,MUS 32,006,931447,Terrazas Perez; Wilfrido D,5,0,5,0
1748422269262,MUS 32,007,931448,Ohnishi; Takae,5,0,5,0
1748422269262,MUS 32,008,931453,Burr; Anthony I,5,0,5,0
1748422269262,MUS 32,009,931454,Carlson; Erik,5,0,5,0
1748422270288,MUS 32V,A00,932529,Staff,5,0,5,0
1748422270288,MUS 32V,B00,932532,Staff,5,0,5,0
1748422271312,MUS 32VM,A00,932533,Staff,15,0,15,0
1748422272339,MUS 33A,A00,932538,Liang; Lei,16,0,17,1
1748422273367,MUS 43,A00,932540,Staff,79,0,96,17
1748422274396,MUS 95C,A00,932544,Staff,30,0,40,10
1748422275424,MUS 95D,A00,932547,Staff,30,0,30,0
1748422276451,MUS 95E,A00,932548,Staff,45,0,45,0
1748422277478,MUS 95F,A00,932549,Staff,40,0,40,0
1748422278505,MUS 95G,A00,932550,Anderson; Kenneth,374,0,395,21
1748422278505,MUS 95G,B00,932553,Anderson; Kenneth,381,0,395,14
1748422279535,MUS 95JC,A00,932555,Kenyatta; Kamau,25,0,25,0
1748422280563,MUS 95L,A00,932556,Staff,65,0,65,0
1748422281590,MUS 95P,A00,932564,Nourai; Keyavash,17,0,20,3
1748422281590,MUS 95P,B00,932565,Nourai; Keyavash,18,0,20,2
1748422282618,MUS 95W,A00,932567,Seshadri; Kartik,26,0,30,4
1748422282618,MUS 95W,B00,932570,Seshadri; Kartik,30,0,30,0
1748422283646,MUS 101A,A01,932575,Burr; Anthony I,31,0,35,4
1748422284671,MUS 107,A00,932578,Terrazas Perez; Wilfrido D,14,0,15,1
1748422285700,MUS 111,A00,932580,Liang; Lei,135,0,140,5
1748422286731,MUS 113,A00,932584,Curtis; Charles Rector,48,0,50,2
1748422287758,MUS 115,A00,932585,Narucki; Susan M,32,0,40,8
1748422288791,MUS 120A,A01,932593,Leslie Santana; Myrta,27,0,30,3
1748422289819,MUS 130,A00,932600,Ohnishi; Takae,35,0,35,0
1748422290845,MUS 132,001,931462,Dresser; Mark Stuart,5,0,5,0
1748422290845,MUS 132,002,931463,Smythe; Cory Benjamin,5,0,5,0
1748422290845,MUS 132,003,931465,Kenyatta; Kamau,5,0,5,0
1748422290845,MUS 132,004,931467,Curtis; Charles Rector,5,0,5,0
1748422290845,MUS 132,005,931468,Staff,5,0,5,0
1748422290845,MUS 132,006,931470,Terrazas Perez; Wilfrido D,5,0,5,0
1748422290845,MUS 132,007,931471,Ohnishi; Takae,5,0,5,0
1748422290845,MUS 132,008,931473,Burr; Anthony I,5,0,5,0
1748422290845,MUS 132,009,931474,Carlson; Erik,5,0,5,0
1748422291870,MUS 132R,A00,961401,Narucki; Susan M,5,0,5,0
1748422292896,MUS 132V,A00,961362,Narucki; Susan M,10,0,10,0
1748422292896,MUS 132V,B00,961397,Staff,10,0,10,0
1748422293922,MUS 134,A00,932601,Staff,30,0,30,0
1748422294948,MUS 137A,A00,932604,Kenyatta; Kamau,31,0,35,4
1748422295973,MUS 143,A00,932617,Staff,10,0,30,20
1748422297003,MUS 170,A01,932620,Freitas Caetano; Marcelo,45,0,50,5
1748422297003,MUS 170,A02,932623,Freitas Caetano; Marcelo,42,0,50,8
1748422298034,MUS 173A,A00,932625,Britt; King James,28,0,65,37
1748422299060,MUS 174A,A00,932649,Erbe; Tom,0,0,25,25
1748422300093,MUS 175,A00,932810,Smyth; Tamara R.,29,0,30,1
1748422301121,MUS 176,A00,932811,Yadegari; Shahrokh D,29,0,30,1
1748422302151,MUS 201A,A00,932812,Carlson; Erik,14,0,15,1
1748422303178,MUS 201C,A00,932818,Schick; Steven,15,0,15,0
1748422304209,MUS 203A,A00,932821,Lou; Michelle Siulai,15,0,15,0
1748422305245,MUS 203D,A00,932825,Davis; Anthony Curtis,10,0,10,0
1748422305245,MUS 203D,B00,932827,Liang; Lei,10,0,10,0
1748422305245,MUS 203D,C00,932828,Lou; Michelle Siulai,9,0,10,1
1748422305245,MUS 203D,D00,932830,Obermueller; Karola,9,0,10,1
1748422305245,MUS 203D,E00,932831,Steiger; Rand,10,0,10,0
1748422305245,MUS 203D,F00,961402,McCormack; Timothy Matthew,10,0,10,0
1748422306271,MUS 204,A00,932832,Obermueller; Karola,29,0,30,1
1748422307303,MUS 205,A00,932833,Guy; Nancy,15,0,15,0
1748422308329,MUS 206,B00,961403,Obermueller; Karola,14,0,15,1
1748422308329,MUS 206,C00,932839,Davis; Anthony Curtis,14,0,15,1
1748422309361,MUS 215A,A00,932985,Cimini; Amy Marie,15,0,15,0
1748422310388,MUS 228,A00,933096,Schick; Steven,13,0,15,2
1748422311419,MUS 229,A00,933148,McCormack; Timothy Matthew,14,0,15,1
1748422312452,MUS 232,001,931483,Dresser; Mark Stuart,5,0,5,0
1748422312452,MUS 232,002,931485,Kenyatta; Kamau,5,0,5,0
1748422312452,MUS 232,003,931487,Narucki; Susan M,4,0,5,1
1748422312452,MUS 232,004,931489,Schick; Steven,5,0,5,0
1748422312452,MUS 232,005,964353,Terrazas Perez; Wilfrido D,3,0,3,0
1748422313481,MUS 234,A00,933176,Erbe; Tom,20,0,20,0
1748422314508,MUS 270D,A00,969315,Smyth; Tamara R.,0,0,0,0
1748422315536,MUS 291,A00,933192,Curtis; Charles Rector,15,0,15,0
1748422316564,NANO 4,A01,912573,Vazquez Mena; Oscar,21,0,24,3
1748422316564,NANO 4,B01,912575,Vazquez Mena; Oscar,24,0,24,0
1748422316564,NANO 4,C01,912577,Vazquez Mena; Oscar,21,0,24,3
1748422316564,NANO 4,D01,912579,Vazquez Mena; Oscar,23,0,24,1
1748422317596,NANO 11,A00,912580,Fenning; David,143,0,146,3
1748422318627,NANO 15,A01,912583,Lubarda; Vlado,26,0,30,4
1748422319660,NANO 20L,A00,912584,Sirbuly; Donald,0,0,30,30
1748422319660,NANO 20L,B00,912585,Sirbuly; Donald,20,0,30,10
1748422320690,NANO 102,A00,912586,Tao; Andrea Rae,99,0,115,16
1748422321717,NANO 103,A00,912587,Jahed Motlagh; Zeinab,49,0,50,1
1748422322744,NANO 111,A00,912588,Vecchio; Kenneth S,50,0,60,10
1748422323775,NANO 119,A00,912589,Jokerst; Jesse Vincent,6,0,28,22
1748422323775,NANO 119,B00,912590,Jokerst; Jesse Vincent,26,0,28,2
1748422324803,NANO 148,A00,912591,Luo; Jian,55,0,70,15
1748422325834,NANO 150,A00,912592,Lubarda; Vlado,48,0,50,2
1748422326860,NANO 159,A00,912593,Wang; Joseph,44,0,50,6
1748422327895,NANO 175,A00,912594,Steinmetz; Nicole F,13,0,35,22
1748422328920,NANO 200,A00,912595,Jahed Motlagh; Zeinab,110,0,120,10
1748422329950,NANO 201,A00,912596,Sirbuly; Donald,49,0,60,11
1748422330982,NANO 202,A00,912597,Pascal; Tod A,60,0,60,0
1748422332012,NANO 203,A00,912598,Fenning; David,95,0,100,5
1748422333038,NANO 227,A00,912599,Graeve; Olivia A,14,0,15,1
1748422334070,NANO 247A,A00,912600,Shi; Lingyan,9,0,15,6
1748422335098,NANO 247B,A00,912601,Aran; Kiana,11,0,15,4
1748422336130,NANO 257,A00,912602,Cai; Shengqiang,32,0,35,3
1748422337159,NANO 265,A00,912603,Luo; Jian,9,0,10,1
1748422338186,NEU 276,A00,969333,Staff,0,0,0,0
1748422338186,NEU 276,A01,969334,Staff,0,0,0,0
1748422339218,NEUG 200A,A01,969326,Bloodgood; Brenda Laurie,0,0,0,0
1748422339218,NEUG 200A,A02,969327,Bloodgood; Brenda Laurie,0,0,0,0
1748422340250,NEUG 221,A00,969330,Dore; Kim Bohemie,6,0,6,0
1748422340250,NEUG 221,B00,969331,Bloodgood; Brenda Laurie,0,0,0,0
1748422341275,NEUG 265,A00,969329,Yaksh; Tony L.,10,0,10,0
1748422342301,NEUG 296,A00,969336,Bloodgood; Brenda Laurie,12,0,12,0
1748422343327,PH 40,A00,922279,Trinidad; Dennis Ryan,136,0,150,14
1748422343327,PH 40,B00,922283,Trinidad; Dennis Ryan,148,0,150,2
1748422344356,PH 50,A00,922284,Glockner; Susan Mariscal,160,0,175,15
1748422345383,PH 90,A00,964352,Larsen; Britta Ann,0,0,0,0
1748422346409,PH 91,A00,922286,Harrell; Maralee Mae,48,0,50,2
1748422347441,PH 101,A00,922287,Brouwer; Kimberly,0,0,50,50
1748422348468,PH 102,A01,922307,Rana; Brinda Kanti,0,0,25,25
1748422348468,PH 102,A02,922310,Rana; Brinda Kanti,0,0,25,25
1748422349495,PH 110,A00,922333,Zoumas-Morse; Christine E.,0,0,50,50
1748422350522,PH 120,A00,922392,McMenamin; Sara B,0,0,50,50
1748422351552,PH 120R,A00,922393,McMenamin; Sara B,0,0,50,50
1748422352580,PH 130,A00,922441,Kayser; Georgia Lyn,0,0,60,60
1748422353611,PH 157,A00,922444,Campbell; Chadwick Karl,29,0,50,21
1748422354638,PH 161,A00,922445,Zoumas-Morse; Christine E.,0,0,50,50
1748422355666,PH 193,A00,922468,Zoumas-Morse; Christine E.,0,0,0,0
1748422356751,PH 231,A00,970937,Hurst; Samantha,12,0,12,0
1748422357783,PH 258,A00,960659,Bazzi; Angela Robertson,15,0,15,0
1748422358809,PH 259,A00,960660,Bandoli; Gretchen,10,0,10,0
1748422359837,PH 275,A00,922474,Groessl; Erik Joseph,10,0,10,0
1748422360864,PH 280,A00,960661,Strong; David R & Skaathun; Britt Paige,10,0,10,0
1748422361899,PHAR 219,A00,954131,Ross; Camille,0,0,0,0
1748422362926,PHAR 236,A00,934403,Chen; Shu-Juan,10,0,10,0
1748422363952,PHAR 295,A00,934404,Joiner; William J.,14,0,15,1
1748422364978,PHB 221,A00,922708,Zou; Jingjing,22,0,39,17
1748422366010,PHB 224,A00,922793,Jain; Sonia,9,0,30,21
1748422367037,PHB 227,A00,922796,Liu; Lin,14,0,37,23
1748422368066,PHB 241,A00,970723,Vaida; Florin,9998,0,9999,1
1748422369093,PHB 243A,A01,922822,Tu; Xin,20,0,45,25
1748422370123,PHB 244A,A00,922870,Zhang; Xinlian,20,0,35,15
1748422371148,PHB 280,A00,922875,Messer; Karen Sue,69,0,70,1
1748422372177,PHB 281,A00,923029,Staff,62,0,65,3
1748422373205,PHIL 1,A00,934405,Sher; Gila,38,0,40,2
1748422374233,PHIL 10,A01,934409,Rudolph; Rachel Etta,34,0,39,5
1748422374233,PHIL 10,A02,934410,Rudolph; Rachel Etta,32,0,40,8
1748422374233,PHIL 10,A03,934414,Rudolph; Rachel Etta,31,0,40,9
1748422374233,PHIL 10,A04,934415,Rudolph; Rachel Etta,39,0,40,1
1748422374233,PHIL 10,A05,934416,Rudolph; Rachel Etta,35,0,40,5
1748422374233,PHIL 10,A06,934417,Rudolph; Rachel Etta,39,0,40,1
1748422375264,PHIL 12,A01,934419,Harrell; Maralee Mae,0,0,0,0
1748422375264,PHIL 12,A02,934422,Harrell; Maralee Mae,0,0,0,0
1748422375264,PHIL 12,A03,934423,Harrell; Maralee Mae,30,0,35,5
1748422375264,PHIL 12,A04,934425,Harrell; Maralee Mae,32,0,35,3
1748422376295,PHIL 13,A01,934427,Lamey; Andy M.,32,0,34,2
1748422376295,PHIL 13,A02,934429,Lamey; Andy M.,31,0,34,3
1748422376295,PHIL 13,A03,934430,Lamey; Andy M.,31,0,34,3
1748422376295,PHIL 13,A04,934432,Lamey; Andy M.,34,0,34,0
1748422377326,PHIL 25,A00,934434,Chen; Keming,66,0,70,4
1748422378353,PHIL 27,A01,934442,Brandt; Reuven A,0,0,33,33
1748422378353,PHIL 27,A02,934443,Brandt; Reuven A,7,0,33,26
1748422378353,PHIL 27,A03,934444,Brandt; Reuven A,10,0,33,23
1748422378353,PHIL 27,A04,934448,Brandt; Reuven A,0,0,33,33
1748422378353,PHIL 27,A05,934450,Brandt; Reuven A,19,0,33,14
1748422378353,PHIL 27,A06,934452,Brandt; Reuven A,0,0,33,33
1748422378353,PHIL 27,A07,934499,Brandt; Reuven A,0,0,33,33
1748422378353,PHIL 27,A08,934500,Brandt; Reuven A,6,0,33,27
1748422379379,PHIL 28,A01,934502,Brink; David O.,26,0,33,7
1748422379379,PHIL 28,A02,934506,Brink; David O.,26,0,33,7
1748422379379,PHIL 28,A03,934507,Brink; David O.,27,0,33,6
1748422379379,PHIL 28,A04,934512,Brink; David O.,8,0,33,25
1748422379379,PHIL 28,A05,934517,Brink; David O.,20,0,33,13
1748422379379,PHIL 28,A06,934518,Brink; David O.,0,0,33,33
1748422379379,PHIL 28,A07,934519,Brink; David O.,17,0,33,16
1748422379379,PHIL 28,A08,934520,Brink; David O.,27,0,33,6
1748422380423,PHIL 35,A00,934521,Vargas; Manuel Rogelio,138,0,140,2
1748422381453,PHIL 50,A00,934524,Nelkin; Dana Kay,124,0,140,16
1748422382480,PHIL 65,A00,934526,Rudolph; Rachel Etta,37,0,40,3
1748422383507,PHIL 110,A00,934529,Shields; Christopher John,38,0,42,4
1748422384535,PHIL 115,A00,934530,Nelkin; Dana Kay,15,0,20,5
1748422385565,PHIL 120,A00,934533,Kocurek; Alexander William,45,0,60,15
1748422386595,PHIL 125,A00,934534,Carr; Jennifer Rose,38,0,40,2
1748422387624,PHIL 138,A00,934535,Brink; David O.,29,0,40,11
1748422388656,PHIL 143,A00,934579,Cohen; Jonathan David,40,0,40,0
1748422389687,PHIL 148,A00,934580,Callender; Craig Adam,126,0,140,14
1748422390713,PHIL 149,A00,934581,Fulkerson; Matthew Todd,37,0,70,33
1748422391743,PHIL 158,A00,934593,Chen; Keming,20,0,40,20
1748422392768,PHIL 166,A00,934675,Lamey; Andy M.,27,0,40,13
1748422393795,PHIL 180,A00,934688,Hardimon; Michael O.,32,0,40,8
1748422394823,PHIL 200,A00,934719,Kovaka; Karenc,20,0,20,0
1748422395853,PHIL 201A,A00,934736,Shields; Christopher John,18,0,20,2
1748422396878,PHIL 209A,A00,934772,McKenzie; Kerry V.,10,0,10,0
1748422397903,PHIL 209C,A00,934787,McKenzie; Kerry V.,10,0,10,0
1748422398929,PHIL 222,A00,934789,Kocurek; Alexander William & Carr; Jennifer Rose,19,0,20,1
1748422399956,PHIL 260,A00,934791,Bazargan-Forward; Saba,18,0,20,2
1748422400985,PHIL 271,A00,934793,Vargas; Manuel Rogelio & Nelkin; Dana Kay & Fulkerson; Matthew Todd,9999,0,9999,0
1748422402015,PHIL 275,A00,934819,Watkins; Eric,9998,0,9999,1
1748422403041,PHIL 277,A00,934820,Tolley; Clinton,9997,0,9999,2
1748422404066,PHIL 278,A00,934821,Cohen; Jonathan David & Fulkerson; Matthew Todd,9999,0,9999,0
1748422405092,PHIL 280,A00,934827,Kovaka; Karenc,9999,0,9999,0
1748422406125,PHIL 281,A00,934828,Tolley; Clinton,9999,0,9999,0
1748422407153,PHIL 282,A00,934869,Bazargan-Forward; Saba,9999,0,9999,0
1748422408179,PHIL 283,A00,934870,Vargas; Manuel Rogelio & Tolley; Clinton,9999,0,9999,0
1748422409208,PHIL 286,A00,934871,Callender; Craig Adam & Chen; Keming,9999,0,9999,0
1748422410237,PHIL 287,A00,934872,Shields; Christopher John,9999,0,9999,0
1748422411275,PHIL 290,001,963258,Bazargan-Forward; Saba,9999,0,9999,0
1748422411275,PHIL 290,002,963281,Brandt; Reuven A,9999,0,9999,0
1748422411275,PHIL 290,003,963724,Brink; David O.,9999,0,9999,0
1748422411275,PHIL 290,004,963726,Callender; Craig Adam,9999,0,9999,0
1748422411275,PHIL 290,005,963740,Carr; Jennifer Rose,9999,0,9999,0
1748422411275,PHIL 290,006,963878,Cartwright; Nancy D.,9999,0,9999,0
1748422411275,PHIL 290,007,963888,Chen; Keming,9999,0,9999,0
1748422411275,PHIL 290,008,963889,Cohen; Jonathan David,9999,0,9999,0
1748422411275,PHIL 290,009,964028,Danks; David J,9999,0,9999,0
1748422411275,PHIL 290,010,964036,Fulkerson; Matthew Todd,9999,0,9999,0
1748422411275,PHIL 290,011,964044,Hardimon; Michael O.,9999,0,9999,0
1748422411275,PHIL 290,012,964084,Harrell; Maralee Mae,9999,0,9999,0
1748422411275,PHIL 290,013,964086,Johnson; Monte,9999,0,9999,0
1748422411275,PHIL 290,014,964093,Kocurek; Alexander William,9999,0,9999,0
1748422411275,PHIL 290,015,964101,Kovaka; Karenc,9999,0,9999,0
1748422411275,PHIL 290,016,964107,Lamey; Andy M.,9999,0,9999,0
1748422411275,PHIL 290,017,964113,Marechal; Patricia,9999,0,9999,0
1748422411275,PHIL 290,018,964125,McKenzie; Kerry V.,9999,0,9999,0
1748422411275,PHIL 290,019,964131,Nelkin; Dana Kay,9999,0,9999,0
1748422411275,PHIL 290,020,964132,Rickless; Samuel Charles,9999,0,9999,0
1748422411275,PHIL 290,021,964133,Rudolph; Rachel Etta,9999,0,9999,0
1748422411275,PHIL 290,022,964141,Sher; Gila,9999,0,9999,0
1748422411275,PHIL 290,023,964142,Shields; Christopher John,9999,0,9999,0
1748422411275,PHIL 290,024,964181,Tolley; Clinton,9999,0,9999,0
1748422411275,PHIL 290,025,964182,Vargas; Manuel Rogelio,9999,0,9999,0
1748422411275,PHIL 290,026,964232,Watkins; Eric,9999,0,9999,0
1748422411275,PHIL 290,027,964233,Yuan; Yuan,9999,0,9999,0
1748422412309,PHIL 295,001,964259,Bazargan-Forward; Saba,9999,0,9999,0
1748422412309,PHIL 295,002,964262,Brandt; Reuven A,9999,0,9999,0
1748422412309,PHIL 295,003,964263,Brink; David O.,9999,0,9999,0
1748422412309,PHIL 295,004,964264,Callender; Craig Adam,9999,0,9999,0
1748422412309,PHIL 295,005,964265,Carr; Jennifer Rose,9999,0,9999,0
1748422412309,PHIL 295,006,964266,Cartwright; Nancy D.,9999,0,9999,0
1748422412309,PHIL 295,007,964267,Chen; Keming,9999,0,9999,0
1748422412309,PHIL 295,008,964268,Cohen; Jonathan David,9999,0,9999,0
1748422412309,PHIL 295,009,964269,Danks; David J,9999,0,9999,0
1748422412309,PHIL 295,010,964270,Fulkerson; Matthew Todd,9999,0,9999,0
1748422412309,PHIL 295,011,964271,Hardimon; Michael O.,9999,0,9999,0
1748422412309,PHIL 295,012,964272,Harrell; Maralee Mae,9999,0,9999,0
1748422412309,PHIL 295,013,964273,Johnson; Monte,9999,0,9999,0
1748422412309,PHIL 295,014,964274,Kocurek; Alexander William,9999,0,9999,0
1748422412309,PHIL 295,015,964275,Kovaka; Karenc,9999,0,9999,0
1748422412309,PHIL 295,016,964276,Lamey; Andy M.,9999,0,9999,0
1748422412309,PHIL 295,017,964277,Marechal; Patricia,9999,0,9999,0
1748422412309,PHIL 295,018,964278,McKenzie; Kerry V.,9999,0,9999,0
1748422412309,PHIL 295,019,964279,Nelkin; Dana Kay,9999,0,9999,0
1748422412309,PHIL 295,020,964280,Rickless; Samuel Charles,9999,0,9999,0
1748422412309,PHIL 295,021,964281,Rudolph; Rachel Etta,9999,0,9999,0
1748422412309,PHIL 295,022,964282,Sher; Gila,9999,0,9999,0
1748422412309,PHIL 295,023,964283,Shields; Christopher John,9999,0,9999,0
1748422412309,PHIL 295,024,964284,Tolley; Clinton,9999,0,9999,0
1748422412309,PHIL 295,025,964285,Vargas; Manuel Rogelio,9999,0,9999,0
1748422412309,PHIL 295,026,964286,Watkins; Eric,9999,0,9999,0
1748422412309,PHIL 295,027,964287,Yuan; Yuan,9999,0,9999,0
1748422413339,PHYS 1A,A00,935435,Groisman; Alexander,434,0,589,155
1748422413339,PHYS 1A,B00,935437,Groisman; Alexander,456,0,600,144
1748422414374,PHYS 1AL,001,935439,Bal; Gurleen K & Frano Pereira; Alex M,18,0,30,12
1748422414374,PHYS 1AL,002,935440,Bal; Gurleen K & Frano Pereira; Alex M,25,0,30,5
1748422414374,PHYS 1AL,003,935443,Bal; Gurleen K & Frano Pereira; Alex M,0,0,30,30
1748422414374,PHYS 1AL,004,935445,Bal; Gurleen K & Frano Pereira; Alex M,0,0,30,30
1748422414374,PHYS 1AL,005,935448,Bal; Gurleen K & Frano Pereira; Alex M,0,0,30,30
1748422414374,PHYS 1AL,006,935449,Bal; Gurleen K & Frano Pereira; Alex M,0,0,30,30
1748422414374,PHYS 1AL,007,935451,Bal; Gurleen K & Frano Pereira; Alex M,0,0,30,30
1748422414374,PHYS 1AL,008,935452,Bal; Gurleen K & Frano Pereira; Alex M,1,0,30,29
1748422414374,PHYS 1AL,009,935454,Bal; Gurleen K & Frano Pereira; Alex M,9,0,30,21
1748422414374,PHYS 1AL,010,935589,Bal; Gurleen K & Frano Pereira; Alex M,17,0,30,13
1748422414374,PHYS 1AL,011,935590,Bal; Gurleen K & Frano Pereira; Alex M,15,0,19,4
1748422414374,PHYS 1AL,012,935591,Bal; Gurleen K & Frano Pereira; Alex M,29,0,30,1
1748422414374,PHYS 1AL,013,935652,Bal; Gurleen K & Frano Pereira; Alex M,0,0,30,30
1748422414374,PHYS 1AL,014,935675,Bal; Gurleen K & Frano Pereira; Alex M,0,0,30,30
1748422414374,PHYS 1AL,015,935680,Bal; Gurleen K & Frano Pereira; Alex M,0,0,30,30
1748422414374,PHYS 1AL,016,935703,Bal; Gurleen K & Frano Pereira; Alex M,0,0,30,30
1748422414374,PHYS 1AL,017,935704,Bal; Gurleen K & Frano Pereira; Alex M,9,0,30,21
1748422414374,PHYS 1AL,018,935729,Bal; Gurleen K & Frano Pereira; Alex M,12,0,30,18
1748422414374,PHYS 1AL,019,935825,Bal; Gurleen K & Frano Pereira; Alex M,23,0,30,7
1748422414374,PHYS 1AL,020,935826,Bal; Gurleen K & Frano Pereira; Alex M,27,0,30,3
1748422414374,PHYS 1AL,021,935946,Bal; Gurleen K & Frano Pereira; Alex M,28,0,30,2
1748422414374,PHYS 1AL,022,935947,Bal; Gurleen K & Frano Pereira; Alex M,30,0,30,0
1748422414374,PHYS 1AL,023,936029,Bal; Gurleen K & Frano Pereira; Alex M,4,0,30,26
1748422414374,PHYS 1AL,024,936031,Bal; Gurleen K & Frano Pereira; Alex M,12,0,30,18
1748422414374,PHYS 1AL,025,936033,Bal; Gurleen K & Frano Pereira; Alex M,19,0,30,11
1748422414374,PHYS 1AL,026,936034,Bal; Gurleen K & Frano Pereira; Alex M,19,0,30,11
1748422414374,PHYS 1AL,027,936036,Bal; Gurleen K & Frano Pereira; Alex M,6,0,30,24
1748422414374,PHYS 1AL,028,936038,Bal; Gurleen K & Frano Pereira; Alex M,22,0,30,8
1748422414374,PHYS 1AL,029,936044,Bal; Gurleen K & Frano Pereira; Alex M,20,0,30,10
1748422414374,PHYS 1AL,030,936045,Bal; Gurleen K & Frano Pereira; Alex M,27,0,30,3
1748422414374,PHYS 1AL,031,936054,Bal; Gurleen K & Frano Pereira; Alex M,28,0,30,2
1748422414374,PHYS 1AL,032,936056,Bal; Gurleen K & Frano Pereira; Alex M,28,0,30,2
1748422414374,PHYS 1AL,033,936057,Bal; Gurleen K & Frano Pereira; Alex M,0,0,30,30
1748422414374,PHYS 1AL,034,936059,Bal; Gurleen K & Frano Pereira; Alex M,1,0,30,29
1748422414374,PHYS 1AL,035,936060,Bal; Gurleen K & Frano Pereira; Alex M,11,0,30,19
1748422414374,PHYS 1AL,036,936063,Bal; Gurleen K & Frano Pereira; Alex M,21,0,30,9
1748422414374,PHYS 1AL,037,960551,Bal; Gurleen K & Frano Pereira; Alex M,25,0,30,5
1748422414374,PHYS 1AL,038,960592,Bal; Gurleen K & Frano Pereira; Alex M,28,0,30,2
1748422414374,PHYS 1AL,039,960618,Bal; Gurleen K & Frano Pereira; Alex M,29,0,30,1
1748422414374,PHYS 1AL,040,960644,Bal; Gurleen K & Frano Pereira; Alex M,30,0,30,0
1748422415400,PHYS 1B,A00,936064,Staff,216,0,360,144
1748422416438,PHYS 1BL,001,936066,Bal; Gurleen K & Frano Pereira; Alex M,1,0,29,28
1748422416438,PHYS 1BL,002,936067,Bal; Gurleen K & Frano Pereira; Alex M,0,0,30,30
1748422416438,PHYS 1BL,003,936068,Bal; Gurleen K & Frano Pereira; Alex M,5,0,30,25
1748422416438,PHYS 1BL,004,936072,Bal; Gurleen K & Frano Pereira; Alex M,0,0,30,30
1748422416438,PHYS 1BL,005,936074,Bal; Gurleen K & Frano Pereira; Alex M,0,0,30,30
1748422416438,PHYS 1BL,006,936075,Bal; Gurleen K & Frano Pereira; Alex M,0,0,30,30
1748422416438,PHYS 1BL,007,936116,Bal; Gurleen K & Frano Pereira; Alex M,7,0,30,23
1748422416438,PHYS 1BL,008,936125,Bal; Gurleen K & Frano Pereira; Alex M,14,0,30,16
1748422416438,PHYS 1BL,009,936128,Bal; Gurleen K & Frano Pereira; Alex M,12,0,30,18
1748422416438,PHYS 1BL,010,936145,Bal; Gurleen K & Frano Pereira; Alex M,14,0,30,16
1748422416438,PHYS 1BL,011,936146,Bal; Gurleen K & Frano Pereira; Alex M,0,0,30,30
1748422416438,PHYS 1BL,012,936147,Bal; Gurleen K & Frano Pereira; Alex M,6,0,30,24
1748422417468,PHYS 1C,A00,936148,Tsai; Philbert S,220,0,360,140
1748422418497,PHYS 1CL,001,936149,Bal; Gurleen K & Frano Pereira; Alex M,0,0,30,30
1748422418497,PHYS 1CL,002,936150,Bal; Gurleen K & Frano Pereira; Alex M,0,0,30,30
1748422418497,PHYS 1CL,003,936152,Bal; Gurleen K & Frano Pereira; Alex M,0,0,30,30
1748422418497,PHYS 1CL,004,936153,Bal; Gurleen K & Frano Pereira; Alex M,0,0,30,30
1748422418497,PHYS 1CL,005,936154,Bal; Gurleen K & Frano Pereira; Alex M,0,0,30,30
1748422418497,PHYS 1CL,006,936156,Bal; Gurleen K & Frano Pereira; Alex M,0,0,24,24
1748422418497,PHYS 1CL,007,936157,Bal; Gurleen K & Frano Pereira; Alex M,22,0,30,8
1748422418497,PHYS 1CL,008,936158,Bal; Gurleen K & Frano Pereira; Alex M,0,0,30,30
1748422418497,PHYS 1CL,009,936159,Bal; Gurleen K & Frano Pereira; Alex M,0,0,30,30
1748422418497,PHYS 1CL,010,936160,Bal; Gurleen K & Frano Pereira; Alex M,0,0,30,30
1748422418497,PHYS 1CL,011,936161,Bal; Gurleen K & Frano Pereira; Alex M,0,0,30,30
1748422418497,PHYS 1CL,012,936162,Bal; Gurleen K & Frano Pereira; Alex M,0,0,30,30
1748422419532,PHYS 2A,A01,936165,Shotwell; Brian,30,0,30,0
1748422419532,PHYS 2A,A02,936167,Shotwell; Brian,28,0,30,2
1748422419532,PHYS 2A,A03,936168,Shotwell; Brian,25,0,30,5
1748422419532,PHYS 2A,A04,936169,Shotwell; Brian,30,0,30,0
1748422419532,PHYS 2A,A05,936170,Shotwell; Brian,16,0,25,9
1748422419532,PHYS 2A,A06,936171,Shotwell; Brian,26,0,30,4
1748422419532,PHYS 2A,A07,936172,Shotwell; Brian,18,0,30,12
1748422419532,PHYS 2A,A08,936174,Shotwell; Brian,24,0,30,6
1748422419532,PHYS 2A,A09,936175,Shotwell; Brian,25,0,30,5
1748422419532,PHYS 2A,A10,936176,Shotwell; Brian,25,0,30,5
1748422419532,PHYS 2A,A11,936177,Shotwell; Brian,21,0,30,9
1748422419532,PHYS 2A,A12,936179,Shotwell; Brian,25,0,30,5
1748422420560,PHYS 2B,A01,936182,Barreiro Guerrero; Julio,13,0,30,17
1748422420560,PHYS 2B,A02,936183,Barreiro Guerrero; Julio,20,0,30,10
1748422420560,PHYS 2B,A03,936184,Barreiro Guerrero; Julio,20,0,30,10
1748422420560,PHYS 2B,A04,936185,Barreiro Guerrero; Julio,26,0,29,3
1748422420560,PHYS 2B,A05,936187,Barreiro Guerrero; Julio,27,0,30,3
1748422420560,PHYS 2B,A06,936217,Barreiro Guerrero; Julio,26,0,30,4
1748422420560,PHYS 2B,A07,936219,Barreiro Guerrero; Julio,23,0,30,7
1748422420560,PHYS 2B,A08,936220,Barreiro Guerrero; Julio,26,0,30,4
1748422420560,PHYS 2B,A09,936221,Barreiro Guerrero; Julio,29,0,30,1
1748422420560,PHYS 2B,A10,936224,Barreiro Guerrero; Julio,29,0,30,1
1748422420560,PHYS 2B,A11,936229,Barreiro Guerrero; Julio,28,0,30,2
1748422420560,PHYS 2B,A12,936231,Barreiro Guerrero; Julio,27,0,30,3
1748422421593,PHYS 2C,A01,936235,Tan; Tzer Han,23,0,30,7
1748422421593,PHYS 2C,A02,936236,Tan; Tzer Han,27,0,30,3
1748422421593,PHYS 2C,A03,936237,Tan; Tzer Han,22,0,30,8
1748422421593,PHYS 2C,A04,936246,Tan; Tzer Han,17,0,30,13
1748422421593,PHYS 2C,A05,936292,Tan; Tzer Han,16,0,28,12
1748422421593,PHYS 2C,A06,936300,Tan; Tzer Han,19,0,30,11
1748422421593,PHYS 2C,A07,936301,Tan; Tzer Han,8,0,30,22
1748422421593,PHYS 2C,A08,936302,Tan; Tzer Han,20,0,30,10
1748422421593,PHYS 2C,A09,936303,Tan; Tzer Han,26,0,30,4
1748422421593,PHYS 2C,A10,936304,Tan; Tzer Han,26,0,30,4
1748422421593,PHYS 2C,A11,936305,Tan; Tzer Han,12,0,30,18
1748422421593,PHYS 2C,A12,936332,Tan; Tzer Han,27,0,30,3
1748422421593,PHYS 2C,B01,936337,Tan; Tzer Han,0,0,30,30
1748422421593,PHYS 2C,B02,936470,Tan; Tzer Han,1,0,30,29
1748422421593,PHYS 2C,B03,936503,Tan; Tzer Han,21,0,30,9
1748422421593,PHYS 2C,B04,936533,Tan; Tzer Han,22,0,30,8
1748422421593,PHYS 2C,B05,936534,Tan; Tzer Han,20,0,30,10
1748422421593,PHYS 2C,B06,936535,Tan; Tzer Han,23,0,30,7
1748422421593,PHYS 2C,B07,936536,Tan; Tzer Han,25,0,30,5
1748422421593,PHYS 2C,B08,936537,Tan; Tzer Han,22,0,30,8
1748422421593,PHYS 2C,B09,936539,Tan; Tzer Han,26,0,30,4
1748422421593,PHYS 2C,B10,936540,Tan; Tzer Han,27,0,30,3
1748422421593,PHYS 2C,B11,936544,Tan; Tzer Han,28,0,30,2
1748422421593,PHYS 2C,B12,936548,Tan; Tzer Han,28,0,30,2
1748422422621,PHYS 2CL,A01,936555,Ni; Kaixuan,0,0,28,28
1748422422621,PHYS 2CL,A02,936556,Ni; Kaixuan,0,0,28,28
1748422422621,PHYS 2CL,A03,936557,Ni; Kaixuan,0,0,28,28
1748422422621,PHYS 2CL,A04,936559,Ni; Kaixuan,0,0,28,28
1748422422621,PHYS 2CL,A05,936566,Ni; Kaixuan,0,0,28,28
1748422422621,PHYS 2CL,A06,936582,Ni; Kaixuan,0,0,28,28
1748422422621,PHYS 2CL,A07,936583,Ni; Kaixuan,0,0,28,28
1748422423651,PHYS 2D,A01,936615,Sharma; Vivek A.,0,0,27,27
1748422424679,PHYS 2DL,A01,936627,Butov; Leonid,14,0,17,3
1748422424679,PHYS 2DL,A02,936628,Butov; Leonid,0,0,17,17
1748422424679,PHYS 2DL,A03,936629,Butov; Leonid,3,0,15,12
1748422424679,PHYS 2DL,A04,936630,Butov; Leonid,10,0,17,7
1748422424679,PHYS 2DL,A05,936631,Butov; Leonid,17,0,17,0
1748422424679,PHYS 2DL,A06,936632,Butov; Leonid,7,0,17,10
1748422424679,PHYS 2DL,A07,936633,Butov; Leonid,8,0,18,10
1748422425713,PHYS 4C,A01,936635,Chivukula; Raja S,22,0,43,21
1748422425713,PHYS 4C,A02,936636,Chivukula; Raja S,33,0,45,12
1748422425713,PHYS 4C,A03,936637,Chivukula; Raja S,38,0,45,7
1748422425713,PHYS 4C,A04,936638,Chivukula; Raja S,44,0,45,1
1748422426742,PHYS 12,A01,936640,Branson; James G,187,0,192,5
1748422427769,PHYS 87,A00,936641,Grinstein; Benjamin,20,0,20,0
1748422428801,PHYS 100A,A01,936643,Green; Daniel Richard,111,0,146,35
1748422429832,PHYS 110A,A01,936645,Dudko; Olga,107,0,146,39
1748422430859,PHYS 116,A00,936646,Diamond; Patrick H & Vergassola; Massimo,12,0,15,3
1748422431888,PHYS 130B,A01,936648,Keating; Brian,56,0,60,4
1748422432920,PHYS 133,A00,936649,Allen; Monica T,20,0,32,12
1748422433963,PHYS 136,A00,936650,Grinstein; Benjamin,42,0,50,8
1748422434989,PHYS 139,A00,936651,Hirsch; Jorge Eduardo,13,0,15,2
1748422434989,PHYS 139,B00,936663,Duarte; Javier Mauricio,0,0,0,10
1748422436019,PHYS 140A,A01,936723,Parker; Daniel E,54,0,60,6
1748422437051,PHYS 161,A01,936727,Fuller; George Michael,53,0,60,7
1748422438078,PHYS 175,A00,936728,Koslover; Elena F,11,0,15,4
1748422439109,PHYS 191,A00,936730,Yang; Liang,68,0,75,7
1748422440138,PHYS 200A,A01,936733,Di Ventra; Massimiliano,20,0,30,10
1748422441163,PHYS 201,A01,936736,Vergassola; Massimo,23,0,30,7
1748422442191,PHYS 210B,A00,936737,McGreevy; John A.,29,0,30,1
1748422443218,PHYS 211A,A00,936740,Butov; Leonid,28,0,30,2
1748422444248,PHYS 212A,A01,936873,Fogler; Michael M.,38,0,50,12
1748422445275,PHYS 215A,A00,936878,Shotwell; Brian,30,0,30,0
1748422446301,PHYS 216,A00,936879,Diamond; Patrick H & Vergassola; Massimo,15,0,15,0
1748422447330,PHYS 219,A00,936903,Allen; Monica T,5,0,5,0
1748422448357,PHYS 220,A01,936910,Arovas; Daniel P,30,0,30,0
1748422449386,PHYS 225A,A00,936911,Flauger; Raphael M,28,0,30,2
1748422450416,PHYS 239,A00,937172,Hirsch; Jorge Eduardo,14,0,15,1
1748422450416,PHYS 239,B00,937176,Duarte; Javier Mauricio,15,0,15,0
1748422450416,PHYS 239,C00,959883,Intriligator; Kenneth Arthur,30,0,30,0
1748422451440,PHYS 250,A00,937178,Hirsch; Jorge Eduardo,14,0,15,1
1748422452466,PHYS 251,A00,937182,Grinstein; Benjamin,15,0,15,0
1748422453492,PHYS 252,A00,937183,Diamond; Patrick H,15,0,15,0
1748422454522,PHYS 253,A00,937184,Fuller; George Michael,15,0,15,0
1748422455553,PHYS 254,A00,937185,Serra; Mattia,15,0,15,0
1748422456580,PHYS 255,A00,937186,Hwa; Terence T.,14,0,15,1
1748422457607,PHYS 260,A00,937187,Shpyrko; Oleg,49,0,50,1
1748422458634,PHYS 275,A00,937190,Koslover; Elena F,15,0,15,0
1748422459664,PHYS 279,A01,946429,Silva; Gabriel,0,0,0,0
1748422460748,PHYS 282,A00,937194,Hwa; Terence T.,20,0,20,0
1748422461778,POLI 5D,A01,937210,Staff,4,0,5,1
1748422461778,POLI 5D,B01,937219,Staff,5,0,5,0
1748422461778,POLI 5D,C01,937225,Dai; Yinlin,0,0,5,5
1748422462808,POLI 10D,A01,937228,Noble; Benjamin S,20,0,28,8
1748422462808,POLI 10D,A02,937229,Noble; Benjamin S,24,0,28,4
1748422462808,POLI 10D,A03,937230,Noble; Benjamin S,25,0,27,2
1748422462808,POLI 10D,A04,937231,Noble; Benjamin S,25,0,27,2
1748422462808,POLI 10D,A05,937238,Noble; Benjamin S,27,0,28,1
1748422462808,POLI 10D,A06,937243,Noble; Benjamin S,26,0,28,2
1748422463841,POLI 11D,A01,937360,Desposato; Scott,20,0,29,9
1748422463841,POLI 11D,A02,937430,Desposato; Scott,22,0,29,7
1748422463841,POLI 11D,A03,937445,Desposato; Scott,25,0,29,4
1748422463841,POLI 11D,A04,937446,Desposato; Scott,29,0,29,0
1748422463841,POLI 11D,A05,937447,Desposato; Scott,27,0,29,2
1748422463841,POLI 11D,A06,937463,Desposato; Scott,27,0,29,2
1748422464889,POLI 12D,A01,937472,Roeder; Philip G,17,0,20,3
1748422464889,POLI 12D,A02,937475,Roeder; Philip G,18,0,20,2
1748422464889,POLI 12D,A03,937485,Roeder; Philip G,17,0,19,2
1748422464889,POLI 12D,A04,937490,Roeder; Philip G,17,0,20,3
1748422464889,POLI 12D,A05,937500,Roeder; Philip G,19,0,20,1
1748422464889,POLI 12D,A06,937507,Roeder; Philip G,20,0,20,0
1748422465916,POLI 30D,A01,937510,Desposato; Scott,0,0,23,23
1748422465916,POLI 30D,A02,937530,Desposato; Scott,0,0,23,23
1748422465916,POLI 30D,A03,937531,Desposato; Scott,11,0,23,12
1748422465916,POLI 30D,A04,937532,Desposato; Scott,18,0,23,5
1748422465916,POLI 30D,A05,937591,Desposato; Scott,5,0,23,18
1748422465916,POLI 30D,A06,937592,Desposato; Scott,19,0,23,4
1748422466942,POLI 100H,A00,937593,Stout; Christopher Timothy,114,0,183,69
1748422467968,POLI 100I,A00,937594,Gause; LaGina,47,0,56,9
1748422469000,POLI 100V,A00,937596,Gause; LaGina,56,0,68,12
1748422470027,POLI 101A,A00,937597,Stout; Christopher Timothy,84,0,115,31
1748422471058,POLI 104A,A00,937598,Smith; Glenn Chatmas,207,0,290,83
1748422472085,POLI 104N,A00,937599,Stephens; Mattheus E,168,0,245,77
1748422473112,POLI 110A,A00,937600,Wiens; David,61,0,70,9
1748422474145,POLI 118,A00,937601,Wiens; David,69,0,94,25
1748422475172,POLI 122D,A00,937602,Strom; Kaare,15,0,70,55
1748422476199,POLI 125B,A00,937603,Naoi; Megumi,128,0,158,30
1748422477225,POLI 125D,A00,937604,Nichter; Simeon C,103,0,158,55
1748422478249,POLI 126,A00,937607,Nichter; Simeon C,43,0,120,77
1748422479279,POLI 133A,A00,937608,Naoi; Megumi,202,0,216,14
1748422480310,POLI 134D,A00,937609,Saiegh; Sebastian,62,0,75,13
1748422481339,POLI 143A,A00,937610,Slantchev; Branislav,147,0,158,11
1748422482370,POLI 145C,A00,937611,Fisk; David Lee,153,0,190,37
1748422483395,POLI 154,A00,937612,Fisk; David Lee,29,0,90,61
1748422484424,POLI 163,A00,937613,Saiegh; Sebastian,103,0,120,17
1748422485450,POLI 176,A00,968071,Roberts; Margaret Earling,23,0,45,22
1748422486486,POLI 191A,A00,937617,Stout; Christopher Timothy & Saiegh; Sebastian,25,0,25,0
1748422487516,POLI 194,A00,954111,Hill; Seth J,9999,0,9999,0
1748422488550,POLI 204A,A00,937618,Schneider; Christina,20,0,25,5
1748422489582,POLI 204B,A00,937619,Desposato; Scott,7,0,12,5
1748422490611,POLI 220B,A00,937621,Strom; Kaare,20,0,25,5
1748422491641,POLI 225,A00,937622,Thomas; Jakana,18,0,25,7
1748422492671,POLI 251,A00,937623,Noble; Benjamin S,24,0,25,1
1748422493703,POLI 252,A00,937624,Hajnal; Zoltan Lloyd,24,0,25,1
1748422495757,POLI 270,A00,973288,Roberts; Margaret Earling,24,0,25,1
1748422496784,POLI 279,A00,937626,Staff,8,0,12,4
1748422497815,POLI 280,A00,937628,Hafner-Burton; Emilie,21,0,25,4
1748422498842,POLI 281,A00,937629,Stout; Christopher Timothy,13,0,15,2
1748422499870,POLI 282,A00,937630,Roeder; Philip G,20,0,25,5
1748422500897,POLI 283,A00,937631,Slantchev; Branislav,18,0,25,7
1748422501924,POLI 285,A00,937632,Wiens; David,12,0,12,0
1748422502957,PSYC 1,A00,937633,Hurwitz; Ethan Scott,175,0,200,25
1748422503989,PSYC 2,A00,937634,Rose; Fred E.,133,0,150,17
1748422505019,PSYC 3R,A00,937693,Pilegard; Celeste Cristine,195,0,200,5
1748422506048,PSYC 6,A00,937694,McCullough; Michael E,142,0,150,8
1748422507089,PSYC 60,A01,957947,Lowe; Angela Beth,10,0,25,15
1748422507089,PSYC 60,A02,957948,Lowe; Angela Beth,17,0,25,8
1748422507089,PSYC 60,A03,957949,Lowe; Angela Beth,18,0,25,7
1748422507089,PSYC 60,A04,957950,Lowe; Angela Beth,24,0,25,1
1748422507089,PSYC 60,A05,957951,Lowe; Angela Beth,22,0,25,3
1748422507089,PSYC 60,A06,957952,Lowe; Angela Beth,22,0,25,3
1748422507089,PSYC 60,A07,957953,Lowe; Angela Beth,24,0,25,1
1748422507089,PSYC 60,B01,957954,Rickard; Timothy C.,24,0,25,1
1748422507089,PSYC 60,B02,957955,Rickard; Timothy C.,24,0,25,1
1748422507089,PSYC 60,B03,957956,Rickard; Timothy C.,25,0,25,0
1748422507089,PSYC 60,B04,957957,Rickard; Timothy C.,25,0,25,0
1748422507089,PSYC 60,B05,957958,Rickard; Timothy C.,24,0,25,1
1748422507089,PSYC 60,B06,957959,Rickard; Timothy C.,22,0,25,3
1748422507089,PSYC 60,B07,957960,Rickard; Timothy C.,22,0,25,3
1748422508119,PSYC 70,A01,957961,Pilegard; Celeste Cristine,6,0,25,19
1748422508119,PSYC 70,A02,957962,Pilegard; Celeste Cristine,19,0,25,6
1748422508119,PSYC 70,A03,957963,Pilegard; Celeste Cristine,19,0,25,6
1748422508119,PSYC 70,A04,957964,Pilegard; Celeste Cristine,21,0,25,4
1748422508119,PSYC 70,A05,957965,Pilegard; Celeste Cristine,24,0,25,1
1748422508119,PSYC 70,A06,957966,Pilegard; Celeste Cristine,23,0,25,2
1748422509153,PSYC 71,A01,937700,Geller; Emma Harlan,0,0,30,30
1748422509153,PSYC 71,A02,937701,Geller; Emma Harlan,0,0,30,30
1748422509153,PSYC 71,B01,937704,Steiner; Eric Tomas,0,0,25,25
1748422509153,PSYC 71,B02,937705,Steiner; Eric Tomas,0,0,25,25
1748422510181,PSYC 88,A00,937706,Dobkins; Karen R.,49,0,65,16
1748422511209,PSYC 100,A00,937707,Dickenson; Janna Alene,0,0,175,175
1748422512238,PSYC 101,A00,937709,Heyman; Gail D.,0,0,170,170
1748422513267,PSYC 104,A00,937711,Staff,0,0,175,175
1748422514293,PSYC 105,A00,937712,Geller; Emma Harlan,17,0,170,153
1748422515323,PSYC 106,A00,937713,Gremel; Christina M,89,0,170,81
1748422516354,PSYC 108,A00,937714,Adrian; Julia Anna,145,0,170,25
1748422517383,PSYC 114,A01,937720,Winkielman; Piotr,0,0,50,50
1748422518411,PSYC 122,A00,937724,Moranton; Nirelia Melbina-,241,0,250,9
1748422519438,PSYC 124,A00,937726,Chapman; Eddie Nathaniel,276,0,348,72
1748422520464,PSYC 137,A00,937727,Jolly; Eshin,249,0,295,46
1748422521491,PSYC 145,A00,937732,Lau; Aubrey,277,0,295,18
1748422522517,PSYC 154,A00,937734,Lacefield; Katharine I,18,0,300,282
1748422523546,PSYC 155,A00,937735,Dickenson; Janna Alene,139,0,295,156
1748422524573,PSYC 167,A00,937750,Walker; Caren Michelle,0,0,25,25
1748422525603,PSYC 169,A00,937751,Staff,212,0,250,38
1748422526629,PSYC 171,A00,937752,Mukku; Dhananjaya,149,0,216,67
1748422527659,PSYC 174,A00,937784,Staff,141,0,146,5
1748422528686,PSYC 178,A00,937788,Glaser; Dale,100,0,146,46
1748422529714,PSYC 181,A00,937814,Anagnostaras; Stephan,140,0,300,160
1748422530743,PSYC 184,A00,937816,Staff,267,0,295,28
1748422531778,PSYC 189,A00,937868,Gentner; Tim,14,0,55,41
1748422532815,PSYC 193,A00,937897,Chapman; Eddie Nathaniel,27,0,35,8
1748422532815,PSYC 193,B00,937917,Gorman; Michael R.,35,0,35,0
1748422532815,PSYC 193,C00,937918,Powell; Lindsey Jane,22,0,24,2
1748422533843,PSYC 193L,A01,937930,Brown; Sandra A,64,0,65,1
1748422533843,PSYC 193L,B01,937939,Lacefield; Katharine I,194,0,216,22
1748422534871,PSYC 194A,A01,937949,Heyman; Gail D.,35,0,35,0
1748422535901,PSYC 201A,A01,937954,Long; Bria,8,0,15,7
1748422536937,PSYC 205,A00,937976,Harris; Christine Renee,12,0,20,8
1748422537966,PSYC 217,A00,937977,Barner; David A.,16,0,20,4
1748422538992,PSYC 221,A00,937979,Dobkins; Karen R.,16,0,20,4
1748422540020,PSYC 224,A00,938013,Mukku; Dhananjaya,28,0,30,2
1748422541051,PSYC 242,A00,938016,Powell; Lindsey Jane,26,0,30,4
1748422542077,PSYC 244,A00,938017,Ferreira; Victor,15,0,20,5
1748422543105,PSYC 269,A00,938024,Schachner; Adena,19,0,20,1
1748422544132,PSYC 270A,A00,938028,Dobkins; Karen R.,13,0,20,7
1748422545160,PSYC 272,A00,938029,Lin; Chujun,14,0,20,6
1748422545160,PSYC 272,B00,938039,Wixted; John T,18,0,20,2
1748422546191,PSYC 274,A00,938042,McCullough; Michael E,26,0,30,4
1748422547221,PSYC 275,A00,938043,Brady; Timothy Francis,28,0,30,2
1748422548248,PSYC 280,A00,938055,Serences; John Thomas,70,0,80,10
1748422549305,PSYC 296,001,952632,Anagnostaras; Stephan,9999,0,9999,0
1748422549305,PSYC 296,002,952633,Aron; Adam,9999,0,9999,0
1748422549305,PSYC 296,003,952634,Mukku; Dhananjaya,9999,0,9999,0
1748422549305,PSYC 296,004,952635,Barner; David A.,9999,0,9999,0
1748422549305,PSYC 296,005,952636,Schachner; Adena,9999,0,9999,0
1748422549305,PSYC 296,006,952637,Brady; Timothy Francis,9999,0,9999,0
1748422549305,PSYC 296,007,952639,Brashier; Nadia Marie,9999,0,9999,0
1748422549305,PSYC 296,008,952640,Brown; Sandra A,9999,0,9999,0
1748422549305,PSYC 296,009,952641,Carver; Leslie J.,9998,0,9999,1
1748422549305,PSYC 296,010,952642,Chapman; Eddie Nathaniel,9999,0,9999,0
1748422549305,PSYC 296,011,952643,Dickenson; Janna Alene,9999,0,9999,0
1748422549305,PSYC 296,012,952644,Dobkins; Karen R.,9997,0,9999,2
1748422549305,PSYC 296,013,952646,Ferreira; Victor,9999,0,9999,0
1748422549305,PSYC 296,014,952647,Geller; Emma Harlan,9999,0,9999,0
1748422549305,PSYC 296,015,952648,Gentner; Tim,9999,0,9999,0
1748422549305,PSYC 296,016,952650,Gorman; Michael R.,9999,0,9999,0
1748422549305,PSYC 296,017,952651,Gremel; Christina M,9999,0,9999,0
1748422549305,PSYC 296,018,952652,Harris; Christine Renee,9999,0,9999,0
1748422549305,PSYC 296,019,952654,Heyman; Gail D.,9999,0,9999,0
1748422549305,PSYC 296,020,952655,Lin; Chujun,9999,0,9999,0
1748422549305,PSYC 296,021,952659,Long; Bria,9999,0,9999,0
1748422549305,PSYC 296,022,952660,McCullough; Michael E,9999,0,9999,0
1748422549305,PSYC 296,023,952661,Mc Kenzie; Craig R.M.,9999,0,9999,0
1748422549305,PSYC 296,024,952663,Miller; Cory T.,9998,0,9999,1
1748422549305,PSYC 296,025,952664,Oesch; Nicholas W,9999,0,9999,0
1748422549305,PSYC 296,026,952665,Pilegard; Celeste Cristine,9999,0,9999,0
1748422549305,PSYC 296,027,952666,Powell; Lindsey Jane,9999,0,9999,0
1748422549305,PSYC 296,028,952667,Rickard; Timothy C.,9999,0,9999,0
1748422549305,PSYC 296,029,952668,Serences; John Thomas,9999,0,9999,0
1748422549305,PSYC 296,030,952669,Walker; Caren Michelle,9998,0,9999,1
1748422549305,PSYC 296,031,952670,Winkielman; Piotr,9999,0,9999,0
1748422549305,PSYC 296,032,952671,Wixted; John T,9998,0,9999,1
1748422549305,PSYC 296,033,952673,Jolly; Eshin,9998,0,9999,1
1748422550332,REV 20,A00,946356,Yu; Paul K L,30,0,30,0
1748422550332,REV 20,B00,946357,Yu; Paul K L,30,0,30,0
1748422551366,REV 87,B00,969668,Rodriguez; Bretton Sigfred,20,0,20,0
1748422552396,SE 1,A01,938060,Van Den Einde; Yael Dahlia,0,0,9,9
1748422552396,SE 1,A02,938076,Van Den Einde; Yael Dahlia,0,0,8,8
1748422552396,SE 1,A03,938077,Van Den Einde; Yael Dahlia,0,0,8,8
1748422552396,SE 1,B01,938097,Van Den Einde; Yael Dahlia,0,0,9,9
1748422552396,SE 1,B02,938098,Van Den Einde; Yael Dahlia,0,0,8,8
1748422552396,SE 1,B03,938109,Van Den Einde; Yael Dahlia,0,0,8,8
1748422553422,SE 101A,A01,938120,Morrison; Machel Leigh,165,0,250,85
1748422554450,SE 101C,A01,938148,Zhu; Qiang,178,0,250,72
1748422555481,SE 105,A01,938153,Qiao; Yu,78,0,120,42
1748422556509,SE 125,A01,938218,Conte; Joel P,166,0,210,44
1748422557540,SE 130A,A00,938219,Loh; Kenneth J. H.,69,0,165,96
1748422558569,SE 131B,A01,938221,Krysl; Petr,119,0,210,91
1748422559597,SE 142,A01,938223,Kim; Hyonny,20,0,27,7
1748422559597,SE 142,A02,938236,Kim; Hyonny,23,0,27,4
1748422559597,SE 142,A03,938237,Kim; Hyonny,19,0,27,8
1748422559597,SE 142,A04,938238,Kim; Hyonny,19,0,22,3
1748422560625,SE 163,A01,938240,Lanza Di Scalea; Francesco,17,0,19,2
1748422560625,SE 163,A02,938241,Lanza Di Scalea; Francesco,16,0,19,3
1748422560625,SE 163,A03,938254,Lanza Di Scalea; Francesco,16,0,17,1
1748422561652,SE 180,A00,938255,Elgamal; Ahmed,142,0,170,28
1748422562687,SE 181,A01,938280,McCartney; John Scott,1,0,24,23
1748422562687,SE 181,A02,938281,McCartney; John Scott,6,0,24,18
1748422562687,SE 181,A03,938296,McCartney; John Scott,0,0,24,24
1748422562687,SE 181,A04,938297,McCartney; John Scott,0,0,24,24
1748422562687,SE 181,A05,938299,McCartney; John Scott,20,0,24,4
1748422562687,SE 181,A06,938320,McCartney; John Scott,22,0,24,2
1748422562687,SE 181,A07,938324,McCartney; John Scott,9,0,24,15
1748422563714,SE 201A,A00,938329,Mosqueda; Gilberto,35,0,65,30
1748422564801,SE 203A,A00,938331,Tsampras; Georgios,32,0,65,33
1748422565828,SE 212,A00,938332,Uang; Chia-Ming,28,0,68,40
1748422566860,SE 220,A00,965249,Mosqueda; Gilberto,28,0,36,8
1748422567890,SE 223,A00,969767,Staff,19,0,25,6
1748422568923,SE 233,A00,938555,Krysl; Petr,19,0,50,31
1748422569951,SE 241,A00,938333,Elgamal; Ahmed,0,0,20,20
1748422570980,SE 244,A00,938334,Elgamal; Ahmed,39,0,40,1
1748422572006,SE 248,A00,938363,McCartney; John Scott,20,0,30,10
1748422573041,SE 253A,A01,938448,Kim; Hyonny,2,0,5,3
1748422573041,SE 253A,A02,938451,Kim; Hyonny,3,0,5,2
1748422573041,SE 253A,A03,938452,Kim; Hyonny,3,0,5,2
1748422573041,SE 253A,A04,938453,Kim; Hyonny,2,0,2,0
1748422574068,SE 263,A01,938460,Lanza Di Scalea; Francesco,15,0,17,2
1748422574068,SE 263,A02,938461,Lanza Di Scalea; Francesco,11,0,17,6
1748422574068,SE 263,A03,938462,Lanza Di Scalea; Francesco,10,0,16,6
1748422575096,SE 271,A00,938464,Asaro; Robert J,25,0,32,7
1748422576127,SE 276A,A00,938465,Chen; Jiun-Shyan,18,0,35,17
1748422577158,SE 285,A00,938466,Kim; Hyunsun Alicia,18,0,20,2
1748422578184,SE 286,A00,938523,Kim; Hyunsun Alicia,13,0,20,7
1748422579213,SE 290,A00,938524,Lanza Di Scalea; Francesco,41,0,100,59
1748422580261,SE 296,001,953990,Asaro; Robert J,9999,0,9999,0
1748422580261,SE 296,002,953992,Chen; Jiun-Shyan,9999,0,9999,0
1748422580261,SE 296,003,953998,Conte; Joel P,9999,0,9999,0
1748422580261,SE 296,004,953999,Elgamal; Ahmed,9999,0,9999,0
1748422580261,SE 296,005,954001,Hutchinson; Tara,9999,0,9999,0
1748422580261,SE 296,006,954003,Jandaghi Semnani; Shabnam,9999,0,9999,0
1748422580261,SE 296,007,954004,Kim; Hyonny,9999,0,9999,0
1748422580261,SE 296,008,954005,Kim; Hyunsun Alicia,9999,0,9999,0
1748422580261,SE 296,009,954007,Kosmatka; John B,9999,0,9999,0
1748422580261,SE 296,010,954009,Krysl; Petr,9999,0,9999,0
1748422580261,SE 296,011,954011,Kuester; Falko,9999,0,9999,0
1748422580261,SE 296,012,954014,Lanza Di Scalea; Francesco,9999,0,9999,0
1748422580261,SE 296,013,954015,Loh; Kenneth J. H.,9999,0,9999,0
1748422580261,SE 296,014,954021,McCartney; John Scott,9999,0,9999,0
1748422580261,SE 296,015,954023,Morrison; Machel Leigh,9999,0,9999,0
1748422580261,SE 296,016,954024,Mosqueda; Gilberto,9999,0,9999,0
1748422580261,SE 296,017,954028,Qiao; Yu,9999,0,9999,0
1748422580261,SE 296,018,954030,Shing; P. Benson,9999,0,9999,0
1748422580261,SE 296,019,954031,Todd; Michael,9998,0,9999,1
1748422580261,SE 296,020,954033,Tomac; Ingrid,9999,0,9999,0
1748422580261,SE 296,021,954037,Tsampras; Georgios,9999,0,9999,0
1748422580261,SE 296,022,954040,Uang; Chia-Ming,9999,0,9999,0
1748422580261,SE 296,023,954043,Van Den Einde; Yael Dahlia,9999,0,9999,0
1748422580261,SE 296,024,954044,Zhu; Qiang,9999,0,9999,0
1748422580261,SE 296,025,954046,Tehrani; Mehran,9999,0,9999,0
1748422580261,SE 296,026,954047,Palermo; Alessandro,9999,0,9999,0
1748422580261,SE 296,027,954049,Chadha; Mayank,9999,0,9999,0
1748422581289,SIO 3,A01,938657,Hetherington; Elizabeth Dorsey,33,0,37,4
1748422581289,SIO 3,A02,938665,Hetherington; Elizabeth Dorsey,36,0,37,1
1748422582320,SIO 15,A00,938667,Laske; Gabi,294,0,348,54
1748422583346,SIO 20R,A01,938679,Russell; Lynn M.,144,0,200,56
1748422584376,SIO 25,A01,938684,Hildebrand; John A,33,0,40,7
1748422584376,SIO 25,A02,938685,Hildebrand; John A,39,0,40,1
1748422584376,SIO 25,A03,938963,Hildebrand; John A,40,0,40,0
1748422584376,SIO 25,A04,939110,Hildebrand; John A,40,0,40,0
1748422584376,SIO 25,A05,939116,Hildebrand; John A,40,0,40,0
1748422584376,SIO 25,A06,939149,Hildebrand; John A,40,0,40,0
1748422584376,SIO 25,A07,939158,Hildebrand; John A,40,0,40,0
1748422584376,SIO 25,A08,939173,Hildebrand; John A,40,0,40,0
1748422584376,SIO 25,A09,939180,Hildebrand; John A,40,0,40,0
1748422584376,SIO 25,A10,939228,Hildebrand; John A,40,0,40,0
1748422585415,SIO 30,A01,939230,Aluwihare; Lihini & Gille; Sarah T,33,0,37,4
1748422585415,SIO 30,A02,939231,Aluwihare; Lihini & Baumann-Pickering ; Simone,37,0,37,0
1748422585415,SIO 30,A03,939232,Aluwihare; Lihini & Gille; Sarah T,34,0,37,3
1748422585415,SIO 30,A04,939233,Aluwihare; Lihini & Gille; Sarah T,31,0,37,6
1748422585415,SIO 30,A05,939234,Aluwihare; Lihini & Gille; Sarah T,38,0,38,0
1748422585415,SIO 30,A06,939235,Aluwihare; Lihini & Gille; Sarah T,37,0,38,1
1748422585415,SIO 30,A07,939236,Aluwihare; Lihini & Gille; Sarah T,36,0,38,2
1748422585415,SIO 30,A08,939237,Aluwihare; Lihini & Gille; Sarah T,36,0,38,2
1748422586446,SIO 50,A01,939239,Cook; Geoffrey W,8,0,20,12
1748422586446,SIO 50,A02,939240,Cook; Geoffrey W,11,0,20,9
1748422587478,SIO 87,A00,939242,Norris; Joel Roland,20,0,20,0
1748422587478,SIO 87,B00,939306,Cook; Geoffrey W,20,0,20,0
1748422587478,SIO 87,C00,939327,Cook; Geoffrey W,20,0,20,0
1748422588505,SIO 100,A00,939328,Odlum; Margaret Larkin,0,0,30,30
1748422589532,SIO 101,A01,939330,Aluwihare; Lihini & Decima; Moira R.,0,0,35,35
1748422589532,SIO 101,A02,939331,Aluwihare; Lihini & Decima; Moira R.,12,0,35,23
1748422590559,SIO 103,A01,939371,Parnell-Turner; Ross Ernes,6,0,20,14
1748422591586,SIO 105,A00,939372,Driscoll; Neal W.,8,0,20,12
1748422592613,SIO 117,A01,939375,Keeling; Ralph F.,14,0,25,11
1748422593639,SIO 122,A01,939377,Lyons; Deirdre Colleen,6,0,30,24
1748422594667,SIO 124,A00,961131,Lukowski; April Lynn,34,0,65,31
1748422595696,SIO 132,A01,939379,Kacev; David & Hechinger; Ryan F.,9,0,34,25
1748422595696,SIO 132,A02,939380,Kacev; David & Hechinger; Ryan F.,28,0,34,6
1748422595696,SIO 132,A03,939381,Kacev; David & Hechinger; Ryan F.,19,0,34,15
1748422595696,SIO 132,A04,939480,Kacev; David & Hechinger; Ryan F.,26,0,34,8
1748422595696,SIO 132,A05,939481,Kacev; David & Hechinger; Ryan F.,18,0,34,16
1748422595696,SIO 132,A06,939482,Kacev; David & Hechinger; Ryan F.,25,0,34,9
1748422596735,SIO 136,A01,939562,Kacev; David & Shipp; Lauren Elizabeth,6,0,34,28
1748422596735,SIO 136,A02,939563,Kacev; David & Shipp; Lauren Elizabeth,24,0,34,10
1748422597762,SIO 147,A01,939566,Betancur Rodriguez; Ricard,0,0,30,30
1748422598790,SIO 166,A00,939567,Jimenez Cano; Nayeli Guada,13,0,30,17
1748422600037,SIO 167,A01,939569,Dunseth; Zachary Clark,9,0,10,1
1748422601064,SIO 170,A00,939571,Cook; Geoffrey W,39,0,45,6
1748422602099,SIO 171,A01,939573,Rudnick; Daniel Lars,44,0,50,6
1748422603129,SIO 177,A00,939574,Becker; Janet Maria,19,0,20,1
1748422604156,SIO 179,A01,939611,Martz; Todd R.,2,0,15,13
1748422605182,SIO 189,A00,939616,Staff,0,0,0,0
1748422606213,SIO 194,A00,954130,Hill; Seth J,9999,0,9999,0
1748422607238,SIOB 218,A01,960525,Staff,13,0,20,7
1748422608269,SIOB 262,A00,939617,Lukowski; April Lynn,15,0,20,5
1748422609294,SIOB 273,A00,939618,Leichter; James J.,9,0,15,6
1748422610324,SIOB 274,A01,939679,Leichter; James J.,15,0,20,5
1748422611352,SIOB 276,A01,939703,Sugihara; George,19,0,20,1
1748422612383,SIOB 279,A00,939717,Barton; Andrew David,19,0,25,6
1748422613409,SIOB 280,A00,939722,Allen; Andrew Ellis & Baumann-Pickering ; Simone,54,0,70,16
1748422614441,SIOB 296,A00,939790,Lyons; Deirdre Colleen,0,0,0,0
1748422615473,SIOB 297,A00,939795,Allen; Eric,57,0,65,8
1748422616500,SIOC 200A,A00,939821,Lin; Ying-Tsong,16,0,20,4
1748422617526,SIOC 203A,A00,939827,Becker; Janet Maria,18,0,20,2
1748422618557,SIOC 207A,A01,939909,Meyer; Florian,12,0,20,8
1748422619586,SIOC 208,A00,939913,Merrifield; Mark A,11,0,20,9
1748422620633,SIOC 210,A00,939917,Purkey; Sarah Michelle G.,25,0,35,10
1748422620633,SIOC 210,B00,939973,Purkey; Sarah Michelle G.,31,0,35,4
1748422621660,SIOC 217A,A00,940015,Evan; Amato Tomas,18,0,25,7
1748422622691,SIOC 221A,A00,940020,Alford; Matthew Hudson,16,0,20,4
1748422623717,SIOG 200C,A00,940290,Fan; Wenyuan,23,0,25,2
1748422624749,SIOG 223A,A00,940333,Constable; Catherine G,22,0,25,3
1748422625775,SIOG 225,A00,940334,Fialko; Yuri A.,19,0,20,1
1748422626801,SIOG 228,A00,940338,Diaz; Julia Michelle,15,0,40,25
1748422627828,SIOG 238,A00,940339,May; David Alexander,20,0,20,0
1748422628859,SIOG 239,A00,940340,Fan; Wenyuan,20,0,20,0
1748422628859,SIOG 239,B00,940342,Sandwell; David T,19,0,20,1
1748422629887,SIOG 240,A00,940409,Parnell-Turner; Ross Ernes,34,0,40,6
1748422630914,SIOG 249,A00,940442,Norris; Richard D.,25,0,25,0
1748422631943,SIOG 267,A01,940444,Martz; Todd R.,15,0,15,0
1748422632968,SIOG 288,A01,940446,Diaz; Julia Michelle,22,0,25,3
1748422633994,SOCE 194,A00,954128,Hill; Seth J,9999,0,9999,0
1748422635027,SOCG 200,A00,935260,Rona-Tas; Akos,2,0,12,10
1748422636054,SOCG 201,A00,935264,Shafir; Gershon,0,0,12,12
1748422637082,SOCG 203,A00,935265,Gong; Neil M,0,0,10,10
1748422638108,SOCG 207,A00,935267,Navon; Daniel,0,0,10,10
1748422639134,SOCG 208A,A00,935269,Blair-Loy; Mary,2,0,12,10
1748422640161,SOCG 226,A00,935302,Skrentny; John David,0,0,10,10
1748422641192,SOCG 227,A00,935303,Jules-Rosette; Bennetta W.,7,0,10,3
1748422642218,SOCG 244,A00,935305,Ribas Norris; Janet Vanesa,0,0,10,10
1748422643243,SOCG 252,A00,935307,Turner; Christena L.,2,0,10,8
1748422644276,SOCG 253,A00,935313,Evans; John Hyde,7,0,10,3
1748422645304,SOCG 255A,A00,934873,McKenzie; Kerry V.,10,0,10,0
1748422646332,SOCG 255C,A00,934874,McKenzie; Kerry V.,9,0,10,1
1748422647363,SOCG 271,A00,935434,Estefan; Michel,4,0,10,6
1748422648393,SOCI 1,A01,934878,Skrentny; John David,20,0,22,2
1748422648393,SOCI 1,A02,934879,Skrentny; John David,21,0,22,1
1748422648393,SOCI 1,A03,934880,Skrentny; John David,22,0,23,1
1748422648393,SOCI 1,A04,934881,Skrentny; John David,12,0,23,11
1748422648393,SOCI 1,A05,934883,Skrentny; John David,23,0,23,0
1748422648393,SOCI 1,A06,934884,Skrentny; John David,23,0,23,0
1748422648393,SOCI 1,A07,934885,Skrentny; John David,22,0,23,1
1748422648393,SOCI 1,A08,934886,Skrentny; John David,22,0,23,1
1748422648393,SOCI 1,A09,934887,Skrentny; John David,22,0,23,1
1748422649421,SOCI 30,A01,934889,Ruiz; Jonathan Joseph,18,0,20,2
1748422649421,SOCI 30,A02,934890,Ruiz; Jonathan Joseph,15,0,20,5
1748422650450,SOCI 60,A01,934892,Ribas Norris; Janet Vanesa,6,0,17,11
1748422650450,SOCI 60,A02,934896,Ribas Norris; Janet Vanesa,17,0,17,0
1748422650450,SOCI 60,A03,934965,Ribas Norris; Janet Vanesa,12,0,17,5
1748422650450,SOCI 60,A04,934974,Ribas Norris; Janet Vanesa,17,0,17,0
1748422651479,SOCI 70,A01,934984,Payne; Christine Anna,4,0,15,11
1748422651479,SOCI 70,A02,934988,Payne; Christine Anna,14,0,15,1
1748422651479,SOCI 70,A03,935006,Payne; Christine Anna,11,0,15,4
1748422651479,SOCI 70,A04,935047,Payne; Christine Anna,15,0,15,0
1748422652506,SOCI 88,A00,935058,Estefan; Michel,0,0,20,20
1748422653537,SOCI 100,A01,935065,Estefan; Michel,6,0,15,9
1748422653537,SOCI 100,A02,935068,Estefan; Michel,4,0,15,11
1748422653537,SOCI 100,A03,935069,Estefan; Michel,5,0,15,10
1748422653537,SOCI 100,A04,935071,Estefan; Michel,0,0,15,15
1748422654563,SOCI 103M,A00,935073,Kilpatrick; Kevin,22,0,30,8
1748422655594,SOCI 104,A00,935077,Arnal; Maud Marie Leonie,18,0,30,12
1748422656625,SOCI 104Q,A00,935079,Rogers; Julia,20,0,30,10
1748422657652,SOCI 105,A01,935083,Jules-Rosette; Bennetta W.,20,0,25,5
1748422658678,SOCI 109,A00,935084,Kilpatrick; Kevin,25,0,30,5
1748422659704,SOCI 112,A00,935085,Pitt; Richard Norris,61,0,65,4
1748422660728,SOCI 113,A00,935086,Rogers; Julia,68,0,75,7
1748422661755,SOCI 117,A01,935151,Jones; Makeba,0,0,13,13
1748422661755,SOCI 117,A02,935153,Jones; Makeba,4,0,13,9
1748422661755,SOCI 117,A03,935155,Jones; Makeba,11,0,12,1
1748422661755,SOCI 117,A04,935156,Jones; Makeba,10,0,12,2
1748422661755,SOCI 117,B01,935158,Jones; Gabrielle Anastasia,7,0,15,8
1748422661755,SOCI 117,B02,935159,Jones; Gabrielle Anastasia,15,0,15,0
1748422661755,SOCI 117,B03,935161,Jones; Gabrielle Anastasia,15,0,15,0
1748422661755,SOCI 117,B04,935162,Jones; Gabrielle Anastasia,15,0,15,0
1748422662781,SOCI 122,A00,935166,Lewis; Kevin Michael,101,0,120,19
1748422663807,SOCI 129,A00,935167,Pitt; Richard Norris,50,0,65,15
1748422664838,SOCI 135,A00,935170,Payne; Christine Anna,112,0,120,8
1748422665867,SOCI 136F,A00,935171,Gong; Neil M,52,0,56,4
1748422666897,SOCI 137,A00,935173,Crofts; Christine,53,0,100,47
1748422667923,SOCI 138,A00,935174,Navon; Daniel,111,0,135,24
1748422669004,SOCI 140,A00,935175,Ng; Kwai,47,0,65,18
1748422670031,SOCI 140K,A00,935176,Ng; Kwai,39,0,56,17
1748422671062,SOCI 142,A00,935177,Crofts; Christine,24,0,75,51
1748422672089,SOCI 143V,A00,935222,Lewis; Kevin Michael,99,0,140,41
1748422673117,SOCI 148,A00,935227,Shafir; Gershon,115,0,120,5
1748422674144,SOCI 148E,A00,935231,Calderon-Zaks; Michael Aar,44,0,56,12
1748422675171,SOCI 150,A00,935232,Victoria Torres; Pablo,14,0,50,36
1748422676197,SOCI 153,A00,935233,Ruiz; Jonathan Joseph,46,0,50,4
1748422677224,SOCI 166,A00,935243,Lampland; Martha,34,0,35,1
1748422678251,SOCI 170,A00,935247,Lampland; Martha,29,0,30,1
1748422679276,SOCI 172,A00,935249,Rona-Tas; Akos,40,0,45,5
1748422680306,SOCI 173,A00,935252,Arnal; Maud Marie Leonie,67,0,75,8
1748422681332,SOCI 180,A00,935253,Calderon-Zaks; Michael Aar,46,0,56,10
1748422682359,SOCI 184,A00,935254,Victoria Torres; Pablo,21,0,56,35
1748422683389,SOCI 196A,A00,935256,Turner; Christena L.,20,0,20,0
1748422684416,SPPS 200B,A00,959322,Luli; Alex J,99,0,99,0
1748422685442,SPPS 201,A00,959324,Mnatzaganian; Christina L,99,0,99,0
1748422686470,SPPS 202A,A00,959400,Tsunoda; Shirley M.,99,0,99,0
1748422687500,SPPS 204,A01,959405,Jones; John,99,0,99,0
1748422688526,SPPS 206,A00,959406,Bounthavong; Mark,80,0,80,0
1748422689561,SPPS 212A,A01,959408,Feist; Ashley,81,0,99,18
1748422690593,SPPS 213A,A00,959409,Namba; Jennifer Mariko,82,0,99,17
1748422691619,SPPS 219,A00,959410,Ma; Joseph David,81,0,99,18
1748422692652,SPPS 221,A01,959412,Siegel; Dionicio R.,80,0,80,0
1748422693680,SPPS 231,A00,959413,Penny; William F.,79,0,99,20
1748422694707,SPPS 232,A00,959415,Simonson; Tatum Sasha Summ,79,0,99,20
1748422695737,SPPS 233,A00,959417,Eckmann; Lars,79,0,99,20
1748422696768,SPPS 247,A00,959419,Brandl; Katharina,79,0,99,20
1748422697797,SPPS 251,A00,959420,Chen; Timothy,99,0,99,0
1748422698826,SPPS 264A,A00,959421,Tsunoda; Shirley M.,99,0,99,0
1748422700882,SPPS 267,A01,959426,Tsunoda; Shirley M.,25,0,25,0
1748422701910,SPPS 269,A00,959427,Atayee; Rabia Samady,29,0,30,1
1748422702937,SPPS 270A,A00,959430,Fricovsky; Eduardo Santiago,99,0,99,0
1748422703962,SPPS 271,A00,959432,Tsunoda; Shirley M.,99,0,99,0
1748422704993,SPPS 278,A00,959433,Fricovsky; Eduardo Santiago,98,0,99,1
1748422706019,SPPS 279,A00,959434,Painter; Nathan A.,99,0,99,0
1748422707058,SYN 2,001,946469,Girard; Gabrielle,3,0,20,17
1748422707058,SYN 2,002,946470,Girard; Gabrielle,0,0,20,20
1748422707058,SYN 2,003,946471,Rock; Martin,0,0,20,20
1748422707058,SYN 2,004,946472,Rock; Martin,0,0,20,20
1748422707058,SYN 2,005,946473,Iatarola; Briana Marie,0,0,20,20
1748422707058,SYN 2,006,946474,Tawater; Hanna Jean,0,0,20,20
1748422707058,SYN 2,007,946475,Browne; Emily,6,0,20,14
1748422707058,SYN 2,008,946476,Browne; Emily,0,0,20,20
1748422707058,SYN 2,009,946477,Staff,0,0,20,20
1748422707058,SYN 2,010,946478,Staff,9,0,20,11
1748422707058,SYN 2,012,946480,Deavenport; James Cary,0,0,20,20
1748422707058,SYN 2,013,946481,Deavenport; James Cary,0,0,20,20
1748422707058,SYN 2,014,946482,Staff,0,0,20,20
1748422707058,SYN 2,015,946483,Staff,0,0,20,20
1748422707058,SYN 2,016,946484,Staff,0,0,20,20
1748422707058,SYN 2,017,946485,Staff,5,0,20,15
1748422707058,SYN 2,019,946487,Atkinson; Arthur Laird,0,0,20,20
1748422707058,SYN 2,020,946488,Staff,0,0,20,20
1748422707058,SYN 2,021,946489,Staff,0,0,20,20
1748422707058,SYN 2,030,946498,Iatarola; Briana Marie,0,0,20,20
1748422707058,SYN 2,036,946587,Bishop; Graham,0,0,20,20
1748422708085,SYN 2R,001,946588,Bishop; Graham,0,0,20,20
1748422709120,SYN 100,A01,946594,Rock; Martin,0,0,15,15
1748422709120,SYN 100,A02,946595,Rock; Martin,0,0,15,15
1748422709120,SYN 100,B01,946598,Browne; Emily,0,0,15,15
1748422709120,SYN 100,B02,946600,Browne; Emily,0,0,15,15
1748422709120,SYN 100,C01,946606,Tawater; Hanna Jean,0,0,15,15
1748422709120,SYN 100,C02,946607,Tawater; Hanna Jean,0,0,15,15
1748422709120,SYN 100,D01,946610,Tawater; Hanna Jean,0,0,15,15
1748422709120,SYN 100,D02,946613,Tawater; Hanna Jean,0,0,15,15
1748422709120,SYN 100,E01,946617,Vega; Adrian,0,0,24,24
1748422709120,SYN 100,G01,946714,Iatarola; Briana Marie,0,0,15,15
1748422709120,SYN 100,G02,946721,Iatarola; Briana Marie,0,0,15,15
1748422709120,SYN 100,I01,946735,Gormally; Brenna,0,0,15,15
1748422709120,SYN 100,I02,946736,Gormally; Brenna,0,0,15,15
1748422709120,SYN 100,J01,946738,Hom; Kirstyn Courtney,0,0,15,15
1748422709120,SYN 100,J02,946739,Hom; Kirstyn Courtney,0,0,15,15
1748422709120,SYN 100,K01,946741,Hom; Kirstyn Courtney,0,0,15,15
1748422709120,SYN 100,K02,946742,Hom; Kirstyn Courtney,0,0,15,15
1748422709120,SYN 100,L01,946745,Difruscio; Mark,0,0,15,15
1748422709120,SYN 100,L02,946746,Difruscio; Mark,0,0,15,15
1748422709120,SYN 100,M01,946748,Difruscio; Mark,0,0,15,15
1748422709120,SYN 100,M02,946749,Difruscio; Mark,0,0,15,15
1748422709120,SYN 100,P01,946759,Atkinson; Arthur Laird,0,0,15,15
1748422709120,SYN 100,P02,946760,Atkinson; Arthur Laird,0,0,15,15
1748422709120,SYN 100,Q01,946763,Bishop; Graham,0,0,15,15
1748422709120,SYN 100,Q02,946764,Bishop; Graham,0,0,15,15
1748422709120,SYN 100,R01,946766,Deavenport; James Cary,0,0,15,15
1748422709120,SYN 100,R02,946767,Deavenport; James Cary,0,0,15,15
1748422710153,SYN 150,001,946771,Gladstein; Jill M,19,0,20,1
1748422710153,SYN 150,002,946772,Lagapa; Jason,17,0,20,3
1748422710153,SYN 150,003,946773,Fish; Gwendolyn Anne,19,0,20,1
1748422710153,SYN 150,004,946774,Fish; Gwendolyn Anne,20,0,20,0
1748422710153,SYN 150,006,946782,Lagapa; Jason,18,0,20,2
1748422710153,SYN 150,007,946783,Lagapa; Jason,19,0,20,1
1748422710153,SYN 150,008,946784,Fish; Gwendolyn Anne,19,0,20,1
1748422711184,SYN 150R,001,946786,Vega; Adrian,19,0,20,1
1748422712213,TDAC 1,A00,946788,Walsh; Kim C.,0,0,12,12
1748422712213,TDAC 1,B00,946789,Walsh; Kim C.,0,0,12,12
1748422712213,TDAC 1,C00,946790,Walsh; Kim C.,0,0,12,12
1748422712213,TDAC 1,D00,946791,Walsh; Kim C.,0,0,12,12
1748422712213,TDAC 1,E00,946792,Walsh; Kim C.,0,0,12,12
1748422712213,TDAC 1,F00,946793,Walsh; Kim C.,0,0,12,12
1748422713240,TDAC 101,A00,946887,Harting; Carla Kelso,3,0,12,9
1748422713240,TDAC 101,B00,946970,Salovey; Todd,9,0,12,3
1748422713240,TDAC 101,C00,946977,Walsh; Kim C.,10,0,12,2
1748422714266,TDAC 102,A00,946979,Celik; Aysan Karagasli,7,0,15,8
1748422715293,TDAC 104,A00,946994,Meyer; Ursula,14,0,15,1
1748422716322,TDAC 107,A00,946997,Stalling; Vanessa,0,0,0,0
1748422717349,TDAC 108,A00,947021,Basso; Beatrice,19,0,20,1
1748422717349,TDAC 108,B00,947025,Caban; Andrea Chudnow,12,0,20,8
1748422717349,TDAC 108,C00,968049,Buescher; Stephen W.,16,0,20,4
1748422718375,TDAC 115,A00,947050,Buescher; Stephen W.,14,0,20,6
1748422719402,TDAC 122,A00,947091,Stalling; Vanessa,30,0,30,0
1748422719402,TDAC 122,B00,947092,Perry; Lamar,30,0,30,0
1748422720435,TDAC 123,A00,947093,Castro; Robert Jess,30,0,30,0
1748422721464,TDDE 1,A01,946795,Guirguis; Mark C,10,0,11,1
1748422721464,TDDE 1,A02,946796,Guirguis; Mark C,10,0,11,1
1748422721464,TDDE 1,A03,946797,Guirguis; Mark C,7,0,11,4
1748422721464,TDDE 1,A04,946798,Guirguis; Mark C,8,0,11,3
1748422721464,TDDE 1,A05,946799,Guirguis; Mark C,11,0,11,0
1748422722494,TDDE 130,A00,947094,Guirguis; Mark C,20,0,20,0
1748422723520,TDDE 131,A00,947095,Guirguis; Mark C,17,0,20,3
1748422724550,TDDE 132,A00,947096,Guirguis; Mark C,20,0,20,0
1748422725576,TDDE 141,A00,947097,McElver; Robert Harrison,20,0,20,0
1748422726607,TDDM 1,A00,946800,Johnston; Holly,7,0,18,11
1748422727635,TDDM 100,A00,947098,Brown; Bernard Joseph,28,0,30,2
1748422728662,TDDR 101,A00,947099,Powell; Lora,4,0,20,16
1748422729690,TDDR 102,A00,947100,Powell; Lora,19,0,20,1
1748422730721,TDDR 111,A00,947101,Castro; Robert Jess,12,0,15,3
1748422731748,TDDR 190,A00,947102,Stalling; Vanessa,35,0,35,0
1748422732777,TDGE 1,A01,946802,Salovey; Todd,12,0,12,0
1748422732777,TDGE 1,A02,946803,Salovey; Todd,11,0,12,1
1748422732777,TDGE 1,A03,946804,Salovey; Todd,12,0,12,0
1748422732777,TDGE 1,A04,946806,Salovey; Todd,12,0,12,0
1748422732777,TDGE 1,A05,946807,Salovey; Todd,10,0,12,2
1748422732777,TDGE 1,A06,946808,Salovey; Todd,12,0,12,0
1748422733804,TDGE 10,A00,946810,Havis; Allan,208,0,225,17
1748422734833,TDGE 11,A00,946811,Fulton; Julia,205,0,245,40
1748422735862,TDGE 25,A00,946812,Harting; Carla Kelso,1,0,20,19
1748422735862,TDGE 25,B00,946813,Harting; Carla Kelso,5,0,20,15
1748422735862,TDGE 25,C00,946814,Harting; Carla Kelso,10,0,20,10
1748422735862,TDGE 25,D00,946815,Harting; Carla Kelso,12,0,20,8
1748422736891,TDGE 124,A00,947103,Fulton; Julia,190,0,245,55
1748422737917,TDGE 133,A00,947104,Brill; Robert L.,19,0,20,1
1748422738945,TDGR 201,A00,947268,Newcomb; James,8,0,8,0
1748422739972,TDGR 210A,A00,947269,Staff,8,0,8,0
1748422740999,TDGR 211A,A00,947270,Caban; Andrea Chudnow,8,0,8,0
1748422742028,TDGR 212,A00,947271,Meyer; Ursula,17,0,17,0
1748422742028,TDGR 212,B00,947272,Caban; Andrea Chudnow,17,0,17,0
1748422743054,TDGR 213A,A00,947273,Buescher; Stephen W.,8,0,8,0
1748422744082,TDGR 214A,A00,947274,Meyer; Ursula,8,0,8,0
1748422745110,TDGR 219,A00,947276,Stalling; Vanessa,3,0,5,2
1748422746137,TDGR 229,A00,947277,Meyer; Ursula,7,0,7,0
1748422747167,TDGR 231A,A00,947278,Meyer; Ursula,9,0,9,0
1748422748193,TDGR 233,A00,947279,Richard; Keiana Nikole,9,0,9,0
1748422749220,TDGR 235,A00,947280,Blair; Kyle Adam,9,0,9,0
1748422750247,TDGR 239,A00,947281,Staff,8,0,8,0
1748422750247,TDGR 239,B00,947282,Meyer; Ursula,9,0,9,0
1748422750247,TDGR 239,C00,947283,Staff,9,0,9,0
1748422751275,TDGR 240,A00,947284,Stalling; Vanessa,3,0,5,2
1748422752308,TDGR 244,A00,947285,Iizuka; Naomi Hisako,19,0,20,1
1748422753334,TDGR 245,A00,947287,Stalling; Vanessa,4,0,5,1
1748422754363,TDGR 250,A00,947289,Stein; Deborah Isobel,5,0,5,0
1748422755390,TDGR 251,A00,947296,Iizuka; Naomi Hisako,5,0,5,0
1748422755390,TDGR 251,B00,947355,Stein; Deborah Isobel,5,0,5,0
1748422756417,TDGR 274,A00,947358,Brill; Robert L.,19,0,20,1
1748422757442,TDGR 275,A00,947361,Staff,10,0,10,0
1748422758469,TDGR 276,A00,947362,Bokovikova; Alina V,10,0,10,0
1748422759497,TDGR 278,A00,947363,Petrovich; Victoria A.,12,0,12,0
1748422759497,TDGR 278,B00,947366,Staff,9,0,10,1
1748422760527,TDGR 279,A00,947367,Petrovich; Victoria A.,3,0,3,0
1748422760527,TDGR 279,B00,947368,Brill; Robert L.,2,0,3,1
1748422760527,TDGR 279,C00,947369,McElver; Robert Harrison,3,0,3,0
1748422760527,TDGR 279,D00,967973,Staff,0,0,0,0
1748422760527,TDGR 279,E00,967974,Bokovikova; Alina V,0,0,0,0
1748422761555,TDGR 282,A00,947370,McElver; Robert Harrison,10,0,10,0
1748422762585,TDGR 289,A00,947371,Power; Jade Yukana,10,0,10,0
1748422763612,TDGR 289C,A00,947373,Burelle; Julie Sara Veronique,10,0,10,0
1748422764638,TDGR 289D,A00,947374,Anderson; Mysia Anyse,5,0,5,0
1748422765666,TDGR 292,A00,947375,Yapp; Hentyle T,14,0,15,1
1748422766692,TDGR 295,A00,947376,Celik; Aysan Karagasli,8,0,8,0
1748422767718,TDGR 296,A00,947379,Powell; Lora,5,0,5,0
1748422768745,TDGR 297,001,947381,Meyer; Ursula,9,0,9,0
1748422769780,TDHT 10,A00,946817,Burelle; Julie Sara Veronique,23,0,25,2
1748422770811,TDHT 21,A02,946821,Power; Jade Yukana,11,0,15,4
1748422770811,TDHT 21,A03,946822,Power; Jade Yukana,8,0,15,7
1748422771840,TDHT 101,A00,947106,Perry; Lamar,19,0,25,6
1748422772937,TDHT 103,A00,947107,Yapp; Hentyle T,8,0,25,17
1748422773968,TDHT 115,A00,947108,Portes; Elizabeth Marie,16,0,25,9
1748422774996,TDMV 1,A00,946823,Arcidiacono; Kristin,18,0,30,12
1748422776022,TDMV 2,A00,946824,Wilson; Terry A.,24,0,30,6
1748422776022,TDMV 2,B00,946825,Brown; Bernard Joseph,23,0,30,7
1748422777053,TDMV 3,A00,946826,Mack; Kara Shanai',23,0,40,17
1748422778080,TDMV 11,A00,946827,Arcidiacono; Kristin,36,0,40,4
1748422778080,TDMV 11,B00,946828,Fyall; Daunte Edward,28,0,30,2
1748422779107,TDMV 20,A00,946830,Alvarez; Ana Maria,38,0,40,2
1748422779107,TDMV 20,B00,946831,Smith; Alison D,20,0,20,0
1748422780134,TDMV 110,A00,947109,Smith; Alison D,25,0,30,5
1748422781163,TDMV 120,A00,947110,Weinberg; Sadie,17,0,18,1
1748422781163,TDMV 120,B00,964374,Johnston; Holly,18,0,18,0
1748422782196,TDMV 123,A00,947111,Duran; Marcos Antonio,29,0,30,1
1748422783223,TDMV 138,A00,947113,Jun; Grace Shin Hae,4,0,40,36
1748422784254,TDMV 140,A00,947114,Corrales; Joseph Bernales,29,0,30,1
1748422784254,TDMV 140,B00,947138,Lima; Paulo Henrique,30,0,30,0
1748422784254,TDMV 140,C00,947139,Staff,25,0,30,5
1748422785280,TDMV 141,A00,947140,Caligagan; Tony,29,0,30,1
1748422786309,TDMV 142,A00,947225,Alvarez; Ana Maria,28,0,40,12
1748422786309,TDMV 142,B00,947226,Blanco; Juan Carlos,27,0,30,3
1748422787338,TDMV 143,A00,947227,Fyall; Daunte Edward,28,0,30,2
1748422788365,TDMV 144,A00,947261,Camaya; Michelle Ann,28,0,30,2
1748422788365,TDMV 144,B00,947262,Patnaik; Shibani,28,0,30,2
1748422789390,TDMV 146,A00,947263,Caligagan; Tony,30,0,30,0
1748422790418,TDPF 160,A00,947264,Mack; Kara Shanai',40,0,40,0
1748422791444,TDPR 6,A01,946869,Guirguis; Mark C,25,0,25,0
1748422791444,TDPR 6,A02,946870,Guirguis; Mark C,25,0,25,0
1748422792470,TDPR 102,A00,947265,Guirguis; Mark C,20,0,20,0
1748422793496,TDPR 104,A00,947266,Powell; Lora,15,0,15,0
1748422794522,TDPW 1,A00,946873,Stein; Deborah Isobel,6,0,10,4
1748422794522,TDPW 1,B00,946878,Stein; Deborah Isobel,10,0,10,0
1748422794522,TDPW 1,C00,946879,Stein; Deborah Isobel,10,0,10,0
1748422794522,TDPW 1,D00,946880,Stein; Deborah Isobel,7,0,10,3
1748422794522,TDPW 1,E00,946882,Stein; Deborah Isobel,7,0,10,3
1748422795548,TDPW 104,A00,947267,Loo; Eric James,13,0,20,7
1748422796578,TDTR 10,A00,946883,Wilson; Terry A.,14,0,20,6
1748422797605,TDTR 15,A00,946885,Smith; Alison D,30,0,30,0
1748422798635,TDTR 20,A00,946886,Duran; Marcos Antonio,25,0,30,5
1748422799666,USP 1,A01,943915,Garcia; Guadalupe,23,0,23,0
1748422799666,USP 1,A02,943916,Garcia; Guadalupe,19,0,23,4
1748422799666,USP 1,A03,943927,Garcia; Guadalupe,23,0,23,0
1748422799666,USP 1,A04,943933,Garcia; Guadalupe,22,0,23,1
1748422799666,USP 1,A05,943942,Garcia; Guadalupe,23,0,23,0
1748422799666,USP 1,A06,943951,Garcia; Guadalupe,22,0,23,1
1748422800695,USP 2,A01,943956,Pezzoli; Keith,15,0,23,8
1748422800695,USP 2,A02,943958,Pezzoli; Keith,20,0,22,2
1748422801722,USP 4,A00,943961,Schwaller; Nora Louise,2,0,18,16
1748422801722,USP 4,B00,943966,Schwaller; Nora Louise,12,0,18,6
1748422802749,USP 5,A01,943968,Boomhower; Matthew Charles,15,0,20,5
1748422802749,USP 5,A02,943969,Boomhower; Matthew Charles,16,0,20,4
1748422803775,USP 15,A01,943971,Anderson; William Raymond,18,0,20,2
1748422803775,USP 15,A02,944015,Anderson; William Raymond,19,0,20,1
1748422804801,USP 25,A00,944021,Shenkman; Michael Thomas,16,0,25,9
1748422805828,USP 50,A00,944025,Sun; Feiyang,3,0,30,27
1748422806859,USP 60,A01,944056,Wali; Behram,26,0,30,4
1748422807891,USP 105,A00,944057,Ruiz; Jonathan Joseph,9,0,15,6
1748422808918,USP 108,A00,944058,Pezzoli; Keith,10,0,21,11
1748422809949,USP 124,A00,944060,Devereux; Christina Schopp,16,0,35,19
1748422810980,USP 125,A00,944063,Lerner; Amy M,21,0,28,7
1748422812008,USP 136,A00,944064,Staff,27,0,35,8
1748422813036,USP 141A,A00,960658,Lewis; Leslie R,0,0,0,0
1748422814066,USP 143,A00,944065,Hinds; Juli Beth,200,0,250,50
1748422815097,USP 144,A00,944066,Chowdhury; Muhammed Zohir,94,0,100,6
1748422816128,USP 150,A00,944067,Devereux; Christina Schopp,68,0,75,7
1748422817184,USP 151,A00,944068,Clark; Christopher N,58,0,70,12
1748422818210,USP 152B,A00,944069,Moeder; Nathan L,14,0,25,11
1748422819239,USP 153,A00,944070,Shenkman; Michael Thomas,19,0,35,16
1748422820270,USP 161,A00,944071,Wartell; Julie Dara,27,0,35,8
1748422821299,USP 165C,A00,944072,Wali; Behram,25,0,30,5
1748422822333,USP 170,A00,944142,Entezam; Maryam,60,0,70,10
1748422823358,USP 171,A00,944153,Lerner; Amy M,24,0,65,41
1748422824393,USP 175,A00,944172,Peerson; Susan,0,0,25,25
1748422825420,USP 177A,A00,944173,Peerson; Susan,0,0,23,23
1748422827473,USP 185A,A01,944198,Boomhower; Matthew Charles,26,0,40,14
1748422827473,USP 185A,B01,944201,Sun; Feiyang,0,0,40,40
1748422828502,USP 186,A01,944255,Bussell; Mirle Rabinowitz,28,0,38,10
1748422828502,USP 186,A02,944262,Bussell; Mirle Rabinowitz,11,0,37,26
1748422829531,USP 189,A00,944269,Garcia; Guadalupe,35,0,35,0
1748422830559,USP 191A,A00,944270,McTague; Sarah,13,0,30,17
1748422831590,USP 193,A00,944271,Shilon; Mor,10,0,23,13
1748422832620,USP 194,A00,954112,Hill; Seth J,9999,0,9999,0
1748422833647,USP 265C,A00,944277,Wali; Behram,3,0,4,1
1748422834676,USP 271,A00,944280,Lerner; Amy M,5,0,5,0
1748422835714,VIS 1,A01,944283,Staff,4,0,12,8
1748422835714,VIS 1,A02,944284,Staff,0,0,12,12
1748422835714,VIS 1,A03,944286,Staff,0,0,12,12
1748422835714,VIS 1,A04,944288,Staff,0,0,12,12
1748422835714,VIS 1,A05,944290,Staff,0,0,12,12
1748422835714,VIS 1,A06,944292,Staff,1,0,12,11
1748422835714,VIS 1,A07,944293,Staff,9,0,12,3
1748422835714,VIS 1,A08,944300,Staff,0,0,12,12
1748422835714,VIS 1,A09,944302,Staff,12,0,12,0
1748422835714,VIS 1,A10,944303,Staff,0,0,12,12
1748422835714,VIS 1,A11,944307,Staff,0,0,12,12
1748422835714,VIS 1,A12,944309,Staff,0,0,12,12
1748422835714,VIS 1,A13,944310,Staff,0,0,12,12
1748422835714,VIS 1,A14,944312,Staff,0,0,12,12
1748422835714,VIS 1,A15,944316,Staff,7,0,12,5
1748422835714,VIS 1,A16,944319,Staff,0,0,12,12
1748422836742,VIS 20,A01,944323,Woods; Ann,14,0,16,2
1748422836742,VIS 20,A02,944325,Woods; Ann,15,0,16,1
1748422836742,VIS 20,A03,944326,Woods; Ann,14,0,16,2
1748422836742,VIS 20,A04,944328,Woods; Ann,14,0,16,2
1748422836742,VIS 20,A05,944330,Woods; Ann,16,0,16,0
1748422836742,VIS 20,A06,944334,Woods; Ann,16,0,16,0
1748422836742,VIS 20,A07,944336,Woods; Ann,14,0,16,2
1748422836742,VIS 20,A08,944337,Woods; Ann,16,0,16,0
1748422836742,VIS 20,A09,944338,Woods; Ann,15,0,16,1
1748422836742,VIS 20,A10,944339,Woods; Ann,16,0,16,0
1748422836742,VIS 20,A11,944340,Woods; Ann,15,0,16,1
1748422836742,VIS 20,A12,944342,Woods; Ann,15,0,16,1
1748422837769,VIS 23,A00,944343,Rose; Jordan M,0,0,5,5
1748422838796,VIS 30,A01,944346,Stone; Patricia,11,0,11,0
1748422838796,VIS 30,A02,944351,Stone; Patricia,0,0,11,11
1748422838796,VIS 30,A03,944353,Stone; Patricia,7,0,11,4
1748422838796,VIS 30,A04,944354,Stone; Patricia,9,0,11,2
1748422838796,VIS 30,A05,944356,Stone; Patricia,10,0,11,1
1748422838796,VIS 30,A06,944359,Stone; Patricia,6,0,11,5
1748422839829,VIS 41,A01,944391,D'Elena-Tweed; Jessica Erin,10,0,12,2
1748422839829,VIS 41,A02,944392,D'Elena-Tweed; Jessica Erin,11,0,12,1
1748422839829,VIS 41,A03,944393,D'Elena-Tweed; Jessica Erin,12,0,12,0
1748422839829,VIS 41,A04,944396,D'Elena-Tweed; Jessica Erin,9,0,12,3
1748422839829,VIS 41,A05,944397,D'Elena-Tweed; Jessica Erin,12,0,12,0
1748422839829,VIS 41,A06,944399,D'Elena-Tweed; Jessica Erin,8,0,12,4
1748422839829,VIS 41,A07,944405,D'Elena-Tweed; Jessica Erin,10,0,12,2
1748422839829,VIS 41,A08,944411,D'Elena-Tweed; Jessica Erin,10,0,12,2
1748422839829,VIS 41,A09,944412,D'Elena-Tweed; Jessica Erin,12,0,12,0
1748422839829,VIS 41,A10,944415,D'Elena-Tweed; Jessica Erin,10,0,12,2
1748422839829,VIS 41,A11,944428,D'Elena-Tweed; Jessica Erin,12,0,12,0
1748422839829,VIS 41,A12,944430,D'Elena-Tweed; Jessica Erin,11,0,12,1
1748422840856,VIS 42,A00,969576,Twomey; Robert Daniel,86,0,100,14
1748422841886,VIS 60,A01,944432,Sepuya; Paul Mpagi,10,0,12,2
1748422841886,VIS 60,A02,944434,Sepuya; Paul Mpagi,12,0,12,0
1748422841886,VIS 60,A03,944436,Sepuya; Paul Mpagi,12,0,12,0
1748422841886,VIS 60,A04,944438,Sepuya; Paul Mpagi,12,0,12,0
1748422842914,VIS 70N,A01,944456,Garnett; Mariah J,11,0,11,0
1748422842914,VIS 70N,A02,944461,Garnett; Mariah J,9,0,11,2
1748422842914,VIS 70N,A03,944462,Garnett; Mariah J,8,0,11,3
1748422842914,VIS 70N,A04,944500,Garnett; Mariah J,10,0,11,1
1748422842914,VIS 70N,A05,944501,Garnett; Mariah J,11,0,11,0
1748422842914,VIS 70N,A06,944502,Garnett; Mariah J,11,0,11,0
1748422842914,VIS 70N,A07,944503,Garnett; Mariah J,11,0,11,0
1748422842914,VIS 70N,A08,944507,Garnett; Mariah J,11,0,11,0
1748422843942,VIS 80,A01,944513,Adler; Amy,12,0,12,0
1748422843942,VIS 80,A02,944515,Adler; Amy,9,0,12,3
1748422843942,VIS 80,A03,944517,Adler; Amy,10,0,12,2
1748422843942,VIS 80,A04,944518,Adler; Amy,10,0,12,2
1748422843942,VIS 80,A05,944519,Adler; Amy,12,0,12,0
1748422843942,VIS 80,A06,944520,Adler; Amy,11,0,12,1
1748422843942,VIS 80,A07,944525,Adler; Amy,11,0,12,1
1748422843942,VIS 80,A08,944526,Adler; Amy,9,0,12,3
1748422844972,VIS 85A,A01,944694,Staff,18,0,18,0
1748422844972,VIS 85A,A02,944695,Staff,18,0,18,0
1748422844972,VIS 85A,A03,944696,Staff,17,0,18,1
1748422844972,VIS 85A,A04,944697,Staff,17,0,18,1
1748422844972,VIS 85A,A05,968082,Staff,17,0,18,1
1748422844972,VIS 85A,A06,968084,Staff,18,0,18,0
1748422844972,VIS 85A,A07,968085,Staff,17,0,18,1
1748422844972,VIS 85A,A08,968087,Staff,17,0,18,1
1748422846004,VIS 100,A00,944698,Cruz; Edwin Teddy,125,0,146,21
1748422847029,VIS 100A,A00,944699,D'Elena-Tweed; Jessica Erin,0,0,15,15
1748422848058,VIS 103D,A00,944767,Cartwright; Lisa,72,0,75,3
1748422849093,VIS 105A,A00,944769,Staff,9,0,30,21
1748422849093,VIS 105A,B00,944770,Staff,20,0,30,10
1748422850121,VIS 105B,A00,944773,Staff,16,0,30,14
1748422851150,VIS 105C,A00,944774,Ortiz-Torres; Ruben,1,0,15,14
1748422852176,VIS 106A,A00,944775,Staff,10,0,25,15
1748422853204,VIS 106B,A00,944776,Staff,0,0,25,25
1748422854230,VIS 107A,A00,944777,Staff,2,0,25,23
1748422855257,VIS 107C,A00,944780,Iglesias; Janelle Ann,11,0,15,4
1748422856284,VIS 108,A00,944781,Staff,0,0,15,15
1748422857310,VIS 110A,A00,944782,Staff,11,0,15,4
1748422858341,VIS 110G,A00,963093,Staff,14,0,15,1
1748422859367,VIS 113CN,A00,944783,Welchman; John C.,11,0,15,4
1748422860394,VIS 120A,A00,944784,Woods; Ann,118,0,146,28
1748422861419,VIS 121C,A00,944789,Tronzo; William,68,0,75,7
1748422862454,VIS 126F,A00,944793,Wardwell; Mariana Razo,74,0,75,1
1748422863480,VIS 128C,A00,944794,Staff,71,0,75,4
1748422864510,VIS 129A,A00,944799,Staff,7,0,15,8
1748422865541,VIS 132,A00,944800,Miller; Nicole L,6,0,15,9
1748422866567,VIS 133,A01,944806,Staff,32,0,34,2
1748422866567,VIS 133,A02,944809,Staff,34,0,34,0
1748422867593,VIS 133A,A00,944854,Staff,0,0,15,15
1748422868628,VIS 141A,A01,944856,Stalbaum; Brett,16,0,25,9
1748422868628,VIS 141A,A02,944858,Stalbaum; Brett,17,0,25,8
1748422868628,VIS 141A,A03,944859,Stalbaum; Brett,11,0,25,14
1748422868628,VIS 141A,A04,944861,Stalbaum; Brett,23,0,25,2
1748422869663,VIS 142,A01,944864,Stalbaum; Brett,11,0,15,4
1748422869663,VIS 142,A02,944865,Stalbaum; Brett,0,0,15,15
1748422869663,VIS 142,A03,944869,Stalbaum; Brett,11,0,15,4
1748422869663,VIS 142,A04,944873,Stalbaum; Brett,5,0,15,10
1748422869663,VIS 142,A05,944876,Stalbaum; Brett,15,0,15,0
1748422869663,VIS 142,A06,944878,Stalbaum; Brett,7,0,15,8
1748422870690,VIS 143,A00,969275,Akten; Mehmet,0,0,15,15
1748422871720,VIS 145B,A00,944879,Akten; Mehmet,0,0,15,15
1748422872750,VIS 146B,A00,944880,Twomey; Robert Daniel,14,0,15,1
1748422873779,VIS 147A,A01,944883,Staff,21,0,22,1
1748422873779,VIS 147A,A02,944923,Staff,12,0,22,10
1748422873779,VIS 147A,A03,944924,Staff,15,0,22,7
1748422873779,VIS 147A,A04,944925,Staff,17,0,22,5
1748422874812,VIS 147B,A00,944926,Staff,0,0,15,15
1748422874812,VIS 147B,B00,944927,Staff,1,0,15,14
1748422875842,VIS 149,A00,944928,Bratton; Benjamin H.,12,0,15,3
1748422875842,VIS 149,B00,944929,Crandall; Jordan,7,0,15,8
1748422876923,VIS 152D,A01,944931,Wardwell; Mariana Razo,19,0,24,5
1748422876923,VIS 152D,A02,945003,Wardwell; Mariana Razo,23,0,24,1
1748422876923,VIS 152D,A03,945007,Wardwell; Mariana Razo,24,0,24,0
1748422876923,VIS 152D,A04,945097,Wardwell; Mariana Razo,22,0,24,2
1748422877949,VIS 157,A01,945131,Cartwright; Lisa,23,0,24,1
1748422877949,VIS 157,A02,945167,Cartwright; Lisa,5,0,24,19
1748422878977,VIS 162,A00,945168,Bratton; Benjamin H.,6,0,15,9
1748422880021,VIS 163,A00,945169,Stone; Patricia,72,0,75,3
1748422881057,VIS 164,A00,945170,Sepuya; Paul Mpagi,19,0,22,3
1748422882102,VIS 165A,A00,945208,Staff,10,0,22,12
1748422883128,VIS 167,A00,945235,Staff,11,0,22,11
1748422884154,VIS 171,A00,945258,Staff,18,0,22,4
1748422885181,VIS 174,A00,945285,Cross; Brian R,0,0,22,22
1748422886207,VIS 175,A00,945286,Staff,18,0,22,4
1748422887233,VIS 179,A00,945287,Erdmann; Dean,20,0,22,2
1748422888260,VIS 180A,A00,945322,Cross; Brian R,9,0,22,13
1748422889285,VIS 180B,A00,945324,Gaines; Malik Julian,17,0,22,5
1748422890311,VIS 183B,A00,945329,Staff,4,0,22,18
1748422891343,VIS 203,A00,945331,Cruz; Edwin Teddy,4,0,15,11
1748422892368,VIS 204,A00,945333,Gaines; Malik Julian,11,0,15,4
1748422893393,VIS 205,A00,945334,Ortiz-Torres; Ruben,14,0,15,1
1748422894422,VIS 207,A00,971577,Staff,13,0,15,2
1748422895449,VIS 209,A00,945337,Welchman; John C.,10,0,15,5
1748422896475,VIS 243,A00,945340,Rose; Jordan M,8,0,15,7
1748422897502,VIS 255,A00,945342,Staff,9,0,15,6
1748422898534,VIS 295,001,971694,Miller; Nicole L,0,0,0,0
1748422898534,VIS 295,002,971695,Cruz; Edwin Teddy,0,0,0,0
1748422898534,VIS 295,003,971696,Segade; Alexandro Abraham,0,0,0,0
1748422898534,VIS 295,004,971697,Vangenderen; Monique Luise,0,0,0,0
1748422898534,VIS 295,005,971725,Sepuya; Paul Mpagi,0,0,0,0
1748422898534,VIS 295,006,971763,Sepuya; Paul Mpagi,0,0,0,0
1748422898534,VIS 295,007,971764,Mostajo; Lorena,0,0,0,0
1748422898534,VIS 295,008,971765,Akten; Mehmet,0,0,0,0
1748422899595,WCWP 10A,001,947782,Escobar; Jordan Christophe,20,0,20,0
1748422899595,WCWP 10A,002,947791,Escobar; Jordan Christophe,20,0,20,0
1748422899595,WCWP 10A,003,947792,Gagnon; Jeffrey C,0,0,0,0
1748422899595,WCWP 10A,004,947793,Escobar; Jordan Christophe,19,0,20,1
1748422899595,WCWP 10A,005,947794,Merryman; Walter,19,0,20,1
1748422899595,WCWP 10A,006,947840,Merryman; Walter,20,0,20,0
1748422899595,WCWP 10A,007,947841,Staff,0,0,0,0
1748422899595,WCWP 10A,008,947842,Staff,0,0,0,0
1748422899595,WCWP 10A,009,947843,Martiniuk; Jill,18,0,20,2
1748422899595,WCWP 10A,010,947844,Staff,0,0,0,0
1748422899595,WCWP 10A,011,947845,Martiniuk; Jill,19,0,20,1
1748422899595,WCWP 10A,012,947861,Martiniuk; Jill,20,0,20,0
1748422899595,WCWP 10A,013,947862,Staff,0,0,0,0
1748422899595,WCWP 10A,014,947863,Staff,0,0,0,0
1748422899595,WCWP 10A,015,947867,Staff,0,0,0,0
1748422899595,WCWP 10A,016,947868,Susi; Natalie,19,0,20,1
1748422899595,WCWP 10A,017,947869,Susi; Natalie,19,0,20,1
1748422899595,WCWP 10A,018,947870,Holloway Ii; Mathew,20,0,20,0
1748422899595,WCWP 10A,019,947912,Welji; Haleema Nazir,0,0,0,0
1748422899595,WCWP 10A,020,947941,Holloway Ii; Mathew,19,0,20,1
1748422899595,WCWP 10A,021,947954,Holloway Ii; Mathew,20,0,20,0
1748422899595,WCWP 10A,022,960902,Windham; Emily,19,0,20,1
1748422899595,WCWP 10A,023,960903,Windham; Emily,16,0,20,4
1748422899595,WCWP 10A,024,960904,Windham; Emily,18,0,20,2
1748422900630,WCWP 10B,001,948038,Dhir; Simrita,17,0,20,3
1748422900630,WCWP 10B,002,948042,Dhir; Simrita,14,0,20,6
1748422900630,WCWP 10B,003,948043,Uriarte; Emma,0,0,20,20
1748422900630,WCWP 10B,004,948044,Dhir; Simrita,12,0,20,8
1748422900630,WCWP 10B,005,948045,Uriarte; Emma,13,0,20,7
1748422900630,WCWP 10B,006,948046,Uriarte; Emma,13,0,20,7
1748422900630,WCWP 10B,007,948047,Staff,0,0,0,0
1748422900630,WCWP 10B,008,948075,Staff,0,0,0,0
1748422900630,WCWP 10B,009,948076,Ornelas; Tricia,15,0,20,5
1748422900630,WCWP 10B,010,948077,Staff,0,0,0,0
1748422900630,WCWP 10B,011,948096,Staff,0,0,0,0
1748422900630,WCWP 10B,012,948103,Staff,0,0,0,0
1748422900630,WCWP 10B,016,948169,Staff,0,0,0,0
1748422900630,WCWP 10B,017,948192,Ornelas; Tricia,12,0,20,8
1748422900630,WCWP 10B,018,948194,Ornelas; Tricia,14,0,20,6
1748422900630,WCWP 10B,019,948195,Staff,0,0,0,0
1748422901659,WCWP 100,A00,948196,McCleary; Keith Long,14,0,20,6
1748422901659,WCWP 100,B00,948198,McCleary; Keith Long,20,0,20,0
1748422901659,WCWP 100,C00,948199,McCleary; Keith Long,20,0,20,0
1748422901659,WCWP 100,D00,948200,Twohig; Niall Ivan,18,0,20,2
1748422901659,WCWP 100,E00,948201,Twohig; Niall Ivan,19,0,20,1
1748422901659,WCWP 100,F00,948202,Twohig; Niall Ivan,17,0,20,3
1748422901659,WCWP 100,G00,948203,Young; Mark T,18,0,20,2
1748422901659,WCWP 100,H00,948204,Young; Mark T,19,0,20,1
1748422901659,WCWP 100,I00,948205,Young; Mark T,19,0,20,1
1748422902688,WES 237C,A00,948206,Staff,15,0,15,0
1748422903714,WES 267,A00,948207,Staff,25,0,25,0
1748422904740,WES 268A,A01,948209,Staff,15,0,15,0
1748422907054,AAPI 87,A00,911745,Solomon; Amanda Lee Albaniel,20,0,20,0
1748422908087,AAS 10R,A01,912566,Butler; Elizabeth Annette,15,0,34,19
1748422908087,AAS 10R,A02,912567,Butler; Elizabeth Annette,20,0,34,14
1748422909112,AAS 170R,A00,912568,Butler; Elizabeth Annette,29,0,32,3
1748422910148,ANAR 104,A01,911408,Shtienberg; Gilad,11,0,20,9
1748422911173,ANAR 120,A00,911411,Staff,22,0,30,8
1748422912206,ANAR 166,A00,911412,Jimenez Cano; Nayeli Guada,21,0,30,9
1748422913238,ANAR 167,A01,911414,Dunseth; Zachary Clark,0,0,10,10
1748422914266,ANBI 100,A00,911416,Marchetto; Maria Carolina,36,0,40,4
1748422914266,ANBI 100,B00,961136,Staff,66,0,80,14
1748422915291,ANBI 112,A00,911417,Marchetto; Maria Carolina,0,0,20,20
1748422916319,ANBI 117,A01,961211,Fox; Patrick Keolu Ozer,33,0,40,7
1748422917346,ANBI 135,A01,911419,Non; Amy L,4,0,15,11
1748422918376,ANBI 141,A00,911420,Gagneux; Pascal,170,0,196,26
1748422919402,ANSC 108,A00,911460,Pedersen; David,38,0,40,2
1748422920429,ANSC 121,A00,911472,Sloane; Julia Kathryn,53,0,60,7
1748422921457,ANSC 124,A00,911473,Bialecki; Jon Anthony,32,0,40,8
1748422922485,ANSC 142,A00,911474,Stone; Annika Britt,31,0,40,9
1748422923515,ANSC 148,A00,911475,Walkover; Lillian B,46,0,46,0
1748422924544,ANSC 149,A00,911476,Varma; Saiba,56,0,60,4
1748422925575,ANSC 152,A00,961212,Staff,40,0,40,0
1748422926604,ANSC 190,A00,911479,Jassal; Aftab,41,0,50,9
1748422927629,ANTH 1,A00,910717,Jassal; Aftab,146,0,150,4
1748422928657,ANTH 2,A01,910719,Wilder; Linnea Lorene,31,0,36,5
1748422928657,ANTH 2,A02,910720,Wilder; Linnea Lorene,36,0,36,0
1748422928657,ANTH 2,A03,910722,Wilder; Linnea Lorene,32,0,36,4
1748422928657,ANTH 2,A04,910723,Wilder; Linnea Lorene,35,0,36,1
1748422928657,ANTH 2,A05,910724,Wilder; Linnea Lorene,35,0,36,1
1748422928657,ANTH 2,A06,910725,Wilder; Linnea Lorene,35,0,36,1
1748422928657,ANTH 2,A07,910726,Wilder; Linnea Lorene,33,0,34,1
1748422929687,ANTH 10,A00,910727,Stewart; Alexander B,148,0,175,27
1748422930715,ANTH 21,A01,910730,Stone; Annika Britt,35,0,36,1
1748422930715,ANTH 21,A02,910731,Stone; Annika Britt,34,0,36,2
1748422930715,ANTH 21,A03,910732,Stone; Annika Britt,34,0,36,2
1748422930715,ANTH 21,A04,910733,Stone; Annika Britt,30,0,36,6
1748422930715,ANTH 21,A05,910734,Stone; Annika Britt,35,0,36,1
1748422930715,ANTH 21,A06,910735,Stone; Annika Britt,30,0,36,6
1748422930715,ANTH 21,A07,910736,Stone; Annika Britt,24,0,34,10
1748422930715,ANTH 21,B01,910738,Kang; Byung Chu,36,0,36,0
1748422930715,ANTH 21,B02,910740,Kang; Byung Chu,36,0,36,0
1748422930715,ANTH 21,B03,910781,Kang; Byung Chu,34,0,36,2
1748422930715,ANTH 21,B04,910782,Kang; Byung Chu,34,0,36,2
1748422930715,ANTH 21,B05,910821,Kang; Byung Chu,36,0,36,0
1748422930715,ANTH 21,B06,910826,Kang; Byung Chu,34,0,36,2
1748422930715,ANTH 21,B07,910834,Kang; Byung Chu,34,0,34,0
1748422931744,ANTH 23,A01,910896,Stewart; Alexander B,25,0,25,0
1748422931744,ANTH 23,A02,910916,Stewart; Alexander B,25,0,25,0
1748422931744,ANTH 23,A03,910932,Stewart; Alexander B,25,0,25,0
1748422931744,ANTH 23,A04,910933,Stewart; Alexander B,24,0,25,1
1748422931744,ANTH 23,A05,910938,Stewart; Alexander B,25,0,25,0
1748422931744,ANTH 23,A06,911043,Stewart; Alexander B,25,0,25,0
1748422931744,ANTH 23,A07,911141,Stewart; Alexander B,24,0,25,1
1748422932777,ANTH 87,A00,911153,Jordan; David K.,20,0,20,0
1748422932777,ANTH 87,B00,911392,Jordan; David K.,20,0,20,0
1748422932777,ANTH 87,C00,911404,Varma; Saiba,20,0,20,0
1748422933803,ANTH 101,A01,911481,Staff,27,0,30,3
1748422933803,ANTH 101,A02,911482,Staff,15,0,30,15
1748422933803,ANTH 101,A03,911483,Staff,24,0,30,6
1748422933803,ANTH 101,A04,911484,Staff,17,0,30,13
1748422934830,ANTH 105,A00,911486,Staff,69,0,80,11
1748422935856,ANTH 108,A00,911487,Sloane; Julia Kathryn,31,0,35,4
1748422936884,ANTH 196A,A00,911488,Staff,14,0,15,1
1748422937911,ANTH 200,A00,911489,Non; Amy L,12,0,15,3
1748422938939,ANTH 203,A00,911490,Gagneux; Pascal,20,0,20,0
1748422939964,ANTH 208,A00,911491,Kang; Byung Chu,8,0,12,4
1748422940994,ANTH 268,A00,911492,McKenzie; Kerry V.,10,0,10,0
1748422942020,ANTH 273,A00,911493,McKenzie; Kerry V.,10,0,10,0
1748422943047,ANTH 281A,A00,911494,Pedersen; David,10,0,10,0
1748422944074,ANTH 285,A00,911495,Algaze; Guillermo,7,0,10,3
1748422945109,ASTR 1,A01,911506,Wright; Shelley Adams,282,0,300,18
1748422946141,ASTR 18,A01,911508,Arnold; Kam S,35,0,37,2
1748422947173,ASTR 20A,A01,911510,Theissen; Christopher Alexander,48,0,56,8
1748422948202,ASTR 65,A01,911512,Trumbo; Samantha Kathleen,49,0,50,1
1748422949229,ASTR 101,A01,911514,Burgasser; Adam Jonathan,25,0,32,7
1748422950260,ASTR 104,A01,911516,Lee; Eve Jihyun,29,0,32,3
1748422951286,ASTR 120,A01,911518,Tytler; David Robert,29,0,37,8
1748422952312,ASTR 124,A01,911520,Konopacky; Quinn Morgan,33,0,37,4
1748422953342,ASTR 150,A01,911522,Hosseinzadeh; Griffin Alex,34,0,40,6
1748422954368,ASTR 200,A00,911523,Sandstrom; Karin Marie,29,0,30,1
1748422955394,ASTR 201,A00,911524,Broekgaarden; Floor Suzan,30,0,30,0
1748422956422,ASTR 213,A00,911525,Keres; Dusan,28,0,30,2
1748422957452,ASTR 250,A00,911526,Theissen; Christopher Alexander & Hosseinzadeh; Griffin Alex,27,0,30,3
1748422958478,ASTR 251,A00,911527,Theissen; Christopher Alexander & Hosseinzadeh; Griffin Alex,27,0,30,3
1748422959526,AWP 3,001,910489,Staff,12,0,12,0
1748422959526,AWP 3,002,910490,Staff,12,0,12,0
1748422959526,AWP 3,003,910491,Staff,12,0,12,0
1748422959526,AWP 3,004,910492,Staff,12,0,12,0
1748422959526,AWP 3,005,910493,Staff,12,0,12,0
1748422959526,AWP 3,006,910495,Staff,12,0,12,0
1748422959526,AWP 3,007,910498,Staff,12,0,12,0
1748422959526,AWP 3,008,910509,Staff,12,0,12,0
1748422959526,AWP 3,009,910516,Staff,12,0,12,0
1748422959526,AWP 3,010,910525,Staff,12,0,12,0
1748422959526,AWP 3,011,910531,Staff,12,0,12,0
1748422959526,AWP 3,012,910532,Staff,12,0,12,0
1748422959526,AWP 3,013,910533,Staff,12,0,12,0
1748422959526,AWP 3,014,910534,Staff,12,0,12,0
1748422959526,AWP 3,015,910535,Staff,12,0,12,0
1748422959526,AWP 3,016,910536,Staff,12,0,12,0
1748422959526,AWP 3,017,910537,Staff,12,0,12,0
1748422959526,AWP 3,018,910538,Staff,12,0,12,0
1748422959526,AWP 3,019,910539,Staff,0,0,0,0
1748422959526,AWP 3,020,910540,Staff,0,0,0,0
1748422959526,AWP 3,021,910541,Staff,12,0,12,0
1748422959526,AWP 3,022,910542,Staff,0,0,0,0
1748422959526,AWP 3,023,910543,Staff,12,0,12,0
1748422959526,AWP 3,024,910545,Staff,12,0,12,0
1748422959526,AWP 3,025,910546,Staff,12,0,12,0
1748422959526,AWP 3,026,910547,Staff,12,0,12,0
1748422959526,AWP 3,027,910548,Staff,12,0,12,0
1748422959526,AWP 3,028,910549,Staff,12,0,12,0
1748422959526,AWP 3,029,910550,Staff,0,0,0,0
1748422959526,AWP 3,030,910551,Staff,0,0,0,0
1748422959526,AWP 3,031,910552,Staff,12,0,12,0
1748422959526,AWP 3,032,910553,Staff,12,0,12,0
1748422959526,AWP 3,033,910554,Staff,12,0,12,0
1748422959526,AWP 3,034,910555,Staff,12,0,12,0
1748422959526,AWP 3,035,910557,Staff,12,0,12,0
1748422959526,AWP 3,036,910558,Staff,12,0,12,0
1748422959526,AWP 3,037,910559,Staff,12,0,12,0
1748422959526,AWP 3,038,910560,Staff,12,0,12,0
1748422959526,AWP 3,039,910561,Staff,12,0,12,0
1748422959526,AWP 3,040,910562,Staff,12,0,12,0
1748422959526,AWP 3,041,910563,Staff,12,0,12,0
1748422959526,AWP 3,042,910564,Staff,12,0,12,0
1748422959526,AWP 3,043,910565,Staff,12,0,12,0
1748422959526,AWP 3,044,910566,Staff,12,0,12,0
1748422959526,AWP 3,045,910567,Staff,12,0,12,0
1748422959526,AWP 3,046,910568,Staff,12,0,12,0
1748422959526,AWP 3,047,910569,Staff,12,0,12,0
1748422959526,AWP 3,048,910570,Staff,12,0,12,0
1748422959526,AWP 3,049,910571,Staff,12,0,12,0
1748422959526,AWP 3,050,910576,Staff,12,0,12,0
1748422959526,AWP 3,051,910629,Staff,12,0,12,0
1748422959526,AWP 3,052,910630,Staff,12,0,12,0
1748422959526,AWP 3,053,910632,Staff,12,0,12,0
1748422959526,AWP 3,054,910633,Staff,12,0,12,0
1748422959526,AWP 3,055,910635,Staff,12,0,12,0
1748422959526,AWP 3,056,910636,Staff,12,0,12,0
1748422959526,AWP 3,057,910638,Staff,12,0,12,0
1748422959526,AWP 3,058,910640,Staff,0,0,0,0
1748422959526,AWP 3,059,910641,Staff,12,0,12,0
1748422959526,AWP 3,060,910645,Staff,12,0,12,0
1748422959526,AWP 3,061,910646,Staff,12,0,12,0
1748422959526,AWP 3,062,910648,Staff,12,0,12,0
1748422959526,AWP 3,063,910649,Staff,12,0,12,0
1748422959526,AWP 3,064,910653,Staff,12,0,12,0
1748422959526,AWP 3,065,910654,Staff,12,0,12,0
1748422959526,AWP 3,066,910656,Staff,12,0,12,0
1748422959526,AWP 3,067,910657,Staff,12,0,12,0
1748422959526,AWP 3,068,910659,Staff,15,0,15,0
1748422959526,AWP 3,069,910660,Staff,0,0,0,0
1748422959526,AWP 3,070,910662,Staff,12,0,12,0
1748422959526,AWP 3,071,910665,Staff,0,0,0,0
1748422959526,AWP 3,072,910667,Staff,12,0,12,0
1748422959526,AWP 3,073,970938,Staff,12,0,12,0
1748422959526,AWP 3,074,970939,Staff,12,0,12,0
1748422959526,AWP 3,075,970940,Staff,0,0,0,0
1748422959526,AWP 3,076,970941,Staff,12,0,12,0
1748422959526,AWP 3,077,970942,Staff,12,0,12,0
1748422959526,AWP 3,078,970943,Staff,0,0,0,0
1748422959526,AWP 3,079,970944,Staff,12,0,12,0
1748422959526,AWP 3,080,970945,Staff,0,0,0,0
1748422959526,AWP 3,081,971140,Staff,0,0,0,0
1748422959526,AWP 3,082,971141,Staff,0,0,0,0
1748422959526,AWP 3,083,971142,Staff,0,0,0,0
1748422959526,AWP 3,084,971152,Staff,0,0,0,0
1748422959526,AWP 3,085,971315,Staff,0,0,0,0
1748422960556,AWP 4B,B00,910682,Staff,0,0,0,0
1748422960556,AWP 4B,C00,910701,Staff,0,0,0,1
1748422961582,BENG 1,A01,911565,Khojah; Reem I,26,0,30,4
1748422961582,BENG 1,A02,911567,Khojah; Reem I,30,0,30,0
1748422961582,BENG 1,A03,911568,Khojah; Reem I,29,0,30,1
1748422962608,BENG 2,A00,911569,Khojah; Reem I,28,0,30,2
1748422963635,BENG 98,001,969809,Sah; Robert Lie-Yuan,9999,0,9999,0
1748422964661,BENG 99,001,969810,Sah; Robert Lie-Yuan,9999,0,9999,0
1748422965694,BENG 100,A01,911579,Taylor Amos; Alyssa C,35,0,50,15
1748422966725,BENG 110,A01,911582,Mc Culloch; Andrew Douglas,5,0,30,25
1748422966725,BENG 110,A02,911584,Mc Culloch; Andrew Douglas,17,0,30,13
1748422967764,BENG 122A,A01,958030,Cauwenberghs; Gert,54,0,70,16
1748422968792,BENG 133,A01,911589,Mali; Prashant Gulab Ram,33,0,40,7
1748422969821,BENG 135,A01,911653,Staff,32,0,40,8
1748422970847,BENG 141,A01,911674,Staff,29,0,40,11
1748422971880,BENG 161A,A01,911676,Fraley; Stephanie I.,16,0,35,19
1748422971880,BENG 161A,A02,957945,Fraley; Stephanie I.,29,0,35,6
1748422972908,BENG 162,A01,911682,Mali; Prashant Gulab Ram,0,0,30,30
1748422972908,BENG 162,A02,911683,Mali; Prashant Gulab Ram,25,0,30,5
1748422973934,BENG 166A,A02,911685,Sah; Robert Lie-Yuan,11,0,35,24
1748422974966,BENG 183,A01,911688,Zhong; Sheng,35,0,120,85
1748422975998,BENG 187B,A00,911689,Taylor Amos; Alyssa C,52,0,120,68
1748422977027,BENG 188A,A01,911691,Taylor Amos; Alyssa C,131,0,170,39
1748422978054,BENG 196,A00,911692,Cabrales; Pedro,5,0,5,0
1748422979082,BENG 197,A00,911693,Cabrales; Pedro,9999,0,9999,0
1748422980109,BENG 198,001,969812,Sah; Robert Lie-Yuan,9999,0,9999,0
1748422981189,BENG 211,A00,911720,Smarr; Benjamin,2,0,30,28
1748422982231,BENG 216,A01,911722,Cauwenberghs; Gert,1,0,40,39
1748422983258,BENG 219,A00,911723,Schoeneberg; Johannes,0,0,0,0
1748422984285,BENG 221,A00,911724,Valdez-Jasso; Daniela,27,0,70,43
1748422985311,BENG 226,A01,911727,Schmid-Schoenbein; Geert W,54,0,120,66
1748422986346,BENG 230A,A00,911728,Huang; Xiaohua,59,0,120,61
1748422987377,BENG 241A,A01,911730,Cyphert; Erika Leah,0,0,50,50
1748422988404,BENG 242,A00,911731,Cai; Shengqiang,16,0,40,24
1748422989430,BENG 247A,A00,911732,Shi; Lingyan,31,0,55,24
1748422990459,BENG 247B,A00,911733,Aran; Kiana,0,0,30,30
1748422991490,BENG 254,A01,911735,Hasty; Jeff M,0,0,20,20
1748422992517,BENG 260,A01,911737,Silva; Gabriel,15,0,45,30
1748422993546,BENG 280A,A00,911738,Liu; Thomas Tao-Ming & McVeigh; Elliot R.,34,0,70,36
1748422994576,BENG 281,A00,911739,Zhong; Sheng,5,0,90,85
1748422995603,BENG 282,A00,911740,Cabrales; Pedro,19,0,100,81
1748422996633,BENG 292,A01,911742,Ross; Camille,20,0,20,0
1748422997663,BENG 294A,A00,911743,King; Kevin R,25,0,50,25
1748422998689,BENG 295,A00,911744,Watson; John Thomas,9999,0,9999,0
1748422999721,BGGN 202,A00,943331,Kadonaga; James T,52,0,60,8
1748423000748,BGGN 204,A00,943332,Shurin; Jonathan,11,0,20,9
1748423001775,BGGN 206A,A00,943343,Bennett; Eric J,50,0,50,0
1748423002803,BGGN 208,A00,943344,Meyer; Justin Raymond & Bennett; Eric J,50,0,50,0
1748423003833,BGGN 213,A00,943349,Grant; Barry J,48,0,48,0
1748423004859,BGGN 214,A00,943351,Suel; Gurol Mehmet,23,0,50,27
1748423005889,BGGN 220,A00,943352,Dickinson; Alexandra Jazz & Pruneda-Paz; Jose L.,24,0,50,26
1748423006919,BGGN 227,A00,943372,Huffaker; Alisa,44,0,50,6
1748423007948,BGGN 249A,A01,969612,Bloodgood; Brenda Laurie,0,0,0,0
1748423007948,BGGN 249A,A02,969639,Bloodgood; Brenda Laurie,0,0,0,0
1748423008975,BGGN 260,A01,946423,Silva; Gabriel,15,0,15,0
1748423010109,BGGN 271,001,967097,Akbari; Omar Sultan,9999,0,9999,0
1748423010109,BGGN 271,002,967098,Allen; Nicola J,9999,0,9999,0
1748423010109,BGGN 271,003,967099,Alperin; Mariann,9999,0,9999,0
1748423010109,BGGN 271,004,967238,Antal; Corina Elena,9998,0,9999,1
1748423010109,BGGN 271,005,967365,Banghart; Matthew Ryan,9999,0,9999,0
1748423010109,BGGN 271,006,967368,Bier; Ethan,9999,0,9999,0
1748423010109,BGGN 271,007,967371,Boss; Gerard R.,9999,0,9999,0
1748423010109,BGGN 271,008,967375,Bouvet; Michael,9999,0,9999,0
1748423010109,BGGN 271,009,967376,Breen; Ellen C.,9999,0,9999,0
1748423010109,BGGN 271,010,967382,Bui; Jack D,9999,0,9999,0
1748423010109,BGGN 271,011,967391,Burnett; Lindsey,9998,0,9999,1
1748423010109,BGGN 271,012,967407,Caffrey; Conor,9999,0,9999,0
1748423010109,BGGN 271,013,967429,Castle; Michael James,9999,0,9999,0
1748423010109,BGGN 271,014,967431,Chang; John Tzu-yu,9999,0,9999,0
1748423010109,BGGN 271,015,967448,Chen; Xu,9999,0,9999,0
1748423010109,BGGN 271,016,967449,Cheng; Christine Shiang-Ling,9999,0,9999,0
1748423010109,BGGN 271,017,967464,Cheresh; David A.,9999,0,9999,0
1748423010109,BGGN 271,018,967496,Cherqui; Stephanie,9999,0,9999,0
1748423010109,BGGN 271,019,967500,Chu; Hiutung,9999,0,9999,0
1748423010109,BGGN 271,020,967559,Church; Kellie Breen,9999,0,9999,0
1748423010109,BGGN 271,021,967560,Cleland; Elsa Eleanor,9999,0,9999,0
1748423010109,BGGN 271,022,967561,Cohen; Shiran,9999,0,9999,0
1748423010109,BGGN 271,023,967562,Coufal; Nicole Gabriele,9999,0,9999,0
1748423010109,BGGN 271,024,967563,Croker; Ben Adam,9999,0,9999,0
1748423010109,BGGN 271,025,967564,Crotty Alexander; Laura E,9999,0,9999,0
1748423010109,BGGN 271,026,967565,Daugherty; Matthew Dorton,9998,0,9999,1
1748423010109,BGGN 271,027,967566,De Silva; Shermin,9999,0,9999,0
1748423010109,BGGN 271,028,967567,Dhar; Debanjan,9999,0,9999,0
1748423010109,BGGN 271,029,967568,Dixon; Jesse,9999,0,9999,0
1748423010109,BGGN 271,030,967569,Doherty; Taylor Alan,9998,0,9999,1
1748423010109,BGGN 271,031,967570,Dore; Kim Bohemie,9999,0,9999,0
1748423010109,BGGN 271,032,967571,Dorrestein; Pieter,9999,0,9999,0
1748423010109,BGGN 271,033,967572,Dulawa; Stephanie Carole,9999,0,9999,0
1748423010109,BGGN 271,034,967573,Fang; Xi,9999,0,9999,0
1748423010109,BGGN 271,035,967575,Farley; Emma Kristen,9998,0,9999,1
1748423010109,BGGN 271,036,967576,Ferguson; Cole John,9999,0,9999,0
1748423010109,BGGN 271,037,967578,Fisch; Kathleen Marie,9999,0,9999,0
1748423010109,BGGN 271,038,967579,George; Olivier,9999,0,9999,0
1748423010109,BGGN 271,039,967580,Ghosh; Pradipta,9998,0,9999,1
1748423010109,BGGN 271,040,967581,Glasgow; Stacey Marie,9999,0,9999,0
1748423010109,BGGN 271,041,967582,Golden; James W,9999,0,9999,0
1748423010109,BGGN 271,042,967583,Gonzalez Gamboa; Ivonne,9999,0,9999,0
1748423010109,BGGN 271,043,967584,Goren; Alon M,9999,0,9999,0
1748423010109,BGGN 271,044,967650,Guatelli; John C,9999,0,9999,0
1748423010109,BGGN 271,045,967651,Guma; Monica,9998,0,9999,1
1748423010109,BGGN 271,046,967652,Gustafsson; Asa Birgitta,9999,0,9999,0
1748423010109,BGGN 271,047,967655,Hamdoun; Amr,9999,0,9999,0
1748423010109,BGGN 271,048,967657,Hao; Nan,9999,0,9999,0
1748423010109,BGGN 271,049,967658,Hasty; Jeff M,9999,0,9999,0
1748423010109,BGGN 271,050,967660,Jiang; Qingfei,9998,0,9999,1
1748423010109,BGGN 271,051,967661,Jin; Chunyu,9999,0,9999,0
1748423010109,BGGN 271,052,967662,Jin; Yishi,9999,0,9999,0
1748423010109,BGGN 271,053,967663,Joshi; Shweta,9998,0,9999,1
1748423010109,BGGN 271,054,967664,Ju; Won-Kyu,9998,0,9999,1
1748423010109,BGGN 271,055,967665,Jun; Suckjoon,9999,0,9999,0
1748423010109,BGGN 271,056,967666,Kaech; Susan Michelle,9999,0,9999,0
1748423010109,BGGN 271,057,967668,Kauffman; Alexander,9998,0,9999,1
1748423010109,BGGN 271,058,967670,Kiger; Amy,9999,0,9999,0
1748423010109,BGGN 271,059,967720,Koloski; Miranda Jane,9998,0,9999,1
1748423010109,BGGN 271,060,967864,Komiyama; Takaki,9999,0,9999,0
1748423010109,BGGN 271,061,967865,Kronenberg; Mitchell E.,9998,0,9999,1
1748423010109,BGGN 271,062,967866,Kufareva; Irina,9999,0,9999,0
1748423010109,BGGN 271,063,967867,Lee; Yun Sok,9999,0,9999,0
1748423010109,BGGN 271,064,967869,Leutgeb; Stefan,9999,0,9999,0
1748423010109,BGGN 271,065,967870,Lewis; Warren G.,9999,0,9999,0
1748423010109,BGGN 271,066,967871,Li; Willis Xiaowei,9998,0,9999,1
1748423010109,BGGN 271,067,967872,Lim; Byungkook,9999,0,9999,0
1748423010109,BGGN 271,068,967873,Lo; Stanley M.,9998,0,9999,1
1748423010109,BGGN 271,069,967874,Lopez Ramirez; Miguel Alej,9999,0,9999,0
1748423010109,BGGN 271,070,967875,Lu; Li-Fan,9998,0,9999,1
1748423010109,BGGN 271,071,967877,Lu; Pengzhe,9999,0,9999,0
1748423010109,BGGN 271,072,967878,Lyons; Deirdre Colleen,9999,0,9999,0
1748423010109,BGGN 271,073,967879,Lyumkis; Dmitry Evgenievich,9999,0,9999,0
1748423010109,BGGN 271,074,967880,Mandyam; Chitra,9999,0,9999,0
1748423010109,BGGN 271,075,967881,McConville; Patrick James,9999,0,9999,0
1748423010109,BGGN 271,076,967882,Mertens; Jerome Stefan,9999,0,9999,0
1748423010109,BGGN 271,077,967884,Morris; Gerald P,9999,0,9999,0
1748423010109,BGGN 271,078,967885,Muroyama; Andrew David,9999,0,9999,0
1748423010109,BGGN 271,079,967886,Murre; Cornelis,9999,0,9999,0
1748423010109,BGGN 271,080,967887,Neal; Sonya E,9999,0,9999,0
1748423010109,BGGN 271,081,967889,Newton; Alexandra C.,9999,0,9999,0
1748423010109,BGGN 271,082,967890,Nieh; James Charles,9999,0,9999,0
1748423010109,BGGN 271,083,967893,Niwa; Maho,9999,0,9999,0
1748423010109,BGGN 271,084,967894,Pantham; Priyadarshini,9999,0,9999,0
1748423010109,BGGN 271,085,967895,Parast; Mana,9999,0,9999,0
1748423010109,BGGN 271,086,967899,Perry; Michael William,9999,0,9999,0
1748423010109,BGGN 271,087,967900,Pillus; Lorraine,9998,0,9999,1
1748423010109,BGGN 271,088,967902,Pogliano; Joseph,9999,0,9999,0
1748423010109,BGGN 271,089,967903,Pruneda-Paz; Jose L.,9999,0,9999,0
1748423010109,BGGN 271,090,967904,Raffatellu; Manuela,9999,0,9999,0
1748423010109,BGGN 271,091,967906,Rana; Tariq,9999,0,9999,0
1748423010109,BGGN 271,092,967907,Rao; Anjana,9998,0,9999,1
1748423010109,BGGN 271,093,967908,Raz; Eyal,9998,0,9999,1
1748423010109,BGGN 271,094,967909,Gaulton; Kyle J,9999,0,9999,0
1748423010109,BGGN 271,095,967910,Rifkin; Scott,9998,0,9999,1
1748423010109,BGGN 271,096,967912,Risbrough; Victoria Blythe,9999,0,9999,0
1748423010109,BGGN 271,097,967916,Rose; Noah Hartmann,9999,0,9999,0
1748423010109,BGGN 271,098,967917,Rouse; Gregory W.,9999,0,9999,0
1748423010109,BGGN 271,099,967918,Saier; Milton H.,9999,0,9999,0
1748423010109,BGGN 271,100,967919,Saltiel; Alan,9998,0,9999,1
1748423010109,BGGN 271,101,967920,Sanchez-Lopez; Elsa,9999,0,9999,0
1748423010109,BGGN 271,102,967921,Schenk; Simon,9999,0,9999,0
1748423010109,BGGN 271,103,967922,Schroeder; Julian I,9998,0,9999,1
1748423010109,BGGN 271,104,967923,Sebat; Lilia Mikhailovna,9999,0,9999,0
1748423010109,BGGN 271,105,967925,Sen; George L,9999,0,9999,0
1748423010109,BGGN 271,106,967926,Shaner; Nathan C.,9999,0,9999,0
1748423010109,BGGN 271,107,967927,Shao; Jianhua,9999,0,9999,0
1748423010109,BGGN 271,108,967928,Shurin; Jonathan,9998,0,9999,1
1748423010109,BGGN 271,109,967929,Sicklick; Jason Keith,9999,0,9999,0
1748423010109,BGGN 271,110,967931,Signer; Robert,9999,0,9999,0
1748423010109,BGGN 271,111,967932,Sigurdson; Christina,9999,0,9999,0
1748423010109,BGGN 271,112,967934,Simonson; Tatum Sasha Summ,9999,0,9999,0
1748423010109,BGGN 271,113,967935,Spitzer; Nicholas,9999,0,9999,0
1748423010109,BGGN 271,114,967936,Steinmetz; Nicole F,9999,0,9999,0
1748423010109,BGGN 271,115,967938,Su; Chih-Ying,9999,0,9999,0
1748423010109,BGGN 271,116,967939,Telese; Francesca,9999,0,9999,0
1748423010109,BGGN 271,117,967942,Towers; Christina Garlingt,9999,0,9999,0
1748423010109,BGGN 271,118,967943,Tye; Kay M,9999,0,9999,0
1748423010109,BGGN 271,119,967945,Wahlin; Karl Jonas,9997,0,9999,2
1748423010109,BGGN 271,120,967947,Wang; Shizhen,9999,0,9999,0
1748423010109,BGGN 271,121,967949,Wang; Jean Yin Jen,9999,0,9999,0
1748423010109,BGGN 271,122,967952,Webster; Nicholas J G,9999,0,9999,0
1748423010109,BGGN 271,123,967953,Weiskopf; Daniela,9998,0,9999,1
1748423010109,BGGN 271,124,967954,Welsbie; Derek,9999,0,9999,0
1748423010109,BGGN 271,125,967956,Wildonger; Jill Cathleen,9999,0,9999,0
1748423010109,BGGN 271,126,967957,Yelon; Deborah,9999,0,9999,0
1748423010109,BGGN 271,127,967958,Yeo; Eugene Wei-Ming,9998,0,9999,1
1748423010109,BGGN 271,128,967959,Ying; Wei,9998,0,9999,1
1748423010109,BGGN 271,129,967960,Young; Jared W.,9999,0,9999,0
1748423010109,BGGN 271,130,967961,Zage; Peter,9999,0,9999,0
1748423010109,BGGN 271,131,967962,Zengler; Karsten B,9999,0,9999,0
1748423010109,BGGN 271,132,967963,Zhang; Jin,9999,0,9999,0
1748423010109,BGGN 271,133,967964,Zhao; Yunde,9999,0,9999,0
1748423010109,BGGN 271,134,967965,Zheng; Ye,9998,0,9999,1
1748423010109,BGGN 271,135,967966,Zhou; Huilin,9998,0,9999,1
1748423010109,BGGN 271,136,967970,Zou; Yimin,9998,0,9999,1
1748423011138,BGGN 272,A00,943373,Lo; Stanley M.,14,0,15,1
1748423012165,BGGN 275,A00,943374,Pogliano; Joseph,0,0,0,0
1748423013192,BGGN 276,A00,943378,Pogliano; Joseph,0,0,0,0
1748423014223,BGJC 204,A00,943407,Lu; Li-Fan & Chang; John Tzu-yu,9998,0,9999,1
1748423015249,BGJC 215,A00,943417,Tour; Ella,9,0,10,1
1748423016431,BGRD 200,001,965406,Akbari; Omar Sultan,9999,0,9999,0
1748423016431,BGRD 200,002,965407,Allen; Eric,9999,0,9999,0
1748423016431,BGRD 200,003,965408,Allen; Nicola J,9998,0,9999,1
1748423016431,BGRD 200,004,965427,Alperin; Mariann,9999,0,9999,0
1748423016431,BGRD 200,005,965428,Amaro; Rommie E,9998,0,9999,1
1748423016431,BGRD 200,006,965429,Antal; Corina Elena,9998,0,9999,1
1748423016431,BGRD 200,007,965731,Asahina; Kenta,9999,0,9999,0
1748423016431,BGRD 200,008,965732,Augustine; Vineet,9999,0,9999,0
1748423016431,BGRD 200,009,965733,Ayres; Janelle Samantha,9998,0,9999,1
1748423016431,BGRD 200,010,965734,Banghart; Matthew Ryan,9999,0,9999,0
1748423016431,BGRD 200,011,965735,Barton; Andrew David,9999,0,9999,0
1748423016431,BGRD 200,012,965736,Bayless; Daniel Wilson,9999,0,9999,0
1748423016431,BGRD 200,013,965737,Benna; Marcus K,9999,0,9999,0
1748423016431,BGRD 200,014,965738,Bennett; Eric J,9999,0,9999,0
1748423016431,BGRD 200,015,965739,Bier; Ethan,9999,0,9999,0
1748423016431,BGRD 200,016,965740,Bloodgood; Brenda Laurie,9999,0,9999,0
1748423016431,BGRD 200,017,965741,Boss; Gerard R.,9999,0,9999,0
1748423016431,BGRD 200,018,966029,Bouvet; Michael,9999,0,9999,0
1748423016431,BGRD 200,019,966054,Breen; Ellen C.,9999,0,9999,0
1748423016431,BGRD 200,020,966072,Bui; Jack D,9999,0,9999,0
1748423016431,BGRD 200,021,966073,Burnett; Lindsey,9998,0,9999,1
1748423016431,BGRD 200,022,966080,Caffrey; Conor,9999,0,9999,0
1748423016431,BGRD 200,023,966082,Callaway; Edward M,9999,0,9999,0
1748423016431,BGRD 200,024,966087,Castle; Michael James,9999,0,9999,0
1748423016431,BGRD 200,025,966089,Chaim; Isaac,9999,0,9999,0
1748423016431,BGRD 200,026,966092,Chang; John Tzu-yu,9999,0,9999,0
1748423016431,BGRD 200,027,966094,Chen; Xu,9999,0,9999,0
1748423016431,BGRD 200,028,966095,Cheng; Christine Shiang-Ling,9999,0,9999,0
1748423016431,BGRD 200,029,966099,Cheresh; David A.,9999,0,9999,0
1748423016431,BGRD 200,030,966103,Cherqui; Stephanie,9999,0,9999,0
1748423016431,BGRD 200,031,966104,Chu; Hiutung,9999,0,9999,0
1748423016431,BGRD 200,032,966107,Church; Kellie Breen,9999,0,9999,0
1748423016431,BGRD 200,033,966108,Cleland; Elsa Eleanor,9997,0,9999,2
1748423016431,BGRD 200,034,966111,Cohen; Shiran,9999,0,9999,0
1748423016431,BGRD 200,035,966112,Cooper; Kimberly Lynn,9999,0,9999,0
1748423016431,BGRD 200,036,966114,Coufal; Nicole Gabriele,9999,0,9999,0
1748423016431,BGRD 200,037,966115,Croker; Ben Adam,9999,0,9999,0
1748423016431,BGRD 200,038,966116,Crotty Alexander; Laura E,9999,0,9999,0
1748423016431,BGRD 200,039,966117,Daugherty; Matthew Dorton,9997,0,9999,2
1748423016431,BGRD 200,040,966118,De Silva; Shermin,9998,0,9999,1
1748423016431,BGRD 200,041,966119,Desai; Arshad,9999,0,9999,0
1748423016431,BGRD 200,042,966120,Dhar; Debanjan,9999,0,9999,0
1748423016431,BGRD 200,043,966121,Dickinson; Alexandra Jazz,9999,0,9999,0
1748423016431,BGRD 200,044,966123,Dixon; Jesse,9999,0,9999,0
1748423016431,BGRD 200,045,966125,Doherty; Taylor Alan,9998,0,9999,1
1748423016431,BGRD 200,046,966128,Dore; Kim Bohemie,9999,0,9999,0
1748423016431,BGRD 200,047,966129,Dorrestein; Pieter,9999,0,9999,0
1748423016431,BGRD 200,048,966130,Dulawa; Stephanie Carole,9999,0,9999,0
1748423016431,BGRD 200,049,966131,Ecker; Joseph R,9999,0,9999,0
1748423016431,BGRD 200,050,966174,Engle; Dannielle D,9998,0,9999,1
1748423016431,BGRD 200,051,966179,Ernst; Andreas,9999,0,9999,0
1748423016431,BGRD 200,052,966182,Esko; Jeffrey D.,9999,0,9999,0
1748423016431,BGRD 200,053,966183,Fang; Xi,9999,0,9999,0
1748423016431,BGRD 200,054,966184,Farley; Emma Kristen,9998,0,9999,1
1748423016431,BGRD 200,055,966187,Ferguson; Cole John,9999,0,9999,0
1748423016431,BGRD 200,056,966190,Fisch; Kathleen Marie,9999,0,9999,0
1748423016431,BGRD 200,057,966193,Gage; Fred H,9999,0,9999,0
1748423016431,BGRD 200,058,966194,George; Monique Leana,9998,0,9999,1
1748423016431,BGRD 200,059,966196,George; Olivier,9999,0,9999,0
1748423016431,BGRD 200,060,966202,Ghosh; Pradipta,9998,0,9999,1
1748423016431,BGRD 200,061,966203,Glasgow; Stacey Marie,9999,0,9999,0
1748423016431,BGRD 200,062,966204,Glass; Christopher,9999,0,9999,0
1748423016431,BGRD 200,063,966226,Golden; James W,9999,0,9999,0
1748423016431,BGRD 200,064,966231,Goldrath; Ananda,9999,0,9999,0
1748423016431,BGRD 200,065,966232,Gonzalez Gamboa; Ivonne,9999,0,9999,0
1748423016431,BGRD 200,066,966233,Goren; Alon M,9999,0,9999,0
1748423016431,BGRD 200,067,966245,Guatelli; John C,9999,0,9999,0
1748423016431,BGRD 200,068,966247,Guma; Monica,9998,0,9999,1
1748423016431,BGRD 200,069,966253,Gustafsson; Asa Birgitta,9999,0,9999,0
1748423016431,BGRD 200,070,966255,Gutkind; Jorge Silvio,9998,0,9999,1
1748423016431,BGRD 200,071,966260,Hamdoun; Amr,9999,0,9999,0
1748423016431,BGRD 200,072,966262,Hampton; Randolph Y.,9998,0,9999,1
1748423016431,BGRD 200,073,966263,Hao; Nan,9999,0,9999,0
1748423016431,BGRD 200,074,966265,Hargreaves; Diana Clare,9997,0,9999,2
1748423016431,BGRD 200,075,966268,Hasty; Jeff M,9999,0,9999,0
1748423016431,BGRD 200,076,966270,Hollern; Daniel Patrick,9999,0,9999,0
1748423016431,BGRD 200,077,966271,Holway; David A.,9998,0,9999,1
1748423016431,BGRD 200,078,966272,Huffaker; Alisa,9999,0,9999,0
1748423016431,BGRD 200,079,966273,Hui; Enfu,9999,0,9999,0
1748423016431,BGRD 200,080,966275,Hwa; Terence T.,9999,0,9999,0
1748423016431,BGRD 200,081,966276,Jackrel; Sara,9998,0,9999,1
1748423016431,BGRD 200,082,966277,Jiang; Qingfei,9998,0,9999,1
1748423016431,BGRD 200,083,966281,Jin; Chunyu,9999,0,9999,0
1748423016431,BGRD 200,084,966283,Jin; Yishi,9999,0,9999,0
1748423016431,BGRD 200,085,966287,Joshi; Shweta,9999,0,9999,0
1748423016431,BGRD 200,086,966290,Ju; Won-Kyu,9998,0,9999,1
1748423016431,BGRD 200,087,966291,Jun; Suckjoon,9999,0,9999,0
1748423016431,BGRD 200,088,966292,Kadonaga; James T,9999,0,9999,0
1748423016431,BGRD 200,089,966293,Kaech; Susan Michelle,9999,0,9999,0
1748423016431,BGRD 200,090,966295,Kauffman; Alexander,9998,0,9999,1
1748423016431,BGRD 200,091,966301,Kendrick; Agnieszka Anasta,9999,0,9999,0
1748423016431,BGRD 200,092,966302,Kiger; Amy,9999,0,9999,0
1748423016431,BGRD 200,093,966314,Knight; Robin,9999,0,9999,0
1748423016431,BGRD 200,094,966315,Koloski; Miranda Jane,9998,0,9999,1
1748423016431,BGRD 200,095,966339,Komiyama; Takaki,9998,0,9999,1
1748423016431,BGRD 200,096,966351,Kosuri; Pallav,9999,0,9999,0
1748423016431,BGRD 200,097,966361,Kronenberg; Mitchell E.,9999,0,9999,0
1748423016431,BGRD 200,098,966374,Kryazhimskiy; Sergey A,9999,0,9999,0
1748423016431,BGRD 200,099,966377,Kufareva; Irina,9999,0,9999,0
1748423016431,BGRD 200,100,966380,Lee; Christopher Tingkuang,9999,0,9999,0
1748423016431,BGRD 200,101,966383,Lee; Kuo Fen,9999,0,9999,0
1748423016431,BGRD 200,102,966387,Lee; Yun Sok,9999,0,9999,0
1748423016431,BGRD 200,103,966397,Leutgeb; Jill K.,9999,0,9999,0
1748423016431,BGRD 200,104,966446,Leutgeb; Stefan,9998,0,9999,1
1748423016431,BGRD 200,105,966478,Lewis; Warren G.,9999,0,9999,0
1748423016431,BGRD 200,106,966490,Li; Willis Xiaowei,9998,0,9999,1
1748423016431,BGRD 200,107,966491,Lim; Byungkook,9998,0,9999,1
1748423016431,BGRD 200,108,966494,Lo; Stanley M.,9998,0,9999,1
1748423016431,BGRD 200,109,966499,Looger; Loren Lee,9998,0,9999,1
1748423016431,BGRD 200,110,966500,Lopez Ramirez; Miguel Alej,9999,0,9999,0
1748423016431,BGRD 200,111,966510,Lovett-Barron; Matthew Rod,9998,0,9999,1
1748423016431,BGRD 200,112,966513,Lu; Li-Fan,9998,0,9999,1
1748423016431,BGRD 200,113,966515,Lu; Pengzhe,9999,0,9999,0
1748423016431,BGRD 200,114,966522,Lykke-Andersen; Jens,9999,0,9999,0
1748423016431,BGRD 200,115,966526,Lyons; Deirdre Colleen,9999,0,9999,0
1748423016431,BGRD 200,116,966528,Lyumkis; Dmitry Evgenievich,9999,0,9999,0
1748423016431,BGRD 200,117,966531,Mandyam; Chitra,9999,0,9999,0
1748423016431,BGRD 200,118,966537,Manor; Uri,9999,0,9999,0
1748423016431,BGRD 200,119,966538,Mayfield; Stephen P.,9998,0,9999,1
1748423016431,BGRD 200,120,966539,McConville; Patrick James,9999,0,9999,0
1748423016431,BGRD 200,121,966546,Mertens; Jerome Stefan,9999,0,9999,0
1748423016431,BGRD 200,122,966586,Meyer; Justin Raymond,9999,0,9999,0
1748423016431,BGRD 200,123,966587,Morris; Gerald P,9999,0,9999,0
1748423016431,BGRD 200,124,966588,Mueller; Lena,9998,0,9999,1
1748423016431,BGRD 200,125,966590,Muroyama; Andrew David,9999,0,9999,0
1748423016431,BGRD 200,126,966591,Murre; Cornelis,9999,0,9999,0
1748423016431,BGRD 200,127,966593,Neal; Sonya E,9998,0,9999,1
1748423016431,BGRD 200,128,966594,Newton; Alexandra C.,9999,0,9999,0
1748423016431,BGRD 200,129,966596,Nieh; James Charles,9999,0,9999,0
1748423016431,BGRD 200,130,966597,Niwa; Maho,9999,0,9999,0
1748423016431,BGRD 200,131,966605,Nizet; Victor F.,9999,0,9999,0
1748423016431,BGRD 200,132,966606,Oegema; Karen,9999,0,9999,0
1748423016431,BGRD 200,133,966608,Panda; Satchidananda,9998,0,9999,1
1748423016431,BGRD 200,134,966610,Pantham; Priyadarshini,9999,0,9999,0
1748423016431,BGRD 200,135,966612,Parast; Mana,9999,0,9999,0
1748423016431,BGRD 200,136,966613,Pasquinelli; Amy,9999,0,9999,0
1748423016431,BGRD 200,137,966615,Pekkurnaz Banghart; Gulcin,9999,0,9999,0
1748423016431,BGRD 200,138,966639,Perry; Michael William,9998,0,9999,1
1748423016431,BGRD 200,139,966640,Pillus; Lorraine,9998,0,9999,1
1748423016431,BGRD 200,140,966654,Pogliano; Joseph,9999,0,9999,0
1748423016431,BGRD 200,141,966700,Pogliano; Kit J.,9999,0,9999,0
1748423016431,BGRD 200,142,966701,Pruneda-Paz; Jose L.,9999,0,9999,0
1748423016431,BGRD 200,143,966744,Raffatellu; Manuela,9999,0,9999,0
1748423016431,BGRD 200,144,966745,Ramanan; Deepshika,9998,0,9999,1
1748423016431,BGRD 200,145,966746,Rana; Tariq,9999,0,9999,0
1748423016431,BGRD 200,146,966747,Rao; Anjana,9999,0,9999,0
1748423016431,BGRD 200,147,966811,Raz; Eyal,9998,0,9999,1
1748423016431,BGRD 200,149,966817,Gaulton; Kyle J,9999,0,9999,0
1748423016431,BGRD 200,150,966824,Rennison; Diana,9999,0,9999,0
1748423016431,BGRD 200,151,966828,Reyes De Barboza; Nabora S,9999,0,9999,0
1748423016431,BGRD 200,152,966837,Rifkin; Scott,9998,0,9999,1
1748423016431,BGRD 200,153,966839,Risbrough; Victoria Blythe,9999,0,9999,0
1748423016431,BGRD 200,154,966846,Rivera; Fabian Chavez,9999,0,9999,0
1748423016431,BGRD 200,155,966851,Rohner; Patrick Thomas,9999,0,9999,0
1748423016431,BGRD 200,156,966859,Rose; Noah Hartmann,9999,0,9999,0
1748423016431,BGRD 200,157,966874,Rosenfeld; Michael G,9999,0,9999,0
1748423016431,BGRD 200,158,966882,Rouse; Gregory W.,9999,0,9999,0
1748423016431,BGRD 200,159,966885,Saier; Milton H.,9999,0,9999,0
1748423016431,BGRD 200,160,966923,Saltiel; Alan,9998,0,9999,1
1748423016431,BGRD 200,161,966926,Sanchez-Lopez; Elsa,9999,0,9999,0
1748423016431,BGRD 200,162,966927,Saphire; Erica Ollmann,9999,0,9999,0
1748423016431,BGRD 200,163,966931,Schenk; Simon,9999,0,9999,0
1748423016431,BGRD 200,164,966938,Schroeder; Julian I,9999,0,9999,0
1748423016431,BGRD 200,165,966966,Sebat; Lilia Mikhailovna,9999,0,9999,0
1748423016431,BGRD 200,166,966978,Sen; George L,9999,0,9999,0
1748423016431,BGRD 200,167,966981,Shah; Sameer B,9999,0,9999,0
1748423016431,BGRD 200,168,966982,Shaner; Nathan C.,9999,0,9999,0
1748423016431,BGRD 200,169,966983,Shao; Jianhua,9999,0,9999,0
1748423016431,BGRD 200,170,966984,Sharpee; Tatyana,9999,0,9999,0
1748423016431,BGRD 200,171,966985,Shaw; Reuben,9999,0,9999,0
1748423016431,BGRD 200,172,966986,Shurin; Jonathan,9997,0,9999,2
1748423016431,BGRD 200,173,966987,Sicklick; Jason Keith,9999,0,9999,0
1748423016431,BGRD 200,174,966988,Signer; Robert,9999,0,9999,0
1748423016431,BGRD 200,175,966989,Sigurdson; Christina,9999,0,9999,0
1748423016431,BGRD 200,176,966991,Simonson; Tatum Sasha Summ,9999,0,9999,0
1748423016431,BGRD 200,177,966992,Soncin; Francesca,9999,0,9999,0
1748423016431,BGRD 200,178,966993,Spitzer; Nicholas,9999,0,9999,0
1748423016431,BGRD 200,179,966994,Steinmetz; Nicole F,9999,0,9999,0
1748423016431,BGRD 200,180,966995,Su; Chih-Ying,9999,0,9999,0
1748423016431,BGRD 200,181,966996,Suel; Gurol Mehmet,9998,0,9999,1
1748423016431,BGRD 200,182,966997,Sun; Xin,9998,0,9999,1
1748423016431,BGRD 200,183,966998,Telese; Francesca,9998,0,9999,1
1748423016431,BGRD 200,184,966999,Towers; Christina Garlingt,9999,0,9999,0
1748423016431,BGRD 200,185,967000,Traver; David,9999,0,9999,0
1748423016431,BGRD 200,186,967001,Troemel; Emily Ruth,9998,0,9999,1
1748423016431,BGRD 200,187,967002,Tye; Kay M,9999,0,9999,0
1748423016431,BGRD 200,188,967003,Vijayanand; Pandurangan,9999,0,9999,0
1748423016431,BGRD 200,189,967004,Villa Rodriguez; Elizabeth,9999,0,9999,0
1748423016431,BGRD 200,190,967005,Wahlin; Karl Jonas,9997,0,9999,2
1748423016431,BGRD 200,191,967009,Wang; Shizhen,9999,0,9999,0
1748423016431,BGRD 200,192,967010,Wang; Jean Yin Jen,9999,0,9999,0
1748423016431,BGRD 200,193,967011,Webster; Nicholas J G,9999,0,9999,0
1748423016431,BGRD 200,194,967016,Weiskopf; Daniela,9998,0,9999,1
1748423016431,BGRD 200,195,967020,Welsbie; Derek,9999,0,9999,0
1748423016431,BGRD 200,196,967022,Wildonger; Jill Cathleen,9998,0,9999,1
1748423016431,BGRD 200,197,967027,Winzeler; Elizabeth A,9998,0,9999,1
1748423016431,BGRD 200,198,967029,Wodarz; Dominik Franz Xave,9999,0,9999,0
1748423016431,BGRD 200,199,967033,Yelon; Deborah,9998,0,9999,1
1748423016431,BGRD 200,200,967034,Yeo; Eugene Wei-Ming,9998,0,9999,1
1748423016431,BGRD 200,201,967040,Ying; Wei,9998,0,9999,1
1748423016431,BGRD 200,202,967052,Young; Jared W.,9999,0,9999,0
1748423016431,BGRD 200,203,967057,Zage; Peter,9999,0,9999,0
1748423016431,BGRD 200,204,967070,Zengler; Karsten B,9998,0,9999,1
1748423016431,BGRD 200,206,967081,Zhang; Jin,9999,0,9999,0
1748423016431,BGRD 200,207,967083,Zhao; Yunde,9999,0,9999,0
1748423016431,BGRD 200,208,967086,Zheng; Binhai,9999,0,9999,0
1748423016431,BGRD 200,209,967091,Zheng; Ye,9999,0,9999,0
1748423016431,BGRD 200,210,967093,Zhou; Huilin,9999,0,9999,0
1748423016431,BGRD 200,211,967095,Zou; Yimin,9998,0,9999,1
1748423016431,BGRD 200,212,967096,Zuniga; Elina I,9999,0,9999,0
1748423016431,BGRD 200,213,967978,Biering; Scott,9999,0,9999,0
1748423017462,BGSE 200,A00,943418,Tour; Ella & Petrie; Katherine Lynn,9999,0,9999,0
1748423018496,BGSE 205,A00,943419,Muroyama; Andrew David,46,0,50,4
1748423018496,BGSE 205,C00,943420,Russell; Alistair B,44,0,50,6
1748423018496,BGSE 205,D00,943421,Villa Rodriguez; Elizabeth,41,0,50,9
1748423018496,BGSE 205,E00,960271,Lim; Byungkook,45,0,50,5
1748423019524,BIBC 100,A01,959758,Flagg; Matthew Paul,0,0,38,38
1748423019524,BIBC 100,A02,959759,Flagg; Matthew Paul,0,0,38,38
1748423019524,BIBC 100,A03,959760,Flagg; Matthew Paul,0,0,38,38
1748423019524,BIBC 100,A04,959761,Flagg; Matthew Paul,0,0,36,36
1748423020562,BIBC 102,A01,959209,Pekkurnaz Banghart; Gulcin,0,0,34,34
1748423020562,BIBC 102,A02,959258,Pekkurnaz Banghart; Gulcin,0,0,34,34
1748423020562,BIBC 102,A03,959300,Pekkurnaz Banghart; Gulcin,0,0,35,35
1748423020562,BIBC 102,A04,959302,Pekkurnaz Banghart; Gulcin,0,0,34,34
1748423020562,BIBC 102,B01,959307,Pekkurnaz Banghart; Gulcin,0,0,34,34
1748423020562,BIBC 102,B02,959309,Pekkurnaz Banghart; Gulcin,0,0,34,34
1748423020562,BIBC 102,B03,959310,Pekkurnaz Banghart; Gulcin,0,0,33,33
1748423020562,BIBC 102,B04,959311,Pekkurnaz Banghart; Gulcin,0,0,34,34
1748423021595,BIBC 103,A01,942080,Grossman; Emily N,0,0,24,24
1748423021595,BIBC 103,A02,942081,Grossman; Emily N,0,0,24,24
1748423021595,BIBC 103,B01,942083,Grossman; Emily N,0,0,24,24
1748423021595,BIBC 103,B02,942129,Grossman; Emily N,0,0,24,24
1748423021595,BIBC 103,C01,942131,Burg; Michael,0,0,24,24
1748423021595,BIBC 103,C02,942152,Burg; Michael,0,0,24,24
1748423021595,BIBC 103,D01,942169,Burg; Michael,0,0,24,24
1748423021595,BIBC 103,D02,942170,Burg; Michael,0,0,24,24
1748423022627,BICD 100,A01,959831,Day; Christopher D,53,0,61,8
1748423022627,BICD 100,A02,959832,Day; Christopher D,49,0,61,12
1748423022627,BICD 100,A03,959833,Day; Christopher D,43,0,61,18
1748423022627,BICD 100,A04,959834,Day; Christopher D,57,0,61,4
1748423022627,BICD 100,B01,959749,McDonnell; Lisa Marie,0,0,61,61
1748423022627,BICD 100,B02,959750,McDonnell; Lisa Marie,0,0,61,61
1748423022627,BICD 100,B03,959751,McDonnell; Lisa Marie,0,0,61,61
1748423022627,BICD 100,B04,959752,McDonnell; Lisa Marie,37,0,61,24
1748423022627,BICD 100,C01,959835,Yelon; Deborah,0,0,61,61
1748423022627,BICD 100,C02,959836,Yelon; Deborah,54,0,61,7
1748423022627,BICD 100,C03,959837,Yelon; Deborah,61,0,61,0
1748423022627,BICD 100,C04,959838,Yelon; Deborah,57,0,61,4
1748423023659,BICD 110,A01,959312,Kiger; Amy,59,0,123,64
1748423023659,BICD 110,A02,959315,Kiger; Amy,94,0,122,28
1748423024690,BICD 130,A01,942207,Perry; Michael William,0,0,48,48
1748423024690,BICD 130,A02,942208,Perry; Michael William,37,0,48,11
1748423024690,BICD 130,A03,942209,Perry; Michael William,29,0,48,19
1748423024690,BICD 130,A04,942236,Perry; Michael William,19,0,48,29
1748423025725,BICD 140,A01,942372,Zuniga; Elina I,42,0,49,7
1748423025725,BICD 140,A02,942492,Zuniga; Elina I,45,0,49,4
1748423025725,BICD 140,A03,942493,Zuniga; Elina I,48,0,49,1
1748423025725,BICD 140,A04,942494,Zuniga; Elina I,46,0,49,3
1748423026757,BIEB 102,A01,942496,Butler; Shannon Rhey,182,0,248,66
1748423027787,BIEB 121,A00,942497,Holway; David A.,0,0,32,32
1748423027787,BIEB 121,B00,942498,Butler; Shannon Rhey,0,0,32,32
1748423028813,BIEB 141,A01,942500,Kryazhimskiy; Sergey A,23,0,40,17
1748423029841,BIEB 146,A01,942502,Petrie; Katherine Lynn,41,0,89,48
1748423029841,BIEB 146,A02,942503,Petrie; Katherine Lynn,0,0,88,88
1748423029841,BIEB 146,A03,942504,Petrie; Katherine Lynn,2,0,88,86
1748423029841,BIEB 146,A04,942505,Petrie; Katherine Lynn,21,0,89,68
1748423030875,BIEB 150,A01,942507,Rennison; Diana,28,0,41,13
1748423030875,BIEB 150,A02,942508,Rennison; Diana,32,0,41,9
1748423030875,BIEB 150,A03,942509,Rennison; Diana,36,0,41,5
1748423030875,BIEB 150,A04,942510,Rennison; Diana,6,0,40,34
1748423031902,BIEB 174,A01,942512,Cleland; Elsa Eleanor & Barton; Andrew David,9,0,41,32
1748423031902,BIEB 174,A02,942513,Cleland; Elsa Eleanor & Barton; Andrew David,37,0,41,4
1748423031902,BIEB 174,A03,942514,Cleland; Elsa Eleanor & Barton; Andrew David,35,0,41,6
1748423031902,BIEB 174,A04,942515,Cleland; Elsa Eleanor & Barton; Andrew David,30,0,40,10
1748423032944,BILD 1,A01,959729,Ochoa Mikrut; Stacy Daniel,50,0,60,10
1748423032944,BILD 1,A02,959730,Ochoa Mikrut; Stacy Daniel,47,0,59,12
1748423032944,BILD 1,A03,959731,Ochoa Mikrut; Stacy Daniel,48,0,59,11
1748423032944,BILD 1,A04,959732,Ochoa Mikrut; Stacy Daniel,50,0,59,9
1748423032944,BILD 1,B01,959733,Cooper; Andrew Michael,46,0,60,14
1748423032944,BILD 1,B02,959734,Cooper; Andrew Michael,58,0,59,1
1748423032944,BILD 1,B03,959735,Cooper; Andrew Michael,54,0,59,5
1748423032944,BILD 1,B04,959736,Cooper; Andrew Michael,50,0,59,9
1748423032944,BILD 1,C01,959737,Rusert; Jessica Marie,58,0,60,2
1748423032944,BILD 1,C02,959738,Rusert; Jessica Marie,59,0,59,0
1748423032944,BILD 1,C03,959739,Rusert; Jessica Marie,49,0,59,10
1748423032944,BILD 1,C04,959740,Rusert; Jessica Marie,55,0,59,4
1748423033974,BILD 2,A01,959013,Reyes Gonzalez; Catalina,28,0,57,29
1748423033974,BILD 2,A02,959016,Reyes Gonzalez; Catalina,51,0,57,6
1748423033974,BILD 2,A03,959017,Reyes Gonzalez; Catalina,46,0,56,10
1748423033974,BILD 2,A04,959018,Reyes Gonzalez; Catalina,51,0,55,4
1748423033974,BILD 2,B01,959078,Reyes Gonzalez; Catalina,42,0,57,15
1748423033974,BILD 2,B02,959095,Reyes Gonzalez; Catalina,50,0,57,7
1748423033974,BILD 2,B03,959165,Reyes Gonzalez; Catalina,55,0,56,1
1748423033974,BILD 2,B04,959169,Reyes Gonzalez; Catalina,54,0,55,1
1748423035013,BILD 3,A01,959741,Stockwell; Sarah R,56,0,60,4
1748423035013,BILD 3,A02,959742,Stockwell; Sarah R,57,0,59,2
1748423035013,BILD 3,A03,959743,Stockwell; Sarah R,59,0,59,0
1748423035013,BILD 3,A04,959744,Stockwell; Sarah R,55,0,59,4
1748423035013,BILD 3,B01,959745,Stockwell; Sarah R,55,0,60,5
1748423035013,BILD 3,B02,959746,Stockwell; Sarah R,59,0,59,0
1748423035013,BILD 3,B03,959747,Stockwell; Sarah R,56,0,59,3
1748423035013,BILD 3,B04,959748,Stockwell; Sarah R,58,0,59,1
1748423035013,BILD 3,C01,959823,Hammond; LaTisha Marie,47,0,60,13
1748423035013,BILD 3,C02,959824,Hammond; LaTisha Marie,48,0,59,11
1748423035013,BILD 3,C03,959825,Hammond; LaTisha Marie,56,0,59,3
1748423035013,BILD 3,C04,959826,Hammond; LaTisha Marie,58,0,59,1
1748423035013,BILD 3,D01,959827,Hammond; LaTisha Marie,43,0,60,17
1748423035013,BILD 3,D02,959828,Hammond; LaTisha Marie,49,0,59,10
1748423035013,BILD 3,D03,959829,Hammond; LaTisha Marie,52,0,59,7
1748423035013,BILD 3,D04,959830,Hammond; LaTisha Marie,56,0,59,3
1748423036046,BILD 4,A01,940749,Gonzalez Gamboa; Ivonne,0,0,0,0
1748423036046,BILD 4,A02,940750,Gonzalez Gamboa; Ivonne,0,0,0,0
1748423036046,BILD 4,A03,940909,Gonzalez Gamboa; Ivonne,0,0,0,0
1748423036046,BILD 4,A04,940922,Gonzalez Gamboa; Ivonne,0,0,0,0
1748423036046,BILD 4,A05,940925,Gonzalez Gamboa; Ivonne,0,0,0,0
1748423036046,BILD 4,A06,941008,Gonzalez Gamboa; Ivonne,0,0,0,0
1748423036046,BILD 4,A07,941009,Gonzalez Gamboa; Ivonne,0,0,0,0
1748423036046,BILD 4,A08,941114,Gonzalez Gamboa; Ivonne,0,0,0,0
1748423036046,BILD 4,B01,941116,Reuther; Keefe,0,0,0,0
1748423036046,BILD 4,B02,941119,Reuther; Keefe,0,0,0,0
1748423036046,BILD 4,B03,941120,Reuther; Keefe,0,0,0,0
1748423036046,BILD 4,B04,941143,Reuther; Keefe,0,0,0,0
1748423036046,BILD 4,B05,941182,Reuther; Keefe,0,0,0,0
1748423036046,BILD 4,B06,941183,Reuther; Keefe,0,0,0,0
1748423036046,BILD 4,B07,941184,Reuther; Keefe,0,0,0,0
1748423036046,BILD 4,B08,941202,Reuther; Keefe,0,0,0,0
1748423036046,BILD 4,C01,941209,Lo; Stanley M.,0,0,0,0
1748423036046,BILD 4,C02,941226,Lo; Stanley M.,0,0,0,0
1748423036046,BILD 4,C03,941228,Lo; Stanley M.,0,0,0,0
1748423036046,BILD 4,C04,941284,Lo; Stanley M.,0,0,0,0
1748423036046,BILD 4,C05,941394,Lo; Stanley M.,0,0,0,0
1748423036046,BILD 4,C06,941473,Lo; Stanley M.,0,0,0,0
1748423036046,BILD 4,C07,941905,Lo; Stanley M.,0,0,0,0
1748423036046,BILD 4,C08,941906,Lo; Stanley M.,0,0,0,0
1748423036046,BILD 4,D01,941908,Lo; Stanley M.,0,0,0,0
1748423036046,BILD 4,D02,941925,Lo; Stanley M.,0,0,0,0
1748423036046,BILD 4,D03,941926,Lo; Stanley M.,0,0,0,0
1748423036046,BILD 4,D04,941927,Lo; Stanley M.,0,0,0,0
1748423036046,BILD 4,D05,941928,Lo; Stanley M.,0,0,0,0
1748423036046,BILD 4,D06,941943,Lo; Stanley M.,0,0,0,0
1748423036046,BILD 4,D07,941944,Lo; Stanley M.,0,0,0,0
1748423036046,BILD 4,D08,941973,Lo; Stanley M.,0,0,0,0
1748423037075,BILD 5,A01,959177,Mueller; Liam O'Connor,0,0,0,0
1748423037075,BILD 5,A02,959178,Mueller; Liam O'Connor,0,0,0,0
1748423037075,BILD 5,A03,959179,Mueller; Liam O'Connor,0,0,0,0
1748423037075,BILD 5,A04,959181,Mueller; Liam O'Connor,0,0,0,0
1748423037075,BILD 5,B01,959183,Mueller; Liam O'Connor,0,0,0,0
1748423037075,BILD 5,B02,959184,Mueller; Liam O'Connor,0,0,0,0
1748423037075,BILD 5,B03,959188,Mueller; Liam O'Connor,0,0,0,0
1748423037075,BILD 5,B04,959189,Mueller; Liam O'Connor,0,0,0,0
1748423037075,BILD 5,C01,959190,Reuther; Keefe,0,0,0,0
1748423037075,BILD 5,C02,959191,Reuther; Keefe,0,0,0,0
1748423037075,BILD 5,C03,959196,Reuther; Keefe,0,0,0,0
1748423037075,BILD 5,C04,959199,Reuther; Keefe,0,0,0,0
1748423038107,BILD 10,A01,942020,Ochoa Mikrut; Stacy Daniel,40,0,40,0
1748423038107,BILD 10,A02,942033,Ochoa Mikrut; Stacy Daniel,35,0,39,4
1748423038107,BILD 10,A03,942045,Ochoa Mikrut; Stacy Daniel,32,0,39,7
1748423038107,BILD 10,A04,942046,Ochoa Mikrut; Stacy Daniel,30,0,39,9
1748423039137,BILD 87,A00,942047,Saier; Milton H.,20,0,20,0
1748423039137,BILD 87,B00,942060,Saier; Milton H.,20,0,20,0
1748423040168,BIMM 100,A01,959797,Lykke-Andersen; Jens,37,0,50,13
1748423040168,BIMM 100,A02,959798,Lykke-Andersen; Jens,5,0,50,45
1748423040168,BIMM 100,A03,959799,Lykke-Andersen; Jens,0,0,50,50
1748423040168,BIMM 100,A04,959800,Lykke-Andersen; Jens,3,0,50,47
1748423040168,BIMM 100,B01,959807,Pruneda-Paz; Jose L.,1,0,50,49
1748423040168,BIMM 100,B02,959808,Pruneda-Paz; Jose L.,0,0,50,50
1748423040168,BIMM 100,B03,959809,Pruneda-Paz; Jose L.,7,0,50,43
1748423040168,BIMM 100,B04,959810,Pruneda-Paz; Jose L.,37,0,50,13
1748423040168,BIMM 100,C01,959762,Pasquinelli; Amy,0,0,54,54
1748423040168,BIMM 100,C02,959763,Pasquinelli; Amy,20,0,54,34
1748423040168,BIMM 100,C03,959764,Pasquinelli; Amy,32,0,54,22
1748423040168,BIMM 100,C04,959765,Pasquinelli; Amy,47,0,54,7
1748423041200,BIMM 101,A01,942520,Meaders; Clara Leigh,0,0,24,24
1748423041200,BIMM 101,A02,942521,Meaders; Clara Leigh,0,0,24,24
1748423041200,BIMM 101,B01,942523,Meaders; Clara Leigh,0,0,24,24
1748423041200,BIMM 101,B02,942524,Meaders; Clara Leigh,0,0,24,24
1748423041200,BIMM 101,C01,942690,McDonnell; Lisa Marie,0,0,24,24
1748423041200,BIMM 101,C02,942755,McDonnell; Lisa Marie,0,0,24,24
1748423041200,BIMM 101,D01,942757,Day; Christopher D,0,0,24,24
1748423041200,BIMM 101,D02,942758,Day; Christopher D,12,0,24,12
1748423041200,BIMM 101,E01,942760,Cooper; Andrew Michael,0,0,24,24
1748423041200,BIMM 101,E02,942761,Cooper; Andrew Michael,0,0,24,24
1748423041200,BIMM 101,F01,942763,Rusert; Jessica Marie,14,0,24,10
1748423041200,BIMM 101,F02,942764,Rusert; Jessica Marie,19,0,24,5
1748423042228,BIMM 120,A01,942766,Saier; Milton H.,40,0,48,8
1748423042228,BIMM 120,A02,942767,Saier; Milton H.,40,0,48,8
1748423042228,BIMM 120,A03,942768,Saier; Milton H.,15,0,48,33
1748423042228,BIMM 120,A04,942769,Saier; Milton H.,0,0,48,48
1748423043266,BIMM 121,A01,942771,Gustafson-Brown; Cindy,0,0,24,24
1748423043266,BIMM 121,A02,942772,Gustafson-Brown; Cindy,0,0,24,24
1748423043266,BIMM 121,B01,942774,Gustafson-Brown; Cindy,0,0,24,24
1748423043266,BIMM 121,B02,942775,Gustafson-Brown; Cindy,5,0,24,19
1748423043266,BIMM 121,C01,942777,Pirino; Giorgia,0,0,24,24
1748423043266,BIMM 121,C02,942778,Pirino; Giorgia,0,0,24,24
1748423043266,BIMM 121,D01,942780,Pirino; Giorgia,0,0,24,24
1748423043266,BIMM 121,D02,942781,Pirino; Giorgia,0,0,24,24
1748423044298,BIMM 122,A01,942783,Russell; Alistair B,19,0,44,25
1748423044298,BIMM 122,A02,942784,Russell; Alistair B,29,0,44,15
1748423044298,BIMM 122,A03,942785,Russell; Alistair B,35,0,44,9
1748423044298,BIMM 122,A04,942786,Russell; Alistair B,30,0,44,14
1748423045325,BIMM 128,A01,942788,Hao; Nan,0,0,30,30
1748423045325,BIMM 128,A02,942789,Hao; Nan,0,0,31,31
1748423045325,BIMM 128,A03,942790,Hao; Nan,0,0,31,31
1748423045325,BIMM 128,A04,942791,Hao; Nan,0,0,31,31
1748423046353,BIMM 143,A01,942793,Grant; Barry J,13,0,40,27
1748423046353,BIMM 143,B01,942795,Bozinovic; Goran,21,0,40,19
1748423047382,BIMM 143R,A01,942797,Bozinovic; Goran,0,0,40,40
1748423048410,BIMM 194,A00,942798,Golden; Susan S.,5,0,32,27
1748423048410,BIMM 194,B00,942799,Golden; James W,21,0,32,11
1748423048410,BIMM 194,C00,942800,Karlseder; Jan & Saghatelian; Alan,0,0,32,32
1748423049437,BIOM 200A,A00,911746,Gordts; Philip,30,0,30,0
1748423050467,BIOM 200B,A00,911747,Gordts; Philip,35,0,35,0
1748423051492,BIOM 201,A00,911749,Daneman; Richard,35,0,35,0
1748423052522,BIOM 202,A01,911753,Corbett; Kevin Daniel,35,0,35,0
1748423053548,BIOM 203A,A00,911755,Corbett; Kevin Daniel,35,0,35,0
1748423054582,BIOM 218,A00,911756,Gagneux; Pascal,11,0,12,1
1748423055608,BIOM 219,A00,911757,Ross; Camille,20,0,20,0
1748423056635,BIOM 242,A00,911758,Hamilton; Bruce Alan,19,0,20,1
1748423057663,BIOM 293,A00,911759,Gustafsson; Asa Birgitta,35,0,35,0
1748423058689,BIOM 295,A00,911760,Joiner; William J.,0,0,0,0
1748423059719,BIOM 296,A00,911761,Yaksh; Tony L.,35,0,35,0
1748423060749,BIPN 100,A01,959801,Leutgeb; Stefan,0,0,36,36
1748423060749,BIPN 100,A02,959802,Leutgeb; Stefan,0,0,36,36
1748423060749,BIPN 100,A03,959803,Leutgeb; Stefan,3,0,36,33
1748423060749,BIPN 100,A04,959804,Leutgeb; Stefan,0,0,36,36
1748423060749,BIPN 100,B01,959766,Cooke; James Edward,33,0,41,8
1748423060749,BIPN 100,B02,959767,Cooke; James Edward,39,0,41,2
1748423060749,BIPN 100,B03,959768,Cooke; James Edward,37,0,40,3
1748423060749,BIPN 100,B04,959769,Cooke; James Edward,37,0,40,3
1748423060749,BIPN 100,C01,959770,Cooke; James Edward,35,0,41,6
1748423060749,BIPN 100,C02,959771,Cooke; James Edward,40,0,41,1
1748423060749,BIPN 100,C03,959772,Cooke; James Edward,37,0,40,3
1748423060749,BIPN 100,C04,959773,Cooke; James Edward,38,0,40,2
1748423060749,BIPN 100,D01,959811,Yang; Mingyu,0,0,41,41
1748423060749,BIPN 100,D02,959812,Yang; Mingyu,0,0,41,41
1748423060749,BIPN 100,D03,959813,Yang; Mingyu,0,0,40,40
1748423060749,BIPN 100,D04,959814,Yang; Mingyu,0,0,40,40
1748423061776,BIPN 103,A01,942981,Yang; Mingyu,0,0,48,48
1748423062811,BIPN 105,A01,942983,Armour; Jon Christopher,0,0,21,21
1748423062811,BIPN 105,A02,942984,Armour; Jon Christopher,0,0,21,21
1748423062811,BIPN 105,B01,942989,Armour; Jon Christopher,0,0,21,21
1748423062811,BIPN 105,B02,942990,Armour; Jon Christopher,0,0,21,21
1748423063838,BIPN 118,A01,960886,Banghart; Matthew Ryan,23,0,30,7
1748423063838,BIPN 118,A02,960889,Banghart; Matthew Ryan,24,0,30,6
1748423063838,BIPN 118,A03,960891,Banghart; Matthew Ryan,23,0,30,7
1748423063838,BIPN 118,A04,960892,Banghart; Matthew Ryan,27,0,30,3
1748423064874,BIPN 140,A01,942992,Owens; Melinda Tsao-Ying,8,0,32,24
1748423064874,BIPN 140,A02,942994,Owens; Melinda Tsao-Ying,0,0,32,32
1748423064874,BIPN 140,A03,942995,Owens; Melinda Tsao-Ying,1,0,32,31
1748423064874,BIPN 140,A04,942996,Owens; Melinda Tsao-Ying,9,0,30,21
1748423064874,BIPN 140,B01,942998,Owens; Melinda Tsao-Ying,4,0,32,28
1748423064874,BIPN 140,B02,942999,Owens; Melinda Tsao-Ying,3,0,32,29
1748423064874,BIPN 140,B03,943000,Owens; Melinda Tsao-Ying,18,0,32,14
1748423064874,BIPN 140,B04,943001,Owens; Melinda Tsao-Ying,23,0,30,7
1748423065904,BIPN 145,A01,943083,Maita; Isabella Vincenza,0,0,42,42
1748423065904,BIPN 145,B01,943085,Marino; Marc J,13,0,42,29
1748423065904,BIPN 145,C01,943108,Marino; Marc J,0,0,42,42
1748423066932,BIPN 148,A01,943119,Leutgeb; Jill K.,15,0,39,24
1748423066932,BIPN 148,A02,943120,Leutgeb; Jill K.,16,0,39,23
1748423066932,BIPN 148,A03,943121,Leutgeb; Jill K.,33,0,39,6
1748423066932,BIPN 148,A04,943201,Leutgeb; Jill K.,27,0,39,12
1748423067963,BIPN 189,A00,943247,Gentner; Tim,0,0,25,25
1748423068994,BISP 182,A00,943255,Pogliano; Joseph,9999,0,9999,0
1748423070022,BISP 194,A00,943261,Wertheim; Joel Okrent,0,0,32,32
1748423071050,BNFO 281,A00,961454,Gaasterland; Theresa,13,0,40,27
1748423072079,BNFO 283,A00,961457,Benner; Christopher William,69,0,100,31
1748423073107,BNFO 294,A01,961499,Ross; Camille,39,0,50,11
1748423074165,CAT 1,A01,915666,Bronstein; Phoebe Malan,13,0,16,3
1748423074165,CAT 1,A02,915673,Bronstein; Phoebe Malan,15,0,16,1
1748423074165,CAT 1,A03,915727,Bronstein; Phoebe Malan,16,0,16,0
1748423074165,CAT 1,A04,915728,Bronstein; Phoebe Malan,16,0,16,0
1748423074165,CAT 1,A05,915729,Bronstein; Phoebe Malan,16,0,16,0
1748423074165,CAT 1,A06,915730,Bronstein; Phoebe Malan,13,0,16,3
1748423074165,CAT 1,A07,915731,Bronstein; Phoebe Malan,16,0,16,0
1748423074165,CAT 1,A08,915732,Bronstein; Phoebe Malan,16,0,16,0
1748423074165,CAT 1,A09,915733,Bronstein; Phoebe Malan,14,0,16,2
1748423074165,CAT 1,A10,915734,Bronstein; Phoebe Malan,16,0,16,0
1748423074165,CAT 1,A11,915751,Bronstein; Phoebe Malan,16,0,16,0
1748423074165,CAT 1,A12,915752,Bronstein; Phoebe Malan,15,0,16,1
1748423074165,CAT 1,A13,915753,Bronstein; Phoebe Malan,15,0,16,1
1748423074165,CAT 1,A14,915754,Bronstein; Phoebe Malan,16,0,16,0
1748423074165,CAT 1,A15,915755,Bronstein; Phoebe Malan,16,0,16,0
1748423074165,CAT 1,A16,915756,Bronstein; Phoebe Malan,16,0,16,0
1748423074165,CAT 1,B01,915763,Bronstein; Phoebe Malan,15,0,16,1
1748423074165,CAT 1,B02,915764,Bronstein; Phoebe Malan,15,0,16,1
1748423074165,CAT 1,B03,915765,Bronstein; Phoebe Malan,14,0,16,2
1748423074165,CAT 1,B04,915766,Bronstein; Phoebe Malan,16,0,16,0
1748423074165,CAT 1,B05,915767,Bronstein; Phoebe Malan,12,0,16,4
1748423074165,CAT 1,B06,915768,Bronstein; Phoebe Malan,16,0,16,0
1748423074165,CAT 1,B07,915769,Bronstein; Phoebe Malan,16,0,16,0
1748423074165,CAT 1,B08,915770,Bronstein; Phoebe Malan,16,0,16,0
1748423074165,CAT 1,B09,915771,Bronstein; Phoebe Malan,16,0,16,0
1748423074165,CAT 1,B10,915772,Bronstein; Phoebe Malan,16,0,16,0
1748423074165,CAT 1,B11,915773,Bronstein; Phoebe Malan,16,0,16,0
1748423074165,CAT 1,B12,915774,Bronstein; Phoebe Malan,15,0,16,1
1748423074165,CAT 1,B13,915775,Bronstein; Phoebe Malan,16,0,16,0
1748423074165,CAT 1,B14,915776,Bronstein; Phoebe Malan,15,0,16,1
1748423074165,CAT 1,B15,915777,Bronstein; Phoebe Malan,14,0,16,2
1748423074165,CAT 1,B16,915778,Bronstein; Phoebe Malan,16,0,16,0
1748423074165,CAT 1,C01,915780,Algaze; Guillermo,11,0,16,5
1748423074165,CAT 1,C02,915781,Algaze; Guillermo,16,0,16,0
1748423074165,CAT 1,C03,915782,Algaze; Guillermo,15,0,16,1
1748423074165,CAT 1,C04,915783,Algaze; Guillermo,16,0,16,0
1748423074165,CAT 1,C05,915784,Algaze; Guillermo,16,0,16,0
1748423074165,CAT 1,C06,915785,Algaze; Guillermo,16,0,16,0
1748423074165,CAT 1,C07,915786,Algaze; Guillermo,16,0,16,0
1748423074165,CAT 1,C08,915787,Algaze; Guillermo,15,0,16,1
1748423074165,CAT 1,C09,915788,Algaze; Guillermo,16,0,16,0
1748423074165,CAT 1,C10,915790,Algaze; Guillermo,16,0,16,0
1748423074165,CAT 1,C11,915791,Algaze; Guillermo,16,0,16,0
1748423074165,CAT 1,C12,915792,Algaze; Guillermo,16,0,16,0
1748423074165,CAT 1,C13,915793,Algaze; Guillermo,16,0,16,0
1748423074165,CAT 1,C14,915794,Algaze; Guillermo,16,0,16,0
1748423074165,CAT 1,D01,915796,Marchisotto; Jennifer Anne,16,0,16,0
1748423074165,CAT 1,D02,915797,Marchisotto; Jennifer Anne,15,0,16,1
1748423074165,CAT 1,D03,915798,Marchisotto; Jennifer Anne,16,0,16,0
1748423074165,CAT 1,D04,915799,Marchisotto; Jennifer Anne,12,0,16,4
1748423074165,CAT 1,D05,915800,Marchisotto; Jennifer Anne,16,0,16,0
1748423074165,CAT 1,D06,915801,Marchisotto; Jennifer Anne,16,0,16,0
1748423074165,CAT 1,D07,915802,Marchisotto; Jennifer Anne,15,0,16,1
1748423074165,CAT 1,D08,915803,Marchisotto; Jennifer Anne,16,0,16,0
1748423074165,CAT 1,D09,915804,Marchisotto; Jennifer Anne,16,0,16,0
1748423074165,CAT 1,D10,915805,Marchisotto; Jennifer Anne,16,0,16,0
1748423074165,CAT 1,D11,915806,Marchisotto; Jennifer Anne,15,0,16,1
1748423074165,CAT 1,D12,915807,Marchisotto; Jennifer Anne,16,0,16,0
1748423074165,CAT 1,D13,915808,Marchisotto; Jennifer Anne,15,0,16,1
1748423074165,CAT 1,D14,915809,Marchisotto; Jennifer Anne,15,0,16,1
1748423075193,CAT 88,A00,969796,Popko; Elizabeth Ashley,0,0,0,0
1748423076219,CAT 90,A00,915812,Geibel; William,7,0,15,8
1748423077254,CAT 124,A01,915814,Rose; Becca Rae,0,0,20,20
1748423077254,CAT 124,B01,961453,Geibel; William,14,0,20,6
1748423078296,CAT 125,001,915815,Delaville; Romain,18,0,20,2
1748423078296,CAT 125,003,915817,Bigham; David Joseph,12,0,20,8
1748423078296,CAT 125,004,915818,Bigham; David Joseph,3,0,20,17
1748423078296,CAT 125,005,915819,Marchisotto; Jennifer Anne,11,0,20,9
1748423078296,CAT 125,006,915820,Marchisotto; Jennifer Anne,0,0,20,20
1748423078296,CAT 125,007,915821,Morales; Celeste Georgianna,12,0,20,8
1748423078296,CAT 125,008,915822,Morales; Celeste Georgianna,15,0,20,5
1748423078296,CAT 125,009,915823,Morales; Celeste Georgianna,18,0,20,2
1748423078296,CAT 125,010,915824,Irwin; Matthew Joseph,18,0,20,2
1748423078296,CAT 125,011,915825,Irwin; Matthew Joseph,15,0,20,5
1748423078296,CAT 125,012,915826,Irwin; Matthew Joseph,15,0,20,5
1748423078296,CAT 125,013,915827,Vanderschuit; Maya Alysia,16,0,20,4
1748423078296,CAT 125,014,915828,Vanderschuit; Maya Alysia,18,0,20,2
1748423078296,CAT 125,015,915829,Vanderschuit; Maya Alysia,15,0,20,5
1748423078296,CAT 125,016,915830,Rose; Becca Rae,5,0,20,15
1748423078296,CAT 125,017,915831,Rose; Becca Rae,4,0,20,16
1748423078296,CAT 125,018,915832,Hyland; Tina Mae,13,0,20,7
1748423078296,CAT 125,019,915833,Hyland; Tina Mae,17,0,20,3
1748423079333,CAT 125R,A00,915834,Hyland; Tina Mae,0,0,20,20
1748423079333,CAT 125R,B00,915835,Hyland; Tina Mae,0,0,20,20
1748423079333,CAT 125R,C00,915836,Hyland; Tina Mae,0,0,20,20
1748423079333,CAT 125R,D00,915837,Tosun; Adriana,0,0,20,20
1748423079333,CAT 125R,E00,915838,Smith; Lauryn Alissa,0,0,20,20
1748423079333,CAT 125R,F00,915839,Smith; Lauryn Alissa,0,0,20,20
1748423079333,CAT 125R,G00,915840,Smith; Lauryn Alissa,0,0,20,20
1748423080363,CAT 200,A00,915841,Popko; Elizabeth Ashley,17,0,20,3
1748423081397,CCE 1,A00,915063,Bigley; Michele Heather,30,0,40,10
1748423081397,CCE 1,B00,915064,Bigley; Michele Heather,36,0,40,4
1748423082432,CCE 2,001,915067,Santos; Vabianna Daria,0,0,20,20
1748423082432,CCE 2,002,915068,Santos; Vabianna Daria,0,0,20,20
1748423082432,CCE 2,003,915069,Santos; Vabianna Daria,18,0,20,2
1748423082432,CCE 2,004,915070,Staff,17,0,20,3
1748423082432,CCE 2,005,915071,Staff,15,0,20,5
1748423082432,CCE 2,006,915072,Staff,8,0,20,12
1748423082432,CCE 2,007,915073,Staff,10,0,20,10
1748423082432,CCE 2,008,915074,Staff,0,0,20,20
1748423082432,CCE 2,009,915090,Staff,5,0,20,15
1748423082432,CCE 2,010,915104,Merryman; Ashley,0,0,20,20
1748423082432,CCE 2,011,915114,Merryman; Ashley,0,0,20,20
1748423082432,CCE 2,012,915136,Merryman; Ashley,0,0,20,20
1748423082432,CCE 2,013,915176,Staff,13,0,20,7
1748423082432,CCE 2,014,915177,Staff,20,0,20,0
1748423082432,CCE 2,015,915178,Staff,17,0,20,3
1748423082432,CCE 2,016,915179,Staff,16,0,20,4
1748423083462,CCE 3,001,915194,Labat Ii; Michael Luis,13,0,20,7
1748423083462,CCE 3,002,915195,Labat Ii; Michael Luis,17,0,20,3
1748423083462,CCE 3,003,915196,Labat Ii; Michael Luis,17,0,20,3
1748423083462,CCE 3,004,915197,Lee; Kassandra,16,0,20,4
1748423083462,CCE 3,005,915198,Lee; Kassandra,6,0,20,14
1748423083462,CCE 3,006,915199,Lee; Kassandra,10,0,20,10
1748423083462,CCE 3,007,915200,Garcia; Kathryn Mary,0,0,20,20
1748423083462,CCE 3,008,915201,Garcia; Kathryn Mary,2,0,20,18
1748423084492,CCE 120,A01,915203,Quijada; David,26,0,30,4
1748423084492,CCE 120,B01,915205,Quijada; David,17,0,30,13
1748423084492,CCE 120,C01,915207,Williams; Danielle,21,0,30,9
1748423084492,CCE 120,D01,915275,Crawford; James,26,0,30,4
1748423084492,CCE 120,E01,915323,Kenley; Nicole,0,0,30,30
1748423084492,CCE 120,F01,915325,Kenley; Nicole,5,0,30,25
1748423085582,CENG 4,A01,913054,Li; Yanran,35,0,36,1
1748423085582,CENG 4,A02,913055,Li; Yanran,36,0,36,0
1748423085582,CENG 4,A03,913058,Li; Yanran,36,0,36,0
1748423085582,CENG 4,A04,913060,Li; Yanran,36,0,36,0
1748423086610,CENG 15,A01,913087,Lubarda; Vlado,69,0,70,1
1748423087642,CENG 100,A00,913088,Powell; Alyssa,108,0,120,12
1748423088671,CENG 101A,A00,913089,Opatkiewicz; Justin Paul,107,0,146,39
1748423089703,CENG 110,A01,913091,Powell; Alyssa,15,0,24,9
1748423090734,CENG 120,A00,913092,Opatkiewicz; Justin Paul,96,0,146,50
1748423091761,CENG 122,A00,913093,Li; Wan-Lu,120,0,140,20
1748423092793,CENG 170,A01,913196,Drews; Aaron,7,0,25,18
1748423092793,CENG 170,A02,913202,Drews; Aaron,4,0,25,21
1748423092793,CENG 170,A03,913204,Drews; Aaron,5,0,30,25
1748423093825,CENG 175,A00,913205,Steinmetz; Nicole F,14,0,35,21
1748423094853,CENG 205,A00,913207,Jahed Motlagh; Zeinab,54,0,70,16
1748423095880,CENG 210A,A00,913209,Shah; Nisarg,50,0,50,0
1748423096907,CENG 211,A00,913211,Sirbuly; Donald,23,0,25,2
1748423097940,CENG 213,A00,913213,Fenning; David,25,0,25,0
1748423098968,CENG 221A,A00,913214,Liu; Ping,38,0,50,12
1748423099994,CENG 252,A00,913215,Chen; Zheng,42,0,50,8
1748423101027,CGS 2A,A01,915347,Martin Sandino; Amanda Maria Yoland,11,0,15,4
1748423101027,CGS 2A,A02,915348,Martin Sandino; Amanda Maria Yoland,12,0,15,3
1748423101027,CGS 2A,A03,915375,Martin Sandino; Amanda Maria Yoland,11,0,15,4
1748423101027,CGS 2A,A04,915376,Martin Sandino; Amanda Maria Yoland,15,0,15,0
1748423102063,CGS 100A,A00,915379,Perez; Roy,16,0,31,15
1748423103090,CGS 109,A00,915458,Cuong; Marisol,36,0,40,4
1748423104117,CGS 110,A00,915463,Cuong; Marisol,27,0,30,3
1748423105147,CGS 113,A00,915465,Martin Sandino; Amanda Maria Yoland,8,0,16,8
1748423106173,CGS 134,A00,915498,Chatti; Deepti,17,0,32,15
1748423107200,CGS 150,A00,915508,Taylor-Garcia; Daphne,13,0,16,3
1748423108231,CGS 187,A00,915515,Martin Sandino; Amanda Maria Yoland,13,0,16,3
1748423109260,CGS 190,A00,915516,Taylor-Garcia; Daphne,7,0,7,0
1748423110289,CGS 208,A00,915517,Kang; Byung Chu,1,0,1,0
1748423111319,CHEM 4,A01,958051,Brydges; Stacey,39,0,40,1
1748423111319,CHEM 4,A02,958052,Brydges; Stacey,38,0,40,2
1748423111319,CHEM 4,A03,958053,Brydges; Stacey,37,0,40,3
1748423111319,CHEM 4,A04,958054,Brydges; Stacey,39,0,40,1
1748423111319,CHEM 4,A05,958055,Brydges; Stacey,40,0,40,0
1748423111319,CHEM 4,A06,958056,Brydges; Stacey,38,0,40,2
1748423111319,CHEM 4,A07,958057,Brydges; Stacey,40,0,40,0
1748423111319,CHEM 4,A08,958058,Brydges; Stacey,40,0,40,0
1748423111319,CHEM 4,B01,958059,Brydges; Stacey,40,0,40,0
1748423111319,CHEM 4,B02,958060,Brydges; Stacey,40,0,40,0
1748423111319,CHEM 4,B03,958061,Brydges; Stacey,40,0,40,0
1748423111319,CHEM 4,B04,958062,Brydges; Stacey,36,0,40,4
1748423111319,CHEM 4,B05,958063,Brydges; Stacey,38,0,40,2
1748423111319,CHEM 4,B06,958064,Brydges; Stacey,39,0,40,1
1748423111319,CHEM 4,B07,958065,Brydges; Stacey,40,0,40,0
1748423111319,CHEM 4,B08,958066,Brydges; Stacey,40,0,40,0
1748423112363,CHEM 6A,A01,958094,Stallings; Dontarie M,5,0,8,3
1748423112363,CHEM 6A,A02,958095,Stallings; Dontarie M,4,0,8,4
1748423112363,CHEM 6A,A03,958096,Stallings; Dontarie M,7,0,8,1
1748423112363,CHEM 6A,A04,958097,Stallings; Dontarie M,8,0,8,0
1748423112363,CHEM 6A,A05,958098,Stallings; Dontarie M,8,0,8,0
1748423112363,CHEM 6A,A06,958099,Stallings; Dontarie M,8,0,8,0
1748423112363,CHEM 6A,A07,958100,Stallings; Dontarie M,8,0,8,0
1748423112363,CHEM 6A,A08,958101,Stallings; Dontarie M,8,0,8,0
1748423112363,CHEM 6A,A09,958102,Stallings; Dontarie M,0,0,0,0
1748423112363,CHEM 6A,B01,958136,Stallings; Dontarie M,0,0,8,8
1748423112363,CHEM 6A,B02,958137,Stallings; Dontarie M,5,0,8,3
1748423112363,CHEM 6A,B03,958138,Stallings; Dontarie M,8,0,8,0
1748423112363,CHEM 6A,B04,958139,Stallings; Dontarie M,7,0,8,1
1748423112363,CHEM 6A,B05,958140,Stallings; Dontarie M,0,0,8,8
1748423112363,CHEM 6A,B06,958141,Stallings; Dontarie M,3,0,8,5
1748423112363,CHEM 6A,B07,958143,Stallings; Dontarie M,2,0,8,6
1748423112363,CHEM 6A,B08,958144,Stallings; Dontarie M,8,0,8,0
1748423112363,CHEM 6A,B09,958145,Stallings; Dontarie M,0,0,0,0
1748423112363,CHEM 6A,C01,958146,Schurmeier; Kimberly,6,0,8,2
1748423112363,CHEM 6A,C02,958147,Schurmeier; Kimberly,7,0,8,1
1748423112363,CHEM 6A,C03,958148,Schurmeier; Kimberly,8,0,8,0
1748423112363,CHEM 6A,C04,958149,Schurmeier; Kimberly,8,0,8,0
1748423112363,CHEM 6A,C05,958150,Schurmeier; Kimberly,8,0,8,0
1748423112363,CHEM 6A,C06,958151,Schurmeier; Kimberly,6,0,8,2
1748423112363,CHEM 6A,C07,958152,Schurmeier; Kimberly,8,0,8,0
1748423112363,CHEM 6A,C08,958153,Schurmeier; Kimberly,7,0,8,1
1748423112363,CHEM 6A,C09,958154,Schurmeier; Kimberly,0,0,0,0
1748423112363,CHEM 6A,D01,958155,Schurmeier; Kimberly,3,0,8,5
1748423112363,CHEM 6A,D02,958156,Schurmeier; Kimberly,3,0,8,5
1748423112363,CHEM 6A,D03,958157,Schurmeier; Kimberly,4,0,8,4
1748423112363,CHEM 6A,D04,958158,Schurmeier; Kimberly,6,0,8,2
1748423112363,CHEM 6A,D05,958159,Schurmeier; Kimberly,7,0,8,1
1748423112363,CHEM 6A,D06,958160,Schurmeier; Kimberly,7,0,8,1
1748423112363,CHEM 6A,D07,958161,Schurmeier; Kimberly,8,0,8,0
1748423112363,CHEM 6A,D08,958162,Schurmeier; Kimberly,8,0,8,0
1748423112363,CHEM 6A,D09,958195,Schurmeier; Kimberly,0,0,0,0
1748423112363,CHEM 6A,E01,958203,Zid; Brian M,0,0,8,8
1748423112363,CHEM 6A,E02,958206,Zid; Brian M,6,0,8,2
1748423112363,CHEM 6A,E03,958207,Zid; Brian M,7,0,8,1
1748423112363,CHEM 6A,E04,958350,Zid; Brian M,8,0,8,0
1748423112363,CHEM 6A,E05,958361,Zid; Brian M,7,0,8,1
1748423112363,CHEM 6A,E06,958373,Zid; Brian M,2,0,8,6
1748423112363,CHEM 6A,E07,958394,Zid; Brian M,7,0,8,1
1748423112363,CHEM 6A,E08,958395,Zid; Brian M,1,0,8,7
1748423112363,CHEM 6A,E09,958396,Zid; Brian M,0,0,0,0
1748423112363,CHEM 6A,F01,958397,Ortony; Julia Helen,8,0,8,0
1748423112363,CHEM 6A,F02,958407,Ortony; Julia Helen,0,0,8,8
1748423112363,CHEM 6A,F03,958409,Ortony; Julia Helen,2,0,8,6
1748423112363,CHEM 6A,F04,958417,Ortony; Julia Helen,6,0,8,2
1748423112363,CHEM 6A,F05,958422,Ortony; Julia Helen,8,0,8,0
1748423112363,CHEM 6A,F06,958425,Ortony; Julia Helen,8,0,8,0
1748423112363,CHEM 6A,F07,958428,Ortony; Julia Helen,7,0,8,1
1748423112363,CHEM 6A,F08,958442,Ortony; Julia Helen,8,0,8,0
1748423112363,CHEM 6A,F09,958488,Ortony; Julia Helen,0,0,0,0
1748423112363,CHEM 6A,G01,958489,Ortony; Julia Helen,7,0,8,1
1748423112363,CHEM 6A,G02,958490,Ortony; Julia Helen,8,0,8,0
1748423112363,CHEM 6A,G03,958491,Ortony; Julia Helen,3,0,8,5
1748423112363,CHEM 6A,G04,958499,Ortony; Julia Helen,2,0,8,6
1748423112363,CHEM 6A,G05,958500,Ortony; Julia Helen,4,0,8,4
1748423112363,CHEM 6A,G06,958501,Ortony; Julia Helen,8,0,8,0
1748423112363,CHEM 6A,G07,958502,Ortony; Julia Helen,8,0,8,0
1748423112363,CHEM 6A,G08,958636,Ortony; Julia Helen,8,0,8,0
1748423112363,CHEM 6A,G09,958637,Ortony; Julia Helen,0,0,0,0
1748423113393,CHEM 6B,A01,958638,Bussey; Thomas J,15,0,22,7
1748423113393,CHEM 6B,A02,958641,Bussey; Thomas J,0,0,22,22
1748423113393,CHEM 6B,A03,958646,Bussey; Thomas J,0,0,22,22
1748423113393,CHEM 6B,A04,958648,Bussey; Thomas J,11,0,22,11
1748423113393,CHEM 6B,A05,958650,Bussey; Thomas J,7,0,22,15
1748423113393,CHEM 6B,A06,958652,Bussey; Thomas J,18,0,22,4
1748423113393,CHEM 6B,A07,958653,Bussey; Thomas J,20,0,22,2
1748423113393,CHEM 6B,A08,958654,Bussey; Thomas J,19,0,22,3
1748423113393,CHEM 6B,A09,958710,Bussey; Thomas J,21,0,22,1
1748423113393,CHEM 6B,A10,958713,Bussey; Thomas J,21,0,22,1
1748423114423,CHEM 6C,A01,958743,Yuen Zhou; Joel,23,0,38,15
1748423114423,CHEM 6C,A02,958744,Yuen Zhou; Joel,20,0,38,18
1748423114423,CHEM 6C,A03,958745,Yuen Zhou; Joel,28,0,38,10
1748423114423,CHEM 6C,A04,958746,Yuen Zhou; Joel,30,0,38,8
1748423114423,CHEM 6C,A05,958747,Yuen Zhou; Joel,36,0,38,2
1748423114423,CHEM 6C,A06,958748,Yuen Zhou; Joel,23,0,38,15
1748423114423,CHEM 6C,A07,958749,Yuen Zhou; Joel,22,0,38,16
1748423114423,CHEM 6C,A08,958750,Yuen Zhou; Joel,12,0,38,26
1748423114423,CHEM 6C,A09,958751,Yuen Zhou; Joel,28,0,38,10
1748423115465,CHEM 7L,A01,912668,Leigh; Brian,0,0,24,24
1748423115465,CHEM 7L,A02,912669,Leigh; Brian,0,0,24,24
1748423115465,CHEM 7L,A03,912670,Leigh; Brian,0,0,24,24
1748423115465,CHEM 7L,A04,912671,Leigh; Brian,0,0,24,24
1748423115465,CHEM 7L,A05,912672,Leigh; Brian,0,0,24,24
1748423115465,CHEM 7L,A06,912673,Leigh; Brian,0,0,20,20
1748423115465,CHEM 7L,A07,912674,Leigh; Brian,0,0,24,24
1748423115465,CHEM 7L,A08,912675,Leigh; Brian,0,0,24,24
1748423115465,CHEM 7L,A09,912676,Leigh; Brian,0,0,24,24
1748423115465,CHEM 7L,A10,912677,Leigh; Brian,0,0,24,24
1748423115465,CHEM 7L,B01,912680,Leigh; Brian,0,0,24,24
1748423115465,CHEM 7L,B02,912681,Leigh; Brian,0,0,24,24
1748423115465,CHEM 7L,B03,912682,Leigh; Brian,0,0,24,24
1748423115465,CHEM 7L,B04,912683,Leigh; Brian,0,0,24,24
1748423115465,CHEM 7L,B05,912684,Leigh; Brian,0,0,24,24
1748423115465,CHEM 7L,B06,912685,Leigh; Brian,0,0,24,24
1748423115465,CHEM 7L,B07,912686,Leigh; Brian,0,0,24,24
1748423115465,CHEM 7L,B08,912687,Leigh; Brian,0,0,24,24
1748423115465,CHEM 7L,B09,912688,Leigh; Brian,0,0,24,24
1748423115465,CHEM 7L,B10,912689,Leigh; Brian,0,0,24,24
1748423116509,CHEM 40A,A01,958809,Bertrand; Guy,0,0,34,34
1748423116509,CHEM 40A,A02,958811,Bertrand; Guy,0,0,29,29
1748423116509,CHEM 40A,A03,958812,Bertrand; Guy,0,0,34,34
1748423116509,CHEM 40A,A04,958813,Bertrand; Guy,0,0,34,34
1748423116509,CHEM 40A,A05,958814,Bertrand; Guy,0,0,34,34
1748423116509,CHEM 40A,A06,958816,Bertrand; Guy,0,0,34,34
1748423116509,CHEM 40A,A07,958822,Bertrand; Guy,0,0,34,34
1748423116509,CHEM 40A,A08,958824,Bertrand; Guy,0,0,34,34
1748423116509,CHEM 40A,B01,958825,Bertrand; Guy,0,0,34,34
1748423116509,CHEM 40A,B02,958826,Bertrand; Guy,0,0,34,34
1748423116509,CHEM 40A,B03,958828,Bertrand; Guy,0,0,34,34
1748423116509,CHEM 40A,B04,958829,Bertrand; Guy,0,0,34,34
1748423116509,CHEM 40A,B05,958898,Bertrand; Guy,0,0,34,34
1748423116509,CHEM 40A,B06,958899,Bertrand; Guy,0,0,34,34
1748423116509,CHEM 40A,B07,958900,Bertrand; Guy,0,0,34,34
1748423116509,CHEM 40A,B08,958901,Bertrand; Guy,0,0,34,34
1748423116509,CHEM 40A,C01,958086,Yang; Jerry,29,0,34,5
1748423116509,CHEM 40A,C02,958087,Yang; Jerry,32,0,34,2
1748423116509,CHEM 40A,C03,958088,Yang; Jerry,31,0,34,3
1748423116509,CHEM 40A,C04,958089,Yang; Jerry,34,0,34,0
1748423116509,CHEM 40A,C05,958090,Yang; Jerry,34,0,34,0
1748423116509,CHEM 40A,C06,958091,Yang; Jerry,27,0,34,7
1748423116509,CHEM 40A,C07,958092,Yang; Jerry,29,0,34,5
1748423116509,CHEM 40A,C08,958093,Yang; Jerry,27,0,34,7
1748423116509,CHEM 40A,D01,958113,Albizati; Kim F.,0,0,34,34
1748423116509,CHEM 40A,D02,958114,Albizati; Kim F.,0,0,34,34
1748423116509,CHEM 40A,D03,958115,Albizati; Kim F.,0,0,34,34
1748423116509,CHEM 40A,D04,958116,Albizati; Kim F.,0,0,34,34
1748423116509,CHEM 40A,D05,958117,Albizati; Kim F.,0,0,34,34
1748423116509,CHEM 40A,D06,958118,Albizati; Kim F.,0,0,34,34
1748423116509,CHEM 40A,D07,958119,Albizati; Kim F.,0,0,34,34
1748423116509,CHEM 40A,D08,958120,Albizati; Kim F.,0,0,34,34
1748423117537,CHEM 40B,A01,958752,Molinski; Tadeusz,0,0,31,31
1748423117537,CHEM 40B,A02,958754,Molinski; Tadeusz,0,0,32,32
1748423117537,CHEM 40B,A03,958755,Molinski; Tadeusz,0,0,32,32
1748423117537,CHEM 40B,A04,958756,Molinski; Tadeusz,0,0,32,32
1748423117537,CHEM 40B,A05,958757,Molinski; Tadeusz,0,0,32,32
1748423117537,CHEM 40B,A06,958758,Molinski; Tadeusz,0,0,32,32
1748423117537,CHEM 40B,A07,958759,Molinski; Tadeusz,0,0,32,32
1748423117537,CHEM 40B,A08,958760,Molinski; Tadeusz,2,0,32,30
1748423117537,CHEM 40B,A09,958761,Molinski; Tadeusz,32,0,32,0
1748423118566,CHEM 41A,A01,958071,Klosterman; Jeremy K,0,0,22,22
1748423118566,CHEM 41A,A02,958072,Klosterman; Jeremy K,1,0,36,35
1748423118566,CHEM 41A,A03,958073,Klosterman; Jeremy K,16,0,36,20
1748423118566,CHEM 41A,A04,958074,Klosterman; Jeremy K,32,0,36,4
1748423118566,CHEM 41A,A05,958075,Klosterman; Jeremy K,0,0,0,0
1748423118566,CHEM 41A,A06,958076,Klosterman; Jeremy K,24,0,36,12
1748423118566,CHEM 41A,A07,958077,Klosterman; Jeremy K,3,0,36,33
1748423118566,CHEM 41A,A08,958078,Klosterman; Jeremy K,0,0,36,36
1748423118566,CHEM 41A,A09,958079,Klosterman; Jeremy K,36,0,36,0
1748423119595,CHEM 41C,A01,958105,Tor; Yitzhak,0,0,38,38
1748423119595,CHEM 41C,A02,958106,Tor; Yitzhak,0,0,40,40
1748423120626,CHEM 43A,A01,912711,Lam; Tin Yiu,0,0,24,24
1748423120626,CHEM 43A,A02,912712,Lam; Tin Yiu,0,0,24,24
1748423120626,CHEM 43A,A03,912713,Lam; Tin Yiu,0,0,24,24
1748423120626,CHEM 43A,A04,912714,Lam; Tin Yiu,0,0,24,24
1748423120626,CHEM 43A,A05,912715,Lam; Tin Yiu,0,0,24,24
1748423120626,CHEM 43A,A06,912716,Lam; Tin Yiu,0,0,24,24
1748423120626,CHEM 43A,A07,912717,Lam; Tin Yiu,0,0,24,24
1748423120626,CHEM 43A,A08,912718,Lam; Tin Yiu,0,0,24,24
1748423120626,CHEM 43A,A09,912719,Lam; Tin Yiu,0,0,24,24
1748423120626,CHEM 43A,A10,912720,Lam; Tin Yiu,0,0,24,24
1748423120626,CHEM 43A,B01,912722,Lam; Tin Yiu,0,0,24,24
1748423120626,CHEM 43A,B02,912723,Lam; Tin Yiu,0,0,24,24
1748423120626,CHEM 43A,B03,912724,Lam; Tin Yiu,0,0,19,19
1748423120626,CHEM 43A,B04,912725,Lam; Tin Yiu,0,0,24,24
1748423120626,CHEM 43A,B05,912726,Lam; Tin Yiu,0,0,24,24
1748423120626,CHEM 43A,B06,912727,Lam; Tin Yiu,0,0,24,24
1748423120626,CHEM 43A,B07,912728,Lam; Tin Yiu,0,0,24,24
1748423120626,CHEM 43A,B08,912729,Lam; Tin Yiu,0,0,24,24
1748423120626,CHEM 43A,B09,912730,Lam; Tin Yiu,0,0,24,24
1748423120626,CHEM 43A,B10,912731,Lam; Tin Yiu,0,0,24,24
1748423121657,CHEM 96,A00,960251,Bussey; Thomas J,15,0,20,5
1748423122690,CHEM 100A,A01,912734,Leigh; Brian,0,0,24,24
1748423122690,CHEM 100A,A02,912735,Leigh; Brian,0,0,24,24
1748423122690,CHEM 100A,A03,912736,Leigh; Brian,0,0,24,24
1748423122690,CHEM 100A,A04,912737,Leigh; Brian,0,0,24,24
1748423122690,CHEM 100A,A05,912738,Leigh; Brian,0,0,24,24
1748423122690,CHEM 100A,A06,912739,Leigh; Brian,0,0,24,24
1748423123719,CHEM 108,A01,912741,Ghosh; Gourisankar,0,0,24,24
1748423123719,CHEM 108,A02,912742,Ghosh; Gourisankar,0,0,24,24
1748423123719,CHEM 108,A03,912743,Ghosh; Gourisankar,13,0,24,11
1748423123719,CHEM 108,A04,912744,Ghosh; Gourisankar,23,0,24,1
1748423124748,CHEM 109,A01,912746,Muller; Ulrich K.,0,0,24,24
1748423124748,CHEM 109,A02,912747,Muller; Ulrich K.,0,0,24,24
1748423124748,CHEM 109,A03,912748,Muller; Ulrich K.,0,0,24,24
1748423124748,CHEM 109,A04,912749,Muller; Ulrich K.,15,0,24,9
1748423125782,CHEM 114A,A01,958067,Toor; Navtej,23,0,30,7
1748423125782,CHEM 114A,A02,958068,Toor; Navtej,18,0,30,12
1748423125782,CHEM 114A,A03,958069,Toor; Navtej,15,0,30,15
1748423125782,CHEM 114A,A04,958070,Toor; Navtej,0,0,30,30
1748423125782,CHEM 114A,B01,958080,Guseman; Alex,0,0,30,30
1748423125782,CHEM 114A,B02,958081,Guseman; Alex,0,0,30,30
1748423125782,CHEM 114A,B03,958082,Guseman; Alex,20,0,30,10
1748423125782,CHEM 114A,B04,958083,Guseman; Alex,24,0,30,6
1748423126813,CHEM 114D,A00,912752,Ghosh; Gourisankar,11,0,20,9
1748423127838,CHEM 116,A01,958121,Godula; Kamil,35,0,50,15
1748423127838,CHEM 116,A02,958122,Godula; Kamil,29,0,50,21
1748423128866,CHEM 117,A00,912754,Jones; Lisa Michelle,89,0,100,11
1748423129899,CHEM 126A,A01,958126,Schoeneberg; Johannes,14,0,35,21
1748423129899,CHEM 126A,A02,958127,Schoeneberg; Johannes,4,0,35,31
1748423129899,CHEM 126A,A03,958128,Schoeneberg; Johannes,0,0,35,35
1748423129899,CHEM 126A,A04,958129,Schoeneberg; Johannes,1,0,35,34
1748423129899,CHEM 126A,A05,958130,Schoeneberg; Johannes,34,0,35,1
1748423129899,CHEM 126A,A06,958131,Schoeneberg; Johannes,25,0,35,10
1748423130927,CHEM 130,A01,958084,Sinha; Amitabha,6,0,35,29
1748423130927,CHEM 130,A02,958085,Sinha; Amitabha,21,0,35,14
1748423131954,CHEM 142,A00,912758,Godula; Kamil,112,0,135,23
1748423132982,CHEM 143C,A01,912760,Klosterman; Jeremy K,8,0,24,16
1748423132982,CHEM 143C,A02,912761,Klosterman; Jeremy K,11,0,24,13
1748423134011,CHEM 152,A00,912762,Schmidt; Valerie A,18,0,30,12
1748423135038,CHEM 163,A00,912763,Jones; Lisa Michelle,1,0,10,9
1748423136065,CHEM 171,A01,958103,Slade; Jonathan,30,0,40,10
1748423136065,CHEM 171,A02,958104,Slade; Jonathan,36,0,40,4
1748423137090,CHEM 204,A00,912765,Ghosh; Partho,29,0,30,1
1748423138117,CHEM 209,A00,912766,Toor; Navtej,36,0,40,4
1748423139143,CHEM 213A,A00,912767,Guseman; Alex,46,0,50,4
1748423140170,CHEM 214,A00,912768,Ghosh; Gourisankar,18,0,20,2
1748423141199,CHEM 216,A00,912769,Godula; Kamil,28,0,30,2
1748423142226,CHEM 219A,A00,912770,Zid; Brian M,43,0,45,2
1748423143257,CHEM 222,A00,912771,Graeve; Olivia A,4,0,5,1
1748423144283,CHEM 224,A00,912772,Rinehart; Jeffrey Dennis,19,0,20,1
1748423145310,CHEM 227,A00,912773,Schimpf; Alina M,28,0,30,2
1748423147362,CHEM 231,A00,912775,Yong; Haiwang,20,0,20,0
1748423148388,CHEM 232A,A00,963071,Yuen Zhou; Joel,15,0,15,0
1748423149419,CHEM 234,A00,912776,Pun; Andrew Brian,39,0,40,1
1748423150448,CHEM 242,A00,912777,Godula; Kamil,22,0,25,3
1748423151474,CHEM 252,A00,912778,Schmidt; Valerie A,27,0,30,3
1748423152504,CHEM 263,A00,912779,Jones; Lisa Michelle,28,0,30,2
1748423153530,CHEM 291,A00,912780,Staff,20,0,20,0
1748423154557,CHEM 294,A00,912781,Staff,49,0,50,1
1748423155591,CHIN 10AD,A01,913381,Liu; Mingming,10,0,12,2
1748423155591,CHIN 10AD,A02,913382,Liu; Mingming,10,0,12,2
1748423156618,CHIN 10AM,A01,913384,Chen; Pei-Chia,9,0,12,3
1748423156618,CHIN 10AM,A02,913385,Chen; Pei-Chia,10,0,12,2
1748423157653,CHIN 10AN,A01,913387,Xu; Li,10,0,10,0
1748423157653,CHIN 10AN,A02,913388,Xu; Li,10,0,10,0
1748423157653,CHIN 10AN,B01,913390,Xu; Li,9,0,10,1
1748423157653,CHIN 10AN,B02,913391,Xu; Li,8,0,10,2
1748423157653,CHIN 10AN,C01,913393,Xu; Li,12,0,12,0
1748423157653,CHIN 10AN,C02,913394,Xu; Li,11,0,12,1
1748423158684,CHIN 20AD,A01,913396,Liu; Mingming,12,0,14,2
1748423158684,CHIN 20AD,A02,913397,Liu; Mingming,13,0,14,1
1748423159717,CHIN 20AM,A01,913399,Wang; Xiao,11,0,12,1
1748423159717,CHIN 20AM,A02,913400,Wang; Xiao,9,0,12,3
1748423159717,CHIN 20AM,B01,913402,Wang; Xiao,12,0,12,0
1748423159717,CHIN 20AM,B02,913403,Wang; Xiao,12,0,12,0
1748423160746,CHIN 20AN,A01,913405,Anderson; Qin-Hong,8,0,12,4
1748423160746,CHIN 20AN,A02,913406,Anderson; Qin-Hong,7,0,12,5
1748423160746,CHIN 20AN,B01,913408,Anderson; Qin-Hong,6,0,12,6
1748423160746,CHIN 20AN,B02,913409,Anderson; Qin-Hong,9,0,12,3
1748423160746,CHIN 20AN,C01,913411,Anderson; Qin-Hong,11,0,12,1
1748423161777,CHIN 100AM,A00,913412,Wang; Xiao,12,0,15,3
1748423162804,CHIN 100AN,A00,913413,Chen; Pei-Chia,8,0,15,7
1748423163832,CHIN 185A,A00,913414,Liu; Mingming,15,0,15,0
1748423164860,CLIN 294A,A00,914822,Weingarten; Amanda Gooding,10,0,10,0
1748423165893,CLIN 296,A00,914825,Moore; David Joseph,100,0,100,0
1748423165893,CLIN 296,B00,914826,Brookman; Lauren Irene,5,0,5,0
1748423166923,CLIN 297,A00,914827,Wall; Tamara Lynn,100,0,100,0
1748423167949,CLRE 254,A00,914830,Vaida; Florin,9997,0,9999,2
1748423168975,CLRE 255,A01,914832,Cuomo; Raphael Eduardo,9997,0,9999,2
1748423170006,CLRE 256,A01,914835,Morris; Sheldon,9996,0,9999,3
1748423171058,CLRE 257,A00,914836,Mehta; Ravindra L.,9997,0,9999,2
1748423172086,CLRE 258,A00,914839,Mehta; Ravindra L.,9997,0,9999,2
1748423173112,CLRE 260,A00,914840,Cuomo; Raphael Eduardo,9999,0,9999,0
1748423174142,CLRE 295A,A00,914845,Cuomo; Raphael Eduardo,9999,0,9999,0
1748423175167,CLRE 297,001,914847,Cuomo; Raphael Eduardo,9999,0,9999,0
1748423176194,CLX 87,A00,913379,Castro; Robert Jess,20,0,20,0
1748423177221,COGR 200A,A00,914800,Dewaard; Andrew Michael,5,0,5,0
1748423178251,COGR 200C,A00,914801,Irani; Lilly C,5,0,5,0
1748423179281,COGR 225A,A00,914803,McKenzie; Kerry V.,10,0,10,0
1748423180307,COGR 225C,A00,914804,McKenzie; Kerry V.,9,0,10,1
1748423181335,COGR 275,A00,914805,Jack; Caroline Sarah,9,0,10,1
1748423181335,COGR 275,B00,914807,Zilberg; Elana,9,0,10,1
1748423181335,COGR 275,C00,914809,Goldfarb; Brian,7,0,10,3
1748423182363,COGS 1,A01,913420,Beatty-Martinez; Anne,47,0,56,9
1748423182363,COGS 1,A02,913421,Beatty-Martinez; Anne,39,0,56,17
1748423182363,COGS 1,A03,913422,Beatty-Martinez; Anne,51,0,55,4
1748423182363,COGS 1,A04,913423,Beatty-Martinez; Anne,46,0,50,4
1748423182363,COGS 1,A05,913424,Beatty-Martinez; Anne,41,0,50,9
1748423182363,COGS 1,A06,913425,Beatty-Martinez; Anne,44,0,50,6
1748423182363,COGS 1,A07,913426,Beatty-Martinez; Anne,48,0,50,2
1748423182363,COGS 1,A08,913427,Beatty-Martinez; Anne,45,0,50,5
1748423183393,COGS 2,A01,913429,Boyle; Mary E. T.,49,0,50,1
1748423183393,COGS 2,A02,913430,Boyle; Mary E. T.,47,0,50,3
1748423183393,COGS 2,A03,913431,Boyle; Mary E. T.,46,0,50,4
1748423183393,COGS 2,A04,913432,Boyle; Mary E. T.,49,0,50,1
1748423183393,COGS 2,A05,913433,Boyle; Mary E. T.,47,0,50,3
1748423184425,COGS 3,A01,913435,Boyle; Mary E. T.,48,0,60,12
1748423184425,COGS 3,A02,913436,Boyle; Mary E. T.,52,0,60,8
1748423185451,COGS 9,A01,913439,Khosla; Meenakshi,48,0,50,2
1748423185451,COGS 9,A02,913440,Khosla; Meenakshi,49,0,50,1
1748423185451,COGS 9,A03,913441,Khosla; Meenakshi,48,0,50,2
1748423185451,COGS 9,A04,913442,Khosla; Meenakshi,46,0,50,4
1748423185451,COGS 9,A05,913443,Khosla; Meenakshi,44,0,50,6
1748423185451,COGS 9,A06,913444,Khosla; Meenakshi,46,0,50,4
1748423186480,COGS 10,A01,913446,Staff,41,0,50,9
1748423186480,COGS 10,A02,913447,Staff,46,0,50,4
1748423186480,COGS 10,A03,913448,Staff,47,0,50,3
1748423186480,COGS 10,A04,913449,Staff,47,0,50,3
1748423186480,COGS 10,A05,913450,Staff,50,0,50,0
1748423186480,COGS 10,A06,913451,Staff,45,0,50,5
1748423187509,COGS 11,A01,913453,Boroditsky; Lera,142,0,149,7
1748423188538,COGS 14A,A01,913455,Creel; Sarah,29,0,50,21
1748423188538,COGS 14A,A02,913456,Creel; Sarah,37,0,50,13
1748423188538,COGS 14A,A03,913457,Creel; Sarah,42,0,50,8
1748423188538,COGS 14A,A04,913458,Creel; Sarah,45,0,50,5
1748423188538,COGS 14A,A05,913459,Creel; Sarah,47,0,50,3
1748423188538,COGS 14A,A06,913460,Creel; Sarah,48,0,50,2
1748423188538,COGS 14A,A07,913461,Creel; Sarah,46,0,50,4
1748423189617,COGS 14B,A01,913463,Barrera; Steven James,32,0,50,18
1748423189617,COGS 14B,A02,913464,Barrera; Steven James,45,0,50,5
1748423189617,COGS 14B,A03,913465,Barrera; Steven James,40,0,50,10
1748423189617,COGS 14B,A04,913466,Barrera; Steven James,46,0,50,4
1748423189617,COGS 14B,A05,913467,Barrera; Steven James,40,0,50,10
1748423190645,COGS 15,A01,913469,Bergen; Benjamin,57,0,60,3
1748423190645,COGS 15,A02,913470,Bergen; Benjamin,57,0,60,3
1748423191677,COGS 17,A01,913472,Johnson; Christine M.,38,0,50,12
1748423191677,COGS 17,A02,913473,Johnson; Christine M.,47,0,50,3
1748423191677,COGS 17,A03,913474,Johnson; Christine M.,39,0,50,11
1748423191677,COGS 17,A04,913475,Johnson; Christine M.,42,0,50,8
1748423191677,COGS 17,A05,913476,Johnson; Christine M.,48,0,50,2
1748423191677,COGS 17,A06,913477,Johnson; Christine M.,48,0,50,2
1748423191677,COGS 17,A07,913478,Johnson; Christine M.,50,0,54,4
1748423191677,COGS 17,A08,913479,Johnson; Christine M.,43,0,56,13
1748423192718,COGS 18,A01,913481,Morgan; Eric,27,0,35,8
1748423192718,COGS 18,A02,913482,Morgan; Eric,30,0,35,5
1748423192718,COGS 18,A03,913483,Morgan; Eric,29,0,35,6
1748423192718,COGS 18,A04,913484,Morgan; Eric,32,0,35,3
1748423192718,COGS 18,A05,913485,Morgan; Eric,31,0,35,4
1748423192718,COGS 18,A06,913486,Morgan; Eric,31,0,35,4
1748423192718,COGS 18,A07,913487,Morgan; Eric,30,0,35,5
1748423192718,COGS 18,A08,913488,Morgan; Eric,31,0,35,4
1748423192718,COGS 18,A09,913520,Morgan; Eric,27,0,35,8
1748423192718,COGS 18,B01,968089,Morgan; Eric,34,0,35,1
1748423192718,COGS 18,B02,968090,Morgan; Eric,35,0,35,0
1748423192718,COGS 18,B03,968091,Morgan; Eric,35,0,35,0
1748423192718,COGS 18,B04,968092,Morgan; Eric,35,0,35,0
1748423192718,COGS 18,B05,968093,Morgan; Eric,35,0,35,0
1748423192718,COGS 18,B06,968094,Morgan; Eric,35,0,35,0
1748423192718,COGS 18,B07,968095,Morgan; Eric,35,0,35,0
1748423192718,COGS 18,B08,968096,Morgan; Eric,34,0,35,1
1748423192718,COGS 18,B09,968097,Morgan; Eric,34,0,35,1
1748423193755,COGS 100,A01,913580,Staff,58,0,60,2
1748423193755,COGS 100,A02,913581,Staff,55,0,60,5
1748423193755,COGS 100,A03,913621,Staff,55,0,60,5
1748423193755,COGS 100,A04,913622,Staff,55,0,60,5
1748423193755,COGS 100,A05,913663,Staff,54,0,60,6
1748423194781,COGS 101A,A01,913705,Barrera; Steven James,37,0,50,13
1748423194781,COGS 101A,A02,913709,Barrera; Steven James,35,0,50,15
1748423194781,COGS 101A,A03,913713,Barrera; Steven James,18,0,50,32
1748423194781,COGS 101A,A04,913715,Barrera; Steven James,25,0,50,25
1748423194781,COGS 101A,A05,913718,Barrera; Steven James,44,0,50,6
1748423194781,COGS 101A,A06,913721,Barrera; Steven James,36,0,50,14
1748423194781,COGS 101A,A07,913722,Barrera; Steven James,41,0,50,9
1748423195807,COGS 101B,A01,913725,Hoffman; Drew Ellen,26,0,50,24
1748423195807,COGS 101B,A02,913726,Hoffman; Drew Ellen,44,0,50,6
1748423195807,COGS 101B,A03,913727,Hoffman; Drew Ellen,47,0,50,3
1748423195807,COGS 101B,A04,913730,Hoffman; Drew Ellen,50,0,50,0
1748423196835,COGS 102A,A01,968009,Staff,41,0,48,7
1748423196835,COGS 102A,A02,968010,Staff,36,0,48,12
1748423196835,COGS 102A,A03,968011,Staff,47,0,50,3
1748423197869,COGS 107A,A01,913748,Rangel; Lara M,44,0,56,12
1748423197869,COGS 107A,A02,913750,Rangel; Lara M,43,0,54,11
1748423197869,COGS 107A,A03,913751,Rangel; Lara M,31,0,50,19
1748423197869,COGS 107A,A04,913754,Rangel; Lara M,20,0,50,30
1748423197869,COGS 107A,A05,913755,Rangel; Lara M,27,0,50,23
1748423197869,COGS 107A,A06,913756,Rangel; Lara M,0,0,50,50
1748423198896,COGS 107B,A01,968098,Staff,0,0,50,50
1748423198896,COGS 107B,A02,968099,Staff,6,0,50,44
1748423198896,COGS 107B,A03,968102,Staff,37,0,49,12
1748423199925,COGS 108,A01,913846,Fleischer; Jason G,0,0,56,56
1748423199925,COGS 108,A02,913847,Fleischer; Jason G,17,0,56,39
1748423199925,COGS 108,A03,913858,Fleischer; Jason G,20,0,50,30
1748423199925,COGS 108,A04,913899,Fleischer; Jason G,44,0,55,11
1748423199925,COGS 108,A05,913984,Fleischer; Jason G,29,0,50,21
1748423199925,COGS 108,A06,914035,Fleischer; Jason G,31,0,50,19
1748423199925,COGS 108,A07,914036,Fleischer; Jason G,36,0,50,14
1748423199925,COGS 108,A08,914037,Fleischer; Jason G,44,0,50,6
1748423199925,COGS 108,B01,914039,Fleischer; Jason G,38,0,50,12
1748423199925,COGS 108,B02,914040,Fleischer; Jason G,48,0,50,2
1748423199925,COGS 108,B03,914172,Fleischer; Jason G,32,0,50,18
1748423199925,COGS 108,B04,914182,Fleischer; Jason G,36,0,50,14
1748423199925,COGS 108,B05,914185,Fleischer; Jason G,28,0,50,22
1748423199925,COGS 108,B06,914188,Fleischer; Jason G,19,0,50,31
1748423199925,COGS 108,B07,914209,Fleischer; Jason G,39,0,54,15
1748423199925,COGS 108,B08,914210,Fleischer; Jason G,49,0,56,7
1748423200951,COGS 109,A01,968106,Mukamel; Eran A,30,0,48,18
1748423200951,COGS 109,A02,968107,Mukamel; Eran A,39,0,49,10
1748423200951,COGS 109,A03,968108,Mukamel; Eran A,47,0,49,2
1748423201982,COGS 111,A01,914261,Hoffman; Drew Ellen,34,0,50,16
1748423201982,COGS 111,A02,914262,Hoffman; Drew Ellen,49,0,50,1
1748423201982,COGS 111,A03,914263,Hoffman; Drew Ellen,46,0,50,4
1748423201982,COGS 111,A04,914264,Hoffman; Drew Ellen,28,0,50,22
1748423203008,COGS 115,A01,914266,Deak; Gedeon O.,35,0,70,35
1748423204038,COGS 116,A01,914268,Greene; Deanna Jacquelyn,49,0,70,21
1748423205066,COGS 118A,A01,914270,Tu; Zhuowen,30,0,50,20
1748423205066,COGS 118A,A02,914271,Tu; Zhuowen,31,0,50,19
1748423205066,COGS 118A,A03,914272,Tu; Zhuowen,7,0,50,43
1748423205066,COGS 118A,A04,914273,Tu; Zhuowen,6,0,50,44
1748423206092,COGS 118B,A01,969817,De Sa; Virginia,32,0,49,17
1748423206092,COGS 118B,A02,969818,De Sa; Virginia,34,0,49,15
1748423206092,COGS 118B,A03,969819,De Sa; Virginia,31,0,49,18
1748423206092,COGS 118B,A04,969822,De Sa; Virginia,43,0,49,6
1748423207119,COGS 125,A00,968043,Klemmer; Scott R,48,0,50,2
1748423208145,COGS 128,A01,914278,Staff,16,0,50,34
1748423208145,COGS 128,A02,914279,Staff,0,0,50,50
1748423209175,COGS 143,A01,914284,Johnson; Christine M.,16,0,40,24
1748423210209,COGS 150,A01,968112,Staff,36,0,50,14
1748423210209,COGS 150,A02,968113,Staff,44,0,49,5
1748423210209,COGS 150,A03,968114,Staff,43,0,48,5
1748423211236,COGS 151,A00,968044,Coulson; Seana M,48,0,50,2
1748423212267,COGS 160,A00,914286,Kirsh; David Joel,25,0,25,0
1748423213297,COGS 165,A01,914291,Kiyonaga; Anastasia,0,0,50,50
1748423214324,COGS 187A,A01,914293,Kirsh; David Joel,0,0,50,50
1748423214324,COGS 187A,A02,914294,Kirsh; David Joel,0,0,50,50
1748423214324,COGS 187A,A03,914295,Kirsh; David Joel,16,0,49,33
1748423215350,COGS 189,A00,914296,De Sa; Virginia,119,0,200,81
1748423216378,COGS 190A,A00,914297,Staff,9999,0,9999,0
1748423217404,COGS 194,A00,914298,Hill; Seth J,9999,0,9999,0
1748423218431,COGS 203,A00,914326,Zettersten; Martin,11,0,20,9
1748423219457,COGS 210A,001,914327,Kirsh; David Joel,9999,0,9999,0
1748423219457,COGS 210A,002,914328,Greene; Deanna Jacquelyn,9998,0,9999,1
1748423219457,COGS 210A,003,914329,Xia; Haijun,9998,0,9999,1
1748423219457,COGS 210A,004,914330,Nitz; Douglas A.,9999,0,9999,0
1748423219457,COGS 210A,005,914331,Hollan; James D.,9999,0,9999,0
1748423219457,COGS 210A,006,914332,De Sa; Virginia,9998,0,9999,1
1748423219457,COGS 210A,007,914333,Rossano; Federico,9999,0,9999,0
1748423219457,COGS 210A,008,914334,Kiyonaga; Anastasia,9999,0,9999,0
1748423219457,COGS 210A,009,914335,Coulson; Seana M,9998,0,9999,1
1748423220486,COGS 211A,A00,914336,Boroditsky; Lera,9995,0,9999,4
1748423221515,COGS 230,A00,914337,Munyaka; Imani N. S.,3,0,15,12
1748423222541,COGS 234,A00,970720,Xia; Haijun,4,0,20,16
1748423223568,COGS 260,A00,914340,Voytek; Bradley Thomas,9994,0,9999,5
1748423224598,COMM 10,A01,914366,Whitworth-Smith; Andrew C,6,0,10,4
1748423224598,COMM 10,A02,914367,Whitworth-Smith; Andrew C,7,0,10,3
1748423224598,COMM 10,A03,914368,Whitworth-Smith; Andrew C,9,0,10,1
1748423224598,COMM 10,A04,914369,Whitworth-Smith; Andrew C,6,0,10,4
1748423224598,COMM 10,A05,914370,Whitworth-Smith; Andrew C,10,0,10,0
1748423224598,COMM 10,A06,914371,Whitworth-Smith; Andrew C,9,0,10,1
1748423224598,COMM 10,A07,914372,Whitworth-Smith; Andrew C,9,0,10,1
1748423224598,COMM 10,A08,914373,Whitworth-Smith; Andrew C,7,0,10,3
1748423224598,COMM 10,A09,914374,Whitworth-Smith; Andrew C,9,0,10,1
1748423224598,COMM 10,A10,914375,Whitworth-Smith; Andrew C,10,0,10,0
1748423224598,COMM 10,A11,914376,Whitworth-Smith; Andrew C,6,0,10,4
1748423224598,COMM 10,A12,914377,Whitworth-Smith; Andrew C,10,0,10,0
1748423225640,COMM 20,A01,914385,Hill; Erin Truesdell,75,0,75,0
1748423226670,COMM 40,A00,914386,Jack; Caroline Sarah,61,0,75,14
1748423227695,COMM 50,A00,914387,Staff,21,0,25,4
1748423228721,COMM 80,A01,914389,Staff,77,0,80,3
1748423229749,COMM 100A,A01,914391,Harb; Anthony Joseph,1,0,10,9
1748423229749,COMM 100A,A02,914392,Harb; Anthony Joseph,0,0,10,10
1748423229749,COMM 100A,A03,914393,Harb; Anthony Joseph,0,0,10,10
1748423229749,COMM 100A,A04,914394,Harb; Anthony Joseph,0,0,10,10
1748423229749,COMM 100A,A05,914395,Harb; Anthony Joseph,0,0,10,10
1748423229749,COMM 100A,A06,914396,Harb; Anthony Joseph,0,0,10,10
1748423229749,COMM 100A,A07,914397,Harb; Anthony Joseph,1,0,10,9
1748423229749,COMM 100A,A08,914398,Harb; Anthony Joseph,6,0,10,4
1748423229749,COMM 100A,A09,914399,Harb; Anthony Joseph,7,0,10,3
1748423229749,COMM 100A,A10,914400,Harb; Anthony Joseph,7,0,10,3
1748423230776,COMM 101,A01,914404,Martinico; Daniel J,8,0,15,7
1748423230776,COMM 101,A02,914405,Martinico; Daniel J,2,0,15,13
1748423230776,COMM 101,A03,914406,Martinico; Daniel J,1,0,15,14
1748423230776,COMM 101,A04,914407,Martinico; Daniel J,13,0,15,2
1748423231805,COMM 101K,A00,914408,Staff,0,0,0,0
1748423232838,COMM 101M,A00,914409,Halm; Gavin Patrick,10,0,18,8
1748423233865,COMM 101N,A00,914410,Martinico; Daniel J,4,0,16,12
1748423234893,COMM 101T,A00,914411,Davis; Zeinabu I.,12,0,18,6
1748423235925,COMM 102C,A01,914417,Campion; Camille E,0,0,6,6
1748423235925,COMM 102C,A02,914423,Campion; Camille E,0,0,6,6
1748423235925,COMM 102C,A03,914432,Campion; Camille E,0,0,6,6
1748423236951,COMM 106,A00,914439,Kidman; Shawna F,54,0,70,16
1748423237977,COMM 106F,A00,914442,Hill; Erin Truesdell,23,0,42,19
1748423239008,COMM 106N,A00,914480,Hallin; Daniel C,46,0,70,24
1748423240038,COMM 108D,A00,914491,Goldfarb; Brian,45,0,46,1
1748423241069,COMM 113T,A00,914493,Dominguez Rubio; Fernando,43,0,46,3
1748423242095,COMM 114E,A00,914767,Pavon Aramburu; Maria Laur,41,0,44,3
1748423243121,COMM 114I,A00,914768,Rojo Solis; Juan Jose,39,0,44,5
1748423244152,COMM 115,A00,914769,Alac; Morana,35,0,46,11
1748423245181,COMM 119,A01,914771,Staff,50,0,50,0
1748423246208,COMM 120M,A00,914773,Abuelhiga; Soraya Jill,37,0,44,7
1748423247235,COMM 127,A00,914774,Abuelhiga; Soraya Jill,33,0,44,11
1748423248263,COMM 133,A00,914775,Dewey; Matthew D,35,0,44,9
1748423249293,COMM 134,A00,914777,Kidman; Shawna F,31,0,44,13
1748423250321,COMM 135,A00,914778,Davis; Zeinabu I.,43,0,46,3
1748423251347,COMM 142,A00,914779,McKenna; Denise,22,0,44,22
1748423252373,COMM 146,A00,914780,Halm; Gavin Patrick,34,0,44,10
1748423252373,COMM 146,B00,968068,Ybarra; Megan,41,0,44,3
1748423253399,COMM 148,A00,914785,Staff,0,0,0,0
1748423254430,COMM 164,A00,914786,Dominguez Rubio; Fernando,9,0,25,16
1748423255459,COMM 173,A00,914787,Alac; Morana,4,0,25,21
1748423256487,COMM 177,A00,914788,Rojo Solis; Juan Jose,2,0,25,23
1748423257518,COMM 185,A00,914792,Boateng; Boatema,21,0,25,4
1748423258547,COMM 190,B00,914793,Staff,0,0,23,23
1748423258547,COMM 190,C00,914794,Staff,10,0,23,13
1748423258547,COMM 190,D00,914795,Hassanpour; Anvar,4,0,23,19
1748423259577,COMM 194,A00,954115,Hill; Seth J,9999,0,9999,0
1748423260606,COMM 196A,A00,914796,Dewaard; Andrew Michael,0,0,0,1
1748423261635,CSE 3,A50,914849,Alvarado; Christine J.,49,0,50,1
1748423261635,CSE 3,A51,914850,Alvarado; Christine J.,49,0,50,1
1748423261635,CSE 3,A52,914852,Alvarado; Christine J.,46,0,46,0
1748423262663,CSE 6R,A01,914856,Soosai Raj; Adalbert Geral,238,0,250,12
1748423263694,CSE 8A,A50,914860,Soosai Raj; Adalbert Geral,2,0,3,1
1748423263694,CSE 8A,A51,914868,Soosai Raj; Adalbert Geral,0,0,3,3
1748423263694,CSE 8A,A52,914870,Soosai Raj; Adalbert Geral,1,0,3,2
1748423263694,CSE 8A,A53,914871,Soosai Raj; Adalbert Geral,1,0,3,2
1748423263694,CSE 8A,A54,914872,Soosai Raj; Adalbert Geral,2,0,3,1
1748423263694,CSE 8A,A55,914873,Soosai Raj; Adalbert Geral,2,0,3,1
1748423263694,CSE 8A,A56,914875,Soosai Raj; Adalbert Geral,3,0,3,0
1748423263694,CSE 8A,A57,914876,Soosai Raj; Adalbert Geral,1,0,3,2
1748423264728,CSE 11,A01,958990,Cao; Yingjun,0,0,50,50
1748423264728,CSE 11,B01,959775,Ochoa; Benjamin Lawrence,103,0,115,12
1748423265754,CSE 12,A01,958991,Cao; Yingjun,0,0,100,100
1748423266788,CSE 20,A01,959784,Jones; Miles E,0,0,25,25
1748423266788,CSE 20,A02,968053,Jones; Miles E,1,0,25,24
1748423267819,CSE 21,A01,959776,Jones; Miles E,0,0,30,30
1748423267819,CSE 21,A02,968059,Jones; Miles E,2,0,30,28
1748423268855,CSE 29,A50,914888,Politz; Joseph Gibbs,0,0,10,10
1748423268855,CSE 29,A51,914889,Politz; Joseph Gibbs,0,0,10,10
1748423268855,CSE 29,A52,914891,Politz; Joseph Gibbs,0,0,10,10
1748423268855,CSE 29,A53,914892,Politz; Joseph Gibbs,0,0,10,10
1748423268855,CSE 29,B50,914897,Shalev; Aaron D,0,0,10,10
1748423268855,CSE 29,B51,914898,Shalev; Aaron D,0,0,10,10
1748423268855,CSE 29,B52,914900,Shalev; Aaron D,0,0,10,10
1748423268855,CSE 29,B53,914901,Shalev; Aaron D,0,0,10,10
1748423269884,CSE 30,A01,959778,Eldon; John,0,0,15,15
1748423270915,CSE 87,A00,914904,Moshiri; Niema,20,0,20,0
1748423271945,CSE 89,A00,914906,Minnes Kemp; Mor Mia,100,0,100,0
1748423271945,CSE 89,B00,969276,Minnes Kemp; Mor Mia,100,0,100,0
1748423272974,CSE 95,A00,914907,Cao; Yingjun,100,0,100,0
1748423274000,CSE 100,A01,959787,Moshiri; Niema,0,0,75,75
1748423275029,CSE 100R,A01,914911,Moshiri; Niema,0,0,125,125
1748423276065,CSE 101,A01,958995,Impagliazzo; Russell,0,0,30,30
1748423276065,CSE 101,A02,958998,Impagliazzo; Russell,0,0,30,30
1748423276065,CSE 101,A03,959000,Impagliazzo; Russell,0,0,30,30
1748423276065,CSE 101,B01,959777,Liu; Qipeng,94,0,175,81
1748423277092,CSE 103,A01,959001,Freund; Yoav,69,0,96,27
1748423278119,CSE 105,A01,959785,Lovett; Shachar,0,0,45,45
1748423279151,CSE 107,A01,959002,Bellare; Mihir,81,0,96,15
1748423280179,CSE 110,A50,914923,Coblenz; Michael J,10,0,50,40
1748423280179,CSE 110,A51,914925,Coblenz; Michael J,18,0,50,32
1748423280179,CSE 110,A52,914926,Coblenz; Michael J,44,0,50,6
1748423280179,CSE 110,A53,914928,Coblenz; Michael J,33,0,50,17
1748423280179,CSE 110,A54,914930,Coblenz; Michael J,42,0,50,8
1748423280179,CSE 110,A55,914931,Coblenz; Michael J,36,0,45,9
1748423281207,CSE 118,A50,914934,Weibel; Nadir,16,0,25,9
1748423282233,CSE 120,A01,959780,Voelker; Geoffrey M.,130,0,295,165
1748423283262,CSE 127,A01,959795,Savage; Stefan,88,0,192,104
1748423284292,CSE 130,A01,959003,Polikarpova; Nadezhda,118,0,145,27
1748423285323,CSE 131,A01,914941,Politz; Joseph Gibbs,33,0,50,17
1748423286353,CSE 132A,A01,959790,Gupta; Amarnath,141,0,196,55
1748423287386,CSE 134B,A01,959005,Powell; Thomas Allan,115,0,146,31
1748423288412,CSE 140,A01,914947,Orailoglu; Alex,124,0,146,22
1748423289437,CSE 140L,A01,914949,Orailoglu; Alex,112,0,146,34
1748423290470,CSE 141,A01,959006,Pannuto; Patrick William,79,0,146,67
1748423291501,CSE 141L,A01,961134,Eldon; John,75,0,146,71
1748423292533,CSE 142,A01,959781,Swanson; Steven James,250,0,295,45
1748423293618,CSE 150A,A01,959774,Bonjour; Trevor,101,0,225,124
1748423294646,CSE 150B,A01,959791,Solares; Edwin A,187,0,196,9
1748423295676,CSE 151A,A01,959782,Dasgupta; Sanjoy,187,0,250,63
1748423295676,CSE 151A,B01,959783,Dasgupta; Sanjoy,226,0,250,24
1748423296708,CSE 152A,A01,959792,Su; Hao,0,0,0,0
1748423297741,CSE 158,A01,959793,McAuley; Julian John,100,0,196,96
1748423298771,CSE 158R,A01,914961,McAuley; Julian John,449,0,550,101
1748423298771,CSE 158R,B01,968064,McAuley; Julian John,100,0,100,0
1748423299801,CSE 167,A01,959796,Li; Tzumao,110,0,192,82
1748423300831,CSE 170,A01,914965,Vaccaro; Kristen Marie,13,0,20,7
1748423300831,CSE 170,A02,914967,Vaccaro; Kristen Marie,0,0,20,20
1748423300831,CSE 170,A03,914968,Vaccaro; Kristen Marie,17,0,20,3
1748423300831,CSE 170,A04,914969,Vaccaro; Kristen Marie,15,0,20,5
1748423300831,CSE 170,A05,914970,Vaccaro; Kristen Marie,17,0,20,3
1748423300831,CSE 170,A06,914971,Vaccaro; Kristen Marie,18,0,20,2
1748423300831,CSE 170,A07,914972,Vaccaro; Kristen Marie,16,0,19,3
1748423300831,CSE 170,A08,914973,Vaccaro; Kristen Marie,1,0,19,18
1748423300831,CSE 170,A09,914974,Vaccaro; Kristen Marie,8,0,19,11
1748423300831,CSE 170,A10,969577,Vaccaro; Kristen Marie,18,0,19,1
1748423301858,CSE 190,A00,914975,Vaccaro; Kristen Marie,146,0,146,0
1748423302889,CSE 191,A00,914976,Minnes Kemp; Mor Mia,9999,0,9999,0
1748423303917,CSE 193,A01,959007,Bonjour; Trevor,50,0,50,0
1748423304945,CSE 194,A01,959009,Munyaka; Imani N. S.,6,0,60,54
1748423305974,CSE 197,001,914980,Minnes Kemp; Mor Mia,9999,0,9999,0
1748423307002,CSE 202,A00,914981,Liu; Qipeng,0,0,0,0
1748423308033,CSE 206A,A00,914982,Micciancio; Daniele,0,0,0,0
1748423309063,CSE 207B,A00,914983,Heninger; Nadia A,0,0,0,0
1748423310089,CSE 209A,A00,914984,Impagliazzo; Russell,0,0,0,0
1748423311119,CSE 209B,A00,914985,Bellare; Mihir,0,0,0,0
1748423312144,CSE 210,A00,914986,Powell; Thomas Allan,0,0,0,0
1748423313170,CSE 216,A00,914987,Munyaka; Imani N. S.,0,0,0,0
1748423314202,CSE 221,A00,914988,Ousterhout; Amy,0,0,0,0
1748423315232,CSE 227,A00,914989,Fernandes; Earlence T,0,0,0,0
1748423316263,CSE 229A,A00,914990,Snoeren; Alex C.,0,0,0,0
1748423317291,CSE 229C,A00,914993,Fernandes; Earlence T,0,0,0,0
1748423318319,CSE 237C,A00,914994,Kastner; Ryan Charles,0,0,0,0
1748423319356,CSE 239B,A00,914996,D'Antoni; Loris,0,0,0,0
1748423320383,CSE 240A,A00,914997,Tullsen; Dean Michael,0,0,0,0
1748423321408,CSE 249E,A00,914998,Pannuto; Patrick William,0,0,0,0
1748423322437,CSE 250A,A00,914999,Bonjour; Trevor,0,0,0,0
1748423323464,CSE 252A,A00,915000,Ochoa; Benjamin Lawrence,0,0,0,0
1748423324492,CSE 258,A01,959794,McAuley; Julian John,0,0,0,0
1748423325518,CSE 258R,A01,915004,McAuley; Julian John,0,0,0,0
1748423326550,CSE 259,A00,915005,Prithviraj; Ammanabrolu,0,0,0,0
1748423327584,CSE 260,A01,959011,Chin; Bryan W.,0,0,0,0
1748423328618,CSE 270,A01,959012,Chern; Albert Ren-Haur,0,0,0,0
1748423329648,CSE 276A,A00,915009,Christensen; Henrik I,0,0,0,0
1748423330685,CSE 290,A00,915013,Bafna; Vineet,0,0,0,0
1748423330685,CSE 290,B00,915014,Nakashole; Ndapandula,0,0,0,0
1748423330685,CSE 290,C00,915015,Ramamoorthi; Ravi,0,0,0,0
1748423330685,CSE 290,D00,915017,Tullsen; Dean Michael,0,0,0,0
1748423330685,CSE 290,F00,915020,Vaccaro; Kristen Marie,0,0,0,0
1748423331716,CSE 291A,A00,915021,Yu; Qi,0,0,0,0
1748423331716,CSE 291A,B00,915022,Weibel; Nadir,0,0,0,0
1748423331716,CSE 291A,C00,915049,Munyaka; Imani N. S.,0,0,0,0
1748423331716,CSE 291A,D00,968730,Zhang; Yiying,0,0,0,0
1748423332745,CSE 291P,A00,915050,D'Antoni; Loris,0,0,0,0
1748423332745,CSE 291P,B00,915051,Ding; Yufei,0,0,0,0
1748423333774,CSE 291T,A00,915052,Grier; Daniel T,0,0,0,0
1748423333774,CSE 291T,B00,915053,Heninger; Nadia A,0,0,0,0
1748423334801,CSE 291Y,A00,915054,Fernandes; Earlence T,0,0,0,0
1748423335830,CSE 292,A00,968504,Ousterhout; Amy,0,0,0,0
1748423336914,CSE 293,001,968115,Bafna; Vineet,9999,0,9999,0
1748423336914,CSE 293,002,968116,Bellare; Mihir,9999,0,9999,0
1748423336914,CSE 293,003,968122,Berg-Kirkpatrick; Taylor D,9999,0,9999,0
1748423336914,CSE 293,004,968298,Chandraker; Manmohan Krishna,9999,0,9999,0
1748423336914,CSE 293,005,968317,Cheng; Chung Kuan,9999,0,9999,0
1748423336914,CSE 293,006,968334,Christensen; Henrik I,9999,0,9999,0
1748423336914,CSE 293,007,968339,Coblenz; Michael J,9999,0,9999,0
1748423336914,CSE 293,008,968345,Cottrell; Garrison W,9999,0,9999,0
1748423336914,CSE 293,009,968346,Deutsch; Alin Bernard,9999,0,9999,0
1748423336914,CSE 293,010,968357,Esmaeilzadeh; Hadi,9999,0,9999,0
1748423336914,CSE 293,011,968359,Freund; Yoav,9999,0,9999,0
1748423336914,CSE 293,012,968427,Griswold; William G.,9999,0,9999,0
1748423336914,CSE 293,013,968472,Gymrek; Melissa Ann,9999,0,9999,0
1748423336914,CSE 293,014,968473,Heninger; Nadia A,9999,0,9999,0
1748423336914,CSE 293,015,968480,Impagliazzo; Russell,9999,0,9999,0
1748423336914,CSE 293,016,968489,Jhala; Ranjit,9999,0,9999,0
1748423336914,CSE 293,017,968490,Kahng; Andrew Byun,9999,0,9999,0
1748423336914,CSE 293,018,968494,Kane; Daniel Mertz,9999,0,9999,0
1748423336914,CSE 293,019,968495,Kriegman; David J,9999,0,9999,0
1748423336914,CSE 293,020,968496,Kumar; Arun Kumar,9999,0,9999,0
1748423336914,CSE 293,021,968497,Lerner; Sorin,9999,0,9999,0
1748423336914,CSE 293,022,968498,Lovett; Shachar,9999,0,9999,0
1748423336914,CSE 293,023,968499,McAuley; Julian John,9999,0,9999,0
1748423336914,CSE 293,024,968501,Micciancio; Daniele,9999,0,9999,0
1748423336914,CSE 293,025,968502,Orailoglu; Alex,9999,0,9999,0
1748423336914,CSE 293,026,968503,Pannuto; Patrick William,9999,0,9999,0
1748423336914,CSE 293,027,968505,Paturi; Ramamohan,9999,0,9999,0
1748423336914,CSE 293,028,968506,Polikarpova; Nadezhda,9999,0,9999,0
1748423336914,CSE 293,029,968507,Politz; Joseph Gibbs,9999,0,9999,0
1748423336914,CSE 293,030,968508,Porter; George M,9999,0,9999,0
1748423336914,CSE 293,031,968509,Porter; Leonard Emerson,9999,0,9999,0
1748423336914,CSE 293,032,968510,Ramamoorthi; Ravi,9999,0,9999,0
1748423336914,CSE 293,033,968511,Riek; Laurel D,9999,0,9999,0
1748423336914,CSE 293,034,968512,Sahoo; Debashis,9999,0,9999,0
1748423336914,CSE 293,035,968513,Saul; Lawrence,9999,0,9999,0
1748423336914,CSE 293,036,968514,Savage; Stefan,9999,0,9999,0
1748423336914,CSE 293,037,968515,Schulze; Jurgen P.,9999,0,9999,0
1748423336914,CSE 293,038,968516,Snoeren; Alex C.,9999,0,9999,0
1748423336914,CSE 293,039,968517,Shang; Jingbo,9999,0,9999,0
1748423336914,CSE 293,040,968575,Stefan; Deian,9999,0,9999,0
1748423336914,CSE 293,041,968580,Su; Hao,9999,0,9999,0
1748423336914,CSE 293,042,968589,Swanson; Steven James,9999,0,9999,0
1748423336914,CSE 293,043,968639,Tullsen; Dean Michael,9999,0,9999,0
1748423336914,CSE 293,044,968674,Vaccaro; Kristen Marie,9999,0,9999,0
1748423336914,CSE 293,045,968681,Voelker; Geoffrey M.,9999,0,9999,0
1748423336914,CSE 293,046,968692,Zhao; Jishen,9999,0,9999,0
1748423336914,CSE 293,047,968694,Zhou; Yuan-Yuan,9999,0,9999,0
1748423336914,CSE 293,048,968702,Gao; Sicun,9999,0,9999,0
1748423336914,CSE 293,049,968703,Weibel; Nadir,9999,0,9999,0
1748423336914,CSE 293,050,968704,Gupta; Rajesh K.,9999,0,9999,0
1748423336914,CSE 293,051,968705,Soosai Raj; Adalbert Geral,9999,0,9999,0
1748423337943,CSE 294,A00,915055,Orailoglu; Alex,0,0,0,0
1748423338975,CSS 1,A01,958041,Staff,31,0,41,10
1748423338975,CSS 1,A02,958042,Staff,41,0,41,0
1748423338975,CSS 1,A03,958043,Staff,33,0,41,8
1748423338975,CSS 1,A04,958044,Staff,39,0,41,2
1748423340001,CSS 120,A01,915059,Staff,0,0,0,0
1748423341030,CSS 204,A01,915061,Long; Bria,0,0,0,0
1748423342065,CSS 209,A00,915062,Staff,14,0,40,26
1748423343100,DDPM 200,A00,919742,Ma; Joseph David,35,0,35,0
1748423344127,DDPM 201,A00,919743,Ma; Joseph David,35,0,35,0
1748423345154,DDPM 202,A00,919761,Reed; Chantal,35,0,35,0
1748423346188,DDPM 203,A00,963085,Momper; Jeremiah D,40,0,40,0
1748423347223,DOC 1,A01,916077,Staff,4,0,4,0
1748423347223,DOC 1,A02,916080,Staff,1,0,4,3
1748423347223,DOC 1,A03,916081,Staff,1,0,4,3
1748423347223,DOC 1,A04,916082,Staff,3,0,4,1
1748423347223,DOC 1,A05,916083,Staff,2,0,4,2
1748423347223,DOC 1,A06,916084,Staff,4,0,4,0
1748423347223,DOC 1,A07,916085,Staff,4,0,4,0
1748423347223,DOC 1,A08,916096,Staff,4,0,4,0
1748423347223,DOC 1,A09,916097,Staff,4,0,4,0
1748423347223,DOC 1,A10,916099,Staff,4,0,4,0
1748423347223,DOC 1,A11,916170,Staff,0,0,0,0
1748423347223,DOC 1,A12,916186,Staff,0,0,0,0
1748423347223,DOC 1,A13,916203,Staff,4,0,4,0
1748423347223,DOC 1,A14,916222,Staff,4,0,4,0
1748423347223,DOC 1,A15,916223,Staff,4,0,4,0
1748423347223,DOC 1,A16,916224,Staff,4,0,4,0
1748423347223,DOC 1,B01,916279,Staff,4,0,4,0
1748423347223,DOC 1,B02,916281,Staff,2,0,4,2
1748423347223,DOC 1,B03,916282,Staff,3,0,4,1
1748423347223,DOC 1,B04,916283,Staff,3,0,4,1
1748423347223,DOC 1,B05,916284,Staff,2,0,4,2
1748423347223,DOC 1,B06,916285,Staff,3,0,4,1
1748423347223,DOC 1,B07,916287,Staff,4,0,4,0
1748423347223,DOC 1,B08,916288,Staff,3,0,4,1
1748423347223,DOC 1,B09,916289,Staff,0,0,0,0
1748423347223,DOC 1,B10,916290,Staff,0,0,0,0
1748423347223,DOC 1,B11,916349,Staff,4,0,4,0
1748423347223,DOC 1,B12,916375,Staff,4,0,4,0
1748423347223,DOC 1,B13,916381,Staff,3,0,4,1
1748423347223,DOC 1,B14,916382,Staff,2,0,4,2
1748423347223,DOC 1,B15,916383,Staff,4,0,4,0
1748423347223,DOC 1,B16,916384,Staff,3,0,4,1
1748423347223,DOC 1,C01,916386,Staff,4,0,4,0
1748423347223,DOC 1,C02,916387,Staff,4,0,4,0
1748423347223,DOC 1,C03,916388,Staff,4,0,4,0
1748423347223,DOC 1,C04,916389,Staff,0,0,4,4
1748423347223,DOC 1,C05,916390,Staff,2,0,4,2
1748423347223,DOC 1,C06,916391,Staff,2,0,4,2
1748423347223,DOC 1,C07,916392,Staff,4,0,4,0
1748423347223,DOC 1,C08,916417,Staff,4,0,4,0
1748423347223,DOC 1,C09,916418,Staff,0,0,0,0
1748423347223,DOC 1,C10,916426,Staff,0,0,0,0
1748423347223,DOC 1,C11,916497,Staff,4,0,4,0
1748423347223,DOC 1,C12,916506,Staff,3,0,4,1
1748423347223,DOC 1,C13,916507,Staff,3,0,4,1
1748423347223,DOC 1,C14,916508,Staff,3,0,4,1
1748423347223,DOC 1,C15,916509,Staff,4,0,4,0
1748423347223,DOC 1,C16,916510,Staff,4,0,4,0
1748423347223,DOC 1,D01,916512,Staff,4,0,4,0
1748423347223,DOC 1,D02,916513,Staff,4,0,4,0
1748423347223,DOC 1,D03,916514,Staff,4,0,4,0
1748423347223,DOC 1,D04,916515,Staff,4,0,4,0
1748423347223,DOC 1,D05,916516,Staff,1,0,4,3
1748423347223,DOC 1,D06,916555,Staff,4,0,4,0
1748423347223,DOC 1,D07,916581,Staff,4,0,4,0
1748423347223,DOC 1,D08,916582,Staff,4,0,4,0
1748423347223,DOC 1,D09,916583,Staff,0,0,0,0
1748423347223,DOC 1,D10,916584,Staff,0,0,0,0
1748423347223,DOC 1,D11,916585,Staff,4,0,4,0
1748423347223,DOC 1,D12,916586,Staff,4,0,4,0
1748423347223,DOC 1,D13,916587,Staff,4,0,4,0
1748423347223,DOC 1,D14,916588,Staff,4,0,4,0
1748423347223,DOC 1,D15,916589,Staff,3,0,4,1
1748423347223,DOC 1,D16,916590,Staff,4,0,4,0
1748423348253,DOC 100D,A00,916591,Pass; Natalye,22,0,25,3
1748423348253,DOC 100D,B00,916838,Pass; Natalye,22,0,25,3
1748423349283,DSC 10,A01,915848,Tiefenbruck; Janine LoBue,0,0,0,0
1748423349283,DSC 10,B01,915851,Tiefenbruck; Janine LoBue,0,0,0,0
1748423349283,DSC 10,C01,915854,Tiefenbruck; Janine LoBue,0,0,0,0
1748423350318,DSC 20,A01,915857,Langlois; Marina,87,0,90,3
1748423351345,DSC 30,A01,915859,Liao; Soohyun Nam,175,0,180,5
1748423352370,DSC 40A,A01,915861,Mishne; Gal,167,0,180,13
1748423353401,DSC 40B,A01,915863,Langlois; Marina,126,0,149,23
1748423354429,DSC 80,A01,915865,Eldridge; Justin Matthew,117,0,145,28
1748423354429,DSC 80,B01,915867,Eldridge; Justin Matthew,140,0,145,5
1748423355460,DSC 95,A01,915869,Langlois; Marina,50,0,50,0
1748423356494,DSC 100,A01,915871,Shannon; Kyle Michael,97,0,150,53
1748423357525,DSC 102,A01,915890,Kolovos; Alexandros,128,0,150,22
1748423358554,DSC 106,A01,915892,Lau; Samuel Ethan,74,0,90,16
1748423358554,DSC 106,B01,915894,Lau; Samuel Ethan,53,0,90,37
1748423359585,DSC 140A,A01,915896,Ustun; Tevfik Berk,135,0,150,15
1748423360617,DSC 161,A00,968072,Roberts; Margaret Earling,24,0,25,1
1748423361662,DSC 180A,A01,915898,Bellur; Umesh,0,0,0,0
1748423361662,DSC 180A,A02,969828,Bellur; Umesh,0,0,0,0
1748423361662,DSC 180A,A03,969829,Bellur; Umesh,0,0,0,0
1748423361662,DSC 180A,A04,969830,Bellur; Umesh,0,0,0,0
1748423361662,DSC 180A,A05,969831,Bellur; Umesh,0,0,0,0
1748423361662,DSC 180A,A06,969833,Bellur; Umesh,0,0,0,0
1748423361662,DSC 180A,A07,969835,Bellur; Umesh,0,0,0,0
1748423361662,DSC 180A,A08,969836,Bellur; Umesh,0,0,0,0
1748423361662,DSC 180A,A09,969978,Bellur; Umesh,0,0,0,0
1748423361662,DSC 180A,A10,969985,Bellur; Umesh,0,0,0,0
1748423361662,DSC 180A,A11,969986,Bellur; Umesh,0,0,0,0
1748423361662,DSC 180A,A12,970002,Bellur; Umesh,0,0,0,0
1748423361662,DSC 180A,A13,970008,Bellur; Umesh,0,0,0,0
1748423361662,DSC 180A,A14,970011,Bellur; Umesh,0,0,0,0
1748423361662,DSC 180A,A15,970014,Bellur; Umesh,0,0,0,0
1748423361662,DSC 180A,A16,970019,Bellur; Umesh,0,0,0,0
1748423361662,DSC 180A,A17,970020,Bellur; Umesh,0,0,0,0
1748423361662,DSC 180A,B01,915901,Bellur; Umesh,0,0,0,0
1748423361662,DSC 180A,B02,915902,Bellur; Umesh,0,0,0,0
1748423361662,DSC 180A,B03,970021,Bellur; Umesh,0,0,0,0
1748423361662,DSC 180A,B04,970024,Bellur; Umesh,0,0,0,0
1748423361662,DSC 180A,B05,970025,Bellur; Umesh,0,0,0,0
1748423361662,DSC 180A,B06,970028,Bellur; Umesh,0,0,0,0
1748423361662,DSC 180A,B07,970030,Bellur; Umesh,0,0,0,0
1748423361662,DSC 180A,B08,970031,Bellur; Umesh,0,0,0,0
1748423361662,DSC 180A,B09,970034,Bellur; Umesh,0,0,0,0
1748423361662,DSC 180A,B10,970035,Bellur; Umesh,0,0,0,0
1748423361662,DSC 180A,B11,970042,Bellur; Umesh,0,0,0,0
1748423361662,DSC 180A,B12,970043,Bellur; Umesh,0,0,0,0
1748423361662,DSC 180A,B13,970047,Bellur; Umesh,0,0,0,0
1748423361662,DSC 180A,B14,970049,Bellur; Umesh,0,0,0,0
1748423361662,DSC 180A,B15,970050,Bellur; Umesh,0,0,0,0
1748423361662,DSC 180A,B16,970052,Bellur; Umesh,0,0,0,0
1748423361662,DSC 180A,B17,970057,Bellur; Umesh,0,0,0,0
1748423361662,DSC 180A,B18,970060,Bellur; Umesh,0,0,0,0
1748423361662,DSC 180A,B19,970063,Bellur; Umesh,0,0,0,0
1748423361662,DSC 180A,B20,970068,Bellur; Umesh,0,0,0,0
1748423361662,DSC 180A,B21,970070,Bellur; Umesh,0,0,0,0
1748423361662,DSC 180A,B22,970071,Bellur; Umesh,0,0,0,0
1748423361662,DSC 180A,B23,970075,Bellur; Umesh,0,0,0,0
1748423361662,DSC 180A,B24,970076,Bellur; Umesh,0,0,0,0
1748423361662,DSC 180A,B25,970083,Bellur; Umesh,0,0,0,0
1748423361662,DSC 180A,B26,970072,Bellur; Umesh,0,0,0,0
1748423362698,DSC 190,A01,915904,Schwartzman; Armin,176,0,200,24
1748423362698,DSC 190,C01,915908,Ma; Yian,48,0,60,12
1748423363725,DSC 197,001,971692,Eldridge; Justin Matthew,9999,0,9999,0
1748423364753,DSC 200,A00,915909,Watson-Parris; Duncan,0,0,100,100
1748423365786,DSC 204A,A00,915910,Zhang; Hao,65,0,90,25
1748423366813,DSC 207R,A01,915912,Soosai Raj; Adalbert Geral,99,0,100,1
1748423367840,DSC 209R,A01,915922,Lau; Samuel Ethan,34,0,75,41
1748423368872,DSC 210,A00,915979,Weng; Tsui-Wei (lily),0,0,100,100
1748423369901,DSC 212,A00,915984,Mazumdar; Arya,0,0,90,90
1748423370928,DSC 215R,A01,916032,Saab; Rayan,99,0,100,1
1748423372990,DSC 241,A00,916052,Aoi; Mikio C,81,0,90,9
1748423374017,DSC 256R,A01,916054,McAuley; Julian John,42,0,100,58
1748423375043,DSC 257R,A01,916057,Dasgupta; Sanjoy,50,0,75,25
1748423376071,DSC 261,A00,916058,Salimi; Babak,0,0,90,90
1748423377106,DSC 291,A00,916059,Rahman; Tauhidur,0,0,60,60
1748423377106,DSC 291,B00,916060,Wang; Yuxiang,0,0,60,60
1748423377106,DSC 291,C00,916061,Li; Aobo,0,0,40,40
1748423378132,DSC 293,A00,916062,Ustun; Tevfik Berk,9983,0,9999,16
1748423379164,DSC 294,001,970730,Danks; David J,9999,0,9999,0
1748423379164,DSC 294,002,970731,Hu; Zhiting,9999,0,9999,0
1748423379164,DSC 294,003,970732,Schwartzman; Armin,9999,0,9999,0
1748423379164,DSC 294,004,970739,Salimi; Babak,9999,0,9999,0
1748423379164,DSC 294,005,970742,Wang; Yuxiang,9999,0,9999,0
1748423379164,DSC 294,006,970749,Huang; Biwei,9999,0,9999,0
1748423379164,DSC 294,007,970751,Amariuta-Bartell; Tiffany,9999,0,9999,0
1748423379164,DSC 294,008,970754,Smarr; Benjamin,9999,0,9999,0
1748423379164,DSC 294,009,970755,Jin; Haojian,9999,0,9999,0
1748423379164,DSC 294,010,970758,Ma; Yian,9999,0,9999,0
1748423379164,DSC 294,011,970763,Warstadt; Alexander Scott,9999,0,9999,0
1748423379164,DSC 294,012,970764,Wang; Yusu,9999,0,9999,0
1748423379164,DSC 294,013,970766,Lau; Samuel Ethan,9999,0,9999,0
1748423379164,DSC 294,014,970771,Politis; Dimitris,9999,0,9999,0
1748423380193,DSE 200,A00,915842,Staff,30,0,30,0
1748423381222,DSE 203,A00,915844,Staff,20,0,20,0
1748423382247,DSE 220,A00,915845,Staff,20,0,20,0
1748423383273,DSE 290,A00,915846,Staff,30,0,30,0
1748423384300,DSGN 1,A01,913417,Meyer; Michael Wayne,0,0,50,50
1748423384300,DSGN 1,A02,913418,Meyer; Michael Wayne,15,0,50,35
1748423386355,DSGN 118,A01,914325,Xia; Haijun,0,0,50,50
1748423387382,DSGN 201,A00,970721,Eikey; Elizabeth Victoria,10,0,20,10
1748423388413,ECE 5,A01,917741,Morris; Karcher William,0,0,0,0
1748423388413,ECE 5,A02,917742,Morris; Karcher William,0,0,0,0
1748423388413,ECE 5,A03,917775,Morris; Karcher William,0,0,0,0
1748423388413,ECE 5,A04,917804,Morris; Karcher William,0,0,0,0
1748423388413,ECE 5,A05,917811,Morris; Karcher William,0,0,0,0
1748423388413,ECE 5,A06,917816,Morris; Karcher William,0,0,0,0
1748423389443,ECE 15,A01,917850,Schurgers; Curt,0,0,0,0
1748423389443,ECE 15,A02,917851,Schurgers; Curt,0,0,0,0
1748423390470,ECE 17,A01,917878,Sahay; Rajeev,61,0,65,4
1748423391497,ECE 18,A01,917886,Sahay; Rajeev,42,0,50,8
1748423392532,ECE 25,A50,917898,Liu; Zhaowei,0,0,0,0
1748423392532,ECE 25,A51,917900,Liu; Zhaowei,0,0,0,0
1748423392532,ECE 25,A52,917904,Liu; Zhaowei,0,0,0,0
1748423392532,ECE 25,A53,969573,Liu; Zhaowei,0,0,0,0
1748423393558,ECE 30,A50,917909,Mir Arabbaygi; Siavash,11,0,30,19
1748423393558,ECE 30,A51,917910,Mir Arabbaygi; Siavash,21,0,30,9
1748423393558,ECE 30,A52,917912,Mir Arabbaygi; Siavash,29,0,30,1
1748423394590,ECE 35,A50,917993,Schurgers; Curt,0,0,0,0
1748423394590,ECE 35,A51,917994,Schurgers; Curt,0,0,0,0
1748423394590,ECE 35,A52,918000,Schurgers; Curt,0,0,0,0
1748423394590,ECE 35,A53,918001,Schurgers; Curt,0,0,0,0
1748423394590,ECE 35,A54,918072,Schurgers; Curt,0,0,0,0
1748423394590,ECE 35,A55,918078,Schurgers; Curt,0,0,0,0
1748423394590,ECE 35,B50,918131,Schurgers; Curt,0,0,0,0
1748423394590,ECE 35,B51,918135,Schurgers; Curt,0,0,0,0
1748423394590,ECE 35,B52,918146,Schurgers; Curt,0,0,0,0
1748423394590,ECE 35,B53,918147,Schurgers; Curt,0,0,0,0
1748423394590,ECE 35,B54,918148,Schurgers; Curt,0,0,0,0
1748423394590,ECE 35,B55,918149,Schurgers; Curt,0,0,0,0
1748423395623,ECE 45,A01,918151,Zeger; Kenneth A.,94,0,120,26
1748423396659,ECE 65,A50,918356,Baghdadchi; Saharnaz,1,0,30,29
1748423396659,ECE 65,A51,918470,Baghdadchi; Saharnaz,17,0,30,13
1748423396659,ECE 65,A52,918477,Baghdadchi; Saharnaz,25,0,30,5
1748423397762,ECE 100,A01,918485,Baghdadchi; Saharnaz,0,0,30,30
1748423397762,ECE 100,A02,918486,Baghdadchi; Saharnaz,1,0,30,29
1748423397762,ECE 100,A03,918488,Baghdadchi; Saharnaz,0,0,30,30
1748423397762,ECE 100,A04,918490,Baghdadchi; Saharnaz,22,0,30,8
1748423398790,ECE 101,A01,918495,Zheng; Yang,21,0,75,54
1748423398790,ECE 101,A02,918497,Zheng; Yang,51,0,75,24
1748423399819,ECE 102,A00,918499,Hsueh; Tzu-Chien,52,0,100,48
1748423400848,ECE 103,A01,918621,Ng; Tse Nga,45,0,60,15
1748423401882,ECE 107,A01,918642,Fullerton; Eric E,31,0,70,39
1748423402910,ECE 108,A01,918661,Turakhia; Yatish Girish,6,0,70,64
1748423403939,ECE 109,A01,918758,Poveda Fonseca; Jorge,122,0,149,27
1748423404969,ECE 111,A01,918766,Koushanfar; Farinaz,46,0,75,29
1748423405997,ECE 121A,A50,918857,Esmaili; Gholamreza,11,0,24,13
1748423405997,ECE 121A,A51,918888,Esmaili; Gholamreza,15,0,24,9
1748423405997,ECE 121A,A52,918889,Esmaili; Gholamreza,2,0,24,22
1748423407023,ECE 128A,A00,918911,Esmaili; Gholamreza,53,0,75,22
1748423408056,ECE 135A,A01,918931,Kuzum; Duygu,24,0,40,16
1748423409085,ECE 143,A00,918936,Staff,0,0,0,3
1748423410117,ECE 148,A01,918940,Silberman; Jack,14,0,24,10
1748423411144,ECE 155,A01,919022,Gonzalez Prelcic; Nuria,20,0,25,5
1748423412176,ECE 158A,A01,919041,Javidi; Tara,58,0,70,12
1748423413203,ECE 161A,A01,919070,Meyer; Florian,65,0,80,15
1748423414231,ECE 164,A00,919098,Hall; Drew A.,100,0,146,46
1748423415261,ECE 166,A50,919250,Rebeiz; Gabriel,0,0,30,30
1748423415261,ECE 166,A51,919254,Rebeiz; Gabriel,23,0,30,7
1748423415261,ECE 166,A52,919262,Rebeiz; Gabriel,29,0,30,1
1748423415261,ECE 166,A53,919316,Rebeiz; Gabriel,28,0,30,2
1748423416288,ECE 171B,A01,919338,Shi; Yuanyuan,36,0,50,14
1748423417315,ECE 174,A01,919371,Wang; Jun-Kun,77,0,100,23
1748423418347,ECE 180,A00,968047,Fainman; Yeshaiahu,30,0,30,0
1748423419376,ECE 182,A01,962444,Fainman; Yeshaiahu,24,0,30,6
1748423420401,ECE 197,001,919379,Mercier; Patrick Philip,9999,0,9999,0
1748423421433,ECE 198,001,919418,Nguyen; Truong Quang,9999,0,9999,0
1748423422462,ECE 201,A00,919420,Lo; Yu-Hwa,0,0,0,0
1748423423489,ECE 203,A01,919506,Mercier; Patrick Philip,0,0,0,0
1748423424518,ECE 207A,A00,919507,Liu; Thomas Tao-Ming & McVeigh; Elliot R.,0,0,0,0
1748423425550,ECE 212AN,A00,919508,Nomura; Kenji,0,0,0,0
1748423426576,ECE 222A,A00,919524,Rebeiz; Gabriel,0,0,0,0
1748423427606,ECE 225A,A00,919525,Orlitsky; Alon,0,0,0,0
1748423428637,ECE 230A,A00,919526,Nomura; Kenji,0,0,0,0
1748423429668,ECE 238A,A00,919540,Luo; Jian,0,0,0,0
1748423430695,ECE 240A,A00,919541,Ndao; Abdoulaye,0,0,0,0
1748423431722,ECE 247A,A00,919553,Shi; Lingyan,0,0,0,0
1748423432752,ECE 247B,A00,919562,Aran; Kiana,0,0,0,0
1748423433782,ECE 250,A00,919563,Naghizadeh Ardabili; Parinaz,0,0,0,0
1748423434814,ECE 251C,A00,919583,Parhi; Rahul,0,0,0,0
1748423435845,ECE 253,A00,919597,Nguyen; Truong Quang,0,0,0,0
1748423436873,ECE 255A,A00,919638,Orlitsky; Alon,0,0,0,0
1748423437905,ECE 257A,A01,919640,Zhang; Xinyu,0,0,0,0
1748423438932,ECE 258A,A00,919653,Heath Jr.; Robert Wendell,0,0,0,0
1748423439963,ECE 260A,A01,919655,Eldon; John,0,0,0,0
1748423440995,ECE 264C,A00,919656,Galton; Ian A,0,0,0,0
1748423442028,ECE 265C,A00,919672,Staff,0,0,0,0
1748423443056,ECE 271A,A00,919673,Vasconcelos; Nuno,0,0,0,0
1748423444083,ECE 276C,A00,919674,Yip; Michael,0,0,0,0
1748423445117,ECE 283,A00,919675,Le; Hanh-Phuc,0,0,0,0
1748423445117,ECE 283,B00,919676,Hall; Drew A.,0,0,0,0
1748423446145,ECE 284,A00,919691,Kang; Mingu,0,0,0,0
1748423447175,ECE 285,A00,919718,Naghizadeh Ardabili; Parinaz,0,0,0,0
1748423448216,ECON 1,A01,917129,Famulari; Melissa,33,0,40,7
1748423448216,ECON 1,A02,917130,Famulari; Melissa,39,0,40,1
1748423448216,ECON 1,A03,917131,Famulari; Melissa,45,0,45,0
1748423448216,ECON 1,B01,917133,Famulari; Melissa,39,0,40,1
1748423448216,ECON 1,B02,917134,Famulari; Melissa,38,0,40,2
1748423448216,ECON 1,B03,917135,Famulari; Melissa,45,0,45,0
1748423448216,ECON 1,C01,917137,Levkoff; Steven B.,53,0,60,7
1748423448216,ECON 1,C02,917138,Levkoff; Steven B.,60,0,60,0
1748423448216,ECON 1,C03,917139,Levkoff; Steven B.,59,0,60,1
1748423448216,ECON 1,C04,917140,Levkoff; Steven B.,60,0,60,0
1748423448216,ECON 1,C05,917141,Levkoff; Steven B.,59,0,60,1
1748423448216,ECON 1,D01,917144,Levkoff; Steven B.,44,0,50,6
1748423448216,ECON 1,D02,917145,Levkoff; Steven B.,50,0,50,0
1748423448216,ECON 1,D03,917146,Levkoff; Steven B.,50,0,50,0
1748423448216,ECON 1,D04,917154,Levkoff; Steven B.,50,0,50,0
1748423449250,ECON 2,A01,917160,Crane; Meredith Helen,35,0,45,10
1748423449250,ECON 2,A02,917164,Crane; Meredith Helen,43,0,45,2
1748423450279,ECON 3,A01,917170,Ma; Alyson Chan,41,0,60,19
1748423451309,ECON 4,A01,917174,Brooks; Marcus Raymond,0,0,0,0
1748423452336,ECON 5,A01,917177,Staff,12,0,30,18
1748423452336,ECON 5,B01,917182,Staff,16,0,30,14
1748423452336,ECON 5,C01,917193,Dai; Yinlin,0,0,30,30
1748423453364,ECON 86,A00,917197,Muendler; Marc,95,0,100,5
1748423454393,ECON 100A,A01,917209,Newhouse; Herbert S,32,0,50,18
1748423454393,ECON 100A,A02,917212,Newhouse; Herbert S,35,0,50,15
1748423454393,ECON 100A,A03,917213,Newhouse; Herbert S,41,0,50,9
1748423454393,ECON 100A,B01,917216,Newhouse; Herbert S,0,0,50,50
1748423454393,ECON 100A,B02,917298,Newhouse; Herbert S,21,0,50,29
1748423454393,ECON 100A,B03,917301,Newhouse; Herbert S,44,0,50,6
1748423455425,ECON 100B,A01,917305,Crane; Meredith Helen,0,0,75,75
1748423455425,ECON 100B,B01,917309,Crane; Meredith Helen,0,0,75,75
1748423456452,ECON 100C,A01,917311,Staff,0,0,25,25
1748423457486,ECON 109,A01,917313,Shishkin; Denis,58,0,65,7
1748423457486,ECON 109,B01,917315,Shishkin; Denis,59,0,75,16
1748423458514,ECON 110A,A01,917336,Jaimovich; Nir,44,0,70,26
1748423458514,ECON 110A,B01,917339,Jaimovich; Nir,19,0,37,18
1748423458514,ECON 110A,B02,917341,Jaimovich; Nir,36,0,38,2
1748423459541,ECON 110B,A01,917388,Trottner; Fabian Gunter We,0,0,50,50
1748423459541,ECON 110B,A02,917389,Trottner; Fabian Gunter We,0,0,50,50
1748423459541,ECON 110B,A03,917390,Trottner; Fabian Gunter We,14,0,50,36
1748423459541,ECON 110B,B01,917396,Trottner; Fabian Gunter We,26,0,50,24
1748423460577,ECON 120A,A01,917401,Dai; Yinlin,21,0,50,29
1748423460577,ECON 120A,A02,917405,Dai; Yinlin,40,0,50,10
1748423460577,ECON 120A,B01,917408,Dai; Yinlin,0,0,40,40
1748423460577,ECON 120A,B02,917409,Dai; Yinlin,0,0,40,40
1748423460577,ECON 120A,B03,917410,Dai; Yinlin,31,0,40,9
1748423461606,ECON 120B,A01,917415,Candido; Maria Teresa,0,0,98,98
1748423461606,ECON 120B,A02,917418,Candido; Maria Teresa,78,0,98,20
1748423461606,ECON 120B,B01,917422,Candido; Maria Teresa,34,0,98,64
1748423461606,ECON 120B,B02,917423,Candido; Maria Teresa,75,0,98,23
1748423462632,ECON 120C,A01,917505,Candido; Maria Teresa,81,0,146,65
1748423463659,ECON 121,A00,917511,Vogl; Tom Saul,68,0,70,2
1748423463659,ECON 121,B00,917516,Vogl; Tom Saul,55,0,70,15
1748423464702,ECON 130,A00,917518,Staff,165,0,190,25
1748423465771,ECON 131,A00,917519,Jacobsen; Mark,56,0,120,64
1748423466796,ECON 139,A00,917520,Arnold; David Hall,21,0,50,29
1748423467823,ECON 152,A00,917523,Fadlon; Yizhak,87,0,90,3
1748423467823,ECON 152,B00,917524,Fadlon; Yizhak,88,0,90,2
1748423468864,ECON 181,A00,965256,Esfahani; Sara,88,0,100,12
1748423469893,ECON 186,A00,917525,Ross; Stephen Geoffrey,80,0,110,30
1748423470923,ECON 191B,A00,917527,Cullen; Julie,20,0,20,0
1748423471955,ECON 200A,A00,917529,Shishkin; Denis,20,0,20,0
1748423472980,ECON 204,A00,917531,Watson; Joel Christopher,25,0,25,0
1748423474006,ECON 205,A00,917532,Du; Songzi,20,0,20,0
1748423475036,ECON 210A,A00,917536,Alon; Titan Michael,20,0,20,0
1748423476062,ECON 220A,A00,917537,Elliott; Graham,20,0,20,0
1748423477099,ECON 220D,A00,917538,Hamilton; James D.,22,0,30,8
1748423478129,ECON 221,A00,960527,Zhu; Ying,20,0,20,0
1748423479160,ECON 232,A00,917539,Fadlon; Yizhak,18,0,20,2
1748423480186,ECON 242,A00,917540,Vogl; Tom Saul & Lee; Munseob,17,0,20,3
1748423481223,ECON 250A,A00,917544,Berman; Eli & Betts; Julian & Arnold; David Hall,21,0,25,4
1748423482248,ECON 262,A00,917546,Trevino; Isabel,20,0,20,0
1748423483275,ECON 268,A00,917547,Boomhower; Judson P,18,0,20,2
1748423484300,ECON 280,A00,917549,Arnold; David Hall,20,0,20,0
1748423485326,ECON 281,A00,917550,Jacobsen; Mark,20,0,20,0
1748423485326,ECON 281,B00,917553,Jaimovich; Nir,15,0,20,5
1748423486352,ECON 285,A00,917554,Bharadwaj; Prashant & Zhu; Ying,24,0,25,1
1748423487382,ECON 286,A00,917556,Ma; Xinwei,20,0,20,0
1748423487382,ECON 286,B00,917558,Eckert; Fabian Paul & Wu; Pak Yeung,20,0,20,0
1748423487382,ECON 286,C00,917559,Bharadwaj; Prashant,20,0,20,0
1748423487382,ECON 286,D00,969571,Cullen; Julie,20,0,20,0
1748423487382,ECON 286,E00,969572,Vespa; Emanuel Ignacio,19,0,20,1
1748423488437,ECON 296,A00,917565,Bharadwaj; Prashant & Zhu; Ying,24,0,25,1
1748423489471,EDS 31,A00,960270,Bussey; Thomas J,5,0,10,5
1748423490497,EDS 88,A00,960441,Bintliff; Amy S.V.,16,0,20,4
1748423491529,EDS 110R,A01,943452,Wishard Guerra; Alison G.,33,0,60,27
1748423491529,EDS 110R,B01,960792,Wishard Guerra; Alison G.,20,0,20,0
1748423492560,EDS 111,A00,969314,Cohen; Shana R,31,0,60,29
1748423493585,EDS 112,A00,969313,Chapman; Thandeka K,32,0,50,18
1748423494609,EDS 114,A01,943493,Eguchi; Emi,19,0,20,1
1748423494609,EDS 114,A02,943494,Eguchi; Emi,18,0,20,2
1748423495634,EDS 115,A00,943495,Jones; Gabrielle Anastasia,46,0,60,14
1748423496665,EDS 117,A01,943675,Jones; Makeba,17,0,37,20
1748423496665,EDS 117,A02,943682,Jones; Makeba,36,0,37,1
1748423496665,EDS 117,A03,943683,Jones; Makeba,33,0,38,5
1748423496665,EDS 117,A04,943691,Jones; Makeba,35,0,38,3
1748423496665,EDS 117,B01,943693,Jones; Gabrielle Anastasia,21,0,30,9
1748423496665,EDS 117,B02,943694,Jones; Gabrielle Anastasia,27,0,30,3
1748423496665,EDS 117,B03,943695,Jones; Gabrielle Anastasia,28,0,30,2
1748423496665,EDS 117,B04,943696,Jones; Gabrielle Anastasia,30,0,30,0
1748423497697,EDS 124AR,A00,943698,Simon; Elizabeth A,129,0,150,21
1748423497697,EDS 124AR,B00,943699,Simon; Elizabeth A,149,0,150,1
1748423497697,EDS 124AR,C00,961307,Simon; Elizabeth A,40,0,40,0
1748423498721,EDS 124BR,A00,943700,Eguchi; Emi,122,0,150,28
1748423498721,EDS 124BR,B00,961276,Eguchi; Emi,20,0,20,0
1748423499746,EDS 125,A00,943701,Jones; Gabrielle Anastasia,49,0,60,11
1748423500774,EDS 129A,A01,943703,Heinzman; Erica M.,48,0,50,2
1748423501855,EDS 130,A01,943705,Staff,6,0,20,14
1748423501855,EDS 130,A02,943706,Staff,18,0,20,2
1748423501855,EDS 130,A03,943707,Staff,20,0,20,0
1748423502884,EDS 131,A01,943709,Staff,8,0,20,12
1748423502884,EDS 131,A02,943710,Staff,17,0,20,3
1748423503924,EDS 133,A01,960443,Bintliff; Amy S.V.,20,0,25,5
1748423503924,EDS 133,A02,960447,Bintliff; Amy S.V.,15,0,15,0
1748423504949,EDS 139,A00,943725,Heinzman; Erica M.,40,0,50,10
1748423504949,EDS 139,B00,943726,Staff,29,0,50,21
1748423504949,EDS 139,C00,943788,Staff,34,0,50,16
1748423504949,EDS 139,E00,943802,Bintliff; Amy S.V.,42,0,50,8
1748423504949,EDS 139,F00,960448,Bintliff; Amy S.V.,40,0,40,0
1748423505973,EDS 149,A00,943814,Black; Alison Michelle,20,0,20,0
1748423506998,EDS 201,A00,943816,Fine; Sarah,44,0,45,1
1748423508023,EDS 203,A01,943818,Eguchi; Emi,44,0,45,1
1748423509051,EDS 205A,A00,943819,Staff,44,0,45,1
1748423510080,EDS 246,A01,943855,Cohen; Shana R,10,0,10,0
1748423511105,EDS 250,A00,943856,Chapman; Thandeka K,49,0,50,1
1748423512165,EDS 251,A00,943862,Wishard Guerra; Alison G.,10,0,10,0
1748423513191,EDS 257,A00,943863,Datnow; Amanda Lee,7,0,10,3
1748423514231,EDS 283,A00,943871,Daly; Alan J.,15,0,15,0
1748423515255,EDS 285,A00,943872,Daly; Alan J.,15,0,15,0
1748423516282,EDS 286,A00,943873,Daly; Alan J.,15,0,15,0
1748423517308,EDS 289D,A00,943874,Hofstetter; Carolyn,15,0,15,0
1748423518336,EDS 292,A00,943876,Hofstetter; Carolyn,15,0,15,0
1748423519412,EDS 296,001,970523,Aragon; Maria Jose,9999,0,9999,0
1748423519412,EDS 296,002,970539,Bintliff; Amy S.V.,9997,0,9999,2
1748423519412,EDS 296,003,970543,Chapman; Thandeka K,9999,0,9999,0
1748423519412,EDS 296,004,970544,Clarke; Sherice Nicole,9999,0,9999,0
1748423519412,EDS 296,005,970587,Cohen; Shana R,9998,0,9999,1
1748423519412,EDS 296,006,970606,Daly; Alan J.,9998,0,9999,1
1748423519412,EDS 296,007,970607,Datnow; Amanda Lee,9997,0,9999,2
1748423519412,EDS 296,008,970608,Eguchi; Emi,9999,0,9999,0
1748423519412,EDS 296,009,970609,Fine; Sarah,9999,0,9999,0
1748423519412,EDS 296,010,970614,Hofstetter; Carolyn,9998,0,9999,1
1748423519412,EDS 296,011,970615,Hopkins; Megan Beth,9998,0,9999,1
1748423519412,EDS 296,012,970616,Jones; Makeba,9999,0,9999,0
1748423519412,EDS 296,013,970631,Jones; Gabrielle Anastasia,9999,0,9999,0
1748423519412,EDS 296,014,970636,Mamas; Christoforos,9998,0,9999,1
1748423519412,EDS 296,015,970649,Phuong; Andrew,9999,0,9999,0
1748423519412,EDS 296,016,970670,Pollock; Mica,9999,0,9999,0
1748423519412,EDS 296,017,970671,Wishard Guerra; Alison G.,9998,0,9999,1
1748423520441,EDS 297,001,972987,Staff,1,0,1,0
1748423521473,ENG 5,A00,916064,Rodriguez; Ruben,70,0,70,0
1748423522520,ENG 10,A00,916066,Evdokimenko; Ekaterina,58,0,60,2
1748423523545,ENG 15,A00,916067,Evdokimenko; Ekaterina,24,0,30,6
1748423524576,ENG 100D,A00,916069,Ngo; Anh-Thu T.,23,0,50,27
1748423525612,ENG 100L,A00,916070,Kleissl; Jan,8,0,8,0
1748423525612,ENG 100L,B00,916071,Bratton; Maryann,8,0,8,0
1748423525612,ENG 100L,C00,916072,Goldberg; Charles G.,8,0,8,0
1748423525612,ENG 100L,D00,916073,de Oliveira; Mauricio,8,0,8,0
1748423525612,ENG 100L,E00,916074,Bratton; Maryann,8,0,8,0
1748423525612,ENG 100L,F00,916075,Boyle; Mary E. T.,8,0,8,0
1748423526639,ENVR 30,A01,959899,Amoa-Bosompem; Michael,17,0,30,13
1748423526639,ENVR 30,A02,959900,Amoa-Bosompem; Michael,27,0,30,3
1748423526639,ENVR 30,A03,959901,Amoa-Bosompem; Michael,26,0,30,4
1748423526639,ENVR 30,A04,959902,Amoa-Bosompem; Michael,28,0,30,2
1748423526639,ENVR 30,A05,959903,Amoa-Bosompem; Michael,29,0,30,1
1748423526639,ENVR 30,A06,959904,Amoa-Bosompem; Michael,30,0,30,0
1748423527668,ENVR 102,A00,960031,Laughing; Cheron,23,0,25,2
1748423528700,ERC 20,A00,921227,Evans; Ivan T,30,0,30,0
1748423528700,ERC 20,B00,921229,Evans; Ivan T,30,0,30,0
1748423529729,ERC 88,A00,961214,Peterson; Johanna L,19,0,20,1
1748423530761,ESYS 101,A01,921233,Taylor; Jennifer Rebecca,21,0,32,11
1748423530761,ESYS 101,A02,921234,Taylor; Jennifer Rebecca,14,0,32,18
1748423530761,ESYS 101,A03,921235,Taylor; Jennifer Rebecca,20,0,32,12
1748423530761,ESYS 101,A04,921241,Taylor; Jennifer Rebecca,26,0,32,6
1748423531795,ESYS 187A,A01,921248,Hetherington; Elizabeth Dorsey,30,0,40,10
1748423531795,ESYS 187A,B01,921250,Shipp; Lauren Elizabeth,27,0,40,13
1748423532827,ETHN 1,A01,919800,Wilson; Brenda K,13,0,15,2
1748423532827,ETHN 1,A02,919843,Wilson; Brenda K,14,0,15,1
1748423532827,ETHN 1,A03,920214,Wilson; Brenda K,15,0,15,0
1748423532827,ETHN 1,A04,920215,Wilson; Brenda K,14,0,15,1
1748423532827,ETHN 1,A05,920223,Wilson; Brenda K,15,0,15,0
1748423532827,ETHN 1,A06,920224,Wilson; Brenda K,15,0,15,0
1748423532827,ETHN 1,A07,920225,Wilson; Brenda K,15,0,15,0
1748423532827,ETHN 1,A08,920226,Wilson; Brenda K,12,0,15,3
1748423532827,ETHN 1,A09,920237,Wilson; Brenda K,15,0,15,0
1748423532827,ETHN 1,A10,920368,Wilson; Brenda K,15,0,15,0
1748423532827,ETHN 1,A11,920402,Wilson; Brenda K,15,0,15,0
1748423532827,ETHN 1,A12,920406,Wilson; Brenda K,15,0,15,0
1748423532827,ETHN 1,A13,920410,Wilson; Brenda K,14,0,15,1
1748423532827,ETHN 1,A14,920441,Wilson; Brenda K,14,0,15,1
1748423533860,ETHN 20R,A01,920461,Sasaki; Christen T,0,0,15,15
1748423533860,ETHN 20R,A02,920467,Sasaki; Christen T,0,0,15,15
1748423533860,ETHN 20R,A03,920468,Sasaki; Christen T,0,0,15,15
1748423533860,ETHN 20R,A04,920470,Sasaki; Christen T,0,0,15,15
1748423534886,ETHN 100A,A00,920489,Patel; Shaista,18,0,35,17
1748423535919,ETHN 101TV,A01,920518,Gallagher-Geurtsen; Tricia Meghan,21,0,25,4
1748423535919,ETHN 101TV,A02,920519,Gallagher-Geurtsen; Tricia Meghan,20,0,25,5
1748423535919,ETHN 101TV,A03,920522,Gallagher-Geurtsen; Tricia Meghan,24,0,25,1
1748423535919,ETHN 101TV,A04,920523,Gallagher-Geurtsen; Tricia Meghan,23,0,25,2
1748423536947,ETHN 110,A00,920528,Klann; Mary Cameron,27,0,35,8
1748423537979,ETHN 116,A00,920529,Cuong; Marisol,29,0,35,6
1748423539006,ETHN 120,A00,920542,Tran; Ly Thi Hai,31,0,35,4
1748423540037,ETHN 122A,A00,920559,Museus; Samuel David,30,0,35,5
1748423541066,ETHN 125R,A00,920694,Sasaki; Christen T,0,0,35,35
1748423542099,ETHN 130,A00,920703,Frank; Ross H.,28,0,30,2
1748423543126,ETHN 139,A00,920704,Ruiz; Ariana,18,0,20,2
1748423544158,ETHN 150,A00,920717,Taylor-Garcia; Daphne,16,0,16,0
1748423545185,ETHN 161,A00,920826,Browne; Errol Tsekani,33,0,35,2
1748423546215,ETHN 174,A00,963091,Staff,15,0,15,0
1748423547245,ETHN 186,A00,959881,Perez; Roy,25,0,30,5
1748423548271,ETHN 187,A00,920860,Martin Sandino; Amanda Maria Yoland,16,0,16,0
1748423549297,ETHN 189,A00,920861,Museus; Samuel David,18,0,20,2
1748423550328,ETHN 200A,A00,920862,Espiritu; Yen,7,0,10,3
1748423551356,ETHN 230,A00,920864,Perreira; Christopher Michael,8,0,10,2
1748423552446,ETIM 289,A00,921224,Patel; Shaista,10,0,10,0
1748423553475,EXPR 100,A00,964355,Staff,9999,0,9999,0
1748423554502,EXPR 105,A00,964356,Staff,9999,0,9999,0
1748423555526,EXPR 201,A00,964357,Staff,9999,0,9999,0
1748423556552,EXPR 205,A00,964358,Staff,9999,0,9999,0
1748423557588,FILM 71,A01,960804,Park; Joanne Moeun,0,0,11,11
1748423557588,FILM 71,B01,960877,Park; Joanne Moeun,3,0,11,8
1748423558615,FILM 72,A01,964349,Kroopf; Jackson Stanford,9,0,11,2
1748423558615,FILM 72,B01,964351,Kroopf; Jackson Stanford,9,0,11,2
1748423559642,FILM 73,A01,964345,Staff,0,0,0,0
1748423559642,FILM 73,B01,964347,Kroopf; Jackson Stanford,7,0,11,4
1748423560669,FMPH 291,A00,969582,Tsuyuki; Kiyomi,10,0,10,0
1748423561703,FPM 291,A00,922036,Rabin; Adrienn Borsika & Stadnick; Nicole & Aarons; Gregory A,12,0,12,0
1748423562730,GLBH 20,A00,921344,Elwardani; Nile Regina,137,0,146,9
1748423563767,GLBH 100,A00,921503,Jenkins; Janis A.,5,0,12,7
1748423563767,GLBH 100,B00,921504,Schonberg; Jeffrey,18,0,20,2
1748423564805,GLBH 111,A01,921733,Burgos; Jose L.,17,0,17,0
1748423564805,GLBH 111,B01,921862,Burgos; Jose L.,17,0,17,0
1748423565835,GLBH 114,A00,921864,Olivas Hernandez; Olga Lid,42,0,50,8
1748423566866,GLBH 116,A00,921865,Villarino; Margarita,41,0,45,4
1748423567895,GLBH 117,A00,921873,Villarino; Margarita,40,0,40,0
1748423568919,GLBH 118,A00,921884,Wilson; Brenda K,25,0,32,7
1748423569946,GLBH 119,A00,921956,Elwardani; Nile Regina,40,0,40,0
1748423570977,GLBH 148,A00,921961,Walkover; Lillian B,75,0,100,25
1748423572003,GLBH 181,A00,921962,Burgos; Jose L.,188,0,216,28
1748423573032,GLBH 200,A00,921963,Schonberg; Jeffrey,15,0,18,3
1748423574060,GLBH 201,A00,921982,Staff,16,0,18,2
1748423575091,GLBH 248,A00,921999,Kaiser; Bronwyn Nicole,16,0,18,2
1748423576119,GPEC 243,A00,946441,McCord; Gordon Carlos,96,0,100,4
1748423577147,GSS 20,A00,923030,Siapno; Jacqueline A,38,0,40,2
1748423577147,GSS 20,B00,923031,Siapno; Jacqueline A,36,0,40,4
1748423578178,HDS 1,A01,923033,Reese; Clarissa Jane,25,0,25,0
1748423578178,HDS 1,A02,923034,Reese; Clarissa Jane,20,0,25,5
1748423578178,HDS 1,A03,923035,Reese; Clarissa Jane,19,0,25,6
1748423578178,HDS 1,A04,923036,Reese; Clarissa Jane,22,0,25,3
1748423578178,HDS 1,A05,923037,Reese; Clarissa Jane,22,0,25,3
1748423578178,HDS 1,A06,923038,Reese; Clarissa Jane,23,0,25,2
1748423578178,HDS 1,A07,923039,Reese; Clarissa Jane,24,0,25,1
1748423579214,HDS 60,A01,923041,Staff,25,0,30,5
1748423579214,HDS 60,A02,923042,Staff,21,0,30,9
1748423580240,HDS 111,A00,923043,Staff,13,0,40,27
1748423581267,HDS 124,A00,923044,Staff,29,0,40,11
1748423582293,HDS 150,A00,923045,Staff,20,0,20,0
1748423583318,HDS 175,A00,923046,Staff,14,0,25,11
1748423584345,HDS 181,A01,923048,Staff,30,0,30,0
1748423585370,HDS 191,A01,923050,Reese; Clarissa Jane,25,0,25,0
1748423586398,HIEA 112,A00,922103,Matsumura; Wendy Y,92,0,115,23
1748423587425,HIEA 153,A00,922106,Henry; Todd A.,43,0,51,8
1748423588450,HIEU 108,A00,922108,Balberg; Mira,29,0,70,41
1748423589476,HIEU 114,A00,959889,Staff,59,0,70,11
1748423590503,HIEU 139,A00,922110,Strasser; Ulrike,40,0,51,11
1748423591533,HIEU 140,A00,922111,Radcliff; Pamela B.,58,0,65,7
1748423592560,HIEU 154,A00,922113,Hansen; Jan Eric,55,0,65,10
1748423593587,HIEU 158,A00,922116,Hertz; Deborah,61,0,70,9
1748423594619,HIEU 171,A00,922117,Hertz; Deborah,15,0,15,0
1748423595646,HIEU 271,A00,922189,Hertz; Deborah,0,0,0,0
1748423596673,HIGR 200,A00,922191,Matsumura; Wendy Y,10,0,10,0
1748423597700,HIGR 210,A00,922221,Muscolino; Micah S,8,0,10,2
1748423598726,HIGR 222,A00,963094,Biess; Frank Peter,10,0,10,0
1748423599757,HIGR 238,A00,922242,McKenzie; Kerry V.,9,0,10,1
1748423600789,HIGR 240,A00,922253,McKenzie; Kerry V.,10,0,10,0
1748423601820,HIGR 267A,A00,922256,Widener; Daniel,8,0,10,2
1748423603873,HILA 114,A00,922118,Cowan; Benjamin A,42,0,65,23
1748423604898,HILA 131,A00,922125,Vitz; Matthew,91,0,99,8
1748423605977,HILA 161,A00,922126,Cowan; Benjamin A,12,0,15,3
1748423607005,HILD 2A,A01,922043,Staff,31,0,32,1
1748423607005,HILD 2A,A02,922044,Staff,31,0,32,1
1748423607005,HILD 2A,A03,922046,Staff,28,0,32,4
1748423607005,HILD 2A,A04,922047,Staff,32,0,32,0
1748423607005,HILD 2A,A05,922051,Staff,30,0,32,2
1748423608039,HILD 7A,A01,922063,Widener; Daniel,31,0,32,1
1748423608039,HILD 7A,A02,922066,Widener; Daniel,31,0,32,1
1748423608039,HILD 7A,A03,922067,Widener; Daniel,32,0,32,0
1748423608039,HILD 7A,A04,922070,Widener; Daniel,28,0,32,4
1748423608039,HILD 7A,A05,922072,Widener; Daniel,32,0,32,0
1748423608039,HILD 7A,A06,922074,Widener; Daniel,32,0,32,0
1748423608039,HILD 7A,A07,922078,Widener; Daniel,29,0,32,3
1748423608039,HILD 7A,A08,922080,Widener; Daniel,32,0,32,0
1748423608039,HILD 7A,A09,922081,Widener; Daniel,32,0,32,0
1748423608039,HILD 7A,A10,922082,Widener; Daniel,32,0,32,0
1748423608039,HILD 7A,A11,922083,Widener; Daniel,32,0,32,0
1748423608039,HILD 7A,A12,922084,Widener; Daniel,32,0,32,0
1748423609066,HILD 10,A01,922089,Muscolino; Micah S,30,0,32,2
1748423609066,HILD 10,A02,922090,Muscolino; Micah S,28,0,32,4
1748423609066,HILD 10,A03,922092,Muscolino; Micah S,31,0,32,1
1748423609066,HILD 10,A04,922095,Muscolino; Micah S,30,0,32,2
1748423610091,HILD 14,A01,959886,Murillo; Dana V.,26,0,32,6
1748423610091,HILD 14,A02,959887,Murillo; Dana V.,32,0,32,0
1748423611120,HINE 144,A00,922132,Provence; Michael,40,0,45,5
1748423612149,HINE 186,A00,922133,Provence; Michael,15,0,15,0
1748423613176,HISA 110,A00,922136,De; Aniket,38,0,45,7
1748423614202,HISA 122,A00,959884,De; Aniket,12,0,15,3
1748423615230,HISC 107,A00,922137,Golan; Tal,41,0,45,4
1748423616260,HISC 131,A00,922148,Golan; Tal,45,0,51,6
1748423617286,HITO 87,A00,922097,Patterson; Patrick H.,0,0,0,0
1748423617286,HITO 87,B00,922098,Patterson; Patrick H.,0,0,0,0
1748423618318,HITO 100,A00,922150,Martinez-Matsuda; Veronica,0,0,17,17
1748423619347,HITO 193,A00,954127,Hill; Seth J,9999,0,9999,0
1748423620376,HITO 194,001,970059,Hertz; Deborah,1,0,1,0
1748423620376,HITO 194,002,970084,Daly; Heather Marie,1,0,1,0
1748423620376,HITO 194,003,970086,Plant; Rebecca Jo,1,0,1,0
1748423620376,HITO 194,004,970093,Henry; Todd A.,1,0,1,0
1748423620376,HITO 194,005,970094,Biess; Frank Peter,1,0,1,0
1748423620376,HITO 194,006,970095,Shafir; Nir,1,0,1,0
1748423620376,HITO 194,007,970099,Martinez-Matsuda; Veronica,1,0,1,0
1748423620376,HITO 194,008,970101,De; Aniket,1,0,1,0
1748423620376,HITO 194,009,970126,Kwak; Nancy,1,0,1,0
1748423620376,HITO 194,010,970128,Muscolino; Micah S,1,0,1,0
1748423620376,HITO 194,011,970129,Hendrickson; Gerald M.,1,0,1,0
1748423620376,HITO 194,012,970132,Balberg; Mira,1,0,1,0
1748423621405,HITO 196,A00,922151,Man; Simeon S,14,0,22,8
1748423622432,HIUS 105,A00,922152,Bermudez; Rosie Cano,22,0,35,13
1748423623459,HIUS 106,A00,922154,Bermudez; Rosie Cano,52,0,65,13
1748423624490,HIUS 144,A00,922156,Daly; Heather Marie,31,0,35,4
1748423625522,HIUS 158,A00,922163,Frank; Ross H.,12,0,20,8
1748423626552,HIUS 181,A00,922187,Daly; Heather Marie,8,0,15,7
1748423627581,HIUS 281,A00,922264,Daly; Heather Marie,0,0,0,0
1748423628609,HUM 1,A01,946360,Markman; Kristina,14,0,15,1
1748423628609,HUM 1,A02,946361,Markman; Kristina,12,0,15,3
1748423628609,HUM 1,A03,946362,Markman; Kristina,14,0,15,1
1748423628609,HUM 1,A04,946363,Markman; Kristina,11,0,15,4
1748423628609,HUM 1,A05,946364,Markman; Kristina,14,0,15,1
1748423628609,HUM 1,A06,946365,Markman; Kristina,14,0,15,1
1748423628609,HUM 1,A07,946366,Markman; Kristina,14,0,15,1
1748423628609,HUM 1,A08,946367,Markman; Kristina,12,0,15,3
1748423628609,HUM 1,A09,946368,Markman; Kristina,13,0,15,2
1748423628609,HUM 1,A10,946369,Markman; Kristina,11,0,15,4
1748423628609,HUM 1,A11,946370,Markman; Kristina,6,0,15,9
1748423628609,HUM 1,A12,946371,Markman; Kristina,15,0,15,0
1748423629651,HUM 3,A01,946373,West; Geoffrey Scott,20,0,28,8
1748423629651,HUM 3,A02,946374,West; Geoffrey Scott,14,0,28,14
1748423629651,HUM 3,A03,946375,West; Geoffrey Scott,13,0,28,15
1748423629651,HUM 3,A04,946376,West; Geoffrey Scott,9,0,28,19
1748423629651,HUM 3,A05,946377,West; Geoffrey Scott,8,0,28,20
1748423629651,HUM 3,A06,946378,West; Geoffrey Scott,22,0,28,6
1748423629651,HUM 3,A07,946379,West; Geoffrey Scott,23,0,28,5
1748423629651,HUM 3,A08,946380,West; Geoffrey Scott,15,0,28,13
1748423629651,HUM 3,A09,946381,West; Geoffrey Scott,0,0,0,0
1748423629651,HUM 3,A10,946382,West; Geoffrey Scott,0,0,0,0
1748423629651,HUM 3,C01,946393,Crum; Matthew Stephen,0,0,0,0
1748423629651,HUM 3,C02,946394,Crum; Matthew Stephen,0,0,0,0
1748423629651,HUM 3,C03,946395,Crum; Matthew Stephen,17,0,28,11
1748423629651,HUM 3,C04,946396,Crum; Matthew Stephen,25,0,28,3
1748423629651,HUM 3,C05,946397,Crum; Matthew Stephen,16,0,28,12
1748423629651,HUM 3,C06,946398,Crum; Matthew Stephen,20,0,28,8
1748423629651,HUM 3,C07,946399,Crum; Matthew Stephen,24,0,28,4
1748423629651,HUM 3,C08,946400,Crum; Matthew Stephen,26,0,28,2
1748423629651,HUM 3,C09,946401,Crum; Matthew Stephen,18,0,28,10
1748423629651,HUM 3,C10,946402,Crum; Matthew Stephen,22,0,28,6
1748423629651,HUM 3,D01,946404,Rodriguez; Bretton Sigfred,4,0,28,24
1748423629651,HUM 3,D02,946405,Rodriguez; Bretton Sigfred,16,0,28,12
1748423629651,HUM 3,D03,946406,Rodriguez; Bretton Sigfred,25,0,28,3
1748423629651,HUM 3,D04,946407,Rodriguez; Bretton Sigfred,12,0,28,16
1748423629651,HUM 3,D05,946408,Rodriguez; Bretton Sigfred,12,0,28,16
1748423629651,HUM 3,D06,946409,Rodriguez; Bretton Sigfred,19,0,28,9
1748423629651,HUM 3,D07,946410,Rodriguez; Bretton Sigfred,0,0,0,0
1748423629651,HUM 3,D08,946411,Rodriguez; Bretton Sigfred,0,0,0,0
1748423629651,HUM 3,D09,946412,Rodriguez; Bretton Sigfred,7,0,28,21
1748423629651,HUM 3,D10,946413,Rodriguez; Bretton Sigfred,20,0,28,8
1748423630677,HUM 88,A00,969578,Markman; Kristina,0,0,0,0
1748423631706,HUM 100,A00,946414,West; Geoffrey Scott,14,0,16,2
1748423631706,HUM 100,B00,946415,West; Geoffrey Scott,15,0,16,1
1748423631706,HUM 100,C00,946416,Zavodny; Tatiana Sophia,13,0,16,3
1748423631706,HUM 100,D00,946417,Zavodny; Tatiana Sophia,15,0,16,1
1748423631706,HUM 100,E00,946419,Zavodny; Tatiana Sophia,15,0,16,1
1748423631706,HUM 100,F00,946420,Crum; Matthew Stephen,0,0,0,0
1748423631706,HUM 100,G00,946421,Crum; Matthew Stephen,0,0,0,0
1748423631706,HUM 100,H00,946422,Crum; Matthew Stephen,16,0,16,0
1748423631706,HUM 100,I00,946424,Staff,0,0,0,0
1748423631706,HUM 100,J00,946425,Crum; Matthew Stephen,16,0,16,0
1748423631706,HUM 100,K00,946426,Staff,0,0,0,0
1748423632742,INTL 100,A01,960908,Feuer; Anna Stagg,9,0,20,11
1748423632742,INTL 100,A02,960964,Feuer; Anna Stagg,16,0,20,4
1748423632742,INTL 100,A03,961088,Feuer; Anna Stagg,15,0,20,5
1748423632742,INTL 100,A04,961091,Feuer; Anna Stagg,17,0,20,3
1748423632742,INTL 100,A05,961100,Feuer; Anna Stagg,16,0,20,4
1748423632742,INTL 100,A06,961130,Feuer; Anna Stagg,19,0,20,1
1748423633773,INTL 101,A01,923053,McIntosh; Justin,1,0,30,29
1748423633773,INTL 101,A02,923055,McIntosh; Justin,8,0,30,22
1748423633773,INTL 101,A03,923127,McIntosh; Justin,5,0,30,25
1748423633773,INTL 101,A04,923140,McIntosh; Justin,0,0,30,30
1748423633773,INTL 101,A05,923148,McIntosh; Justin,9,0,30,21
1748423633773,INTL 101,A06,923186,McIntosh; Justin,10,0,30,20
1748423634801,INTL 102,A01,923194,Prather; Lauren R,3,0,30,27
1748423634801,INTL 102,A02,923195,Prather; Lauren R,4,0,30,26
1748423634801,INTL 102,A03,923199,Prather; Lauren R,13,0,30,17
1748423634801,INTL 102,A04,923202,Prather; Lauren R,8,0,30,22
1748423635832,INTL 190,A00,923203,Segui; Alan S,0,0,0,5
1748423635832,INTL 190,B00,923205,Segui; Alan S,0,0,0,9
1748423635832,INTL 190,C00,923219,Lee; Munseob,0,0,0,5
1748423636860,INTL 190H,A00,923247,Feuer; Anna Stagg,0,0,0,1
1748423637901,JAPN 10A,A01,923258,Kamioka; Sachiko,22,0,23,1
1748423637901,JAPN 10A,B01,923261,Ross; Kayoko F,23,0,23,0
1748423637901,JAPN 10A,C01,923265,Sato; Kyoko,20,0,23,3
1748423637901,JAPN 10A,D01,923268,Inada; Minori,22,0,23,1
1748423637901,JAPN 10A,E01,923270,Tipton; Yuko,9,0,12,3
1748423637901,JAPN 10A,E02,923273,Tipton; Yuko,12,0,12,0
1748423637901,JAPN 10A,F01,923352,Ross; Kayoko F,11,0,12,1
1748423637901,JAPN 10A,F02,923355,Ross; Kayoko F,12,0,12,0
1748423637901,JAPN 10A,G01,923358,McKee; Mayumi Mochizuki,7,0,10,3
1748423637901,JAPN 10A,G02,923360,McKee; Mayumi Mochizuki,6,0,10,4
1748423637901,JAPN 10A,H01,923365,Sato; Kyoko,8,0,12,4
1748423637901,JAPN 10A,H02,923370,Sato; Kyoko,12,0,12,0
1748423637901,JAPN 10A,I01,923373,Inada; Minori,8,0,12,4
1748423637901,JAPN 10A,I02,923374,Inada; Minori,8,0,12,4
1748423637901,JAPN 10A,J01,923376,McKee; Mayumi Mochizuki,11,0,12,1
1748423637901,JAPN 10A,J02,923428,McKee; Mayumi Mochizuki,11,0,12,1
1748423637901,JAPN 10A,K01,923433,Tipton; Yuko,5,0,10,5
1748423637901,JAPN 10A,K02,923437,Tipton; Yuko,9,0,10,1
1748423637901,JAPN 10A,L01,923439,Sato; Kyoko,12,0,12,0
1748423637901,JAPN 10A,L02,923449,Sato; Kyoko,11,0,12,1
1748423637901,JAPN 10A,M01,923455,Kamioka; Sachiko,22,0,23,1
1748423637901,JAPN 10A,N01,923459,McKee; Mayumi Mochizuki,22,0,23,1
1748423638929,JAPN 10AR,A01,923462,Tipton; Yuko,17,0,20,3
1748423639958,JAPN 20A,A01,923470,Takeda; Izumi,21,0,23,2
1748423639958,JAPN 20A,B01,923473,Iwamoto; Naoki,9,0,12,3
1748423639958,JAPN 20A,B02,923475,Iwamoto; Naoki,6,0,12,6
1748423639958,JAPN 20A,C01,923519,Takeda; Izumi,0,0,12,12
1748423639958,JAPN 20A,C02,923520,Takeda; Izumi,5,0,12,7
1748423639958,JAPN 20A,D01,923623,Iwamoto; Naoki,11,0,12,1
1748423639958,JAPN 20A,D02,923625,Iwamoto; Naoki,11,0,12,1
1748423639958,JAPN 20A,E01,923627,Simpson; Junko Tokuda,12,0,20,8
1748423640986,JAPN 130A,A01,923630,Kamioka; Sachiko,14,0,15,1
1748423640986,JAPN 130A,B01,923634,Ross; Kayoko F,11,0,15,4
1748423642016,JAPN 135A,A00,923636,Iwamoto; Naoki,10,0,20,10
1748423643042,JAPN 137A,A00,923638,Simpson; Junko Tokuda,19,0,20,1
1748423644071,JAPN 140A,A00,923640,Takeda; Izumi,18,0,20,2
1748423645106,JWSP 1,A01,921258,Shuster; Alana,19,0,20,1
1748423646133,JWSP 104,A01,921340,Shuster; Alana,15,0,15,0
1748423647168,LATI 10,A01,923694,Kennemore; Amy Michelle,22,0,28,6
1748423647168,LATI 10,A02,923695,Kennemore; Amy Michelle,25,0,28,3
1748423647168,LATI 10,A03,923707,Kennemore; Amy Michelle,25,0,28,3
1748423647168,LATI 10,A04,923713,Kennemore; Amy Michelle,27,0,28,1
1748423647168,LATI 10,A05,923720,Kennemore; Amy Michelle,28,0,28,0
1748423647168,LATI 10,A06,923723,Kennemore; Amy Michelle,30,0,30,0
1748423647168,LATI 10,A07,923745,Kennemore; Amy Michelle,26,0,30,4
1748423648196,LATI 50,A01,923778,Kokinis; Troy Andreas,27,0,30,3
1748423648196,LATI 50,A02,923779,Kokinis; Troy Andreas,28,0,30,2
1748423648196,LATI 50,A03,923780,Kokinis; Troy Andreas,29,0,30,1
1748423648196,LATI 50,A04,923783,Kokinis; Troy Andreas,28,0,30,2
1748423648196,LATI 50,A05,923784,Kokinis; Troy Andreas,30,0,30,0
1748423649226,LATI 166,A00,923785,Kokinis; Troy Andreas,117,0,120,3
1748423650252,LATI 170,A00,923787,Kennemore; Amy Michelle,45,0,60,15
1748423651280,LATI 180,A00,923788,Kennemore; Amy Michelle,52,0,60,8
1748423652308,LATI 184,A00,923790,Jimenez Cano; Nayeli Guada,29,0,30,1
1748423653335,LATI 200,A00,923791,Martin-Cabrera; Luis,7,0,10,3
1748423654363,LIAB 1A,A00,923983,Saab; Dima,12,0,14,2
1748423654363,LIAB 1A,B00,923984,Saab; Dima,8,0,14,6
1748423655389,LIAB 1AX,A00,923992,El Cheddadi; Youniss,25,0,28,3
1748423656417,LIAB 1D,A00,923996,Saab; Dima,7,0,14,7
1748423657442,LIAB 1DX,A00,923998,El Cheddadi; Youniss,10,0,14,4
1748423658471,LIFR 1A,A00,923999,Van Moer; Vinciane G,14,0,14,0
1748423658471,LIFR 1A,B00,924001,Van Moer; Vinciane G,14,0,14,0
1748423658471,LIFR 1A,C00,924003,Van Moer; Vinciane G,13,0,14,1
1748423658471,LIFR 1A,D00,924039,Van Moer; Vinciane G,12,0,14,2
1748423658471,LIFR 1A,E00,924044,Van Moer; Vinciane G,12,0,14,2
1748423658471,LIFR 1A,F00,924100,Van Moer; Vinciane G,10,0,14,4
1748423659504,LIFR 1AX,A00,924134,Van Moer; Vinciane G,26,0,28,2
1748423659504,LIFR 1AX,B00,924138,Van Moer; Vinciane G,24,0,28,4
1748423659504,LIFR 1AX,C00,924196,Van Moer; Vinciane G,26,0,28,2
1748423660530,LIFR 1B,A00,924197,Van Moer; Vinciane G,11,0,14,3
1748423660530,LIFR 1B,B00,924199,Van Moer; Vinciane G,11,0,14,3
1748423661557,LIFR 1BX,A00,924215,Van Moer; Vinciane G,23,0,28,5
1748423662585,LIFR 1D,A00,924216,Van Moer; Vinciane G,11,0,14,3
1748423662585,LIFR 1D,B00,924217,Van Moer; Vinciane G,12,0,14,2
1748423662585,LIFR 1D,C00,924218,Van Moer; Vinciane G,3,0,14,11
1748423663611,LIFR 1DX,A00,924219,Van Moer; Vinciane G,14,0,21,7
1748423663611,LIFR 1DX,B00,924220,Van Moer; Vinciane G,13,0,21,8
1748423664636,LIFR 11,A00,924221,Goodall; Grant Todd,10,0,10,0
1748423665670,LIGM 1A,A00,924222,Fischer-Grunski; Eva K,11,0,14,3
1748423665670,LIGM 1A,B00,924223,Fischer-Grunski; Eva K,13,0,14,1
1748423665670,LIGM 1A,C00,924224,Fischer-Grunski; Eva K,11,0,14,3
1748423665670,LIGM 1A,D00,924227,Fischer-Grunski; Eva K,11,0,14,3
1748423666701,LIGM 1AX,A00,924228,Fischer-Grunski; Eva K,28,0,28,0
1748423666701,LIGM 1AX,B00,924229,Fischer-Grunski; Eva K,19,0,28,9
1748423667731,LIGM 1D,A00,924230,Fischer-Grunski; Eva K,0,0,0,0
1748423667731,LIGM 1D,B00,924231,Fischer-Grunski; Eva K,12,0,14,2
1748423668763,LIGM 1DX,A00,924232,Fischer-Grunski; Eva K,0,0,0,0
1748423669790,LIGM 11,A00,924233,Goodall; Grant Todd,10,0,10,0
1748423670817,LIGN 5,A00,923794,Goodall; Grant Todd,112,0,120,8
1748423671843,LIGN 7,A00,923796,Mayberry; Rachel,115,0,120,5
1748423672871,LIGN 8,A00,923797,McIntosh; Justin,231,0,245,14
1748423673901,LIGN 17,A00,923798,Staff,232,0,245,13
1748423674929,LIGN 101,A01,923929,Bakovic; Eric John,26,0,30,4
1748423674929,LIGN 101,A02,923930,Bakovic; Eric John,26,0,30,4
1748423674929,LIGN 101,A04,923935,Bakovic; Eric John,19,0,30,11
1748423674929,LIGN 101,A05,923940,Bakovic; Eric John,23,0,30,7
1748423675961,LIGN 108,A00,923942,Rose; Sharon,29,0,35,6
1748423676993,LIGN 110,A01,923944,Garellek; Marc,15,0,27,12
1748423676993,LIGN 110,A02,923947,Garellek; Marc,14,0,27,13
1748423676993,LIGN 110,A03,923948,Garellek; Marc,20,0,27,7
1748423676993,LIGN 110,A04,923949,Garellek; Marc,4,0,27,23
1748423678020,LIGN 152,A00,967971,Caballero; Gabriela Hernandez,17,0,30,13
1748423679045,LIGN 160,A00,963083,Dudley; Rachel,39,0,50,11
1748423680076,LIGN 167,A00,923951,Warstadt; Alexander Scott,0,0,90,90
1748423681103,LIGN 179,A00,923955,Kluender; Robert,0,0,35,35
1748423682128,LIGN 188R,A00,923956,Clem; Emily,40,0,40,0
1748423683159,LIGN 200,A00,973075,Staff,0,0,0,0
1748423684186,LIGN 210,A00,923962,Garellek; Marc,10,0,10,0
1748423685212,LIGN 221,A00,923964,Clem; Emily,9,0,10,1
1748423686241,LIGN 236,A00,923965,Clem; Emily,8,0,10,2
1748423687268,LIGN 293,A00,923971,Caballero; Gabriela Hernandez,0,0,0,0
1748423688300,LIGN 296,001,950061,Ackerman; Farrell,10,0,10,0
1748423688300,LIGN 296,002,950062,Bakovic; Eric John,10,0,10,0
1748423688300,LIGN 296,003,950063,Bergen; Leon,10,0,10,0
1748423688300,LIGN 296,004,950064,Caballero; Gabriela Hernandez,10,0,10,0
1748423688300,LIGN 296,005,950065,Caponigro; Ivano,10,0,10,0
1748423688300,LIGN 296,006,950066,Clem; Emily,10,0,10,0
1748423688300,LIGN 296,007,950067,Dudley; Rachel,10,0,10,0
1748423688300,LIGN 296,008,950068,Garellek; Marc,10,0,10,0
1748423688300,LIGN 296,009,950070,Goodall; Grant Todd,9,0,10,1
1748423688300,LIGN 296,010,950071,Kehler; Andrew Scott,10,0,10,0
1748423688300,LIGN 296,011,950072,Kluender; Robert,10,0,10,0
1748423688300,LIGN 296,012,950073,Rose; Sharon,10,0,10,0
1748423688300,LIGN 296,013,950074,Styler; William Francis,10,0,10,0
1748423688300,LIGN 296,014,950075,Caponigro; Ivano,10,0,10,0
1748423689331,LIHL 112F,A00,923972,Pagkalinawan; Leticia Cant,15,0,28,13
1748423690356,LIHL 114F,A00,923973,Nguyen; Hoan Thi,8,0,28,20
1748423691385,LIHL 117F,A00,923974,Sadegholvad; Elham,19,0,20,1
1748423692423,LIHL 118,A00,923975,Chen; Areana Yen,23,0,28,5
1748423693449,LIHL 124F,A00,923976,Nguyen; Hoan Thi,17,0,20,3
1748423694479,LIHL 132F,A00,923978,Pagkalinawan; Leticia Cant,18,0,20,2
1748423695509,LIHL 134F,A00,923980,Nguyen; Hoan Thi,19,0,20,1
1748423696540,LIHL 138,A00,923982,Chen; Areana Yen,28,0,28,0
1748423697572,LIIT 1A,A00,924234,Carnelos; Chiara,11,0,14,3
1748423697572,LIIT 1A,B00,924235,Carnelos; Chiara,11,0,14,3
1748423697572,LIIT 1A,C00,924236,Carnelos; Chiara,13,0,14,1
1748423697572,LIIT 1A,D00,924237,Carnelos; Chiara,12,0,14,2
1748423698605,LIIT 1AX,A00,924238,Carnelos; Chiara,28,0,28,0
1748423698605,LIIT 1AX,B00,924239,Carnelos; Chiara,24,0,28,4
1748423699638,LIPO 1A,A00,924241,Paladini; Denise,13,0,14,1
1748423699638,LIPO 1A,B00,924242,Paladini; Denise,14,0,14,0
1748423700666,LIPO 1AX,A00,924243,De Abreu; Cassia,13,0,14,1
1748423700666,LIPO 1AX,B00,924244,De Abreu; Cassia,14,0,14,0
1748423701694,LIPO 1D,A00,924245,Paladini; Denise,11,0,14,3
1748423702724,LIPO 1DX,A00,924248,De Abreu; Cassia,14,0,14,0
1748423703752,LISL 1A,A00,924249,Lott; Margaret S.,9,0,14,5
1748423703752,LISL 1A,B00,924250,Lott; Margaret S.,11,0,14,3
1748423703752,LISL 1A,C00,924252,Lott; Margaret S.,7,0,14,7
1748423703752,LISL 1A,D00,924253,Lott; Margaret S.,12,0,14,2
1748423703752,LISL 1A,E00,924254,Lott; Margaret S.,4,0,14,10
1748423703752,LISL 1A,F00,924255,Lott; Margaret S.,13,0,14,1
1748423704788,LISL 1AR,A00,924257,Lott; Margaret S.,11,0,15,4
1748423704788,LISL 1AR,B00,924258,Lott; Margaret S.,10,0,15,5
1748423704788,LISL 1AR,C00,924260,Lott; Margaret S.,9,0,15,6
1748423704788,LISL 1AR,D00,968060,Lott; Margaret S.,3,0,3,0
1748423704788,LISL 1AR,E00,968061,Lott; Margaret S.,3,0,3,0
1748423704788,LISL 1AR,F00,968062,Lott; Margaret S.,3,0,3,0
1748423705814,LISL 1AX,A00,924261,Lott; Margaret S.,28,0,28,0
1748423705814,LISL 1AX,B00,924262,Lott; Margaret S.,18,0,28,10
1748423705814,LISL 1AX,C00,924263,Lott; Margaret S.,21,0,28,7
1748423706846,LISL 1B,A00,924264,Lott; Margaret S.,13,0,14,1
1748423706846,LISL 1B,B00,924265,Lott; Margaret S.,6,0,14,8
1748423706846,LISL 1B,C00,924302,Lott; Margaret S.,9,0,14,5
1748423706846,LISL 1B,D00,924304,Lott; Margaret S.,7,0,14,7
1748423706846,LISL 1B,E00,924305,Lott; Margaret S.,10,0,14,4
1748423706846,LISL 1B,F00,964375,Lott; Margaret S.,12,0,14,2
1748423707874,LISL 1BX,A00,924307,Lott; Margaret S.,12,0,28,16
1748423707874,LISL 1BX,B00,924308,Lott; Margaret S.,20,0,28,8
1748423707874,LISL 1BX,C00,924314,Lott; Margaret S.,28,0,28,0
1748423708901,LISL 1D,A00,924316,Lott; Margaret S.,0,0,14,14
1748423708901,LISL 1D,B00,924317,Lott; Margaret S.,0,0,14,14
1748423708901,LISL 1D,C00,924319,Lott; Margaret S.,0,0,14,14
1748423708901,LISL 1D,D00,924321,Lott; Margaret S.,0,0,14,14
1748423709981,LISL 1DX,A00,924323,Lott; Margaret S.,0,0,28,28
1748423709981,LISL 1DX,B00,924365,Lott; Margaret S.,0,0,28,28
1748423711011,LISP 1A,A00,924370,Munoz Sanchez; Alicia,12,0,14,2
1748423711011,LISP 1A,B00,924372,Munoz Sanchez; Alicia,8,0,14,6
1748423711011,LISP 1A,C00,924401,Munoz Sanchez; Alicia,0,0,14,14
1748423711011,LISP 1A,D00,924406,Munoz Sanchez; Alicia,3,0,14,11
1748423711011,LISP 1A,E00,924471,Munoz Sanchez; Alicia,0,0,14,14
1748423711011,LISP 1A,F00,924472,Munoz Sanchez; Alicia,4,0,14,10
1748423711011,LISP 1A,G00,924473,Munoz Sanchez; Alicia,11,0,14,3
1748423711011,LISP 1A,H00,924474,Munoz Sanchez; Alicia,9,0,14,5
1748423712039,LISP 1AX,A00,924478,Munoz Sanchez; Alicia,16,0,28,12
1748423712039,LISP 1AX,B00,924479,Munoz Sanchez; Alicia,26,0,28,2
1748423712039,LISP 1AX,C00,924484,Munoz Sanchez; Alicia,12,0,28,16
1748423712039,LISP 1AX,D00,924491,Munoz Sanchez; Alicia,18,0,28,10
1748423713082,LISP 1B,A00,924492,Munoz Sanchez; Alicia,12,0,14,2
1748423713082,LISP 1B,B00,924493,Munoz Sanchez; Alicia,6,0,14,8
1748423713082,LISP 1B,C00,924498,Munoz Sanchez; Alicia,13,0,14,1
1748423713082,LISP 1B,D00,924501,Munoz Sanchez; Alicia,13,0,14,1
1748423713082,LISP 1B,E00,924505,Munoz Sanchez; Alicia,11,0,14,3
1748423713082,LISP 1B,F00,924506,Munoz Sanchez; Alicia,9,0,14,5
1748423713082,LISP 1B,G00,924507,Munoz Sanchez; Alicia,10,0,14,4
1748423713082,LISP 1B,H00,924549,Munoz Sanchez; Alicia,12,0,14,2
1748423713082,LISP 1B,I00,924566,Munoz Sanchez; Alicia,13,0,14,1
1748423713082,LISP 1B,J00,924572,Munoz Sanchez; Alicia,13,0,14,1
1748423713082,LISP 1B,K00,924576,Munoz Sanchez; Alicia,12,0,14,2
1748423713082,LISP 1B,L00,924577,Munoz Sanchez; Alicia,13,0,14,1
1748423714112,LISP 1BX,A00,924578,Munoz Sanchez; Alicia,26,0,28,2
1748423714112,LISP 1BX,B00,924618,Munoz Sanchez; Alicia,24,0,28,4
1748423714112,LISP 1BX,C00,924619,Munoz Sanchez; Alicia,20,0,28,8
1748423714112,LISP 1BX,D00,924629,Munoz Sanchez; Alicia,24,0,28,4
1748423714112,LISP 1BX,E00,924635,Munoz Sanchez; Alicia,24,0,28,4
1748423714112,LISP 1BX,F00,924640,Munoz Sanchez; Alicia,27,0,28,1
1748423715154,LISP 1D,A00,924641,Munoz Sanchez; Alicia,10,0,14,4
1748423715154,LISP 1D,B00,924649,Munoz Sanchez; Alicia,10,0,14,4
1748423715154,LISP 1D,C00,924654,Munoz Sanchez; Alicia,11,0,14,3
1748423715154,LISP 1D,D00,924660,Munoz Sanchez; Alicia,7,0,14,7
1748423715154,LISP 1D,E00,924671,Munoz Sanchez; Alicia,5,0,14,9
1748423715154,LISP 1D,F00,924722,Munoz Sanchez; Alicia,6,0,14,8
1748423715154,LISP 1D,G00,924724,Munoz Sanchez; Alicia,8,0,14,6
1748423715154,LISP 1D,H00,924726,Munoz Sanchez; Alicia,9,0,14,5
1748423715154,LISP 1D,I00,924728,Munoz Sanchez; Alicia,13,0,14,1
1748423715154,LISP 1D,J00,924732,Munoz Sanchez; Alicia,14,0,14,0
1748423715154,LISP 1D,K00,924739,Munoz Sanchez; Alicia,13,0,14,1
1748423715154,LISP 1D,L00,924745,Munoz Sanchez; Alicia,12,0,14,2
1748423716190,LISP 1DX,A00,924747,Munoz Sanchez; Alicia,23,0,28,5
1748423716190,LISP 1DX,B00,924818,Munoz Sanchez; Alicia,27,0,28,1
1748423716190,LISP 1DX,C00,924819,Munoz Sanchez; Alicia,16,0,28,12
1748423716190,LISP 1DX,D00,924820,Munoz Sanchez; Alicia,23,0,28,5
1748423716190,LISP 1DX,E00,924821,Munoz Sanchez; Alicia,16,0,28,12
1748423716190,LISP 1DX,F00,924822,Munoz Sanchez; Alicia,22,0,28,6
1748423717216,LISP 15,A00,924823,Munoz Sanchez; Alicia,17,0,20,3
1748423718246,LISP 18,A00,924824,Munoz Sanchez; Alicia,14,0,20,6
1748423719280,LTAF 120,A00,925431,Zhiri; Oumelbanine,37,0,40,3
1748423720312,LTAM 100,A00,925432,Villafuerte Vazquez; Nadia,33,0,40,7
1748423721340,LTCH 101,A00,964372,Liao; Ping H,35,0,40,5
1748423722368,LTCO 285,A00,925806,Glaser; Amelia,0,0,0,0
1748423723393,LTCS 10,A00,924830,Bessett; Ryan Matthew,39,0,40,1
1748423724421,LTCS 87,A00,969580,Nguyen; Hoang Tan,20,0,20,0
1748423724421,LTCS 87,B00,969581,Nguyen; Hoang Tan,20,0,20,0
1748423725452,LTCS 130,A00,925434,Kim; Joo Ok,36,0,40,4
1748423726482,LTCS 150,A00,925435,Mendoza; Andrea,36,0,40,4
1748423727510,LTCS 250,A00,925807,Sanchez Cruz; Jorge,9,0,15,6
1748423728540,LTEA 120A,A00,925438,Fiss; Geraldine Anna,16,0,40,24
1748423729566,LTEA 120B,A00,925439,Liao; Ping H,211,0,225,14
1748423730593,LTEA 132,A00,925441,Mendoza; Andrea,66,0,75,9
1748423731621,LTEA 143,A00,925443,Lee; Jin-Kyung,72,0,75,3
1748423732651,LTEA 145,A00,925444,Lee; Jin-Kyung,39,0,40,1
1748423733679,LTEN 21,A01,924832,Vitkus; Daniel J.,23,0,28,5
1748423733679,LTEN 21,A02,924833,Vitkus; Daniel J.,28,0,28,0
1748423734708,LTEN 28,A01,924835,Suzuki; Erin M.,26,0,28,2
1748423734708,LTEN 28,A02,924836,Suzuki; Erin M.,25,0,28,3
1748423734708,LTEN 28,A03,924837,Suzuki; Erin M.,25,0,28,3
1748423734708,LTEN 28,A04,924838,Suzuki; Erin M.,28,0,28,0
1748423734708,LTEN 28,A05,924839,Suzuki; Erin M.,28,0,28,0
1748423734708,LTEN 28,A06,924840,Suzuki; Erin M.,28,0,28,0
1748423734708,LTEN 28,A07,924841,Suzuki; Erin M.,28,0,28,0
1748423734708,LTEN 28,A08,924842,Suzuki; Erin M.,28,0,28,0
1748423735735,LTEN 113,A00,925449,Vitkus; Daniel J.,31,0,40,9
1748423736764,LTEN 152,A00,925450,Staff,13,0,40,27
1748423737795,LTEN 169,A00,925451,Ruiz; Ariana,34,0,40,6
1748423738825,LTEN 180,A00,925452,Ruiz; Ariana,9,0,20,11
1748423739853,LTEN 181,A00,925453,Suzuki; Erin M.,27,0,40,13
1748423740880,LTEN 185,A00,963086,Staff,23,0,25,2
1748423741913,LTEN 189,A00,925458,Vijay; Ameeth Varma,35,0,40,5
1748423742945,LTEN 271,A00,925808,Garofalo; Devin,13,0,15,2
1748423743973,LTEU 140,A00,925459,De Marchi Gherini; Adriana,33,0,40,7
1748423745000,LTEU 154,A00,925461,Morse; Ainsley,25,0,30,5
1748423746037,LTFR 2A,A01,924916,Ploye; Catherine,20,0,25,5
1748423747066,LTFR 2B,A01,924920,Ploye; Catherine,25,0,25,0
1748423748096,LTFR 104,A00,925462,Ploye; Catherine,25,0,25,0
1748423749124,LTGK 1,A00,924923,Murray; Kourtney Kristine,34,0,40,6
1748423750153,LTGK 104,A00,925465,Myerston Santana; Jacobo,29,0,30,1
1748423751180,LTGM 2A,A01,924926,Fischer-Grunski; Eva K,19,0,25,6
1748423752212,LTIT 2A,A01,925054,De Marchi Gherini; Adriana,19,0,25,6
1748423753245,LTKO 1A,A01,925085,Cho; Hye Jin,25,0,28,3
1748423753245,LTKO 1A,B01,925182,Cho; Hye Jin,25,0,28,3
1748423753245,LTKO 1A,C01,925210,Cho; Hye Jin,23,0,28,5
1748423753245,LTKO 1A,D01,925229,Staff,27,0,28,1
1748423753245,LTKO 1A,E01,925246,Staff,25,0,28,3
1748423753245,LTKO 1A,F01,925248,Yim; Nancy,26,0,28,2
1748423753245,LTKO 1A,G01,925323,Yim; Nancy,26,0,28,2
1748423753245,LTKO 1A,H01,925331,Yim; Nancy,25,0,28,3
1748423754279,LTKO 2A,A01,925333,Jung; Ji Yun,14,0,28,14
1748423754279,LTKO 2A,B01,925335,Jung; Ji Yun,24,0,28,4
1748423754279,LTKO 2A,C01,925338,Lee; Jeyseon,26,0,28,2
1748423755310,LTKO 130F,A00,925468,Lee; Jeyseon,22,0,25,3
1748423756339,LTLA 1,A00,925339,Murray; Kourtney Kristine,0,0,20,20
1748423757366,LTLA 100,A00,925470,Murray; Kourtney Kristine,39,0,40,1
1748423758396,LTRU 1A,A01,925342,Wells; Patricia Rebecca,22,0,28,6
1748423759424,LTRU 2A,A01,925345,Wells; Patricia Rebecca,19,0,20,1
1748423760450,LTRU 104B,A01,925473,Wells; Patricia Rebecca,20,0,20,0
1748423761482,LTRU 150,A00,925474,Morse; Ainsley,10,0,10,0
1748423762515,LTSP 2A,A01,925347,Staff,22,0,28,6
1748423762515,LTSP 2A,B01,925349,Staff,24,0,28,4
1748423763542,LTSP 2B,A01,925351,Staff,17,0,28,11
1748423764574,LTSP 2C,A01,925353,Mastromartino; Alexandra L,22,0,28,6
1748423765602,LTSP 2F,A00,925354,Mastromartino; Alexandra L,25,0,25,0
1748423766632,LTSP 3F,A00,925355,Dominguez; Noelia,24,0,25,1
1748423766632,LTSP 3F,B00,925356,Dominguez; Noelia,22,0,25,3
1748423767660,LTSP 87,A00,925357,Bessett; Ryan Matthew,20,0,20,0
1748423768691,LTSP 100A,A00,925595,Dominguez; Noelia,21,0,25,4
1748423769718,LTSP 100F,A00,925621,Bessett; Ryan Matthew,25,0,25,0
1748423769718,LTSP 100F,B00,925623,Bessett; Ryan Matthew,25,0,25,0
1748423769718,LTSP 100F,C00,925626,Martin-Cabrera; Luis,25,0,25,0
1748423770748,LTSP 116,A00,925629,Villafuerte Vazquez; Nadia,35,0,40,5
1748423771779,LTSP 172,A00,925637,Chacon; Gloria Elizabeth,36,0,40,4
1748423772807,LTSP 174,A00,925639,Chacon; Gloria Elizabeth,34,0,40,6
1748423773836,LTTH 210A,A00,925809,Fiss; Geraldine Anna,6,0,15,9
1748423774863,LTWL 10,A00,925358,Garofalo; Devin,40,0,40,0
1748423775890,LTWL 19A,A00,925360,Myerston Santana; Jacobo,39,0,40,1
1748423776917,LTWL 101,A00,925661,Kelting; Edward William,32,0,40,8
1748423777946,LTWL 165,A00,925748,Kim; Joo Ok,40,0,40,0
1748423778979,LTWL 167,A00,964371,Glaser; Amelia,40,0,40,0
1748423780007,LTWL 183,A00,925755,Cohen; Alain J. J.,34,0,40,6
1748423781034,LTWL 194,A00,925757,Vijay; Ameeth Varma,38,0,40,2
1748423782062,LTWR 8A,A01,925362,Springer; Anna Joy,28,0,28,0
1748423782062,LTWR 8A,A02,925363,Springer; Anna Joy,23,0,28,5
1748423782062,LTWR 8A,A03,925364,Springer; Anna Joy,23,0,28,5
1748423782062,LTWR 8A,A04,925365,Springer; Anna Joy,18,0,28,10
1748423783093,LTWR 8B,A01,925368,Lopez; Casandra,18,0,28,10
1748423783093,LTWR 8B,A02,925370,Lopez; Casandra,19,0,28,9
1748423783093,LTWR 8B,A03,925371,Lopez; Casandra,28,0,28,0
1748423783093,LTWR 8B,A04,925372,Lopez; Casandra,26,0,28,2
1748423784120,LTWR 100C,A00,925759,Staff,16,0,30,14
1748423785148,LTWR 100W,A00,925760,Forbes; Camille,0,0,15,15
1748423786174,LTWR 102W,A00,925761,Lopez; Casandra,6,0,15,9
1748423787201,LTWR 104AW,A00,925762,Hoang; Lily Kim,5,0,15,10
1748423788229,LTWR 106C,A00,925764,Ali; Mohammad Kazim,22,0,30,8
1748423789259,LTWR 113C,A00,925765,Wilkinson; Marco,28,0,30,2
1748423790289,LTWR 115C,A00,925766,Ali; Mohammad Kazim,23,0,30,7
1748423791320,LTWR 124C,A00,925801,Morse; Ainsley,29,0,30,1
1748423792349,LTWR 126C,A00,925802,Forbes; Camille,28,0,30,2
1748423793376,LTWR 148,A00,925804,Wilkinson; Marco,27,0,30,3
1748423794408,LTWR 194,A00,925805,Carroll; Amy Sara,30,0,40,10
1748423795434,LTWR 215,A00,925934,Hoang; Lily Kim,13,0,20,7
1748423796461,LTWR 220,A00,925935,Springer; Anna Joy,10,0,15,5
1748423797504,MAE 2,A01,931344,Anderson; Mark Ronald,0,0,1,1
1748423797504,MAE 2,A02,931345,Anderson; Mark Ronald,0,0,1,1
1748423797504,MAE 2,A03,931347,Anderson; Mark Ronald,0,0,1,1
1748423797504,MAE 2,B01,960499,Sadeghizadeh; Zahra,0,0,1,1
1748423797504,MAE 2,B02,960500,Sadeghizadeh; Zahra,0,0,1,1
1748423797504,MAE 2,B03,960501,Sadeghizadeh; Zahra,0,0,1,1
1748423798532,MAE 3,A01,931355,Delson; Nathan Joseph,8,0,11,3
1748423798532,MAE 3,A02,931356,Delson; Nathan Joseph,10,0,11,1
1748423798532,MAE 3,A03,931357,Delson; Nathan Joseph,10,0,11,1
1748423798532,MAE 3,A04,931358,Delson; Nathan Joseph,11,0,11,0
1748423798532,MAE 3,B01,931360,Qi; Huihui,0,0,11,11
1748423798532,MAE 3,B02,931361,Qi; Huihui,6,0,11,5
1748423798532,MAE 3,B03,931362,Qi; Huihui,9,0,11,2
1748423798532,MAE 3,B04,931364,Qi; Huihui,10,0,11,1
1748423799560,MAE 8,A01,931368,Pham; Hieu Tan,90,0,100,10
1748423800587,MAE 11,A00,931369,Nomura; Keiko K.,83,0,180,97
1748423801613,MAE 20,A00,931371,Graeve; Olivia A,79,0,100,21
1748423802643,MAE 21,A01,931373,Cai; Shengqiang,1,0,10,9
1748423802643,MAE 21,A02,931375,Cai; Shengqiang,7,0,10,3
1748423802643,MAE 21,A03,931376,Cai; Shengqiang,1,0,10,9
1748423802643,MAE 21,A04,931377,Cai; Shengqiang,5,0,10,5
1748423802643,MAE 21,A05,931378,Cai; Shengqiang,10,0,10,0
1748423802643,MAE 21,A06,931381,Cai; Shengqiang,10,0,10,0
1748423802643,MAE 21,A07,931382,Cai; Shengqiang,8,0,10,2
1748423802643,MAE 21,A08,931384,Cai; Shengqiang,7,0,10,3
1748423802643,MAE 21,A09,931385,Cai; Shengqiang,8,0,10,2
1748423802643,MAE 21,A10,931386,Cai; Shengqiang,9,0,10,1
1748423803669,MAE 30A,A00,931387,Lubarda; Marko,29,0,70,41
1748423804694,MAE 40,A00,931388,Cortes; Jorge,83,0,146,63
1748423805722,MAE 101A,A00,931389,Sarkar; Sutanu,94,0,150,56
1748423806749,MAE 101C,A00,931390,Seshadri; Kalyanasundaram,175,0,200,25
1748423807779,MAE 104,A00,931391,Pham; Hieu Tan,146,0,160,14
1748423808808,MAE 105,A00,931392,Bandaru; Prabhakar,135,0,180,45
1748423809844,MAE 107,A00,931393,Chen; Renkun,0,0,90,90
1748423809844,MAE 107,B00,931394,McEneaney; William Michael,45,0,90,45
1748423810877,MAE 108,A00,931395,Hao; Xuanting,91,0,120,29
1748423811904,MAE 113,A00,931396,Seshadri; Kalyanasundaram,92,0,130,38
1748423812936,MAE 114,A00,931399,Krasheninnikov; Sergei,37,0,40,3
1748423814031,MAE 120,A00,931400,Krasheninnikov; Sergei,36,0,50,14
1748423815063,MAE 122,A00,931402,Pawlak; Geno Ronald,43,0,70,27
1748423816094,MAE 131A,A00,931403,Lubarda; Marko,46,0,70,24
1748423817124,MAE 142,A00,931404,Anderson; Mark Ronald,21,0,60,39
1748423818159,MAE 143A,A00,931406,Diagne; Mamadou Lamine,98,0,125,27
1748423819188,MAE 148,A01,931409,Silberman; Jack,11,0,30,19
1748423820214,MAE 150,A00,931411,Friend; James Robert,139,0,192,53
1748423821242,MAE 153,A00,931413,Ghazinejad; Maziar,2,0,45,43
1748423822273,MAE 156A,A01,931416,Delson; Nathan Joseph,2,0,12,10
1748423822273,MAE 156A,A02,931417,Delson; Nathan Joseph,9,0,12,3
1748423822273,MAE 156A,A03,931418,Delson; Nathan Joseph,12,0,12,0
1748423822273,MAE 156A,A04,931419,Delson; Nathan Joseph,10,0,12,2
1748423822273,MAE 156A,A05,931420,Delson; Nathan Joseph,2,0,12,10
1748423822273,MAE 156A,A06,931421,Delson; Nathan Joseph,12,0,12,0
1748423823300,MAE 165,A00,931422,Scholtes Acevedo; Claire,19,0,30,11
1748423824332,MAE 170,A01,931424,Evdokimenko; Ekaterina,9,0,30,21
1748423824332,MAE 170,A02,931427,Evdokimenko; Ekaterina,14,0,30,16
1748423824332,MAE 170,A03,931428,Evdokimenko; Ekaterina,0,0,30,30
1748423824332,MAE 170,A04,931429,Evdokimenko; Ekaterina,14,0,30,16
1748423824332,MAE 170,A05,931430,Evdokimenko; Ekaterina,27,0,30,3
1748423824332,MAE 170,A06,931434,Evdokimenko; Ekaterina,23,0,30,7
1748423825359,MAE 180,A00,931436,Sadeghizadeh; Zahra,109,0,140,31
1748423826388,MAE 181,A00,931437,Bahadori; Mohammad Yousef,53,0,80,27
1748423827420,MAE 190,A00,971317,Marinoni; Alessandro & Krasheninnikov; Sergei,19,0,20,1
1748423828449,MAE 191,A01,931442,Qi; Huihui,19,0,20,1
1748423829481,MAE 201,A00,931445,Pawlak; Geno Ronald,36,0,90,54
1748423830509,MAE 202,A00,931452,Poulikakos; Lisa Voula,42,0,90,48
1748423831540,MAE 203,A00,931455,Frazier; Michael,26,0,90,64
1748423832567,MAE 205,A00,931456,Staff,9989,0,9999,10
1748423833596,MAE 208,A00,931457,Marinoni; Alessandro,52,0,150,98
1748423834623,MAE 210A,A00,931458,Saintillan; David,37,0,60,23
1748423835649,MAE 217A,A00,931459,Arefiev; Alexey,13,0,20,7
1748423836677,MAE 221A,A00,931460,Chen; Renkun,26,0,40,14
1748423837706,MAE 232A,A00,931464,Chen; Jiun-Shyan,3,0,35,32
1748423838733,MAE 233A,A00,931466,Luan; Haiwen,29,0,40,11
1748423839762,MAE 235,A00,954132,Krysl; Petr,0,0,0,0
1748423840789,MAE 249,A00,931472,Tolley; Michael Thomas,8,0,50,42
1748423841820,MAE 251,A00,931477,Graeve; Olivia A,12,0,15,3
1748423842849,MAE 257,A00,931478,Cai; Shengqiang,0,0,10,10
1748423843875,MAE 265A,A00,931480,Bandaru; Prabhakar,10,0,15,5
1748423844903,MAE 271A,A00,931481,Luo; Jian,9,0,10,1
1748423845930,MAE 280A,A00,931482,Kramer; Boris,61,0,110,49
1748423846958,MAE 283A,A00,931484,de Callafon; Raymond A,12,0,50,38
1748423847984,MAE 285,A00,931486,Friend; James Robert,30,0,30,0
1748423849012,MAE 287,A00,931488,Diagne; Mamadou Lamine,17,0,30,13
1748423850044,MAE 290A,A00,931490,Lindsey; Stephanie,42,0,70,28
1748423851069,MAE 294A,A00,931491,Becker; Janet Maria,14,0,20,6
1748423852097,MATH 2,A01,929271,Quarfoot; David James,22,0,25,3
1748423852097,MATH 2,B01,929278,Staff,21,0,25,4
1748423853140,MATH 3B,A01,929284,Hammock; Frances H,1,0,2,1
1748423853140,MATH 3B,A02,929312,Hammock; Frances H,1,0,2,1
1748423853140,MATH 3B,A03,967979,Hammock; Frances H,2,0,2,0
1748423853140,MATH 3B,A04,967980,Hammock; Frances H,1,0,2,1
1748423853140,MATH 3B,A05,967983,Hammock; Frances H,1,0,2,1
1748423853140,MATH 3B,A06,967984,Hammock; Frances H,2,0,2,0
1748423853140,MATH 3B,D01,929666,Staff,0,0,2,2
1748423853140,MATH 3B,D02,929667,Staff,0,0,2,2
1748423853140,MATH 3B,D03,929668,Staff,0,0,2,2
1748423853140,MATH 3B,D04,967987,Staff,0,0,2,2
1748423854171,MATH 3C,A01,929670,Staff,0,0,2,2
1748423854171,MATH 3C,A02,929671,Staff,0,0,2,2
1748423854171,MATH 3C,A03,929672,Staff,2,0,2,0
1748423854171,MATH 3C,A04,929673,Staff,2,0,2,0
1748423854171,MATH 3C,A05,967985,Staff,0,0,2,2
1748423854171,MATH 3C,A06,967986,Staff,1,0,2,1
1748423854171,MATH 3C,B01,929675,Staff,0,0,0,2
1748423854171,MATH 3C,B02,929676,Staff,0,0,2,2
1748423854171,MATH 3C,B03,929677,Staff,0,0,2,2
1748423854171,MATH 3C,B04,929679,Staff,0,0,2,2
1748423854171,MATH 3C,B05,967988,Staff,0,0,2,2
1748423854171,MATH 3C,B06,967989,Staff,0,0,2,2
1748423855210,MATH 4C,B01,929698,Anzaldo; Leesa B,0,0,0,2
1748423855210,MATH 4C,B02,929699,Anzaldo; Leesa B,4,0,4,0
1748423855210,MATH 4C,B03,929700,Anzaldo; Leesa B,3,0,4,1
1748423855210,MATH 4C,B04,929701,Anzaldo; Leesa B,4,0,4,0
1748423855210,MATH 4C,D01,929709,Staff,4,0,4,0
1748423855210,MATH 4C,D02,929710,Staff,3,0,4,1
1748423855210,MATH 4C,D03,967990,Staff,4,0,4,0
1748423855210,MATH 4C,D04,967991,Staff,4,0,4,0
1748423856245,MATH 10A,A01,929713,Staff,8,0,12,4
1748423856245,MATH 10A,A02,929715,Staff,12,0,12,0
1748423856245,MATH 10A,A03,929717,Staff,5,0,5,0
1748423856245,MATH 10A,A04,929718,Staff,5,0,5,0
1748423856245,MATH 10A,A05,929719,Staff,5,0,5,0
1748423856245,MATH 10A,A06,929720,Staff,4,0,5,1
1748423856245,MATH 10A,B01,929723,Eggers; John Dietrich,0,0,0,4
1748423856245,MATH 10A,B02,929724,Eggers; John Dietrich,0,0,4,4
1748423856245,MATH 10A,B03,929726,Eggers; John Dietrich,0,0,4,4
1748423856245,MATH 10A,B04,929727,Eggers; John Dietrich,0,0,4,4
1748423856245,MATH 10A,B05,929728,Eggers; John Dietrich,0,0,4,4
1748423856245,MATH 10A,B06,929729,Eggers; John Dietrich,1,0,4,3
1748423856245,MATH 10A,C01,929732,Staff,0,0,0,3
1748423856245,MATH 10A,C02,929734,Staff,0,0,4,4
1748423856245,MATH 10A,C03,929735,Staff,0,0,4,4
1748423856245,MATH 10A,C04,929736,Staff,0,0,4,4
1748423856245,MATH 10A,C05,929737,Staff,0,0,4,4
1748423856245,MATH 10A,C06,929739,Staff,0,0,4,4
1748423856245,MATH 10A,D01,929742,Staff,0,0,4,4
1748423856245,MATH 10A,D02,929743,Staff,0,0,4,4
1748423856245,MATH 10A,D03,929744,Staff,4,0,4,0
1748423856245,MATH 10A,D04,929746,Staff,4,0,4,0
1748423856245,MATH 10A,D05,929747,Staff,3,0,4,1
1748423856245,MATH 10A,D06,929748,Staff,4,0,4,0
1748423856245,MATH 10A,D07,968012,Staff,0,0,4,4
1748423856245,MATH 10A,D08,968013,Staff,3,0,4,1
1748423856245,MATH 10A,D09,968015,Staff,4,0,4,0
1748423856245,MATH 10A,D10,968017,Staff,2,0,4,2
1748423857279,MATH 10B,A01,929759,Bowers; Adam R.,0,0,10,10
1748423857279,MATH 10B,A02,929760,Bowers; Adam R.,0,0,10,10
1748423857279,MATH 10B,A03,929761,Bowers; Adam R.,0,0,10,10
1748423857279,MATH 10B,A04,929762,Bowers; Adam R.,0,0,10,10
1748423857279,MATH 10B,A05,929763,Bowers; Adam R.,0,0,10,10
1748423857279,MATH 10B,A06,929764,Bowers; Adam R.,0,0,10,10
1748423857279,MATH 10B,B01,929767,Staff,0,0,10,10
1748423857279,MATH 10B,B02,929770,Staff,7,0,10,3
1748423857279,MATH 10B,B03,929771,Staff,10,0,10,0
1748423857279,MATH 10B,B04,929772,Staff,9,0,10,1
1748423857279,MATH 10B,B05,929774,Staff,1,0,10,9
1748423857279,MATH 10B,B06,929775,Staff,10,0,10,0
1748423857279,MATH 10B,C01,929778,Huang; Lei,0,0,8,8
1748423857279,MATH 10B,C02,929779,Huang; Lei,0,0,10,10
1748423857279,MATH 10B,C03,929780,Huang; Lei,2,0,10,8
1748423857279,MATH 10B,C04,929781,Huang; Lei,8,0,10,2
1748423857279,MATH 10B,C05,929784,Huang; Lei,0,0,10,10
1748423857279,MATH 10B,C06,929785,Huang; Lei,2,0,10,8
1748423858306,MATH 10C,A01,929788,Staff,0,0,15,15
1748423858306,MATH 10C,A02,929789,Staff,0,0,15,15
1748423858306,MATH 10C,A03,929790,Staff,12,0,15,3
1748423858306,MATH 10C,A04,929791,Staff,13,0,15,2
1748423858306,MATH 10C,A05,929792,Staff,0,0,15,15
1748423858306,MATH 10C,A06,929793,Staff,0,0,15,15
1748423858306,MATH 10C,A07,929795,Staff,2,0,15,13
1748423858306,MATH 10C,A08,929796,Staff,15,0,15,0
1748423858306,MATH 10C,B01,929798,Staff,15,0,15,0
1748423858306,MATH 10C,B02,929799,Staff,0,0,15,15
1748423858306,MATH 10C,B03,929800,Staff,11,0,15,4
1748423858306,MATH 10C,B04,929802,Staff,14,0,15,1
1748423858306,MATH 10C,B05,929803,Staff,14,0,15,1
1748423858306,MATH 10C,B06,929805,Staff,15,0,15,0
1748423859333,MATH 11,A01,929807,Rava; Denise,0,0,25,25
1748423859333,MATH 11,A02,929808,Rava; Denise,0,0,25,25
1748423859333,MATH 11,A03,929809,Rava; Denise,0,0,25,25
1748423859333,MATH 11,A04,929811,Rava; Denise,0,0,25,25
1748423859333,MATH 11,B01,929816,Rava; Denise,0,0,25,25
1748423859333,MATH 11,B02,929817,Rava; Denise,0,0,25,25
1748423859333,MATH 11,B03,929818,Rava; Denise,0,0,25,25
1748423859333,MATH 11,B04,929819,Rava; Denise,0,0,25,25
1748423860375,MATH 18,C01,929841,Peca-Medlin; John Michael,4,0,10,6
1748423860375,MATH 18,C02,929843,Peca-Medlin; John Michael,7,0,10,3
1748423860375,MATH 18,C03,929844,Peca-Medlin; John Michael,3,0,10,7
1748423860375,MATH 18,C04,929845,Peca-Medlin; John Michael,0,0,10,10
1748423860375,MATH 18,C05,929846,Peca-Medlin; John Michael,2,0,10,8
1748423860375,MATH 18,C06,929848,Peca-Medlin; John Michael,0,0,10,10
1748423860375,MATH 18,D01,929852,Anzaldo; Leesa B,0,0,10,10
1748423860375,MATH 18,D02,929855,Anzaldo; Leesa B,0,0,10,10
1748423860375,MATH 18,D03,929856,Anzaldo; Leesa B,0,0,9,9
1748423860375,MATH 18,D04,929857,Anzaldo; Leesa B,0,0,10,10
1748423860375,MATH 18,D05,929858,Anzaldo; Leesa B,0,0,10,10
1748423860375,MATH 18,D06,929859,Anzaldo; Leesa B,0,0,10,10
1748423860375,MATH 18,E01,929862,Ganesan; Priyanga,0,0,10,10
1748423860375,MATH 18,E02,929863,Ganesan; Priyanga,0,0,10,10
1748423860375,MATH 18,E03,929865,Ganesan; Priyanga,0,0,10,10
1748423860375,MATH 18,E04,929866,Ganesan; Priyanga,8,0,10,2
1748423860375,MATH 18,E05,929867,Ganesan; Priyanga,10,0,10,0
1748423860375,MATH 18,E06,929869,Ganesan; Priyanga,10,0,10,0
1748423860375,MATH 18,F01,929872,Ganesan; Priyanga,12,0,20,8
1748423860375,MATH 18,F02,929873,Ganesan; Priyanga,17,0,20,3
1748423860375,MATH 18,F03,929874,Ganesan; Priyanga,19,0,20,1
1748423860375,MATH 18,F04,929875,Ganesan; Priyanga,19,0,20,1
1748423860375,MATH 18,F05,968018,Ganesan; Priyanga,12,0,12,0
1748423860375,MATH 18,F06,968019,Ganesan; Priyanga,11,0,12,1
1748423860375,MATH 18,F07,968020,Ganesan; Priyanga,10,0,12,2
1748423860375,MATH 18,F08,968022,Ganesan; Priyanga,11,0,12,1
1748423861404,MATH 20A,A01,929880,Bowers; Adam R.,23,0,25,2
1748423861404,MATH 20A,A02,929881,Bowers; Adam R.,24,0,25,1
1748423861404,MATH 20A,A03,929883,Bowers; Adam R.,1,0,5,4
1748423861404,MATH 20A,A04,929884,Bowers; Adam R.,4,0,5,1
1748423861404,MATH 20A,B01,929886,Staff,0,0,0,0
1748423861404,MATH 20A,B02,929887,Staff,3,0,5,2
1748423861404,MATH 20A,B03,929888,Staff,5,0,5,0
1748423861404,MATH 20A,B04,929889,Staff,5,0,5,0
1748423861404,MATH 20A,B05,929890,Staff,5,0,5,0
1748423861404,MATH 20A,B06,929891,Staff,5,0,5,0
1748423861404,MATH 20A,B07,967992,Staff,5,0,5,0
1748423861404,MATH 20A,B08,967993,Staff,5,0,5,0
1748423861404,MATH 20A,B09,967994,Staff,5,0,5,0
1748423861404,MATH 20A,B10,967995,Staff,5,0,5,0
1748423862436,MATH 20B,A01,929910,Staff,14,0,15,1
1748423862436,MATH 20B,A02,929911,Staff,15,0,15,0
1748423862436,MATH 20B,A03,929982,Staff,15,0,15,0
1748423862436,MATH 20B,A04,929983,Staff,15,0,15,0
1748423862436,MATH 20B,A05,929984,Staff,15,0,15,0
1748423862436,MATH 20B,A06,929985,Staff,15,0,15,0
1748423862436,MATH 20B,C01,930160,Staff,24,0,25,1
1748423862436,MATH 20B,C02,930186,Staff,25,0,25,0
1748423862436,MATH 20B,C03,930198,Staff,15,0,15,0
1748423862436,MATH 20B,C04,968000,Staff,15,0,15,0
1748423862436,MATH 20B,D01,930241,Chou; Raymond Oliver,13,0,25,12
1748423862436,MATH 20B,D02,930242,Chou; Raymond Oliver,23,0,25,2
1748423862436,MATH 20B,D03,930244,Chou; Raymond Oliver,0,0,15,15
1748423862436,MATH 20B,D04,968002,Chou; Raymond Oliver,0,0,13,13
1748423862436,MATH 20B,E01,930428,Wesley; William J,32,0,35,3
1748423862436,MATH 20B,E02,930529,Wesley; William J,35,0,35,0
1748423862436,MATH 20B,E03,968023,Wesley; William J,15,0,15,0
1748423862436,MATH 20B,E04,968024,Wesley; William J,15,0,15,0
1748423862436,MATH 20B,E05,968025,Wesley; William J,15,0,15,0
1748423862436,MATH 20B,E06,968026,Wesley; William J,15,0,15,0
1748423863468,MATH 20C,A01,930548,Staff,18,0,20,2
1748423863468,MATH 20C,A02,930554,Staff,19,0,20,1
1748423863468,MATH 20C,A03,930584,Staff,19,0,20,1
1748423863468,MATH 20C,A04,930606,Staff,20,0,20,0
1748423863468,MATH 20C,A05,930610,Staff,19,0,20,1
1748423863468,MATH 20C,A06,930641,Staff,20,0,20,0
1748423863468,MATH 20C,A07,968027,Staff,20,0,20,0
1748423863468,MATH 20C,A08,968028,Staff,20,0,20,0
1748423863468,MATH 20C,A09,968029,Staff,19,0,20,1
1748423863468,MATH 20C,A10,968031,Staff,20,0,20,0
1748423863468,MATH 20C,C01,930911,Staff,6,0,20,14
1748423863468,MATH 20C,C02,930940,Staff,16,0,20,4
1748423863468,MATH 20C,C03,930946,Staff,18,0,20,2
1748423863468,MATH 20C,C04,930959,Staff,20,0,20,0
1748423863468,MATH 20C,C05,930966,Staff,19,0,20,1
1748423863468,MATH 20C,C06,930974,Staff,16,0,20,4
1748423863468,MATH 20C,D01,931266,Hammock; Frances H,10,0,20,10
1748423863468,MATH 20C,D02,931267,Hammock; Frances H,14,0,17,3
1748423863468,MATH 20C,D03,931268,Hammock; Frances H,17,0,20,3
1748423863468,MATH 20C,D04,931269,Hammock; Frances H,19,0,20,1
1748423863468,MATH 20C,D05,931270,Hammock; Frances H,20,0,20,0
1748423863468,MATH 20C,D06,931271,Hammock; Frances H,18,0,20,2
1748423863468,MATH 20C,E01,931273,Staff,11,0,20,9
1748423863468,MATH 20C,E02,931274,Staff,19,0,20,1
1748423863468,MATH 20C,E03,931275,Staff,17,0,20,3
1748423863468,MATH 20C,E04,931276,Staff,19,0,20,1
1748423863468,MATH 20C,E05,931278,Staff,20,0,20,0
1748423863468,MATH 20C,E06,931279,Staff,20,0,20,0
1748423863468,MATH 20C,F01,931281,Staff,20,0,25,5
1748423863468,MATH 20C,F02,931282,Staff,22,0,25,3
1748423863468,MATH 20C,F03,931283,Staff,23,0,25,2
1748423863468,MATH 20C,F04,931285,Staff,24,0,25,1
1748423864501,MATH 20D,B01,931293,Upadrashta; Pranav Kumar,0,0,24,25
1748423864501,MATH 20D,B02,931294,Upadrashta; Pranav Kumar,0,0,30,30
1748423864501,MATH 20D,B03,931297,Upadrashta; Pranav Kumar,0,0,30,30
1748423864501,MATH 20D,B04,931298,Upadrashta; Pranav Kumar,8,0,30,22
1748423864501,MATH 20D,B05,931299,Upadrashta; Pranav Kumar,1,0,30,29
1748423864501,MATH 20D,B06,931300,Upadrashta; Pranav Kumar,25,0,30,5
1748423864501,MATH 20D,C01,931305,Upadrashta; Pranav Kumar,15,0,40,25
1748423864501,MATH 20D,C02,931306,Upadrashta; Pranav Kumar,38,0,40,2
1748423864501,MATH 20D,C03,931307,Upadrashta; Pranav Kumar,12,0,30,18
1748423864501,MATH 20D,C04,931308,Upadrashta; Pranav Kumar,26,0,30,4
1748423865535,MATH 20E,A01,931313,Staff,0,0,27,27
1748423865535,MATH 20E,A02,931315,Staff,19,0,27,8
1748423865535,MATH 20E,A03,931316,Staff,27,0,27,0
1748423865535,MATH 20E,A04,931317,Staff,27,0,27,0
1748423865535,MATH 20E,A05,968032,Staff,9,0,27,18
1748423865535,MATH 20E,A06,968033,Staff,24,0,27,3
1748423865535,MATH 20E,A07,968034,Staff,27,0,27,0
1748423865535,MATH 20E,A08,968035,Staff,26,0,27,1
1748423865535,MATH 20E,C01,931327,Staff,0,0,23,23
1748423865535,MATH 20E,C02,931329,Staff,0,0,27,27
1748423865535,MATH 20E,C03,931331,Staff,0,0,27,27
1748423865535,MATH 20E,C04,931332,Staff,0,0,27,27
1748423865535,MATH 20E,C05,931333,Staff,0,0,27,27
1748423865535,MATH 20E,C06,931334,Staff,7,0,27,20
1748423866568,MATH 31AH,A01,931337,Nandi; Achinta Kumar,5,0,5,0
1748423866568,MATH 31AH,A02,931340,Nandi; Achinta Kumar,5,0,5,0
1748423867597,MATH 87,A00,970775,Harel; Guershon,0,0,0,0
1748423867597,MATH 87,B00,970803,Meyer; David A.,0,0,0,0
1748423868623,MATH 88,A00,967999,Seward; Brandon M.,30,0,35,5
1748423869651,MATH 96,A00,931341,Kane; Daniel Mertz,0,0,0,0
1748423870680,MATH 100A,A01,927335,De Vleming; Kristin Elizab,21,0,30,9
1748423870680,MATH 100A,A02,927337,De Vleming; Kristin Elizab,24,0,30,6
1748423870680,MATH 100A,B01,927341,De Vleming; Kristin Elizab,2,0,30,28
1748423870680,MATH 100A,B02,927342,De Vleming; Kristin Elizab,8,0,30,22
1748423871712,MATH 102,B01,927348,Harel; Guershon,2,0,30,28
1748423871712,MATH 102,B02,927349,Harel; Guershon,22,0,30,8
1748423872746,MATH 103A,B01,927370,Staff,16,0,30,14
1748423872746,MATH 103A,B02,927378,Staff,29,0,30,1
1748423872746,MATH 103A,B03,969574,Staff,27,0,30,3
1748423872746,MATH 103A,C01,927381,Staff,12,0,30,18
1748423872746,MATH 103A,C02,927385,Staff,24,0,30,6
1748423872746,MATH 103A,D01,927388,Suk; Andrew Hoon,0,0,30,30
1748423872746,MATH 103A,D02,927389,Suk; Andrew Hoon,0,0,30,30
1748423873772,MATH 105,A01,927391,Ganapathy; Karthik,26,0,35,9
1748423873772,MATH 105,A02,927454,Ganapathy; Karthik,29,0,35,6
1748423874811,MATH 109,B01,927493,Xiao; Ming,0,0,5,5
1748423874811,MATH 109,B02,927494,Xiao; Ming,0,0,5,5
1748423874811,MATH 109,C01,927500,Xiao; Ming,0,0,5,5
1748423874811,MATH 109,C02,927501,Xiao; Ming,0,0,5,5
1748423874811,MATH 109,D01,927516,Buzaglo; Lucas,0,0,5,5
1748423874811,MATH 109,D02,927517,Buzaglo; Lucas,0,0,5,5
1748423874811,MATH 109,E01,927519,Buzaglo; Lucas,0,0,5,5
1748423874811,MATH 109,E02,927552,Buzaglo; Lucas,0,0,5,5
1748423875841,MATH 111A,A01,927559,Meyer; David A.,0,0,35,35
1748423876870,MATH 120A,A01,927572,Eggers; John Dietrich,13,0,30,17
1748423876870,MATH 120A,A02,927574,Eggers; John Dietrich,29,0,30,1
1748423877899,MATH 140A,A01,927580,Spolaor; Luca,0,0,30,30
1748423877899,MATH 140A,A02,927582,Spolaor; Luca,6,0,30,24
1748423877899,MATH 140A,B01,927588,Ioana; Adrian,0,0,30,30
1748423877899,MATH 140A,B02,927599,Ioana; Adrian,0,0,30,30
1748423878928,MATH 142A,B01,927620,Bejenaru; Ioan,0,0,30,30
1748423878928,MATH 142A,B02,927750,Bejenaru; Ioan,13,0,30,17
1748423878928,MATH 142A,C01,927789,Staff,25,0,30,5
1748423878928,MATH 142A,C02,927815,Staff,30,0,30,0
1748423878928,MATH 142A,C03,969575,Staff,25,0,30,5
1748423878928,MATH 142A,D01,927829,Staff,15,0,30,15
1748423878928,MATH 142A,D02,927832,Staff,30,0,30,0
1748423879959,MATH 153,A01,927862,Harel; Guershon,25,0,35,10
1748423880986,MATH 154,A01,928077,Kane; Daniel Mertz,27,0,35,8
1748423880986,MATH 154,A02,928083,Kane; Daniel Mertz,35,0,35,0
1748423880986,MATH 154,A03,928085,Kane; Daniel Mertz,0,0,35,35
1748423880986,MATH 154,A04,928086,Kane; Daniel Mertz,20,0,35,15
1748423882022,MATH 170A,A01,928146,Tian; Xiaochuan,0,0,30,30
1748423882022,MATH 170A,A02,928225,Tian; Xiaochuan,1,0,30,29
1748423882022,MATH 170A,A03,928231,Tian; Xiaochuan,26,0,30,4
1748423882022,MATH 170A,A04,928237,Tian; Xiaochuan,30,0,30,0
1748423882022,MATH 170A,B01,928244,Huang; Lei,23,0,30,7
1748423882022,MATH 170A,B02,928273,Huang; Lei,30,0,30,0
1748423882022,MATH 170A,B03,928274,Huang; Lei,18,0,30,12
1748423882022,MATH 170A,B04,928276,Huang; Lei,28,0,30,2
1748423883056,MATH 173A,A01,928278,Ding; Lijun,0,0,30,30
1748423883056,MATH 173A,A02,928319,Ding; Lijun,0,0,30,30
1748423883056,MATH 173A,A03,928322,Ding; Lijun,0,0,30,30
1748423883056,MATH 173A,A04,928377,Ding; Lijun,0,0,30,30
1748423883056,MATH 173A,B01,928383,Cloninger; Alexander,0,0,30,30
1748423883056,MATH 173A,B02,928384,Cloninger; Alexander,0,0,30,30
1748423883056,MATH 173A,B03,928385,Cloninger; Alexander,0,0,30,30
1748423883056,MATH 173A,B04,928386,Cloninger; Alexander,0,0,30,30
1748423884083,MATH 174,A01,928397,Cheng; Li-Tien,15,0,28,13
1748423884083,MATH 174,A02,928402,Cheng; Li-Tien,23,0,28,5
1748423885112,MATH 180A,A01,928408,Staff,0,0,25,25
1748423885112,MATH 180A,A02,928409,Staff,18,0,25,7
1748423885112,MATH 180A,A03,928416,Staff,23,0,25,2
1748423885112,MATH 180A,A04,928417,Staff,21,0,25,4
1748423885112,MATH 180A,B01,928428,Peca-Medlin; John Michael,0,0,25,25
1748423885112,MATH 180A,B02,928435,Peca-Medlin; John Michael,11,0,25,14
1748423885112,MATH 180A,B03,928436,Peca-Medlin; John Michael,20,0,25,5
1748423885112,MATH 180A,B04,928453,Peca-Medlin; John Michael,21,0,25,4
1748423885112,MATH 180A,C01,928466,Dixit; Rishabh,20,0,25,5
1748423885112,MATH 180A,C02,928467,Dixit; Rishabh,25,0,25,0
1748423885112,MATH 180A,C03,928506,Dixit; Rishabh,22,0,25,3
1748423885112,MATH 180A,C04,928511,Dixit; Rishabh,25,0,25,0
1748423886139,MATH 180C,A01,928520,Schweinsberg; Jason,0,0,35,35
1748423886139,MATH 180C,A02,928527,Schweinsberg; Jason,0,0,35,35
1748423887192,MATH 181B,A01,928538,Lou; Zhipeng,3,0,30,27
1748423887192,MATH 181B,A02,928539,Lou; Zhipeng,21,0,30,9
1748423887192,MATH 181B,A03,928543,Lou; Zhipeng,27,0,30,3
1748423888221,MATH 183,A01,928545,Quarfoot; David James,0,0,22,22
1748423888221,MATH 183,A02,928560,Quarfoot; David James,0,0,22,22
1748423888221,MATH 183,A03,928565,Quarfoot; David James,0,0,22,22
1748423888221,MATH 183,A04,928566,Quarfoot; David James,0,0,22,22
1748423888221,MATH 183,A05,928567,Quarfoot; David James,0,0,22,22
1748423888221,MATH 183,A06,928568,Quarfoot; David James,0,0,22,22
1748423889246,MATH 184,A01,928587,Chou; Raymond Oliver,14,0,35,21
1748423889246,MATH 184,A02,928592,Chou; Raymond Oliver,29,0,35,6
1748423889246,MATH 184,A03,928593,Chou; Raymond Oliver,32,0,35,3
1748423889246,MATH 184,A04,928594,Chou; Raymond Oliver,35,0,35,0
1748423890272,MATH 187A,A01,928609,Ganapathy; Karthik,0,0,25,25
1748423890272,MATH 187A,A02,928614,Ganapathy; Karthik,0,0,25,25
1748423890272,MATH 187A,A03,928615,Ganapathy; Karthik,0,0,25,25
1748423890272,MATH 187A,A04,928616,Ganapathy; Karthik,7,0,25,18
1748423890272,MATH 187A,A05,928617,Ganapathy; Karthik,0,0,25,25
1748423890272,MATH 187A,A06,928618,Ganapathy; Karthik,12,0,25,13
1748423891327,MATH 190A,A01,928685,Roberts; Justin Deritter,15,0,35,20
1748423892352,MATH 197,001,973284,Kedlaya; Kiran S.,9999,0,9999,0
1748423893384,MATH 200A,A00,928693,Salehi Golsefidy; Alireza,20,0,20,0
1748423894413,MATH 201A,A00,928694,Wenzl; Hans G,20,0,20,0
1748423895437,MATH 202A,A00,928732,Novak; Jonathan I,15,0,20,5
1748423896495,MATH 203A,A00,928743,Izadi; Elham,20,0,20,0
1748423897540,MATH 204A,A00,928764,Sorensen; Claus M,19,0,20,1
1748423898567,MATH 208,A00,928765,Staff,10,0,10,0
1748423899591,MATH 209,A00,928766,Staff,10,0,10,0
1748423900621,MATH 210A,A00,928808,Miller; Pearson,19,0,20,1
1748423901649,MATH 211A,A00,928809,Staff,10,0,10,0
1748423902676,MATH 211B,A00,928811,Staff,10,0,10,0
1748423903700,MATH 216A,A00,928812,Webber; Robert Jacobs,12,0,20,8
1748423904725,MATH 218,A00,928828,Staff,9,0,10,1
1748423905751,MATH 220A,A00,928829,Ebenfelt; Peter F,15,0,20,5
1748423906775,MATH 240A,A00,928830,Spolaor; Luca,17,0,20,3
1748423907803,MATH 241A,A00,928831,Zlatos; Andrej,14,0,20,6
1748423908830,MATH 242,A00,928903,Bejenaru; Ioan,16,0,20,4
1748423909855,MATH 243,A00,928911,Staff,10,0,10,0
1748423910916,MATH 248,A00,928919,Staff,10,0,10,0
1748423911942,MATH 251A,A00,928970,Sam; Steven V,18,0,20,2
1748423912966,MATH 258,A00,928973,Staff,10,0,10,0
1748423913994,MATH 259A,A00,929052,Staff,18,0,20,2
1748423915020,MATH 261A,A00,929059,Warnke; Lutz Peter,10,0,20,10
1748423916061,MATH 269,A00,929060,Staff,10,0,10,0
1748423917121,MATH 270A,A00,929061,Dumitriu; Ioana,8,0,20,12
1748423918205,MATH 273A,A00,929063,Leok; Melvin,17,0,20,3
1748423919233,MATH 274,A01,929069,Cheng; Li-Tien,5,0,5,0
1748423919233,MATH 274,A02,929071,Cheng; Li-Tien,5,0,5,0
1748423920263,MATH 277A,A00,929073,Grier; Daniel T,18,0,20,2
1748423920263,MATH 277A,B00,929080,Nie; Jiawang,20,0,20,0
1748423921287,MATH 278A,A00,929092,Staff,10,0,10,0
1748423922317,MATH 278B,A00,929105,Staff,10,0,10,0
1748423923342,MATH 278C,A00,929113,Staff,10,0,10,0
1748423924381,MATH 280A,A00,929117,Ang; Jie Jun,7,0,20,13
1748423925405,MATH 281A,A00,929120,Lou; Zhipeng,9,0,20,11
1748423926433,MATH 282A,A00,929138,Zhang; Danna,4,0,20,16
1748423927459,MATH 283,A00,929153,Tesler; Glenn,0,0,0,17
1748423928503,MATH 287A,A00,967998,Politis; Dimitris,9,0,15,6
1748423929527,MATH 288,A00,929158,Staff,9,0,10,1
1748423930553,MATH 290A,A00,929180,McKernan; James,18,0,20,2
1748423931580,MATH 292,A00,929185,Staff,10,0,10,0
1748423932604,MATH 295,A00,929189,Staff,15,0,15,0
1748423933633,MATH 297,001,929218,Gamst; Anthony Collins,0,0,0,0
1748423934686,MATS 200,A00,927075,Graeve; Olivia A,9983,0,9999,16
1748423935710,MATS 201A,A00,927076,Luo; Jian,36,0,50,14
1748423936738,MATS 202,A00,927102,Staff,37,0,50,13
1748423937763,MATS 227,A00,927103,Graeve; Olivia A,36,0,50,14
1748423938864,MATS 251A,A00,927139,Bandaru; Prabhakar,40,0,50,10
1748423939894,MATS 257,A00,927140,Cai; Shengqiang,8,0,20,12
1748423940928,MATS 295,A00,927151,Graeve; Olivia A,9999,0,9999,0
1748423940928,MATS 295,B00,927152,Kummel; Andrew C,9999,0,9999,0
1748423941962,MCWP 40,001,945345,Guillen; Melinda,3,0,3,0
1748423941962,MCWP 40,002,945347,Guillen; Melinda,0,0,3,3
1748423941962,MCWP 40,003,945348,Guillen; Melinda,0,0,3,3
1748423941962,MCWP 40,004,945379,Wastal; Carrie King,3,0,3,0
1748423941962,MCWP 40,005,945382,Wastal; Carrie King,2,0,3,1
1748423941962,MCWP 40,006,945383,Compas; Sean Matthew,0,0,3,3
1748423941962,MCWP 40,007,945387,Bartulis; Jason Michael,3,0,3,0
1748423941962,MCWP 40,008,945388,Wastal; Carrie King,2,0,3,1
1748423941962,MCWP 40,009,945391,Wastal; Carrie King,3,0,3,0
1748423941962,MCWP 40,011,945394,Bartulis; Jason Michael,3,0,3,0
1748423941962,MCWP 40,012,945395,Carter; Jennifer A,3,0,3,0
1748423941962,MCWP 40,013,945396,Carter; Jennifer A,2,0,3,1
1748423941962,MCWP 40,014,945429,Carter; Jennifer A,2,0,3,1
1748423941962,MCWP 40,015,945432,Smith; Haydee Marie,3,0,3,0
1748423941962,MCWP 40,016,945433,Smith; Haydee Marie,3,0,3,0
1748423941962,MCWP 40,017,945435,Smith; Haydee Marie,3,0,3,0
1748423941962,MCWP 40,018,945436,Pham; Vincent Minhduc,3,0,3,0
1748423941962,MCWP 40,019,945453,Pham; Vincent Minhduc,3,0,3,0
1748423941962,MCWP 40,020,945459,Pham; Vincent Minhduc,3,0,3,0
1748423941962,MCWP 40,023,945469,Montejo; Carolina,3,0,3,0
1748423941962,MCWP 40,024,945472,Montejo; Carolina,3,0,3,0
1748423941962,MCWP 40,026,945708,Compas; Sean Matthew,3,0,3,0
1748423941962,MCWP 40,027,945710,Duru; Nur,2,0,3,1
1748423941962,MCWP 40,028,945714,Duru; Nur,1,0,3,2
1748423941962,MCWP 40,029,945715,Duru; Nur,2,0,3,1
1748423941962,MCWP 40,030,945718,Compas; Sean Matthew,0,0,3,3
1748423942989,MCWP 40R,A00,945742,Miller; Elizabeth Deen,0,0,0,1
1748423942989,MCWP 40R,B00,945743,Miller; Elizabeth Deen,0,0,0,0
1748423942989,MCWP 40R,C00,945744,Miller; Elizabeth Deen,0,0,0,1
1748423944017,MCWP 50,001,945745,Wastal; Carrie King,2,0,15,13
1748423944017,MCWP 50,002,945746,Carter; Andrea L,18,0,20,2
1748423944017,MCWP 50,003,945788,Carter; Andrea L,11,0,20,9
1748423944017,MCWP 50,004,945887,Carter; Andrea L,8,0,20,12
1748423945059,MCWP 125,001,945901,Nies; Laurie Elizabeth,3,0,3,0
1748423945059,MCWP 125,002,945902,Nies; Laurie Elizabeth,3,0,3,0
1748423945059,MCWP 125,003,945904,Redela; Pamela Morgan,3,0,3,0
1748423945059,MCWP 125,004,945930,Redela; Pamela Morgan,3,0,3,0
1748423945059,MCWP 125,005,945931,Redela; Pamela Morgan,3,0,3,0
1748423945059,MCWP 125,006,945932,Silva; Kelly B,3,0,3,0
1748423945059,MCWP 125,007,945933,Silva; Kelly B,3,0,3,0
1748423945059,MCWP 125,009,945935,Krone; Jarret,3,0,3,0
1748423945059,MCWP 125,010,945940,Krone; Jarret,3,0,3,0
1748423945059,MCWP 125,011,945941,Krone; Jarret,3,0,3,0
1748423945059,MCWP 125,012,945942,Morshed; Michael James,3,0,3,0
1748423945059,MCWP 125,013,945943,Morshed; Michael James,3,0,3,0
1748423945059,MCWP 125,014,945944,Morshed; Michael James,3,0,3,0
1748423946092,MGT 3,A00,945992,Wagner; Timothy Ryan,96,0,98,2
1748423947119,MGT 4,A01,945994,Brooks; Marcus Raymond,80,0,90,10
1748423948146,MGT 5,A00,945995,Molloie Jr.; William H,134,0,150,16
1748423949187,MGT 12,A00,945996,Lindenberger; Wade Douglas,63,0,98,35
1748423949187,MGT 12,B00,945997,Pecore; Joseph P.,58,0,98,40
1748423950220,MGT 16,A00,945998,Buchanan; Harold G,96,0,98,2
1748423950220,MGT 16,B00,946005,Buchanan; Harold G,90,0,98,8
1748423950220,MGT 16,C00,946006,Campbell; Robert Harold,92,0,98,6
1748423950220,MGT 16,D00,946007,Campbell; Robert Harold,93,0,98,5
1748423950220,MGT 16,E00,946022,Lindenberger; Wade Douglas,42,0,98,56
1748423951258,MGT 18,A00,946040,McKay; Michael J,95,0,98,3
1748423951258,MGT 18,B00,946041,McKay; Michael J,96,0,98,2
1748423951258,MGT 18,C00,946044,McKay; Michael J,96,0,98,2
1748423951258,MGT 18,D00,946047,Chamberlain; Travis Dean,98,0,98,0
1748423951258,MGT 18,E00,946051,Chamberlain; Travis Dean,96,0,98,2
1748423951258,MGT 18,F00,960148,Chamberlain; Travis Dean,0,0,0,2
1748423952290,MGT 45,A00,946055,Pecore; Joseph P.,80,0,150,70
1748423952290,MGT 45,B00,946057,Pecore; Joseph P.,118,0,150,32
1748423953316,MGT 52,A00,946059,Staff,77,0,98,21
1748423954349,MGT 71,A00,946060,Goodarzi; Shadi,0,0,98,98
1748423954349,MGT 71,B00,946061,Erat; Sanjiv,0,0,98,98
1748423954349,MGT 71,D00,960149,Staff,0,0,98,98
1748423955375,MGT 100,A00,946069,Yavorsky; Daniel Ryan,0,0,98,98
1748423956410,MGT 103,A00,946081,Ehrich; Kristine R,96,0,98,2
1748423956410,MGT 103,C00,946083,Ehrich; Kristine R,75,0,98,23
1748423956410,MGT 103,D00,946084,Ehrich; Kristine R,57,0,98,41
1748423956410,MGT 103,E00,946138,Bates; Kenneth Walter,82,0,98,16
1748423957439,MGT 105,A00,946139,Bates; Kenneth Walter,0,0,98,98
1748423958471,MGT 108R,A00,946141,Amir; On,888,0,999,111
1748423959499,MGT 109,A00,946142,Staff,14,0,98,84
1748423960525,MGT 112,A00,960205,Zimmermann; Carsten,30,0,98,68
1748423961561,MGT 119,A00,946144,Schurr; Amos Shlomo,96,0,98,2
1748423961561,MGT 119,B00,946153,Staff,97,0,98,1
1748423962587,MGT 121A,A00,946154,Wang; Helen Shan,89,0,98,9
1748423962587,MGT 121A,B00,946188,Wang; Helen Shan,96,0,98,2
1748423963614,MGT 127R,A00,946197,Zhu; Kevin Xiaoguo,70,0,98,28
1748423964644,MGT 131A,A00,946227,Brooks; Marcus Raymond,91,0,98,7
1748423965672,MGT 132,A00,946230,Blakley; Bruce,76,0,98,22
1748423966702,MGT 135,A00,946234,Anderson; John Charles,1,0,40,39
1748423967731,MGT 137,A00,960206,Lindenberger; Wade Douglas,0,0,98,98
1748423968758,MGT 151R,A00,946235,Staff,64,0,98,34
1748423969792,MGT 153,A00,946242,Perols; Johan Lars,0,0,90,90
1748423969792,MGT 153,B00,946244,Perols; Johan Lars,0,0,90,90
1748423970823,MGT 158,A00,946247,Bliss; Barbara Ann,85,0,98,13
1748423971849,MGT 160,A00,946265,Johnson; Erik Barry,30,0,90,60
1748423971849,MGT 160,B00,946266,Johnson; Erik Barry,58,0,90,32
1748423972883,MGT 162,A00,946267,Demill; Burritt,85,0,98,13
1748423972883,MGT 162,B00,946269,Demill; Burritt,67,0,98,31
1748423973909,MGT 162R,A00,946270,Gneezy; Uri,0,0,150,150
1748423974938,MGT 164,A00,946271,McKay; Mary A,88,0,98,10
1748423974938,MGT 164,B00,946272,McKay; Mary A,80,0,98,18
1748423974938,MGT 164,C00,946273,McKay; Mary A,88,0,98,10
1748423974938,MGT 164,D00,946274,Meyer; Alison Bloomfield,0,0,98,98
1748423975966,MGT 166,A00,946276,Moran; Cathleen L.,40,0,60,20
1748423975966,MGT 166,B00,946277,Moran; Cathleen L.,84,0,98,14
1748423975966,MGT 166,C00,946278,Moran; Cathleen L.,94,0,98,4
1748423976997,MGT 167,A00,946279,Jacob; Jo Dee C,88,0,98,10
1748423976997,MGT 167,B00,946280,Klaas; Jeffrey David,97,0,98,1
1748423979060,MGT 172,A00,946282,Hedges; Kathleen & Royal; Rebecca,92,0,98,6
1748423979060,MGT 172,B00,946283,Hedges; Kathleen,73,0,98,25
1748423979060,MGT 172,C00,946284,Zimmermann; Carsten,0,0,0,3
1748423980086,MGT 172R,A00,946285,Erat; Sanjiv,134,0,150,16
1748423981113,MGT 173,A00,946286,Hayes; Sherry Lorine,66,0,98,32
1748423982139,MGT 175,A00,946287,Gopal; Christopher S.,81,0,90,9
1748423983168,MGT 180,A00,946288,Bliss; Barbara Ann,96,0,150,54
1748423983168,MGT 180,B00,946289,Buti; Krisztina,140,0,150,10
1748423983168,MGT 180,C00,960207,Buti; Krisztina,142,0,150,8
1748423984195,MGT 181,A00,946290,Buchanan; Harold G,17,0,120,103
1748423985222,MGT 183,A00,960208,Staff,53,0,98,45
1748423986251,MGT 185,A00,946291,Dunn; Louis Jean,70,0,98,28
1748423987276,MGT 187,A00,946292,Dunn; Louis Jean,43,0,98,55
1748423988306,MGT 189,A00,946293,Staff,88,0,98,10
1748423989333,MGT 228,A00,946294,Sadoff; Sally,16,0,20,4
1748423990359,MGT 286,A00,946295,Staff,20,0,20,0
1748423991394,MGT 296,001,969295,Gneezy; Ayelet,2,0,3,1
1748423991394,MGT 296,002,969296,Amir; On,3,0,3,0
1748423991394,MGT 296,003,969297,Amir; On & Karmarkar; Uma R,2,0,3,1
1748423991394,MGT 296,004,969298,Liu; Jun,3,0,3,0
1748423991394,MGT 296,005,969300,Hansen; Karsten T.,2,0,3,1
1748423991394,MGT 296,006,969301,Erat; Sanjiv,2,0,3,1
1748423991394,MGT 296,007,969302,Avenancio-Leon; Carlos,3,0,3,0
1748423991394,MGT 296,008,969303,Engelberg; Joseph Edward,3,0,3,0
1748423991394,MGT 296,009,969304,Zhang; Zhe,3,0,3,0
1748423991394,MGT 296,010,969305,Oveis; Christopher S,3,0,3,0
1748423991394,MGT 296,011,969306,Zhu; Kevin Xiaoguo & Gneezy; Ayelet,3,0,3,0
1748423991394,MGT 296,012,969307,Luo; Danqi,3,0,3,0
1748423991394,MGT 296,013,969309,Oveis; Christopher S & Campbell; Elizabeth L,3,0,3,0
1748423991394,MGT 296,014,969310,Serra Garcia; Marta & Gneezy; Uri,3,0,3,0
1748423991394,MGT 296,015,969311,Rai; Tage S,3,0,3,0
1748423992441,MMW 11,A01,925937,Herbst; Matthew,4,0,4,0
1748423992441,MMW 11,A02,925938,Herbst; Matthew,3,0,4,1
1748423992441,MMW 11,A03,925939,Herbst; Matthew,4,0,4,0
1748423992441,MMW 11,A04,925940,Herbst; Matthew,4,0,4,0
1748423992441,MMW 11,A05,925941,Herbst; Matthew,0,0,0,0
1748423992441,MMW 11,A06,925942,Herbst; Matthew,0,0,0,0
1748423992441,MMW 11,A07,925975,Herbst; Matthew,3,0,4,1
1748423992441,MMW 11,A08,926004,Herbst; Matthew,3,0,4,1
1748423992441,MMW 11,A09,926021,Herbst; Matthew,3,0,4,1
1748423992441,MMW 11,A10,926064,Herbst; Matthew,4,0,4,0
1748423992441,MMW 11,A11,926067,Herbst; Matthew,4,0,4,0
1748423992441,MMW 11,A12,926072,Herbst; Matthew,4,0,4,0
1748423992441,MMW 11,B01,926211,Chang; Edmond Yi-Teh,3,0,4,1
1748423992441,MMW 11,B02,926212,Chang; Edmond Yi-Teh,4,0,4,0
1748423992441,MMW 11,B03,926213,Chang; Edmond Yi-Teh,4,0,4,0
1748423992441,MMW 11,B04,926214,Chang; Edmond Yi-Teh,4,0,4,0
1748423992441,MMW 11,B05,926215,Chang; Edmond Yi-Teh,4,0,4,0
1748423992441,MMW 11,B06,926216,Chang; Edmond Yi-Teh,4,0,4,0
1748423992441,MMW 11,B07,926217,Chang; Edmond Yi-Teh,4,0,4,0
1748423992441,MMW 11,B08,926218,Chang; Edmond Yi-Teh,3,0,4,1
1748423992441,MMW 11,B09,926219,Chang; Edmond Yi-Teh,4,0,4,0
1748423992441,MMW 11,B10,926220,Chang; Edmond Yi-Teh,4,0,4,0
1748423992441,MMW 11,B11,926221,Chang; Edmond Yi-Teh,0,0,0,0
1748423992441,MMW 11,B12,926233,Chang; Edmond Yi-Teh,0,0,0,0
1748423992441,MMW 11,C01,926237,Chang; Edmond Yi-Teh,4,0,4,0
1748423992441,MMW 11,C02,926238,Chang; Edmond Yi-Teh,4,0,4,0
1748423992441,MMW 11,C03,926239,Chang; Edmond Yi-Teh,3,0,4,1
1748423992441,MMW 11,C04,926240,Chang; Edmond Yi-Teh,4,0,4,0
1748423992441,MMW 11,C05,926241,Chang; Edmond Yi-Teh,4,0,4,0
1748423992441,MMW 11,C06,926242,Chang; Edmond Yi-Teh,4,0,4,0
1748423992441,MMW 11,C07,926243,Chang; Edmond Yi-Teh,4,0,4,0
1748423992441,MMW 11,C08,926244,Chang; Edmond Yi-Teh,4,0,4,0
1748423992441,MMW 11,C09,926245,Chang; Edmond Yi-Teh,0,0,0,0
1748423992441,MMW 11,C10,926301,Chang; Edmond Yi-Teh,0,0,0,0
1748423992441,MMW 11,C11,926303,Chang; Edmond Yi-Teh,4,0,4,0
1748423992441,MMW 11,C12,926305,Chang; Edmond Yi-Teh,4,0,4,0
1748423993469,MMW 14,A01,926309,Carreras; Maria Victoria,0,0,0,0
1748423993469,MMW 14,A02,926470,Carreras; Maria Victoria,0,0,0,0
1748423993469,MMW 14,A03,926472,Carreras; Maria Victoria,0,0,28,28
1748423993469,MMW 14,A04,926474,Carreras; Maria Victoria,0,0,28,28
1748423993469,MMW 14,A05,926475,Carreras; Maria Victoria,0,0,28,28
1748423993469,MMW 14,A06,926476,Carreras; Maria Victoria,0,0,28,28
1748423993469,MMW 14,A07,926477,Carreras; Maria Victoria,0,0,28,28
1748423993469,MMW 14,A08,926513,Carreras; Maria Victoria,0,0,28,28
1748423993469,MMW 14,A09,926514,Carreras; Maria Victoria,0,0,0,0
1748423993469,MMW 14,A10,926515,Carreras; Maria Victoria,0,0,0,0
1748423994505,MMW 121,A01,926517,Adamiak; Patrick John,0,0,0,0
1748423994505,MMW 121,A02,926548,Adamiak; Patrick John,0,0,0,0
1748423994505,MMW 121,A03,926549,Adamiak; Patrick John,0,0,4,4
1748423994505,MMW 121,A04,926550,Adamiak; Patrick John,2,0,4,2
1748423994505,MMW 121,A05,926551,Adamiak; Patrick John,0,0,4,4
1748423994505,MMW 121,A06,926552,Adamiak; Patrick John,3,0,4,1
1748423994505,MMW 121,A07,926585,Adamiak; Patrick John,3,0,4,1
1748423994505,MMW 121,A08,926590,Adamiak; Patrick John,3,0,4,1
1748423994505,MMW 121,A09,926641,Adamiak; Patrick John,0,0,0,0
1748423994505,MMW 121,A10,926658,Adamiak; Patrick John,0,0,0,0
1748423994505,MMW 121,B01,926680,Adamiak; Patrick John,0,0,4,4
1748423994505,MMW 121,B02,926691,Adamiak; Patrick John,0,0,4,4
1748423994505,MMW 121,B03,926710,Adamiak; Patrick John,2,0,4,2
1748423994505,MMW 121,B04,926714,Adamiak; Patrick John,4,0,4,0
1748423994505,MMW 121,B05,926750,Adamiak; Patrick John,0,0,4,4
1748423994505,MMW 121,B06,926765,Adamiak; Patrick John,4,0,4,0
1748423994505,MMW 121,B07,926769,Adamiak; Patrick John,3,0,4,1
1748423994505,MMW 121,B08,926953,Adamiak; Patrick John,3,0,4,1
1748423994505,MMW 121,B09,926954,Adamiak; Patrick John,0,0,0,0
1748423994505,MMW 121,B10,926955,Adamiak; Patrick John,0,0,0,0
1748423995533,MSED 295,A00,927153,Staff,5,0,5,0
1748423996559,MSED 296A,A00,927181,Rabin; Jeffrey Mark,13,0,15,2
1748423997590,MUS 1A,A01,931495,Staff,24,0,25,1
1748423997590,MUS 1A,A02,931499,Staff,21,0,25,4
1748423997590,MUS 1A,A03,931502,Staff,21,0,25,4
1748423997590,MUS 1A,A04,931503,Staff,25,0,25,0
1748423997590,MUS 1A,A05,931504,Staff,19,0,25,6
1748423997590,MUS 1A,A06,931505,Staff,22,0,25,3
1748423997590,MUS 1A,B01,931507,Staff,25,0,25,0
1748423997590,MUS 1A,B02,931530,Staff,22,0,25,3
1748423997590,MUS 1A,B03,931534,Staff,23,0,25,2
1748423997590,MUS 1A,B04,931536,Staff,24,0,25,1
1748423997590,MUS 1A,B05,931539,Staff,17,0,25,8
1748423997590,MUS 1A,B06,931541,Staff,13,0,25,12
1748423998616,MUS 2A,A01,931544,Carlson; Erik,40,0,40,0
1748423999648,MUS 2AK,A00,931545,Ohnishi; Takae,15,0,15,0
1748423999648,MUS 2AK,B00,931546,Ohnishi; Takae,15,0,15,0
1748424000683,MUS 4,A01,931551,Staff,24,0,25,1
1748424000683,MUS 4,A02,931552,Staff,25,0,25,0
1748424000683,MUS 4,A03,931553,Staff,24,0,25,1
1748424000683,MUS 4,A04,931554,Staff,25,0,25,0
1748424000683,MUS 4,A05,931558,Staff,24,0,25,1
1748424000683,MUS 4,A06,931561,Staff,25,0,25,0
1748424000683,MUS 4,A07,931562,Staff,25,0,25,0
1748424000683,MUS 4,A08,931563,Staff,25,0,25,0
1748424000683,MUS 4,A09,931564,Staff,25,0,25,0
1748424000683,MUS 4,A10,931566,Staff,25,0,25,0
1748424001718,MUS 6,A01,931573,Freitas Caetano; Marcelo,27,0,30,3
1748424001718,MUS 6,A02,931574,Freitas Caetano; Marcelo,28,0,30,2
1748424001718,MUS 6,A03,931677,Freitas Caetano; Marcelo,28,0,30,2
1748424001718,MUS 6,A04,931696,Freitas Caetano; Marcelo,30,0,30,0
1748424002759,MUS 8,A01,931732,Smythe; Cory Benjamin,12,0,25,13
1748424002759,MUS 8,A02,931737,Smythe; Cory Benjamin,17,0,25,8
1748424002759,MUS 8,A03,931761,Smythe; Cory Benjamin,25,0,25,0
1748424002759,MUS 8,A04,931920,Smythe; Cory Benjamin,23,0,25,2
1748424002759,MUS 8,A05,931925,Smythe; Cory Benjamin,21,0,25,4
1748424002759,MUS 8,A06,931943,Smythe; Cory Benjamin,19,0,25,6
1748424002759,MUS 8,A07,931948,Smythe; Cory Benjamin,22,0,25,3
1748424002759,MUS 8,A08,931955,Smythe; Cory Benjamin,18,0,25,7
1748424002759,MUS 8,A09,931964,Smythe; Cory Benjamin,25,0,25,0
1748424002759,MUS 8,A10,931974,Smythe; Cory Benjamin,24,0,25,1
1748424003801,MUS 13,A01,961328,Guy; Nancy,28,0,30,2
1748424003801,MUS 13,A02,961333,Guy; Nancy,30,0,30,0
1748424003801,MUS 13,A03,961343,Guy; Nancy,28,0,30,2
1748424003801,MUS 13,A04,961351,Guy; Nancy,30,0,30,0
1748424004829,MUS 14,A01,932176,McCormack; Timothy Matthew,29,0,30,1
1748424004829,MUS 14,A02,932183,McCormack; Timothy Matthew,29,0,30,1
1748424004829,MUS 14,A03,932186,McCormack; Timothy Matthew,30,0,30,0
1748424004829,MUS 14,A04,932190,McCormack; Timothy Matthew,29,0,30,1
1748424005873,MUS 15,A01,932270,Lou; Michelle Siulai,28,0,30,2
1748424005873,MUS 15,A02,932315,Lou; Michelle Siulai,29,0,30,1
1748424005873,MUS 15,A03,932316,Lou; Michelle Siulai,28,0,30,2
1748424005873,MUS 15,A04,932323,Lou; Michelle Siulai,30,0,30,0
1748424005873,MUS 15,A05,932325,Lou; Michelle Siulai,27,0,30,3
1748424005873,MUS 15,A06,932326,Lou; Michelle Siulai,27,0,30,3
1748424005873,MUS 15,A07,932327,Lou; Michelle Siulai,30,0,30,0
1748424005873,MUS 15,A08,932328,Lou; Michelle Siulai,28,0,30,2
1748424005873,MUS 15,A09,932366,Lou; Michelle Siulai,29,0,30,1
1748424005873,MUS 15,A10,932380,Lou; Michelle Siulai,25,0,30,5
1748424006901,MUS 17,A01,932416,Staff,0,0,0,0
1748424006901,MUS 17,A02,932423,Staff,0,0,0,0
1748424006901,MUS 17,A03,932437,Staff,0,0,0,0
1748424006901,MUS 17,A04,932447,Staff,0,0,0,0
1748424006901,MUS 17,A05,932460,Staff,0,0,0,0
1748424006901,MUS 17,A06,932466,Staff,0,0,0,0
1748424006901,MUS 17,A07,932475,Staff,0,0,0,0
1748424006901,MUS 17,A08,932479,Staff,0,0,0,0
1748424006901,MUS 17,A09,932480,Staff,0,0,0,0
1748424006901,MUS 17,A10,932481,Staff,0,0,0,0
1748424006901,MUS 17,A11,932487,Staff,0,0,0,9
1748424006901,MUS 17,A12,932490,Staff,0,0,0,1
1748424007946,MUS 19R,A01,932494,Britt; King James,7,0,25,18
1748424007946,MUS 19R,A02,932500,Britt; King James,20,0,25,5
1748424007946,MUS 19R,A03,932503,Britt; King James,24,0,25,1
1748424007946,MUS 19R,A04,932504,Britt; King James,23,0,25,2
1748424007946,MUS 19R,A05,932512,Britt; King James,25,0,25,0
1748424007946,MUS 19R,A06,932513,Britt; King James,17,0,25,8
1748424007946,MUS 19R,A07,932517,Britt; King James,22,0,25,3
1748424007946,MUS 19R,A08,932522,Britt; King James,20,0,25,5
1748424007946,MUS 19R,A09,960795,Britt; King James,25,0,25,0
1748424007946,MUS 19R,A10,960796,Britt; King James,15,0,25,10
1748424007946,MUS 19R,B01,960808,Britt; King James,5,0,5,0
1748424007946,MUS 19R,B02,960810,Britt; King James,4,0,5,1
1748424007946,MUS 19R,B03,960812,Britt; King James,5,0,5,0
1748424007946,MUS 19R,B04,960815,Britt; King James,5,0,5,0
1748424007946,MUS 19R,B05,960861,Britt; King James,5,0,5,0
1748424007946,MUS 19R,B06,960863,Britt; King James,5,0,5,0
1748424007946,MUS 19R,B07,960866,Britt; King James,5,0,5,0
1748424007946,MUS 19R,B08,960870,Britt; King James,5,0,5,0
1748424007946,MUS 19R,B09,960871,Britt; King James,5,0,5,0
1748424007946,MUS 19R,B10,960872,Britt; King James,5,0,5,0
1748424008976,MUS 32,001,931432,Dresser; Mark Stuart,5,0,5,0
1748424008976,MUS 32,002,931433,Smythe; Cory Benjamin,5,0,5,0
1748424008976,MUS 32,003,931438,Kenyatta; Kamau,5,0,5,0
1748424008976,MUS 32,004,931441,Curtis; Charles Rector,5,0,5,0
1748424008976,MUS 32,005,931443,Staff,5,0,5,0
1748424008976,MUS 32,006,931447,Terrazas Perez; Wilfrido D,5,0,5,0
1748424008976,MUS 32,007,931448,Ohnishi; Takae,5,0,5,0
1748424008976,MUS 32,008,931453,Burr; Anthony I,5,0,5,0
1748424008976,MUS 32,009,931454,Carlson; Erik,5,0,5,0
1748424010002,MUS 32V,A00,932529,Staff,5,0,5,0
1748424010002,MUS 32V,B00,932532,Staff,5,0,5,0
1748424011027,MUS 32VM,A00,932533,Staff,15,0,15,0
1748424012055,MUS 33A,A00,932538,Liang; Lei,16,0,17,1
1748424013085,MUS 43,A00,932540,Staff,79,0,96,17
1748424014112,MUS 95C,A00,932544,Staff,30,0,40,10
1748424015138,MUS 95D,A00,932547,Staff,30,0,30,0
1748424016165,MUS 95E,A00,932548,Staff,45,0,45,0
1748424017194,MUS 95F,A00,932549,Staff,40,0,40,0
1748424018221,MUS 95G,A00,932550,Anderson; Kenneth,374,0,395,21
1748424018221,MUS 95G,B00,932553,Anderson; Kenneth,381,0,395,14
1748424019249,MUS 95JC,A00,932555,Kenyatta; Kamau,25,0,25,0
1748424020274,MUS 95L,A00,932556,Staff,65,0,65,0
1748424021304,MUS 95P,A00,932564,Nourai; Keyavash,17,0,20,3
1748424021304,MUS 95P,B00,932565,Nourai; Keyavash,18,0,20,2
1748424022387,MUS 95W,A00,932567,Seshadri; Kartik,26,0,30,4
1748424022387,MUS 95W,B00,932570,Seshadri; Kartik,30,0,30,0
1748424023418,MUS 101A,A01,932575,Burr; Anthony I,31,0,35,4
1748424024445,MUS 107,A00,932578,Terrazas Perez; Wilfrido D,14,0,15,1
1748424025476,MUS 111,A00,932580,Liang; Lei,135,0,140,5
1748424026503,MUS 113,A00,932584,Curtis; Charles Rector,48,0,50,2
1748424027762,MUS 115,A00,932585,Narucki; Susan M,32,0,40,8
1748424028790,MUS 120A,A01,932593,Leslie Santana; Myrta,27,0,30,3
1748424029821,MUS 130,A00,932600,Ohnishi; Takae,35,0,35,0
1748424030849,MUS 132,001,931462,Dresser; Mark Stuart,5,0,5,0
1748424030849,MUS 132,002,931463,Smythe; Cory Benjamin,5,0,5,0
1748424030849,MUS 132,003,931465,Kenyatta; Kamau,5,0,5,0
1748424030849,MUS 132,004,931467,Curtis; Charles Rector,5,0,5,0
1748424030849,MUS 132,005,931468,Staff,5,0,5,0
1748424030849,MUS 132,006,931470,Terrazas Perez; Wilfrido D,5,0,5,0
1748424030849,MUS 132,007,931471,Ohnishi; Takae,5,0,5,0
1748424030849,MUS 132,008,931473,Burr; Anthony I,5,0,5,0
1748424030849,MUS 132,009,931474,Carlson; Erik,5,0,5,0
1748424031882,MUS 132R,A00,961401,Narucki; Susan M,5,0,5,0
1748424032915,MUS 132V,A00,961362,Narucki; Susan M,10,0,10,0
1748424032915,MUS 132V,B00,961397,Staff,10,0,10,0
1748424033947,MUS 134,A00,932601,Staff,30,0,30,0
1748424034977,MUS 137A,A00,932604,Kenyatta; Kamau,31,0,35,4
1748424036009,MUS 143,A00,932617,Staff,10,0,30,20
1748424037035,MUS 170,A01,932620,Freitas Caetano; Marcelo,45,0,50,5
1748424037035,MUS 170,A02,932623,Freitas Caetano; Marcelo,41,0,50,9
1748424038065,MUS 173A,A00,932625,Britt; King James,27,0,65,38
1748424039094,MUS 174A,A00,932649,Erbe; Tom,0,0,25,25
1748424040124,MUS 175,A00,932810,Smyth; Tamara R.,29,0,30,1
1748424041880,MUS 176,A00,932811,Yadegari; Shahrokh D,29,0,30,1
1748424042907,MUS 201A,A00,932812,Carlson; Erik,14,0,15,1
1748424043940,MUS 201C,A00,932818,Schick; Steven,15,0,15,0
1748424044970,MUS 203A,A00,932821,Lou; Michelle Siulai,15,0,15,0
1748424046007,MUS 203D,A00,932825,Davis; Anthony Curtis,10,0,10,0
1748424046007,MUS 203D,B00,932827,Liang; Lei,10,0,10,0
1748424046007,MUS 203D,C00,932828,Lou; Michelle Siulai,9,0,10,1
1748424046007,MUS 203D,D00,932830,Obermueller; Karola,9,0,10,1
1748424046007,MUS 203D,E00,932831,Steiger; Rand,10,0,10,0
1748424046007,MUS 203D,F00,961402,McCormack; Timothy Matthew,10,0,10,0
1748424047033,MUS 204,A00,932832,Obermueller; Karola,29,0,30,1
1748424048060,MUS 205,A00,932833,Guy; Nancy,15,0,15,0
1748424049103,MUS 206,B00,961403,Obermueller; Karola,14,0,15,1
1748424049103,MUS 206,C00,932839,Davis; Anthony Curtis,14,0,15,1
1748424050136,MUS 215A,A00,932985,Cimini; Amy Marie,15,0,15,0
1748424051165,MUS 228,A00,933096,Schick; Steven,13,0,15,2
1748424052193,MUS 229,A00,933148,McCormack; Timothy Matthew,14,0,15,1
1748424053224,MUS 232,001,931483,Dresser; Mark Stuart,5,0,5,0
1748424053224,MUS 232,002,931485,Kenyatta; Kamau,5,0,5,0
1748424053224,MUS 232,003,931487,Narucki; Susan M,4,0,5,1
1748424053224,MUS 232,004,931489,Schick; Steven,5,0,5,0
1748424053224,MUS 232,005,964353,Terrazas Perez; Wilfrido D,3,0,3,0
1748424054256,MUS 234,A00,933176,Erbe; Tom,20,0,20,0
1748424055282,MUS 270D,A00,969315,Smyth; Tamara R.,0,0,0,0
1748424056306,MUS 291,A00,933192,Curtis; Charles Rector,15,0,15,0
1748424057344,NANO 4,A01,912573,Vazquez Mena; Oscar,21,0,24,3
1748424057344,NANO 4,B01,912575,Vazquez Mena; Oscar,24,0,24,0
1748424057344,NANO 4,C01,912577,Vazquez Mena; Oscar,21,0,24,3
1748424057344,NANO 4,D01,912579,Vazquez Mena; Oscar,23,0,24,1
1748424058371,NANO 11,A00,912580,Fenning; David,143,0,146,3
1748424059399,NANO 15,A01,912583,Lubarda; Vlado,26,0,30,4
1748424060432,NANO 20L,A00,912584,Sirbuly; Donald,0,0,30,30
1748424060432,NANO 20L,B00,912585,Sirbuly; Donald,20,0,30,10
1748424061459,NANO 102,A00,912586,Tao; Andrea Rae,99,0,115,16
1748424062486,NANO 103,A00,912587,Jahed Motlagh; Zeinab,49,0,50,1
1748424063514,NANO 111,A00,912588,Vecchio; Kenneth S,50,0,60,10
1748424064859,NANO 119,A00,912589,Jokerst; Jesse Vincent,6,0,28,22
1748424064859,NANO 119,B00,912590,Jokerst; Jesse Vincent,26,0,28,2
1748424065887,NANO 148,A00,912591,Luo; Jian,55,0,70,15
1748424066921,NANO 150,A00,912592,Lubarda; Vlado,48,0,50,2
1748424067948,NANO 159,A00,912593,Wang; Joseph,44,0,50,6
1748424068975,NANO 175,A00,912594,Steinmetz; Nicole F,13,0,35,22
1748424070005,NANO 200,A00,912595,Jahed Motlagh; Zeinab,110,0,120,10
1748424071030,NANO 201,A00,912596,Sirbuly; Donald,49,0,60,11
1748424072067,NANO 202,A00,912597,Pascal; Tod A,60,0,60,0
1748424073101,NANO 203,A00,912598,Fenning; David,95,0,100,5
1748424074128,NANO 227,A00,912599,Graeve; Olivia A,14,0,15,1
1748424075156,NANO 247A,A00,912600,Shi; Lingyan,9,0,15,6
1748424076230,NANO 247B,A00,912601,Aran; Kiana,11,0,15,4
1748424077255,NANO 257,A00,912602,Cai; Shengqiang,32,0,35,3
1748424078281,NANO 265,A00,912603,Luo; Jian,9,0,10,1
1748424079309,NEU 276,A00,969333,Staff,0,0,0,0
1748424079309,NEU 276,A01,969334,Staff,0,0,0,0
1748424080434,NEUG 200A,A01,969326,Bloodgood; Brenda Laurie,0,0,0,0
1748424080434,NEUG 200A,A02,969327,Bloodgood; Brenda Laurie,0,0,0,0
1748424081462,NEUG 221,A00,969330,Dore; Kim Bohemie,6,0,6,0
1748424081462,NEUG 221,B00,969331,Bloodgood; Brenda Laurie,0,0,0,0
1748424082489,NEUG 265,A00,969329,Yaksh; Tony L.,10,0,10,0
1748424083515,NEUG 296,A00,969336,Bloodgood; Brenda Laurie,12,0,12,0
1748424084574,PH 40,A00,922279,Trinidad; Dennis Ryan,136,0,150,14
1748424084574,PH 40,B00,922283,Trinidad; Dennis Ryan,148,0,150,2
1748424085613,PH 50,A00,922284,Glockner; Susan Mariscal,160,0,175,15
1748424086647,PH 90,A00,964352,Larsen; Britta Ann,0,0,0,0
1748424087674,PH 91,A00,922286,Harrell; Maralee Mae,48,0,50,2
1748424088701,PH 101,A00,922287,Brouwer; Kimberly,0,0,50,50
1748424089730,PH 102,A01,922307,Rana; Brinda Kanti,0,0,25,25
1748424089730,PH 102,A02,922310,Rana; Brinda Kanti,0,0,25,25
1748424090767,PH 110,A00,922333,Zoumas-Morse; Christine E.,0,0,50,50
1748424091795,PH 120,A00,922392,McMenamin; Sara B,0,0,50,50
1748424092825,PH 120R,A00,922393,McMenamin; Sara B,0,0,50,50
1748424094611,PH 130,A00,922441,Kayser; Georgia Lyn,0,0,60,60
1748424095638,PH 157,A00,922444,Campbell; Chadwick Karl,29,0,50,21
1748424096665,PH 161,A00,922445,Zoumas-Morse; Christine E.,0,0,50,50
1748424097698,PH 193,A00,922468,Zoumas-Morse; Christine E.,0,0,0,0
1748424099379,PH 231,A00,970937,Hurst; Samantha,12,0,12,0
1748424100994,PH 258,A00,960659,Bazzi; Angela Robertson,15,0,15,0
1748424102026,PH 259,A00,960660,Bandoli; Gretchen,10,0,10,0
1748424103057,PH 275,A00,922474,Groessl; Erik Joseph,10,0,10,0
1748424104086,PH 280,A00,960661,Strong; David R & Skaathun; Britt Paige,10,0,10,0
1748424105118,PHAR 219,A00,954131,Ross; Camille,0,0,0,0
1748424106145,PHAR 236,A00,934403,Chen; Shu-Juan,10,0,10,0
1748424107177,PHAR 295,A00,934404,Joiner; William J.,14,0,15,1
1748424108242,PHB 221,A00,922708,Zou; Jingjing,22,0,39,17
1748424109449,PHB 224,A00,922793,Jain; Sonia,9,0,30,21
1748424110476,PHB 227,A00,922796,Liu; Lin,14,0,37,23
1748424111505,PHB 241,A00,970723,Vaida; Florin,9998,0,9999,1
1748424112533,PHB 243A,A01,922822,Tu; Xin,20,0,45,25
1748424113564,PHB 244A,A00,922870,Zhang; Xinlian,20,0,35,15
1748424114864,PHB 280,A00,922875,Messer; Karen Sue,69,0,70,1
1748424115891,PHB 281,A00,923029,Staff,62,0,65,3
1748424116927,PHIL 1,A00,934405,Sher; Gila,38,0,40,2
1748424117986,PHIL 10,A01,934409,Rudolph; Rachel Etta,34,0,39,5
1748424117986,PHIL 10,A02,934410,Rudolph; Rachel Etta,32,0,40,8
1748424117986,PHIL 10,A03,934414,Rudolph; Rachel Etta,31,0,40,9
1748424117986,PHIL 10,A04,934415,Rudolph; Rachel Etta,39,0,40,1
1748424117986,PHIL 10,A05,934416,Rudolph; Rachel Etta,35,0,40,5
1748424117986,PHIL 10,A06,934417,Rudolph; Rachel Etta,39,0,40,1
1748424120017,PHIL 12,A01,934419,Harrell; Maralee Mae,0,0,0,0
1748424120017,PHIL 12,A02,934422,Harrell; Maralee Mae,0,0,0,0
1748424120017,PHIL 12,A03,934423,Harrell; Maralee Mae,30,0,35,5
1748424120017,PHIL 12,A04,934425,Harrell; Maralee Mae,32,0,35,3
1748424121057,PHIL 13,A01,934427,Lamey; Andy M.,32,0,34,2
1748424121057,PHIL 13,A02,934429,Lamey; Andy M.,31,0,34,3
1748424121057,PHIL 13,A03,934430,Lamey; Andy M.,31,0,34,3
1748424121057,PHIL 13,A04,934432,Lamey; Andy M.,34,0,34,0
1748424122115,PHIL 25,A00,934434,Chen; Keming,65,0,70,5
1748424123143,PHIL 27,A01,934442,Brandt; Reuven A,0,0,33,33
1748424123143,PHIL 27,A02,934443,Brandt; Reuven A,7,0,33,26
1748424123143,PHIL 27,A03,934444,Brandt; Reuven A,10,0,33,23
1748424123143,PHIL 27,A04,934448,Brandt; Reuven A,0,0,33,33
1748424123143,PHIL 27,A05,934450,Brandt; Reuven A,19,0,33,14
1748424123143,PHIL 27,A06,934452,Brandt; Reuven A,0,0,33,33
1748424123143,PHIL 27,A07,934499,Brandt; Reuven A,0,0,33,33
1748424123143,PHIL 27,A08,934500,Brandt; Reuven A,6,0,33,27
1748424124179,PHIL 28,A01,934502,Brink; David O.,26,0,33,7
1748424124179,PHIL 28,A02,934506,Brink; David O.,26,0,33,7
1748424124179,PHIL 28,A03,934507,Brink; David O.,27,0,33,6
1748424124179,PHIL 28,A04,934512,Brink; David O.,8,0,33,25
1748424124179,PHIL 28,A05,934517,Brink; David O.,20,0,33,13
1748424124179,PHIL 28,A06,934518,Brink; David O.,0,0,33,33
1748424124179,PHIL 28,A07,934519,Brink; David O.,16,0,33,17
1748424124179,PHIL 28,A08,934520,Brink; David O.,27,0,33,6
1748424125207,PHIL 35,A00,934521,Vargas; Manuel Rogelio,138,0,140,2
1748424126239,PHIL 50,A00,934524,Nelkin; Dana Kay,124,0,140,16
1748424127265,PHIL 65,A00,934526,Rudolph; Rachel Etta,37,0,40,3
1748424128314,PHIL 110,A00,934529,Shields; Christopher John,38,0,42,4
1748424129350,PHIL 115,A00,934530,Nelkin; Dana Kay,15,0,20,5
1748424130382,PHIL 120,A00,934533,Kocurek; Alexander William,45,0,60,15
1748424132307,PHIL 125,A00,934534,Carr; Jennifer Rose,38,0,40,2
1748424133355,PHIL 138,A00,934535,Brink; David O.,29,0,40,11
1748424134384,PHIL 143,A00,934579,Cohen; Jonathan David,40,0,40,0
1748424135415,PHIL 148,A00,934580,Callender; Craig Adam,126,0,140,14
1748424136448,PHIL 149,A00,934581,Fulkerson; Matthew Todd,37,0,70,33
1748424137478,PHIL 158,A00,934593,Chen; Keming,20,0,40,20
1748424138505,PHIL 166,A00,934675,Lamey; Andy M.,27,0,40,13
1748424139533,PHIL 180,A00,934688,Hardimon; Michael O.,32,0,40,8
1748424140565,PHIL 200,A00,934719,Kovaka; Karenc,20,0,20,0
1748424141591,PHIL 201A,A00,934736,Shields; Christopher John,18,0,20,2
1748424142843,PHIL 209A,A00,934772,McKenzie; Kerry V.,10,0,10,0
1748424143873,PHIL 209C,A00,934787,McKenzie; Kerry V.,10,0,10,0
1748424144907,PHIL 222,A00,934789,Kocurek; Alexander William & Carr; Jennifer Rose,19,0,20,1
1748424145935,PHIL 260,A00,934791,Bazargan-Forward; Saba,18,0,20,2
1748424146962,PHIL 271,A00,934793,Vargas; Manuel Rogelio & Nelkin; Dana Kay & Fulkerson; Matthew Todd,9999,0,9999,0
1748424147995,PHIL 275,A00,934819,Watkins; Eric,9998,0,9999,1
1748424149021,PHIL 277,A00,934820,Tolley; Clinton,9997,0,9999,2
1748424150056,PHIL 278,A00,934821,Cohen; Jonathan David & Fulkerson; Matthew Todd,9999,0,9999,0
1748424151086,PHIL 280,A00,934827,Kovaka; Karenc,9999,0,9999,0
1748424152115,PHIL 281,A00,934828,Tolley; Clinton,9999,0,9999,0
1748424153150,PHIL 282,A00,934869,Bazargan-Forward; Saba,9999,0,9999,0
1748424154178,PHIL 283,A00,934870,Vargas; Manuel Rogelio & Tolley; Clinton,9999,0,9999,0
1748424155204,PHIL 286,A00,934871,Callender; Craig Adam & Chen; Keming,9999,0,9999,0
1748424156230,PHIL 287,A00,934872,Shields; Christopher John,9999,0,9999,0
1748424157269,PHIL 290,001,963258,Bazargan-Forward; Saba,9999,0,9999,0
1748424157269,PHIL 290,002,963281,Brandt; Reuven A,9999,0,9999,0
1748424157269,PHIL 290,003,963724,Brink; David O.,9999,0,9999,0
1748424157269,PHIL 290,004,963726,Callender; Craig Adam,9999,0,9999,0
1748424157269,PHIL 290,005,963740,Carr; Jennifer Rose,9999,0,9999,0
1748424157269,PHIL 290,006,963878,Cartwright; Nancy D.,9999,0,9999,0
1748424157269,PHIL 290,007,963888,Chen; Keming,9999,0,9999,0
1748424157269,PHIL 290,008,963889,Cohen; Jonathan David,9999,0,9999,0
1748424157269,PHIL 290,009,964028,Danks; David J,9999,0,9999,0
1748424157269,PHIL 290,010,964036,Fulkerson; Matthew Todd,9999,0,9999,0
1748424157269,PHIL 290,011,964044,Hardimon; Michael O.,9999,0,9999,0
1748424157269,PHIL 290,012,964084,Harrell; Maralee Mae,9999,0,9999,0
1748424157269,PHIL 290,013,964086,Johnson; Monte,9999,0,9999,0
1748424157269,PHIL 290,014,964093,Kocurek; Alexander William,9999,0,9999,0
1748424157269,PHIL 290,015,964101,Kovaka; Karenc,9999,0,9999,0
1748424157269,PHIL 290,016,964107,Lamey; Andy M.,9999,0,9999,0
1748424157269,PHIL 290,017,964113,Marechal; Patricia,9999,0,9999,0
1748424157269,PHIL 290,018,964125,McKenzie; Kerry V.,9999,0,9999,0
1748424157269,PHIL 290,019,964131,Nelkin; Dana Kay,9999,0,9999,0
1748424157269,PHIL 290,020,964132,Rickless; Samuel Charles,9999,0,9999,0
1748424157269,PHIL 290,021,964133,Rudolph; Rachel Etta,9999,0,9999,0
1748424157269,PHIL 290,022,964141,Sher; Gila,9999,0,9999,0
1748424157269,PHIL 290,023,964142,Shields; Christopher John,9999,0,9999,0
1748424157269,PHIL 290,024,964181,Tolley; Clinton,9999,0,9999,0
1748424157269,PHIL 290,025,964182,Vargas; Manuel Rogelio,9999,0,9999,0
1748424157269,PHIL 290,026,964232,Watkins; Eric,9999,0,9999,0
1748424157269,PHIL 290,027,964233,Yuan; Yuan,9999,0,9999,0
1748424158312,PHIL 295,001,964259,Bazargan-Forward; Saba,9999,0,9999,0
1748424158312,PHIL 295,002,964262,Brandt; Reuven A,9999,0,9999,0
1748424158312,PHIL 295,003,964263,Brink; David O.,9999,0,9999,0
1748424158312,PHIL 295,004,964264,Callender; Craig Adam,9999,0,9999,0
1748424158312,PHIL 295,005,964265,Carr; Jennifer Rose,9999,0,9999,0
1748424158312,PHIL 295,006,964266,Cartwright; Nancy D.,9999,0,9999,0
1748424158312,PHIL 295,007,964267,Chen; Keming,9999,0,9999,0
1748424158312,PHIL 295,008,964268,Cohen; Jonathan David,9999,0,9999,0
1748424158312,PHIL 295,009,964269,Danks; David J,9999,0,9999,0
1748424158312,PHIL 295,010,964270,Fulkerson; Matthew Todd,9999,0,9999,0
1748424158312,PHIL 295,011,964271,Hardimon; Michael O.,9999,0,9999,0
1748424158312,PHIL 295,012,964272,Harrell; Maralee Mae,9999,0,9999,0
1748424158312,PHIL 295,013,964273,Johnson; Monte,9999,0,9999,0
1748424158312,PHIL 295,014,964274,Kocurek; Alexander William,9999,0,9999,0
1748424158312,PHIL 295,015,964275,Kovaka; Karenc,9999,0,9999,0
1748424158312,PHIL 295,016,964276,Lamey; Andy M.,9999,0,9999,0
1748424158312,PHIL 295,017,964277,Marechal; Patricia,9999,0,9999,0
1748424158312,PHIL 295,018,964278,McKenzie; Kerry V.,9999,0,9999,0
1748424158312,PHIL 295,019,964279,Nelkin; Dana Kay,9999,0,9999,0
1748424158312,PHIL 295,020,964280,Rickless; Samuel Charles,9999,0,9999,0
1748424158312,PHIL 295,021,964281,Rudolph; Rachel Etta,9999,0,9999,0
1748424158312,PHIL 295,022,964282,Sher; Gila,9999,0,9999,0
1748424158312,PHIL 295,023,964283,Shields; Christopher John,9999,0,9999,0
1748424158312,PHIL 295,024,964284,Tolley; Clinton,9999,0,9999,0
1748424158312,PHIL 295,025,964285,Vargas; Manuel Rogelio,9999,0,9999,0
1748424158312,PHIL 295,026,964286,Watkins; Eric,9999,0,9999,0
1748424158312,PHIL 295,027,964287,Yuan; Yuan,9999,0,9999,0
1748424159340,PHYS 1A,A00,935435,Groisman; Alexander,434,0,589,155
1748424159340,PHYS 1A,B00,935437,Groisman; Alexander,456,0,600,144
1748424160395,PHYS 1AL,001,935439,Bal; Gurleen K & Frano Pereira; Alex M,18,0,30,12
1748424160395,PHYS 1AL,002,935440,Bal; Gurleen K & Frano Pereira; Alex M,25,0,30,5
1748424160395,PHYS 1AL,003,935443,Bal; Gurleen K & Frano Pereira; Alex M,0,0,30,30
1748424160395,PHYS 1AL,004,935445,Bal; Gurleen K & Frano Pereira; Alex M,0,0,30,30
1748424160395,PHYS 1AL,005,935448,Bal; Gurleen K & Frano Pereira; Alex M,0,0,30,30
1748424160395,PHYS 1AL,006,935449,Bal; Gurleen K & Frano Pereira; Alex M,0,0,30,30
1748424160395,PHYS 1AL,007,935451,Bal; Gurleen K & Frano Pereira; Alex M,0,0,30,30
1748424160395,PHYS 1AL,008,935452,Bal; Gurleen K & Frano Pereira; Alex M,1,0,30,29
1748424160395,PHYS 1AL,009,935454,Bal; Gurleen K & Frano Pereira; Alex M,9,0,30,21
1748424160395,PHYS 1AL,010,935589,Bal; Gurleen K & Frano Pereira; Alex M,17,0,30,13
1748424160395,PHYS 1AL,011,935590,Bal; Gurleen K & Frano Pereira; Alex M,15,0,19,4
1748424160395,PHYS 1AL,012,935591,Bal; Gurleen K & Frano Pereira; Alex M,29,0,30,1
1748424160395,PHYS 1AL,013,935652,Bal; Gurleen K & Frano Pereira; Alex M,0,0,30,30
1748424160395,PHYS 1AL,014,935675,Bal; Gurleen K & Frano Pereira; Alex M,0,0,30,30
1748424160395,PHYS 1AL,015,935680,Bal; Gurleen K & Frano Pereira; Alex M,0,0,30,30
1748424160395,PHYS 1AL,016,935703,Bal; Gurleen K & Frano Pereira; Alex M,0,0,30,30
1748424160395,PHYS 1AL,017,935704,Bal; Gurleen K & Frano Pereira; Alex M,9,0,30,21
1748424160395,PHYS 1AL,018,935729,Bal; Gurleen K & Frano Pereira; Alex M,12,0,30,18
1748424160395,PHYS 1AL,019,935825,Bal; Gurleen K & Frano Pereira; Alex M,23,0,30,7
1748424160395,PHYS 1AL,020,935826,Bal; Gurleen K & Frano Pereira; Alex M,27,0,30,3
1748424160395,PHYS 1AL,021,935946,Bal; Gurleen K & Frano Pereira; Alex M,28,0,30,2
1748424160395,PHYS 1AL,022,935947,Bal; Gurleen K & Frano Pereira; Alex M,30,0,30,0
1748424160395,PHYS 1AL,023,936029,Bal; Gurleen K & Frano Pereira; Alex M,4,0,30,26
1748424160395,PHYS 1AL,024,936031,Bal; Gurleen K & Frano Pereira; Alex M,12,0,30,18
1748424160395,PHYS 1AL,025,936033,Bal; Gurleen K & Frano Pereira; Alex M,19,0,30,11
1748424160395,PHYS 1AL,026,936034,Bal; Gurleen K & Frano Pereira; Alex M,19,0,30,11
1748424160395,PHYS 1AL,027,936036,Bal; Gurleen K & Frano Pereira; Alex M,6,0,30,24
1748424160395,PHYS 1AL,028,936038,Bal; Gurleen K & Frano Pereira; Alex M,22,0,30,8
1748424160395,PHYS 1AL,029,936044,Bal; Gurleen K & Frano Pereira; Alex M,20,0,30,10
1748424160395,PHYS 1AL,030,936045,Bal; Gurleen K & Frano Pereira; Alex M,27,0,30,3
1748424160395,PHYS 1AL,031,936054,Bal; Gurleen K & Frano Pereira; Alex M,28,0,30,2
1748424160395,PHYS 1AL,032,936056,Bal; Gurleen K & Frano Pereira; Alex M,28,0,30,2
1748424160395,PHYS 1AL,033,936057,Bal; Gurleen K & Frano Pereira; Alex M,0,0,30,30
1748424160395,PHYS 1AL,034,936059,Bal; Gurleen K & Frano Pereira; Alex M,1,0,30,29
1748424160395,PHYS 1AL,035,936060,Bal; Gurleen K & Frano Pereira; Alex M,11,0,30,19
1748424160395,PHYS 1AL,036,936063,Bal; Gurleen K & Frano Pereira; Alex M,21,0,30,9
1748424160395,PHYS 1AL,037,960551,Bal; Gurleen K & Frano Pereira; Alex M,25,0,30,5
1748424160395,PHYS 1AL,038,960592,Bal; Gurleen K & Frano Pereira; Alex M,28,0,30,2
1748424160395,PHYS 1AL,039,960618,Bal; Gurleen K & Frano Pereira; Alex M,29,0,30,1
1748424160395,PHYS 1AL,040,960644,Bal; Gurleen K & Frano Pereira; Alex M,30,0,30,0
1748424161422,PHYS 1B,A00,936064,Staff,216,0,360,144
1748424162451,PHYS 1BL,001,936066,Bal; Gurleen K & Frano Pereira; Alex M,1,0,29,28
1748424162451,PHYS 1BL,002,936067,Bal; Gurleen K & Frano Pereira; Alex M,0,0,30,30
1748424162451,PHYS 1BL,003,936068,Bal; Gurleen K & Frano Pereira; Alex M,5,0,30,25
1748424162451,PHYS 1BL,004,936072,Bal; Gurleen K & Frano Pereira; Alex M,0,0,30,30
1748424162451,PHYS 1BL,005,936074,Bal; Gurleen K & Frano Pereira; Alex M,0,0,30,30
1748424162451,PHYS 1BL,006,936075,Bal; Gurleen K & Frano Pereira; Alex M,0,0,30,30
1748424162451,PHYS 1BL,007,936116,Bal; Gurleen K & Frano Pereira; Alex M,7,0,30,23
1748424162451,PHYS 1BL,008,936125,Bal; Gurleen K & Frano Pereira; Alex M,14,0,30,16
1748424162451,PHYS 1BL,009,936128,Bal; Gurleen K & Frano Pereira; Alex M,12,0,30,18
1748424162451,PHYS 1BL,010,936145,Bal; Gurleen K & Frano Pereira; Alex M,14,0,30,16
1748424162451,PHYS 1BL,011,936146,Bal; Gurleen K & Frano Pereira; Alex M,0,0,30,30
1748424162451,PHYS 1BL,012,936147,Bal; Gurleen K & Frano Pereira; Alex M,6,0,30,24
1748424163481,PHYS 1C,A00,936148,Tsai; Philbert S,220,0,360,140
1748424164526,PHYS 1CL,001,936149,Bal; Gurleen K & Frano Pereira; Alex M,0,0,30,30
1748424164526,PHYS 1CL,002,936150,Bal; Gurleen K & Frano Pereira; Alex M,0,0,30,30
1748424164526,PHYS 1CL,003,936152,Bal; Gurleen K & Frano Pereira; Alex M,0,0,30,30
1748424164526,PHYS 1CL,004,936153,Bal; Gurleen K & Frano Pereira; Alex M,0,0,30,30
1748424164526,PHYS 1CL,005,936154,Bal; Gurleen K & Frano Pereira; Alex M,0,0,30,30
1748424164526,PHYS 1CL,006,936156,Bal; Gurleen K & Frano Pereira; Alex M,0,0,24,24
1748424164526,PHYS 1CL,007,936157,Bal; Gurleen K & Frano Pereira; Alex M,22,0,30,8
1748424164526,PHYS 1CL,008,936158,Bal; Gurleen K & Frano Pereira; Alex M,0,0,30,30
1748424164526,PHYS 1CL,009,936159,Bal; Gurleen K & Frano Pereira; Alex M,0,0,30,30
1748424164526,PHYS 1CL,010,936160,Bal; Gurleen K & Frano Pereira; Alex M,0,0,30,30
1748424164526,PHYS 1CL,011,936161,Bal; Gurleen K & Frano Pereira; Alex M,0,0,30,30
1748424164526,PHYS 1CL,012,936162,Bal; Gurleen K & Frano Pereira; Alex M,0,0,30,30
1748424165561,PHYS 2A,A01,936165,Shotwell; Brian,30,0,30,0
1748424165561,PHYS 2A,A02,936167,Shotwell; Brian,28,0,30,2
1748424165561,PHYS 2A,A03,936168,Shotwell; Brian,25,0,30,5
1748424165561,PHYS 2A,A04,936169,Shotwell; Brian,30,0,30,0
1748424165561,PHYS 2A,A05,936170,Shotwell; Brian,16,0,25,9
1748424165561,PHYS 2A,A06,936171,Shotwell; Brian,26,0,30,4
1748424165561,PHYS 2A,A07,936172,Shotwell; Brian,18,0,30,12
1748424165561,PHYS 2A,A08,936174,Shotwell; Brian,24,0,30,6
1748424165561,PHYS 2A,A09,936175,Shotwell; Brian,25,0,30,5
1748424165561,PHYS 2A,A10,936176,Shotwell; Brian,25,0,30,5
1748424165561,PHYS 2A,A11,936177,Shotwell; Brian,21,0,30,9
1748424165561,PHYS 2A,A12,936179,Shotwell; Brian,25,0,30,5
1748424166595,PHYS 2B,A01,936182,Barreiro Guerrero; Julio,13,0,30,17
1748424166595,PHYS 2B,A02,936183,Barreiro Guerrero; Julio,20,0,30,10
1748424166595,PHYS 2B,A03,936184,Barreiro Guerrero; Julio,20,0,30,10
1748424166595,PHYS 2B,A04,936185,Barreiro Guerrero; Julio,26,0,29,3
1748424166595,PHYS 2B,A05,936187,Barreiro Guerrero; Julio,27,0,30,3
1748424166595,PHYS 2B,A06,936217,Barreiro Guerrero; Julio,26,0,30,4
1748424166595,PHYS 2B,A07,936219,Barreiro Guerrero; Julio,23,0,30,7
1748424166595,PHYS 2B,A08,936220,Barreiro Guerrero; Julio,26,0,30,4
1748424166595,PHYS 2B,A09,936221,Barreiro Guerrero; Julio,29,0,30,1
1748424166595,PHYS 2B,A10,936224,Barreiro Guerrero; Julio,29,0,30,1
1748424166595,PHYS 2B,A11,936229,Barreiro Guerrero; Julio,28,0,30,2
1748424166595,PHYS 2B,A12,936231,Barreiro Guerrero; Julio,27,0,30,3
1748424167626,PHYS 2C,A01,936235,Tan; Tzer Han,23,0,30,7
1748424167626,PHYS 2C,A02,936236,Tan; Tzer Han,27,0,30,3
1748424167626,PHYS 2C,A03,936237,Tan; Tzer Han,22,0,30,8
1748424167626,PHYS 2C,A04,936246,Tan; Tzer Han,17,0,30,13
1748424167626,PHYS 2C,A05,936292,Tan; Tzer Han,16,0,28,12
1748424167626,PHYS 2C,A06,936300,Tan; Tzer Han,19,0,30,11
1748424167626,PHYS 2C,A07,936301,Tan; Tzer Han,8,0,30,22
1748424167626,PHYS 2C,A08,936302,Tan; Tzer Han,20,0,30,10
1748424167626,PHYS 2C,A09,936303,Tan; Tzer Han,26,0,30,4
1748424167626,PHYS 2C,A10,936304,Tan; Tzer Han,26,0,30,4
1748424167626,PHYS 2C,A11,936305,Tan; Tzer Han,12,0,30,18
1748424167626,PHYS 2C,A12,936332,Tan; Tzer Han,27,0,30,3
1748424167626,PHYS 2C,B01,936337,Tan; Tzer Han,0,0,30,30
1748424167626,PHYS 2C,B02,936470,Tan; Tzer Han,1,0,30,29
1748424167626,PHYS 2C,B03,936503,Tan; Tzer Han,21,0,30,9
1748424167626,PHYS 2C,B04,936533,Tan; Tzer Han,22,0,30,8
1748424167626,PHYS 2C,B05,936534,Tan; Tzer Han,20,0,30,10
1748424167626,PHYS 2C,B06,936535,Tan; Tzer Han,23,0,30,7
1748424167626,PHYS 2C,B07,936536,Tan; Tzer Han,25,0,30,5
1748424167626,PHYS 2C,B08,936537,Tan; Tzer Han,22,0,30,8
1748424167626,PHYS 2C,B09,936539,Tan; Tzer Han,26,0,30,4
1748424167626,PHYS 2C,B10,936540,Tan; Tzer Han,27,0,30,3
1748424167626,PHYS 2C,B11,936544,Tan; Tzer Han,28,0,30,2
1748424167626,PHYS 2C,B12,936548,Tan; Tzer Han,28,0,30,2
1748424168657,PHYS 2CL,A01,936555,Ni; Kaixuan,0,0,28,28
1748424168657,PHYS 2CL,A02,936556,Ni; Kaixuan,0,0,28,28
1748424168657,PHYS 2CL,A03,936557,Ni; Kaixuan,0,0,28,28
1748424168657,PHYS 2CL,A04,936559,Ni; Kaixuan,0,0,28,28
1748424168657,PHYS 2CL,A05,936566,Ni; Kaixuan,0,0,28,28
1748424168657,PHYS 2CL,A06,936582,Ni; Kaixuan,0,0,28,28
1748424168657,PHYS 2CL,A07,936583,Ni; Kaixuan,0,0,28,28
1748424169689,PHYS 2D,A01,936615,Sharma; Vivek A.,0,0,27,27
1748424170721,PHYS 2DL,A01,936627,Butov; Leonid,14,0,17,3
1748424170721,PHYS 2DL,A02,936628,Butov; Leonid,0,0,17,17
1748424170721,PHYS 2DL,A03,936629,Butov; Leonid,3,0,15,12
1748424170721,PHYS 2DL,A04,936630,Butov; Leonid,10,0,17,7
1748424170721,PHYS 2DL,A05,936631,Butov; Leonid,17,0,17,0
1748424170721,PHYS 2DL,A06,936632,Butov; Leonid,7,0,17,10
1748424170721,PHYS 2DL,A07,936633,Butov; Leonid,8,0,18,10
1748424172075,PHYS 4C,A01,936635,Chivukula; Raja S,22,0,43,21
1748424172075,PHYS 4C,A02,936636,Chivukula; Raja S,33,0,45,12
1748424172075,PHYS 4C,A03,936637,Chivukula; Raja S,38,0,45,7
1748424172075,PHYS 4C,A04,936638,Chivukula; Raja S,44,0,45,1
1748424173102,PHYS 12,A01,936640,Branson; James G,187,0,192,5
1748424174170,PHYS 87,A00,936641,Grinstein; Benjamin,20,0,20,0
1748424176157,PHYS 100A,A01,936643,Green; Daniel Richard,111,0,146,35
1748424177193,PHYS 110A,A01,936645,Dudko; Olga,107,0,146,39
1748424178223,PHYS 116,A00,936646,Diamond; Patrick H & Vergassola; Massimo,12,0,15,3
1748424179606,PHYS 130B,A01,936648,Keating; Brian,56,0,60,4
1748424180779,PHYS 133,A00,936649,Allen; Monica T,20,0,32,12
1748424181807,PHYS 136,A00,936650,Grinstein; Benjamin,42,0,50,8
1748424182835,PHYS 139,A00,936651,Hirsch; Jorge Eduardo,13,0,15,2
1748424182835,PHYS 139,B00,936663,Duarte; Javier Mauricio,0,0,0,10
1748424183871,PHYS 140A,A01,936723,Parker; Daniel E,54,0,60,6
1748424184903,PHYS 161,A01,936727,Fuller; George Michael,53,0,60,7
1748424185931,PHYS 175,A00,936728,Koslover; Elena F,11,0,15,4
1748424186960,PHYS 191,A00,936730,Yang; Liang,68,0,75,7
1748424187989,PHYS 200A,A01,936733,Di Ventra; Massimiliano,20,0,30,10
1748424189022,PHYS 201,A01,936736,Vergassola; Massimo,23,0,30,7
1748424190049,PHYS 210B,A00,936737,McGreevy; John A.,29,0,30,1
1748424191079,PHYS 211A,A00,936740,Butov; Leonid,28,0,30,2
1748424192109,PHYS 212A,A01,936873,Fogler; Michael M.,38,0,50,12
1748424193138,PHYS 215A,A00,936878,Shotwell; Brian,30,0,30,0
1748424194164,PHYS 216,A00,936879,Diamond; Patrick H & Vergassola; Massimo,15,0,15,0
1748424195194,PHYS 219,A00,936903,Allen; Monica T,5,0,5,0
1748424196221,PHYS 220,A01,936910,Arovas; Daniel P,30,0,30,0
1748424197253,PHYS 225A,A00,936911,Flauger; Raphael M,28,0,30,2
1748424198281,PHYS 239,A00,937172,Hirsch; Jorge Eduardo,14,0,15,1
1748424198281,PHYS 239,B00,937176,Duarte; Javier Mauricio,15,0,15,0
1748424198281,PHYS 239,C00,959883,Intriligator; Kenneth Arthur,30,0,30,0
1748424199314,PHYS 250,A00,937178,Hirsch; Jorge Eduardo,14,0,15,1
1748424200342,PHYS 251,A00,937182,Grinstein; Benjamin,15,0,15,0
1748424201371,PHYS 252,A00,937183,Diamond; Patrick H,15,0,15,0
1748424202401,PHYS 253,A00,937184,Fuller; George Michael,15,0,15,0
1748424203432,PHYS 254,A00,937185,Serra; Mattia,15,0,15,0
1748424204612,PHYS 255,A00,937186,Hwa; Terence T.,14,0,15,1
1748424205642,PHYS 260,A00,937187,Shpyrko; Oleg,49,0,50,1
1748424206669,PHYS 275,A00,937190,Koslover; Elena F,15,0,15,0
1748424207700,PHYS 279,A01,946429,Silva; Gabriel,0,0,0,0
1748424208729,PHYS 282,A00,937194,Hwa; Terence T.,20,0,20,0
1748424209761,POLI 5D,A01,937210,Staff,4,0,5,1
1748424209761,POLI 5D,B01,937219,Staff,5,0,5,0
1748424209761,POLI 5D,C01,937225,Dai; Yinlin,0,0,5,5
1748424210830,POLI 10D,A01,937228,Noble; Benjamin S,20,0,28,8
1748424210830,POLI 10D,A02,937229,Noble; Benjamin S,24,0,28,4
1748424210830,POLI 10D,A03,937230,Noble; Benjamin S,24,0,27,3
1748424210830,POLI 10D,A04,937231,Noble; Benjamin S,25,0,27,2
1748424210830,POLI 10D,A05,937238,Noble; Benjamin S,27,0,28,1
1748424210830,POLI 10D,A06,937243,Noble; Benjamin S,26,0,28,2
1748424211864,POLI 11D,A01,937360,Desposato; Scott,20,0,29,9
1748424211864,POLI 11D,A02,937430,Desposato; Scott,22,0,29,7
1748424211864,POLI 11D,A03,937445,Desposato; Scott,25,0,29,4
1748424211864,POLI 11D,A04,937446,Desposato; Scott,29,0,29,0
1748424211864,POLI 11D,A05,937447,Desposato; Scott,27,0,29,2
1748424211864,POLI 11D,A06,937463,Desposato; Scott,27,0,29,2
1748424212895,POLI 12D,A01,937472,Roeder; Philip G,17,0,20,3
1748424212895,POLI 12D,A02,937475,Roeder; Philip G,18,0,20,2
1748424212895,POLI 12D,A03,937485,Roeder; Philip G,17,0,19,2
1748424212895,POLI 12D,A04,937490,Roeder; Philip G,17,0,20,3
1748424212895,POLI 12D,A05,937500,Roeder; Philip G,19,0,20,1
1748424212895,POLI 12D,A06,937507,Roeder; Philip G,20,0,20,0
1748424213955,POLI 30D,A01,937510,Desposato; Scott,0,0,23,23
1748424213955,POLI 30D,A02,937530,Desposato; Scott,0,0,23,23
1748424213955,POLI 30D,A03,937531,Desposato; Scott,11,0,23,12
1748424213955,POLI 30D,A04,937532,Desposato; Scott,18,0,23,5
1748424213955,POLI 30D,A05,937591,Desposato; Scott,5,0,23,18
1748424213955,POLI 30D,A06,937592,Desposato; Scott,19,0,23,4
1748424214984,POLI 100H,A00,937593,Stout; Christopher Timothy,114,0,183,69
1748424216014,POLI 100I,A00,937594,Gause; LaGina,47,0,56,9
1748424217041,POLI 100V,A00,937596,Gause; LaGina,56,0,68,12
1748424218068,POLI 101A,A00,937597,Stout; Christopher Timothy,84,0,115,31
1748424219097,POLI 104A,A00,937598,Smith; Glenn Chatmas,207,0,290,83
1748424220129,POLI 104N,A00,937599,Stephens; Mattheus E,168,0,245,77
1748424221156,POLI 110A,A00,937600,Wiens; David,61,0,70,9
1748424222183,POLI 118,A00,937601,Wiens; David,69,0,94,25
1748424223216,POLI 122D,A00,937602,Strom; Kaare,15,0,70,55
1748424224243,POLI 125B,A00,937603,Naoi; Megumi,128,0,158,30
1748424225270,POLI 125D,A00,937604,Nichter; Simeon C,103,0,158,55
1748424226299,POLI 126,A00,937607,Nichter; Simeon C,43,0,120,77
1748424227324,POLI 133A,A00,937608,Naoi; Megumi,202,0,216,14
1748424228356,POLI 134D,A00,937609,Saiegh; Sebastian,62,0,75,13
1748424229401,POLI 143A,A00,937610,Slantchev; Branislav,147,0,158,11
1748424230447,POLI 145C,A00,937611,Fisk; David Lee,153,0,190,37
1748424231477,POLI 154,A00,937612,Fisk; David Lee,28,0,90,62
1748424232505,POLI 163,A00,937613,Saiegh; Sebastian,103,0,120,17
1748424233535,POLI 176,A00,968071,Roberts; Margaret Earling,23,0,45,22
1748424234563,POLI 191A,A00,937617,Stout; Christopher Timothy & Saiegh; Sebastian,25,0,25,0
1748424235591,POLI 194,A00,954111,Hill; Seth J,9999,0,9999,0
1748424236619,POLI 204A,A00,937618,Schneider; Christina,20,0,25,5
1748424237645,POLI 204B,A00,937619,Desposato; Scott,7,0,12,5
1748424238728,POLI 220B,A00,937621,Strom; Kaare,20,0,25,5
1748424239765,POLI 225,A00,937622,Thomas; Jakana,18,0,25,7
1748424240794,POLI 251,A00,937623,Noble; Benjamin S,24,0,25,1
1748424241822,POLI 252,A00,937624,Hajnal; Zoltan Lloyd,24,0,25,1
1748424243889,POLI 270,A00,973288,Roberts; Margaret Earling,24,0,25,1
1748424244916,POLI 279,A00,937626,Staff,8,0,12,4
1748424245943,POLI 280,A00,937628,Hafner-Burton; Emilie,21,0,25,4
1748424246975,POLI 281,A00,937629,Stout; Christopher Timothy,13,0,15,2
1748424248004,POLI 282,A00,937630,Roeder; Philip G,20,0,25,5
1748424249077,POLI 283,A00,937631,Slantchev; Branislav,18,0,25,7
1748424250104,POLI 285,A00,937632,Wiens; David,12,0,12,0
1748424251133,PSYC 1,A00,937633,Hurwitz; Ethan Scott,175,0,200,25
1748424252161,PSYC 2,A00,937634,Rose; Fred E.,133,0,150,17
1748424253188,PSYC 3R,A00,937693,Pilegard; Celeste Cristine,195,0,200,5
1748424254221,PSYC 6,A00,937694,McCullough; Michael E,142,0,150,8
1748424255250,PSYC 60,A01,957947,Lowe; Angela Beth,10,0,25,15
1748424255250,PSYC 60,A02,957948,Lowe; Angela Beth,17,0,25,8
1748424255250,PSYC 60,A03,957949,Lowe; Angela Beth,18,0,25,7
1748424255250,PSYC 60,A04,957950,Lowe; Angela Beth,24,0,25,1
1748424255250,PSYC 60,A05,957951,Lowe; Angela Beth,22,0,25,3
1748424255250,PSYC 60,A06,957952,Lowe; Angela Beth,22,0,25,3
1748424255250,PSYC 60,A07,957953,Lowe; Angela Beth,24,0,25,1
1748424255250,PSYC 60,B01,957954,Rickard; Timothy C.,24,0,25,1
1748424255250,PSYC 60,B02,957955,Rickard; Timothy C.,24,0,25,1
1748424255250,PSYC 60,B03,957956,Rickard; Timothy C.,25,0,25,0
1748424255250,PSYC 60,B04,957957,Rickard; Timothy C.,25,0,25,0
1748424255250,PSYC 60,B05,957958,Rickard; Timothy C.,24,0,25,1
1748424255250,PSYC 60,B06,957959,Rickard; Timothy C.,22,0,25,3
1748424255250,PSYC 60,B07,957960,Rickard; Timothy C.,22,0,25,3
1748424256278,PSYC 70,A01,957961,Pilegard; Celeste Cristine,6,0,25,19
1748424256278,PSYC 70,A02,957962,Pilegard; Celeste Cristine,19,0,25,6
1748424256278,PSYC 70,A03,957963,Pilegard; Celeste Cristine,19,0,25,6
1748424256278,PSYC 70,A04,957964,Pilegard; Celeste Cristine,21,0,25,4
1748424256278,PSYC 70,A05,957965,Pilegard; Celeste Cristine,24,0,25,1
1748424256278,PSYC 70,A06,957966,Pilegard; Celeste Cristine,23,0,25,2
1748424257307,PSYC 71,A01,937700,Geller; Emma Harlan,0,0,30,30
1748424257307,PSYC 71,A02,937701,Geller; Emma Harlan,0,0,30,30
1748424257307,PSYC 71,B01,937704,Steiner; Eric Tomas,0,0,25,25
1748424257307,PSYC 71,B02,937705,Steiner; Eric Tomas,0,0,25,25
1748424258338,PSYC 88,A00,937706,Dobkins; Karen R.,49,0,65,16
1748424259365,PSYC 100,A00,937707,Dickenson; Janna Alene,0,0,175,175
1748424260390,PSYC 101,A00,937709,Heyman; Gail D.,0,0,170,170
1748424261418,PSYC 104,A00,937711,Staff,0,0,175,175
1748424262446,PSYC 105,A00,937712,Geller; Emma Harlan,17,0,170,153
1748424263471,PSYC 106,A00,937713,Gremel; Christina M,89,0,170,81
1748424264500,PSYC 108,A00,937714,Adrian; Julia Anna,145,0,170,25
1748424265531,PSYC 114,A01,937720,Winkielman; Piotr,0,0,50,50
1748424266564,PSYC 122,A00,937724,Moranton; Nirelia Melbina-,241,0,250,9
1748424267604,PSYC 124,A00,937726,Chapman; Eddie Nathaniel,276,0,348,72
1748424268635,PSYC 137,A00,937727,Jolly; Eshin,249,0,295,46
1748424269666,PSYC 145,A00,937732,Lau; Aubrey,277,0,295,18
1748424270696,PSYC 154,A00,937734,Lacefield; Katharine I,18,0,300,282
1748424271724,PSYC 155,A00,937735,Dickenson; Janna Alene,139,0,295,156
1748424272753,PSYC 167,A00,937750,Walker; Caren Michelle,0,0,25,25
1748424273784,PSYC 169,A00,937751,Staff,212,0,250,38
1748424274817,PSYC 171,A00,937752,Mukku; Dhananjaya,149,0,216,67
1748424275844,PSYC 174,A00,937784,Staff,141,0,146,5
1748424276877,PSYC 178,A00,937788,Glaser; Dale,100,0,146,46
1748424277912,PSYC 181,A00,937814,Anagnostaras; Stephan,140,0,300,160
1748424278939,PSYC 184,A00,937816,Staff,267,0,295,28
1748424279975,PSYC 189,A00,937868,Gentner; Tim,14,0,55,41
1748424281047,PSYC 193,A00,937897,Chapman; Eddie Nathaniel,27,0,35,8
1748424281047,PSYC 193,B00,937917,Gorman; Michael R.,35,0,35,0
1748424281047,PSYC 193,C00,937918,Powell; Lindsey Jane,22,0,24,2
1748424282085,PSYC 193L,A01,937930,Brown; Sandra A,64,0,65,1
1748424282085,PSYC 193L,B01,937939,Lacefield; Katharine I,194,0,216,22
1748424283115,PSYC 194A,A01,937949,Heyman; Gail D.,35,0,35,0
1748424284148,PSYC 201A,A01,937954,Long; Bria,8,0,15,7
1748424285176,PSYC 205,A00,937976,Harris; Christine Renee,12,0,20,8
1748424286204,PSYC 217,A00,937977,Barner; David A.,16,0,20,4
1748424287234,PSYC 221,A00,937979,Dobkins; Karen R.,16,0,20,4
1748424288260,PSYC 224,A00,938013,Mukku; Dhananjaya,28,0,30,2
1748424289288,PSYC 242,A00,938016,Powell; Lindsey Jane,26,0,30,4
1748424290314,PSYC 244,A00,938017,Ferreira; Victor,15,0,20,5
1748424291346,PSYC 269,A00,938024,Schachner; Adena,19,0,20,1
1748424292375,PSYC 270A,A00,938028,Dobkins; Karen R.,13,0,20,7
1748424293407,PSYC 272,A00,938029,Lin; Chujun,14,0,20,6
1748424293407,PSYC 272,B00,938039,Wixted; John T,18,0,20,2
1748424294435,PSYC 274,A00,938042,McCullough; Michael E,26,0,30,4
1748424295462,PSYC 275,A00,938043,Brady; Timothy Francis,28,0,30,2
1748424296495,PSYC 280,A00,938055,Serences; John Thomas,70,0,80,10
1748424297559,PSYC 296,001,952632,Anagnostaras; Stephan,9999,0,9999,0
1748424297559,PSYC 296,002,952633,Aron; Adam,9999,0,9999,0
1748424297559,PSYC 296,003,952634,Mukku; Dhananjaya,9999,0,9999,0
1748424297559,PSYC 296,004,952635,Barner; David A.,9999,0,9999,0
1748424297559,PSYC 296,005,952636,Schachner; Adena,9999,0,9999,0
1748424297559,PSYC 296,006,952637,Brady; Timothy Francis,9999,0,9999,0
1748424297559,PSYC 296,007,952639,Brashier; Nadia Marie,9999,0,9999,0
1748424297559,PSYC 296,008,952640,Brown; Sandra A,9999,0,9999,0
1748424297559,PSYC 296,009,952641,Carver; Leslie J.,9998,0,9999,1
1748424297559,PSYC 296,010,952642,Chapman; Eddie Nathaniel,9999,0,9999,0
1748424297559,PSYC 296,011,952643,Dickenson; Janna Alene,9999,0,9999,0
1748424297559,PSYC 296,012,952644,Dobkins; Karen R.,9997,0,9999,2
1748424297559,PSYC 296,013,952646,Ferreira; Victor,9999,0,9999,0
1748424297559,PSYC 296,014,952647,Geller; Emma Harlan,9999,0,9999,0
1748424297559,PSYC 296,015,952648,Gentner; Tim,9999,0,9999,0
1748424297559,PSYC 296,016,952650,Gorman; Michael R.,9999,0,9999,0
1748424297559,PSYC 296,017,952651,Gremel; Christina M,9999,0,9999,0
1748424297559,PSYC 296,018,952652,Harris; Christine Renee,9999,0,9999,0
1748424297559,PSYC 296,019,952654,Heyman; Gail D.,9999,0,9999,0
1748424297559,PSYC 296,020,952655,Lin; Chujun,9999,0,9999,0
1748424297559,PSYC 296,021,952659,Long; Bria,9999,0,9999,0
1748424297559,PSYC 296,022,952660,McCullough; Michael E,9999,0,9999,0
1748424297559,PSYC 296,023,952661,Mc Kenzie; Craig R.M.,9999,0,9999,0
1748424297559,PSYC 296,024,952663,Miller; Cory T.,9998,0,9999,1
1748424297559,PSYC 296,025,952664,Oesch; Nicholas W,9999,0,9999,0
1748424297559,PSYC 296,026,952665,Pilegard; Celeste Cristine,9999,0,9999,0
1748424297559,PSYC 296,027,952666,Powell; Lindsey Jane,9999,0,9999,0
1748424297559,PSYC 296,028,952667,Rickard; Timothy C.,9999,0,9999,0
1748424297559,PSYC 296,029,952668,Serences; John Thomas,9999,0,9999,0
1748424297559,PSYC 296,030,952669,Walker; Caren Michelle,9998,0,9999,1
1748424297559,PSYC 296,031,952670,Winkielman; Piotr,9999,0,9999,0
1748424297559,PSYC 296,032,952671,Wixted; John T,9998,0,9999,1
1748424297559,PSYC 296,033,952673,Jolly; Eshin,9998,0,9999,1
1748424298611,REV 20,A00,946356,Yu; Paul K L,30,0,30,0
1748424298611,REV 20,B00,946357,Yu; Paul K L,30,0,30,0
1748424299663,REV 87,B00,969668,Rodriguez; Bretton Sigfred,20,0,20,0
1748424300725,SE 1,A01,938060,Van Den Einde; Yael Dahlia,0,0,9,9
1748424300725,SE 1,A02,938076,Van Den Einde; Yael Dahlia,0,0,8,8
1748424300725,SE 1,A03,938077,Van Den Einde; Yael Dahlia,0,0,8,8
1748424300725,SE 1,B01,938097,Van Den Einde; Yael Dahlia,0,0,9,9
1748424300725,SE 1,B02,938098,Van Den Einde; Yael Dahlia,0,0,8,8
1748424300725,SE 1,B03,938109,Van Den Einde; Yael Dahlia,0,0,8,8
1748424301753,SE 101A,A01,938120,Morrison; Machel Leigh,165,0,250,85
1748424302781,SE 101C,A01,938148,Zhu; Qiang,178,0,250,72
1748424303843,SE 105,A01,938153,Qiao; Yu,78,0,120,42
1748424304882,SE 125,A01,938218,Conte; Joel P,166,0,210,44
1748424305921,SE 130A,A00,938219,Loh; Kenneth J. H.,69,0,165,96
1748424306955,SE 131B,A01,938221,Krysl; Petr,119,0,210,91
1748424307984,SE 142,A01,938223,Kim; Hyonny,20,0,27,7
1748424307984,SE 142,A02,938236,Kim; Hyonny,23,0,27,4
1748424307984,SE 142,A03,938237,Kim; Hyonny,19,0,27,8
1748424307984,SE 142,A04,938238,Kim; Hyonny,19,0,22,3
1748424309014,SE 163,A01,938240,Lanza Di Scalea; Francesco,17,0,19,2
1748424309014,SE 163,A02,938241,Lanza Di Scalea; Francesco,16,0,19,3
1748424309014,SE 163,A03,938254,Lanza Di Scalea; Francesco,16,0,17,1
1748424310043,SE 180,A00,938255,Elgamal; Ahmed,142,0,170,28
1748424311073,SE 181,A01,938280,McCartney; John Scott,1,0,24,23
1748424311073,SE 181,A02,938281,McCartney; John Scott,6,0,24,18
1748424311073,SE 181,A03,938296,McCartney; John Scott,0,0,24,24
1748424311073,SE 181,A04,938297,McCartney; John Scott,0,0,24,24
1748424311073,SE 181,A05,938299,McCartney; John Scott,20,0,24,4
1748424311073,SE 181,A06,938320,McCartney; John Scott,22,0,24,2
1748424311073,SE 181,A07,938324,McCartney; John Scott,9,0,24,15
1748424312100,SE 201A,A00,938329,Mosqueda; Gilberto,35,0,65,30
1748424313134,SE 203A,A00,938331,Tsampras; Georgios,32,0,65,33
1748424314161,SE 212,A00,938332,Uang; Chia-Ming,28,0,68,40
1748424315189,SE 220,A00,965249,Mosqueda; Gilberto,28,0,36,8
1748424316218,SE 223,A00,969767,Staff,19,0,25,6
1748424317284,SE 233,A00,938555,Krysl; Petr,19,0,50,31
1748424318315,SE 241,A00,938333,Elgamal; Ahmed,0,0,20,20
1748424319345,SE 244,A00,938334,Elgamal; Ahmed,39,0,40,1
1748424320370,SE 248,A00,938363,McCartney; John Scott,20,0,30,10
1748424321408,SE 253A,A01,938448,Kim; Hyonny,2,0,5,3
1748424321408,SE 253A,A02,938451,Kim; Hyonny,3,0,5,2
1748424321408,SE 253A,A03,938452,Kim; Hyonny,3,0,5,2
1748424321408,SE 253A,A04,938453,Kim; Hyonny,2,0,2,0
1748424322435,SE 263,A01,938460,Lanza Di Scalea; Francesco,15,0,17,2
1748424322435,SE 263,A02,938461,Lanza Di Scalea; Francesco,11,0,17,6
1748424322435,SE 263,A03,938462,Lanza Di Scalea; Francesco,10,0,16,6
1748424323471,SE 271,A00,938464,Asaro; Robert J,25,0,32,7
1748424324503,SE 276A,A00,938465,Chen; Jiun-Shyan,18,0,35,17
1748424325528,SE 285,A00,938466,Kim; Hyunsun Alicia,18,0,20,2
1748424326559,SE 286,A00,938523,Kim; Hyunsun Alicia,13,0,20,7
1748424327586,SE 290,A00,938524,Lanza Di Scalea; Francesco,41,0,100,59
1748424328636,SE 296,001,953990,Asaro; Robert J,9999,0,9999,0
1748424328636,SE 296,002,953992,Chen; Jiun-Shyan,9999,0,9999,0
1748424328636,SE 296,003,953998,Conte; Joel P,9999,0,9999,0
1748424328636,SE 296,004,953999,Elgamal; Ahmed,9999,0,9999,0
1748424328636,SE 296,005,954001,Hutchinson; Tara,9999,0,9999,0
1748424328636,SE 296,006,954003,Jandaghi Semnani; Shabnam,9999,0,9999,0
1748424328636,SE 296,007,954004,Kim; Hyonny,9999,0,9999,0
1748424328636,SE 296,008,954005,Kim; Hyunsun Alicia,9999,0,9999,0
1748424328636,SE 296,009,954007,Kosmatka; John B,9999,0,9999,0
1748424328636,SE 296,010,954009,Krysl; Petr,9999,0,9999,0
1748424328636,SE 296,011,954011,Kuester; Falko,9999,0,9999,0
1748424328636,SE 296,012,954014,Lanza Di Scalea; Francesco,9999,0,9999,0
1748424328636,SE 296,013,954015,Loh; Kenneth J. H.,9999,0,9999,0
1748424328636,SE 296,014,954021,McCartney; John Scott,9999,0,9999,0
1748424328636,SE 296,015,954023,Morrison; Machel Leigh,9999,0,9999,0
1748424328636,SE 296,016,954024,Mosqueda; Gilberto,9999,0,9999,0
1748424328636,SE 296,017,954028,Qiao; Yu,9999,0,9999,0
1748424328636,SE 296,018,954030,Shing; P. Benson,9999,0,9999,0
1748424328636,SE 296,019,954031,Todd; Michael,9998,0,9999,1
1748424328636,SE 296,020,954033,Tomac; Ingrid,9999,0,9999,0
1748424328636,SE 296,021,954037,Tsampras; Georgios,9999,0,9999,0
1748424328636,SE 296,022,954040,Uang; Chia-Ming,9999,0,9999,0
1748424328636,SE 296,023,954043,Van Den Einde; Yael Dahlia,9999,0,9999,0
1748424328636,SE 296,024,954044,Zhu; Qiang,9999,0,9999,0
1748424328636,SE 296,025,954046,Tehrani; Mehran,9999,0,9999,0
1748424328636,SE 296,026,954047,Palermo; Alessandro,9999,0,9999,0
1748424328636,SE 296,027,954049,Chadha; Mayank,9999,0,9999,0
1748424329663,SIO 3,A01,938657,Hetherington; Elizabeth Dorsey,33,0,37,4
1748424329663,SIO 3,A02,938665,Hetherington; Elizabeth Dorsey,36,0,37,1
1748424330697,SIO 15,A00,938667,Laske; Gabi,293,0,348,55
1748424331726,SIO 20R,A01,938679,Russell; Lynn M.,144,0,200,56
1748424332762,SIO 25,A01,938684,Hildebrand; John A,33,0,40,7
1748424332762,SIO 25,A02,938685,Hildebrand; John A,39,0,40,1
1748424332762,SIO 25,A03,938963,Hildebrand; John A,40,0,40,0
1748424332762,SIO 25,A04,939110,Hildebrand; John A,40,0,40,0
1748424332762,SIO 25,A05,939116,Hildebrand; John A,40,0,40,0
1748424332762,SIO 25,A06,939149,Hildebrand; John A,40,0,40,0
1748424332762,SIO 25,A07,939158,Hildebrand; John A,40,0,40,0
1748424332762,SIO 25,A08,939173,Hildebrand; John A,40,0,40,0
1748424332762,SIO 25,A09,939180,Hildebrand; John A,40,0,40,0
1748424332762,SIO 25,A10,939228,Hildebrand; John A,40,0,40,0
1748424333792,SIO 30,A01,939230,Aluwihare; Lihini & Gille; Sarah T,33,0,37,4
1748424333792,SIO 30,A02,939231,Aluwihare; Lihini & Baumann-Pickering ; Simone,37,0,37,0
1748424333792,SIO 30,A03,939232,Aluwihare; Lihini & Gille; Sarah T,34,0,37,3
1748424333792,SIO 30,A04,939233,Aluwihare; Lihini & Gille; Sarah T,31,0,37,6
1748424333792,SIO 30,A05,939234,Aluwihare; Lihini & Gille; Sarah T,38,0,38,0
1748424333792,SIO 30,A06,939235,Aluwihare; Lihini & Gille; Sarah T,37,0,38,1
1748424333792,SIO 30,A07,939236,Aluwihare; Lihini & Gille; Sarah T,36,0,38,2
1748424333792,SIO 30,A08,939237,Aluwihare; Lihini & Gille; Sarah T,36,0,38,2
1748424334821,SIO 50,A01,939239,Cook; Geoffrey W,8,0,20,12
1748424334821,SIO 50,A02,939240,Cook; Geoffrey W,11,0,20,9
1748424335847,SIO 87,A00,939242,Norris; Joel Roland,20,0,20,0
1748424335847,SIO 87,B00,939306,Cook; Geoffrey W,20,0,20,0
1748424335847,SIO 87,C00,939327,Cook; Geoffrey W,20,0,20,0
1748424336934,SIO 100,A00,939328,Odlum; Margaret Larkin,0,0,30,30
1748424337967,SIO 101,A01,939330,Aluwihare; Lihini & Decima; Moira R.,0,0,35,35
1748424337967,SIO 101,A02,939331,Aluwihare; Lihini & Decima; Moira R.,12,0,35,23
1748424338995,SIO 103,A01,939371,Parnell-Turner; Ross Ernes,6,0,20,14
1748424340027,SIO 105,A00,939372,Driscoll; Neal W.,8,0,20,12
1748424341073,SIO 117,A01,939375,Keeling; Ralph F.,14,0,25,11
1748424342103,SIO 122,A01,939377,Lyons; Deirdre Colleen,6,0,30,24
1748424343182,SIO 124,A00,961131,Lukowski; April Lynn,34,0,65,31
1748424344213,SIO 132,A01,939379,Kacev; David & Hechinger; Ryan F.,9,0,34,25
1748424344213,SIO 132,A02,939380,Kacev; David & Hechinger; Ryan F.,28,0,34,6
1748424344213,SIO 132,A03,939381,Kacev; David & Hechinger; Ryan F.,19,0,34,15
1748424344213,SIO 132,A04,939480,Kacev; David & Hechinger; Ryan F.,26,0,34,8
1748424344213,SIO 132,A05,939481,Kacev; David & Hechinger; Ryan F.,18,0,34,16
1748424344213,SIO 132,A06,939482,Kacev; David & Hechinger; Ryan F.,25,0,34,9
1748424345244,SIO 136,A01,939562,Kacev; David & Shipp; Lauren Elizabeth,6,0,34,28
1748424345244,SIO 136,A02,939563,Kacev; David & Shipp; Lauren Elizabeth,24,0,34,10
1748424346272,SIO 147,A01,939566,Betancur Rodriguez; Ricard,0,0,30,30
1748424347300,SIO 166,A00,939567,Jimenez Cano; Nayeli Guada,13,0,30,17
1748424348333,SIO 167,A01,939569,Dunseth; Zachary Clark,9,0,10,1
1748424349365,SIO 170,A00,939571,Cook; Geoffrey W,39,0,45,6
1748424350391,SIO 171,A01,939573,Rudnick; Daniel Lars,44,0,50,6
1748424351425,SIO 177,A00,939574,Becker; Janet Maria,19,0,20,1
1748424352453,SIO 179,A01,939611,Martz; Todd R.,2,0,15,13
1748424353479,SIO 189,A00,939616,Staff,0,0,0,0
1748424354507,SIO 194,A00,954130,Hill; Seth J,9999,0,9999,0
1748424355537,SIOB 218,A01,960525,Staff,13,0,20,7
1748424356564,SIOB 262,A00,939617,Lukowski; April Lynn,15,0,20,5
1748424357591,SIOB 273,A00,939618,Leichter; James J.,9,0,15,6
1748424358619,SIOB 274,A01,939679,Leichter; James J.,15,0,20,5
1748424359647,SIOB 276,A01,939703,Sugihara; George,19,0,20,1
1748424360674,SIOB 279,A00,939717,Barton; Andrew David,19,0,25,6
1748424361702,SIOB 280,A00,939722,Allen; Andrew Ellis & Baumann-Pickering ; Simone,54,0,70,16
1748424362739,SIOB 296,A00,939790,Lyons; Deirdre Colleen,0,0,0,0
1748424363778,SIOB 297,A00,939795,Allen; Eric,57,0,65,8
1748424364809,SIOC 200A,A00,939821,Lin; Ying-Tsong,16,0,20,4
1748424365836,SIOC 203A,A00,939827,Becker; Janet Maria,18,0,20,2
1748424366866,SIOC 207A,A01,939909,Meyer; Florian,12,0,20,8
1748424367897,SIOC 208,A00,939913,Merrifield; Mark A,11,0,20,9
1748424368924,SIOC 210,A00,939917,Purkey; Sarah Michelle G.,25,0,35,10
1748424368924,SIOC 210,B00,939973,Purkey; Sarah Michelle G.,31,0,35,4
1748424369952,SIOC 217A,A00,940015,Evan; Amato Tomas,18,0,25,7
1748424370987,SIOC 221A,A00,940020,Alford; Matthew Hudson,16,0,20,4
1748424372036,SIOG 200C,A00,940290,Fan; Wenyuan,23,0,25,2
1748424373068,SIOG 223A,A00,940333,Constable; Catherine G,22,0,25,3
1748424374098,SIOG 225,A00,940334,Fialko; Yuri A.,19,0,20,1
1748424375128,SIOG 228,A00,940338,Diaz; Julia Michelle,15,0,40,25
1748424376162,SIOG 238,A00,940339,May; David Alexander,20,0,20,0
1748424377194,SIOG 239,A00,940340,Fan; Wenyuan,20,0,20,0
1748424377194,SIOG 239,B00,940342,Sandwell; David T,19,0,20,1
1748424378222,SIOG 240,A00,940409,Parnell-Turner; Ross Ernes,34,0,40,6
1748424379249,SIOG 249,A00,940442,Norris; Richard D.,25,0,25,0
1748424380275,SIOG 267,A01,940444,Martz; Todd R.,15,0,15,0
1748424381302,SIOG 288,A01,940446,Diaz; Julia Michelle,22,0,25,3
1748424382328,SOCE 194,A00,954128,Hill; Seth J,9999,0,9999,0
1748424383357,SOCG 200,A00,935260,Rona-Tas; Akos,2,0,12,10
1748424384389,SOCG 201,A00,935264,Shafir; Gershon,0,0,12,12
1748424385416,SOCG 203,A00,935265,Gong; Neil M,0,0,10,10
1748424386444,SOCG 207,A00,935267,Navon; Daniel,0,0,10,10
1748424387472,SOCG 208A,A00,935269,Blair-Loy; Mary,2,0,12,10
1748424388499,SOCG 226,A00,935302,Skrentny; John David,0,0,10,10
1748424389533,SOCG 227,A00,935303,Jules-Rosette; Bennetta W.,7,0,10,3
1748424390566,SOCG 244,A00,935305,Ribas Norris; Janet Vanesa,0,0,10,10
1748424391599,SOCG 252,A00,935307,Turner; Christena L.,2,0,10,8
1748424392630,SOCG 253,A00,935313,Evans; John Hyde,7,0,10,3
1748424393658,SOCG 255A,A00,934873,McKenzie; Kerry V.,10,0,10,0
1748424394684,SOCG 255C,A00,934874,McKenzie; Kerry V.,9,0,10,1
1748424395714,SOCG 271,A00,935434,Estefan; Michel,4,0,10,6
1748424396773,SOCI 1,A01,934878,Skrentny; John David,20,0,22,2
1748424396773,SOCI 1,A02,934879,Skrentny; John David,21,0,22,1
1748424396773,SOCI 1,A03,934880,Skrentny; John David,22,0,23,1
1748424396773,SOCI 1,A04,934881,Skrentny; John David,12,0,23,11
1748424396773,SOCI 1,A05,934883,Skrentny; John David,23,0,23,0
1748424396773,SOCI 1,A06,934884,Skrentny; John David,23,0,23,0
1748424396773,SOCI 1,A07,934885,Skrentny; John David,22,0,23,1
1748424396773,SOCI 1,A08,934886,Skrentny; John David,22,0,23,1
1748424396773,SOCI 1,A09,934887,Skrentny; John David,22,0,23,1
1748424397803,SOCI 30,A01,934889,Ruiz; Jonathan Joseph,18,0,20,2
1748424397803,SOCI 30,A02,934890,Ruiz; Jonathan Joseph,15,0,20,5
1748424398837,SOCI 60,A01,934892,Ribas Norris; Janet Vanesa,6,0,17,11
1748424398837,SOCI 60,A02,934896,Ribas Norris; Janet Vanesa,17,0,17,0
1748424398837,SOCI 60,A03,934965,Ribas Norris; Janet Vanesa,12,0,17,5
1748424398837,SOCI 60,A04,934974,Ribas Norris; Janet Vanesa,17,0,17,0
1748424399871,SOCI 70,A01,934984,Payne; Christine Anna,4,0,15,11
1748424399871,SOCI 70,A02,934988,Payne; Christine Anna,14,0,15,1
1748424399871,SOCI 70,A03,935006,Payne; Christine Anna,11,0,15,4
1748424399871,SOCI 70,A04,935047,Payne; Christine Anna,15,0,15,0
1748424400904,SOCI 88,A00,935058,Estefan; Michel,0,0,20,20
1748424401938,SOCI 100,A01,935065,Estefan; Michel,6,0,15,9
1748424401938,SOCI 100,A02,935068,Estefan; Michel,4,0,15,11
1748424401938,SOCI 100,A03,935069,Estefan; Michel,5,0,15,10
1748424401938,SOCI 100,A04,935071,Estefan; Michel,0,0,15,15
1748424402975,SOCI 103M,A00,935073,Kilpatrick; Kevin,22,0,30,8
1748424404006,SOCI 104,A00,935077,Arnal; Maud Marie Leonie,18,0,30,12
1748424405036,SOCI 104Q,A00,935079,Rogers; Julia,20,0,30,10
1748424406063,SOCI 105,A01,935083,Jules-Rosette; Bennetta W.,20,0,25,5
1748424407091,SOCI 109,A00,935084,Kilpatrick; Kevin,25,0,30,5
1748424408119,SOCI 112,A00,935085,Pitt; Richard Norris,61,0,65,4
1748424409155,SOCI 113,A00,935086,Rogers; Julia,68,0,75,7
1748424410184,SOCI 117,A01,935151,Jones; Makeba,0,0,13,13
1748424410184,SOCI 117,A02,935153,Jones; Makeba,4,0,13,9
1748424410184,SOCI 117,A03,935155,Jones; Makeba,11,0,12,1
1748424410184,SOCI 117,A04,935156,Jones; Makeba,10,0,12,2
1748424410184,SOCI 117,B01,935158,Jones; Gabrielle Anastasia,7,0,15,8
1748424410184,SOCI 117,B02,935159,Jones; Gabrielle Anastasia,15,0,15,0
1748424410184,SOCI 117,B03,935161,Jones; Gabrielle Anastasia,15,0,15,0
1748424410184,SOCI 117,B04,935162,Jones; Gabrielle Anastasia,15,0,15,0
1748424411218,SOCI 122,A00,935166,Lewis; Kevin Michael,101,0,120,19
1748424412247,SOCI 129,A00,935167,Pitt; Richard Norris,50,0,65,15
1748424413273,SOCI 135,A00,935170,Payne; Christine Anna,112,0,120,8
1748424414306,SOCI 136F,A00,935171,Gong; Neil M,52,0,56,4
1748424415336,SOCI 137,A00,935173,Crofts; Christine,53,0,100,47
1748424416362,SOCI 138,A00,935174,Navon; Daniel,111,0,135,24
1748424417393,SOCI 140,A00,935175,Ng; Kwai,47,0,65,18
1748424418419,SOCI 140K,A00,935176,Ng; Kwai,39,0,56,17
1748424419457,SOCI 142,A00,935177,Crofts; Christine,24,0,75,51
1748424420485,SOCI 143V,A00,935222,Lewis; Kevin Michael,99,0,140,41
1748424421515,SOCI 148,A00,935227,Shafir; Gershon,115,0,120,5
1748424422547,SOCI 148E,A00,935231,Calderon-Zaks; Michael Aar,44,0,56,12
1748424423578,SOCI 150,A00,935232,Victoria Torres; Pablo,14,0,50,36
1748424424605,SOCI 153,A00,935233,Ruiz; Jonathan Joseph,46,0,50,4
1748424425634,SOCI 166,A00,935243,Lampland; Martha,34,0,35,1
1748424426667,SOCI 170,A00,935247,Lampland; Martha,29,0,30,1
1748424427698,SOCI 172,A00,935249,Rona-Tas; Akos,40,0,45,5
1748424428730,SOCI 173,A00,935252,Arnal; Maud Marie Leonie,67,0,75,8
1748424429759,SOCI 180,A00,935253,Calderon-Zaks; Michael Aar,46,0,56,10
1748424430788,SOCI 184,A00,935254,Victoria Torres; Pablo,21,0,56,35
1748424431814,SOCI 196A,A00,935256,Turner; Christena L.,20,0,20,0
1748424432845,SPPS 200B,A00,959322,Luli; Alex J,99,0,99,0
1748424433871,SPPS 201,A00,959324,Mnatzaganian; Christina L,99,0,99,0
1748424434909,SPPS 202A,A00,959400,Tsunoda; Shirley M.,99,0,99,0
1748424435937,SPPS 204,A01,959405,Jones; John,99,0,99,0
1748424436969,SPPS 206,A00,959406,Bounthavong; Mark,80,0,80,0
1748424437996,SPPS 212A,A01,959408,Feist; Ashley,81,0,99,18
1748424439023,SPPS 213A,A00,959409,Namba; Jennifer Mariko,82,0,99,17
1748424440051,SPPS 219,A00,959410,Ma; Joseph David,81,0,99,18
1748424441078,SPPS 221,A01,959412,Siegel; Dionicio R.,80,0,80,0
1748424442109,SPPS 231,A00,959413,Penny; William F.,79,0,99,20
1748424443140,SPPS 232,A00,959415,Simonson; Tatum Sasha Summ,79,0,99,20
1748424444170,SPPS 233,A00,959417,Eckmann; Lars,79,0,99,20
1748424445197,SPPS 247,A00,959419,Brandl; Katharina,79,0,99,20
1748424446223,SPPS 251,A00,959420,Chen; Timothy,99,0,99,0
1748424447303,SPPS 264A,A00,959421,Tsunoda; Shirley M.,99,0,99,0
1748424449359,SPPS 267,A01,959426,Tsunoda; Shirley M.,25,0,25,0
1748424450387,SPPS 269,A00,959427,Atayee; Rabia Samady,29,0,30,1
1748424451417,SPPS 270A,A00,959430,Fricovsky; Eduardo Santiago,99,0,99,0
1748424452445,SPPS 271,A00,959432,Tsunoda; Shirley M.,99,0,99,0
1748424453475,SPPS 278,A00,959433,Fricovsky; Eduardo Santiago,98,0,99,1
1748424454502,SPPS 279,A00,959434,Painter; Nathan A.,99,0,99,0
1748424455540,SYN 2,001,946469,Girard; Gabrielle,3,0,20,17
1748424455540,SYN 2,002,946470,Girard; Gabrielle,0,0,20,20
1748424455540,SYN 2,003,946471,Rock; Martin,0,0,20,20
1748424455540,SYN 2,004,946472,Rock; Martin,0,0,20,20
1748424455540,SYN 2,005,946473,Iatarola; Briana Marie,0,0,20,20
1748424455540,SYN 2,006,946474,Tawater; Hanna Jean,0,0,20,20
1748424455540,SYN 2,007,946475,Browne; Emily,6,0,20,14
1748424455540,SYN 2,008,946476,Browne; Emily,0,0,20,20
1748424455540,SYN 2,009,946477,Staff,0,0,20,20
1748424455540,SYN 2,010,946478,Staff,9,0,20,11
1748424455540,SYN 2,012,946480,Deavenport; James Cary,0,0,20,20
1748424455540,SYN 2,013,946481,Deavenport; James Cary,0,0,20,20
1748424455540,SYN 2,014,946482,Staff,0,0,20,20
1748424455540,SYN 2,015,946483,Staff,0,0,20,20
1748424455540,SYN 2,016,946484,Staff,0,0,20,20
1748424455540,SYN 2,017,946485,Staff,5,0,20,15
1748424455540,SYN 2,019,946487,Atkinson; Arthur Laird,0,0,20,20
1748424455540,SYN 2,020,946488,Staff,0,0,20,20
1748424455540,SYN 2,021,946489,Staff,0,0,20,20
1748424455540,SYN 2,030,946498,Iatarola; Briana Marie,0,0,20,20
1748424455540,SYN 2,036,946587,Bishop; Graham,0,0,20,20
1748424456569,SYN 2R,001,946588,Bishop; Graham,0,0,20,20
1748424457622,SYN 100,A01,946594,Rock; Martin,0,0,15,15
1748424457622,SYN 100,A02,946595,Rock; Martin,0,0,15,15
1748424457622,SYN 100,B01,946598,Browne; Emily,0,0,15,15
1748424457622,SYN 100,B02,946600,Browne; Emily,0,0,15,15
1748424457622,SYN 100,C01,946606,Tawater; Hanna Jean,0,0,15,15
1748424457622,SYN 100,C02,946607,Tawater; Hanna Jean,0,0,15,15
1748424457622,SYN 100,D01,946610,Tawater; Hanna Jean,0,0,15,15
1748424457622,SYN 100,D02,946613,Tawater; Hanna Jean,0,0,15,15
1748424457622,SYN 100,E01,946617,Vega; Adrian,0,0,24,24
1748424457622,SYN 100,G01,946714,Iatarola; Briana Marie,0,0,15,15
1748424457622,SYN 100,G02,946721,Iatarola; Briana Marie,0,0,15,15
1748424457622,SYN 100,I01,946735,Gormally; Brenna,0,0,15,15
1748424457622,SYN 100,I02,946736,Gormally; Brenna,0,0,15,15
1748424457622,SYN 100,J01,946738,Hom; Kirstyn Courtney,0,0,15,15
1748424457622,SYN 100,J02,946739,Hom; Kirstyn Courtney,0,0,15,15
1748424457622,SYN 100,K01,946741,Hom; Kirstyn Courtney,0,0,15,15
1748424457622,SYN 100,K02,946742,Hom; Kirstyn Courtney,0,0,15,15
1748424457622,SYN 100,L01,946745,Difruscio; Mark,0,0,15,15
1748424457622,SYN 100,L02,946746,Difruscio; Mark,0,0,15,15
1748424457622,SYN 100,M01,946748,Difruscio; Mark,0,0,15,15
1748424457622,SYN 100,M02,946749,Difruscio; Mark,0,0,15,15
1748424457622,SYN 100,P01,946759,Atkinson; Arthur Laird,0,0,15,15
1748424457622,SYN 100,P02,946760,Atkinson; Arthur Laird,0,0,15,15
1748424457622,SYN 100,Q01,946763,Bishop; Graham,0,0,15,15
1748424457622,SYN 100,Q02,946764,Bishop; Graham,0,0,15,15
1748424457622,SYN 100,R01,946766,Deavenport; James Cary,0,0,15,15
1748424457622,SYN 100,R02,946767,Deavenport; James Cary,0,0,15,15
1748424458657,SYN 150,001,946771,Gladstein; Jill M,19,0,20,1
1748424458657,SYN 150,002,946772,Lagapa; Jason,17,0,20,3
1748424458657,SYN 150,003,946773,Fish; Gwendolyn Anne,19,0,20,1
1748424458657,SYN 150,004,946774,Fish; Gwendolyn Anne,20,0,20,0
1748424458657,SYN 150,006,946782,Lagapa; Jason,18,0,20,2
1748424458657,SYN 150,007,946783,Lagapa; Jason,19,0,20,1
1748424458657,SYN 150,008,946784,Fish; Gwendolyn Anne,19,0,20,1
1748424459687,SYN 150R,001,946786,Vega; Adrian,19,0,20,1
1748424460716,TDAC 1,A00,946788,Walsh; Kim C.,0,0,12,12
1748424460716,TDAC 1,B00,946789,Walsh; Kim C.,0,0,12,12
1748424460716,TDAC 1,C00,946790,Walsh; Kim C.,0,0,12,12
1748424460716,TDAC 1,D00,946791,Walsh; Kim C.,0,0,12,12
1748424460716,TDAC 1,E00,946792,Walsh; Kim C.,0,0,12,12
1748424460716,TDAC 1,F00,946793,Walsh; Kim C.,0,0,12,12
1748424461757,TDAC 101,A00,946887,Harting; Carla Kelso,3,0,12,9
1748424461757,TDAC 101,B00,946970,Salovey; Todd,9,0,12,3
1748424461757,TDAC 101,C00,946977,Walsh; Kim C.,10,0,12,2
1748424462793,TDAC 102,A00,946979,Celik; Aysan Karagasli,7,0,15,8
1748424463830,TDAC 104,A00,946994,Meyer; Ursula,14,0,15,1
1748424464858,TDAC 107,A00,946997,Stalling; Vanessa,0,0,0,0
1748424465895,TDAC 108,A00,947021,Basso; Beatrice,19,0,20,1
1748424465895,TDAC 108,B00,947025,Caban; Andrea Chudnow,12,0,20,8
1748424465895,TDAC 108,C00,968049,Buescher; Stephen W.,16,0,20,4
1748424466922,TDAC 115,A00,947050,Buescher; Stephen W.,14,0,20,6
1748424467951,TDAC 122,A00,947091,Stalling; Vanessa,30,0,30,0
1748424467951,TDAC 122,B00,947092,Perry; Lamar,30,0,30,0
1748424468982,TDAC 123,A00,947093,Castro; Robert Jess,30,0,30,0
1748424470010,TDDE 1,A01,946795,Guirguis; Mark C,10,0,11,1
1748424470010,TDDE 1,A02,946796,Guirguis; Mark C,10,0,11,1
1748424470010,TDDE 1,A03,946797,Guirguis; Mark C,7,0,11,4
1748424470010,TDDE 1,A04,946798,Guirguis; Mark C,8,0,11,3
1748424470010,TDDE 1,A05,946799,Guirguis; Mark C,11,0,11,0
1748424471036,TDDE 130,A00,947094,Guirguis; Mark C,20,0,20,0
1748424472068,TDDE 131,A00,947095,Guirguis; Mark C,17,0,20,3
1748424473100,TDDE 132,A00,947096,Guirguis; Mark C,20,0,20,0
1748424474127,TDDE 141,A00,947097,McElver; Robert Harrison,20,0,20,0
1748424475158,TDDM 1,A00,946800,Johnston; Holly,7,0,18,11
1748424476190,TDDM 100,A00,947098,Brown; Bernard Joseph,28,0,30,2
1748424477218,TDDR 101,A00,947099,Powell; Lora,4,0,20,16
1748424478252,TDDR 102,A00,947100,Powell; Lora,19,0,20,1
1748424479282,TDDR 111,A00,947101,Castro; Robert Jess,12,0,15,3
1748424480313,TDDR 190,A00,947102,Stalling; Vanessa,35,0,35,0
1748424481366,TDGE 1,A01,946802,Salovey; Todd,12,0,12,0
1748424481366,TDGE 1,A02,946803,Salovey; Todd,11,0,12,1
1748424481366,TDGE 1,A03,946804,Salovey; Todd,12,0,12,0
1748424481366,TDGE 1,A04,946806,Salovey; Todd,12,0,12,0
1748424481366,TDGE 1,A05,946807,Salovey; Todd,10,0,12,2
1748424481366,TDGE 1,A06,946808,Salovey; Todd,12,0,12,0
1748424482402,TDGE 10,A00,946810,Havis; Allan,208,0,225,17
1748424483437,TDGE 11,A00,946811,Fulton; Julia,205,0,245,40
1748424484465,TDGE 25,A00,946812,Harting; Carla Kelso,1,0,20,19
1748424484465,TDGE 25,B00,946813,Harting; Carla Kelso,5,0,20,15
1748424484465,TDGE 25,C00,946814,Harting; Carla Kelso,10,0,20,10
1748424484465,TDGE 25,D00,946815,Harting; Carla Kelso,12,0,20,8
1748424485495,TDGE 124,A00,947103,Fulton; Julia,190,0,245,55
1748424486521,TDGE 133,A00,947104,Brill; Robert L.,19,0,20,1
1748424487557,TDGR 201,A00,947268,Newcomb; James,8,0,8,0
1748424488585,TDGR 210A,A00,947269,Staff,8,0,8,0
1748424489612,TDGR 211A,A00,947270,Caban; Andrea Chudnow,8,0,8,0
1748424490641,TDGR 212,A00,947271,Meyer; Ursula,17,0,17,0
1748424490641,TDGR 212,B00,947272,Caban; Andrea Chudnow,17,0,17,0
1748424491669,TDGR 213A,A00,947273,Buescher; Stephen W.,8,0,8,0
1748424492701,TDGR 214A,A00,947274,Meyer; Ursula,8,0,8,0
1748424493732,TDGR 219,A00,947276,Stalling; Vanessa,3,0,5,2
1748424494766,TDGR 229,A00,947277,Meyer; Ursula,7,0,7,0
1748424495794,TDGR 231A,A00,947278,Meyer; Ursula,9,0,9,0
1748424496826,TDGR 233,A00,947279,Richard; Keiana Nikole,9,0,9,0
1748424497855,TDGR 235,A00,947280,Blair; Kyle Adam,9,0,9,0
1748424498885,TDGR 239,A00,947281,Staff,8,0,8,0
1748424498885,TDGR 239,B00,947282,Meyer; Ursula,9,0,9,0
1748424498885,TDGR 239,C00,947283,Staff,9,0,9,0
1748424499914,TDGR 240,A00,947284,Stalling; Vanessa,3,0,5,2
1748424500945,TDGR 244,A00,947285,Iizuka; Naomi Hisako,19,0,20,1
1748424501988,TDGR 245,A00,947287,Stalling; Vanessa,4,0,5,1
1748424503022,TDGR 250,A00,947289,Stein; Deborah Isobel,5,0,5,0
1748424504056,TDGR 251,A00,947296,Iizuka; Naomi Hisako,5,0,5,0
1748424504056,TDGR 251,B00,947355,Stein; Deborah Isobel,5,0,5,0
1748424505083,TDGR 274,A00,947358,Brill; Robert L.,19,0,20,1
1748424506111,TDGR 275,A00,947361,Staff,10,0,10,0
1748424507137,TDGR 276,A00,947362,Bokovikova; Alina V,10,0,10,0
1748424508165,TDGR 278,A00,947363,Petrovich; Victoria A.,12,0,12,0
1748424508165,TDGR 278,B00,947366,Staff,9,0,10,1
1748424509197,TDGR 279,A00,947367,Petrovich; Victoria A.,3,0,3,0
1748424509197,TDGR 279,B00,947368,Brill; Robert L.,2,0,3,1
1748424509197,TDGR 279,C00,947369,McElver; Robert Harrison,3,0,3,0
1748424509197,TDGR 279,D00,967973,Staff,0,0,0,0
1748424509197,TDGR 279,E00,967974,Bokovikova; Alina V,0,0,0,0
1748424510223,TDGR 282,A00,947370,McElver; Robert Harrison,10,0,10,0
1748424511250,TDGR 289,A00,947371,Power; Jade Yukana,10,0,10,0
1748424512275,TDGR 289C,A00,947373,Burelle; Julie Sara Veronique,10,0,10,0
1748424513301,TDGR 289D,A00,947374,Anderson; Mysia Anyse,5,0,5,0
1748424514328,TDGR 292,A00,947375,Yapp; Hentyle T,14,0,15,1
1748424515354,TDGR 295,A00,947376,Celik; Aysan Karagasli,8,0,8,0
1748424516381,TDGR 296,A00,947379,Powell; Lora,5,0,5,0
1748424517407,TDGR 297,001,947381,Meyer; Ursula,9,0,9,0
1748424518443,TDHT 10,A00,946817,Burelle; Julie Sara Veronique,23,0,25,2
1748424519470,TDHT 21,A02,946821,Power; Jade Yukana,11,0,15,4
1748424519470,TDHT 21,A03,946822,Power; Jade Yukana,8,0,15,7
1748424520498,TDHT 101,A00,947106,Perry; Lamar,19,0,25,6
1748424521523,TDHT 103,A00,947107,Yapp; Hentyle T,8,0,25,17
1748424522551,TDHT 115,A00,947108,Portes; Elizabeth Marie,16,0,25,9
1748424523580,TDMV 1,A00,946823,Arcidiacono; Kristin,18,0,30,12
1748424524607,TDMV 2,A00,946824,Wilson; Terry A.,24,0,30,6
1748424524607,TDMV 2,B00,946825,Brown; Bernard Joseph,23,0,30,7
1748424525634,TDMV 3,A00,946826,Mack; Kara Shanai',23,0,40,17
1748424526661,TDMV 11,A00,946827,Arcidiacono; Kristin,36,0,40,4
1748424526661,TDMV 11,B00,946828,Fyall; Daunte Edward,28,0,30,2
1748424527689,TDMV 20,A00,946830,Alvarez; Ana Maria,38,0,40,2
1748424527689,TDMV 20,B00,946831,Smith; Alison D,20,0,20,0
1748424528719,TDMV 110,A00,947109,Smith; Alison D,25,0,30,5
1748424529757,TDMV 120,A00,947110,Weinberg; Sadie,17,0,18,1
1748424529757,TDMV 120,B00,964374,Johnston; Holly,18,0,18,0
1748424530784,TDMV 123,A00,947111,Duran; Marcos Antonio,29,0,30,1
1748424531816,TDMV 138,A00,947113,Jun; Grace Shin Hae,4,0,40,36
1748424532844,TDMV 140,A00,947114,Corrales; Joseph Bernales,29,0,30,1
1748424532844,TDMV 140,B00,947138,Lima; Paulo Henrique,30,0,30,0
1748424532844,TDMV 140,C00,947139,Staff,25,0,30,5
1748424533870,TDMV 141,A00,947140,Caligagan; Tony,29,0,30,1
1748424534904,TDMV 142,A00,947225,Alvarez; Ana Maria,28,0,40,12
1748424534904,TDMV 142,B00,947226,Blanco; Juan Carlos,27,0,30,3
1748424535965,TDMV 143,A00,947227,Fyall; Daunte Edward,28,0,30,2
1748424536995,TDMV 144,A00,947261,Camaya; Michelle Ann,28,0,30,2
1748424536995,TDMV 144,B00,947262,Patnaik; Shibani,28,0,30,2
1748424538025,TDMV 146,A00,947263,Caligagan; Tony,30,0,30,0
1748424539073,TDPF 160,A00,947264,Mack; Kara Shanai',40,0,40,0
1748424540103,TDPR 6,A01,946869,Guirguis; Mark C,25,0,25,0
1748424540103,TDPR 6,A02,946870,Guirguis; Mark C,25,0,25,0
1748424541132,TDPR 102,A00,947265,Guirguis; Mark C,20,0,20,0
1748424542311,TDPR 104,A00,947266,Powell; Lora,15,0,15,0
1748424543347,TDPW 1,A00,946873,Stein; Deborah Isobel,6,0,10,4
1748424543347,TDPW 1,B00,946878,Stein; Deborah Isobel,10,0,10,0
1748424543347,TDPW 1,C00,946879,Stein; Deborah Isobel,10,0,10,0
1748424543347,TDPW 1,D00,946880,Stein; Deborah Isobel,7,0,10,3
1748424543347,TDPW 1,E00,946882,Stein; Deborah Isobel,7,0,10,3
1748424544377,TDPW 104,A00,947267,Loo; Eric James,13,0,20,7
1748424545408,TDTR 10,A00,946883,Wilson; Terry A.,14,0,20,6
1748424546436,TDTR 15,A00,946885,Smith; Alison D,30,0,30,0
1748424547463,TDTR 20,A00,946886,Duran; Marcos Antonio,25,0,30,5
1748424548494,USP 1,A01,943915,Garcia; Guadalupe,23,0,23,0
1748424548494,USP 1,A02,943916,Garcia; Guadalupe,19,0,23,4
1748424548494,USP 1,A03,943927,Garcia; Guadalupe,23,0,23,0
1748424548494,USP 1,A04,943933,Garcia; Guadalupe,22,0,23,1
1748424548494,USP 1,A05,943942,Garcia; Guadalupe,23,0,23,0
1748424548494,USP 1,A06,943951,Garcia; Guadalupe,22,0,23,1
1748424549531,USP 2,A01,943956,Pezzoli; Keith,15,0,23,8
1748424549531,USP 2,A02,943958,Pezzoli; Keith,20,0,22,2
1748424550564,USP 4,A00,943961,Schwaller; Nora Louise,2,0,18,16
1748424550564,USP 4,B00,943966,Schwaller; Nora Louise,12,0,18,6
1748424551648,USP 5,A01,943968,Boomhower; Matthew Charles,16,0,20,4
1748424551648,USP 5,A02,943969,Boomhower; Matthew Charles,16,0,20,4
1748424552682,USP 15,A01,943971,Anderson; William Raymond,18,0,20,2
1748424552682,USP 15,A02,944015,Anderson; William Raymond,19,0,20,1
1748424553710,USP 25,A00,944021,Shenkman; Michael Thomas,16,0,25,9
1748424554741,USP 50,A00,944025,Sun; Feiyang,3,0,30,27
1748424555776,USP 60,A01,944056,Wali; Behram,26,0,30,4
1748424556810,USP 105,A00,944057,Ruiz; Jonathan Joseph,9,0,15,6
1748424557845,USP 108,A00,944058,Pezzoli; Keith,10,0,21,11
1748424558873,USP 124,A00,944060,Devereux; Christina Schopp,16,0,35,19
1748424559903,USP 125,A00,944063,Lerner; Amy M,21,0,28,7
1748424560930,USP 136,A00,944064,Staff,27,0,35,8
1748424562000,USP 141A,A00,960658,Lewis; Leslie R,0,0,0,0
1748424563029,USP 143,A00,944065,Hinds; Juli Beth,200,0,250,50
1748424564057,USP 144,A00,944066,Chowdhury; Muhammed Zohir,94,0,100,6
1748424565085,USP 150,A00,944067,Devereux; Christina Schopp,68,0,75,7
1748424566115,USP 151,A00,944068,Clark; Christopher N,58,0,70,12
1748424567142,USP 152B,A00,944069,Moeder; Nathan L,14,0,25,11
1748424568176,USP 153,A00,944070,Shenkman; Michael Thomas,19,0,35,16
1748424569204,USP 161,A00,944071,Wartell; Julie Dara,27,0,35,8
1748424570230,USP 165C,A00,944072,Wali; Behram,25,0,30,5
1748424571261,USP 170,A00,944142,Entezam; Maryam,60,0,70,10
1748424572288,USP 171,A00,944153,Lerner; Amy M,24,0,65,41
1748424573316,USP 175,A00,944172,Peerson; Susan,0,0,25,25
1748424574343,USP 177A,A00,944173,Peerson; Susan,0,0,23,23
1748424576400,USP 185A,A01,944198,Boomhower; Matthew Charles,26,0,40,14
1748424576400,USP 185A,B01,944201,Sun; Feiyang,0,0,40,40
1748424577431,USP 186,A01,944255,Bussell; Mirle Rabinowitz,28,0,38,10
1748424577431,USP 186,A02,944262,Bussell; Mirle Rabinowitz,11,0,37,26
1748424578472,USP 189,A00,944269,Garcia; Guadalupe,35,0,35,0
1748424579507,USP 191A,A00,944270,McTague; Sarah,13,0,30,17
1748424580537,USP 193,A00,944271,Shilon; Mor,10,0,23,13
1748424581564,USP 194,A00,954112,Hill; Seth J,9999,0,9999,0
1748424582593,USP 265C,A00,944277,Wali; Behram,3,0,4,1
1748424583648,USP 271,A00,944280,Lerner; Amy M,5,0,5,0
1748424584683,VIS 1,A01,944283,Staff,4,0,12,8
1748424584683,VIS 1,A02,944284,Staff,0,0,12,12
1748424584683,VIS 1,A03,944286,Staff,0,0,12,12
1748424584683,VIS 1,A04,944288,Staff,0,0,12,12
1748424584683,VIS 1,A05,944290,Staff,0,0,12,12
1748424584683,VIS 1,A06,944292,Staff,1,0,12,11
1748424584683,VIS 1,A07,944293,Staff,9,0,12,3
1748424584683,VIS 1,A08,944300,Staff,0,0,12,12
1748424584683,VIS 1,A09,944302,Staff,12,0,12,0
1748424584683,VIS 1,A10,944303,Staff,0,0,12,12
1748424584683,VIS 1,A11,944307,Staff,0,0,12,12
1748424584683,VIS 1,A12,944309,Staff,0,0,12,12
1748424584683,VIS 1,A13,944310,Staff,0,0,12,12
1748424584683,VIS 1,A14,944312,Staff,0,0,12,12
1748424584683,VIS 1,A15,944316,Staff,7,0,12,5
1748424584683,VIS 1,A16,944319,Staff,0,0,12,12
1748424585718,VIS 20,A01,944323,Woods; Ann,14,0,16,2
1748424585718,VIS 20,A02,944325,Woods; Ann,15,0,16,1
1748424585718,VIS 20,A03,944326,Woods; Ann,14,0,16,2
1748424585718,VIS 20,A04,944328,Woods; Ann,14,0,16,2
1748424585718,VIS 20,A05,944330,Woods; Ann,16,0,16,0
1748424585718,VIS 20,A06,944334,Woods; Ann,16,0,16,0
1748424585718,VIS 20,A07,944336,Woods; Ann,14,0,16,2
1748424585718,VIS 20,A08,944337,Woods; Ann,16,0,16,0
1748424585718,VIS 20,A09,944338,Woods; Ann,15,0,16,1
1748424585718,VIS 20,A10,944339,Woods; Ann,16,0,16,0
1748424585718,VIS 20,A11,944340,Woods; Ann,15,0,16,1
1748424585718,VIS 20,A12,944342,Woods; Ann,15,0,16,1
1748424586745,VIS 23,A00,944343,Rose; Jordan M,0,0,5,5
1748424587780,VIS 30,A01,944346,Stone; Patricia,11,0,11,0
1748424587780,VIS 30,A02,944351,Stone; Patricia,0,0,11,11
1748424587780,VIS 30,A03,944353,Stone; Patricia,7,0,11,4
1748424587780,VIS 30,A04,944354,Stone; Patricia,9,0,11,2
1748424587780,VIS 30,A05,944356,Stone; Patricia,10,0,11,1
1748424587780,VIS 30,A06,944359,Stone; Patricia,6,0,11,5
1748424588807,VIS 41,A01,944391,D'Elena-Tweed; Jessica Erin,10,0,12,2
1748424588807,VIS 41,A02,944392,D'Elena-Tweed; Jessica Erin,11,0,12,1
1748424588807,VIS 41,A03,944393,D'Elena-Tweed; Jessica Erin,12,0,12,0
1748424588807,VIS 41,A04,944396,D'Elena-Tweed; Jessica Erin,9,0,12,3
1748424588807,VIS 41,A05,944397,D'Elena-Tweed; Jessica Erin,12,0,12,0
1748424588807,VIS 41,A06,944399,D'Elena-Tweed; Jessica Erin,8,0,12,4
1748424588807,VIS 41,A07,944405,D'Elena-Tweed; Jessica Erin,10,0,12,2
1748424588807,VIS 41,A08,944411,D'Elena-Tweed; Jessica Erin,10,0,12,2
1748424588807,VIS 41,A09,944412,D'Elena-Tweed; Jessica Erin,12,0,12,0
1748424588807,VIS 41,A10,944415,D'Elena-Tweed; Jessica Erin,10,0,12,2
1748424588807,VIS 41,A11,944428,D'Elena-Tweed; Jessica Erin,12,0,12,0
1748424588807,VIS 41,A12,944430,D'Elena-Tweed; Jessica Erin,11,0,12,1
1748424589836,VIS 42,A00,969576,Twomey; Robert Daniel,86,0,100,14
1748424590865,VIS 60,A01,944432,Sepuya; Paul Mpagi,10,0,12,2
1748424590865,VIS 60,A02,944434,Sepuya; Paul Mpagi,12,0,12,0
1748424590865,VIS 60,A03,944436,Sepuya; Paul Mpagi,12,0,12,0
1748424590865,VIS 60,A04,944438,Sepuya; Paul Mpagi,12,0,12,0
1748424591892,VIS 70N,A01,944456,Garnett; Mariah J,11,0,11,0
1748424591892,VIS 70N,A02,944461,Garnett; Mariah J,9,0,11,2
1748424591892,VIS 70N,A03,944462,Garnett; Mariah J,8,0,11,3
1748424591892,VIS 70N,A04,944500,Garnett; Mariah J,10,0,11,1
1748424591892,VIS 70N,A05,944501,Garnett; Mariah J,11,0,11,0
1748424591892,VIS 70N,A06,944502,Garnett; Mariah J,11,0,11,0
1748424591892,VIS 70N,A07,944503,Garnett; Mariah J,11,0,11,0
1748424591892,VIS 70N,A08,944507,Garnett; Mariah J,11,0,11,0
1748424592928,VIS 80,A01,944513,Adler; Amy,12,0,12,0
1748424592928,VIS 80,A02,944515,Adler; Amy,9,0,12,3
1748424592928,VIS 80,A03,944517,Adler; Amy,10,0,12,2
1748424592928,VIS 80,A04,944518,Adler; Amy,10,0,12,2
1748424592928,VIS 80,A05,944519,Adler; Amy,12,0,12,0
1748424592928,VIS 80,A06,944520,Adler; Amy,11,0,12,1
1748424592928,VIS 80,A07,944525,Adler; Amy,11,0,12,1
1748424592928,VIS 80,A08,944526,Adler; Amy,9,0,12,3
1748424593963,VIS 85A,A01,944694,Staff,18,0,18,0
1748424593963,VIS 85A,A02,944695,Staff,18,0,18,0
1748424593963,VIS 85A,A03,944696,Staff,17,0,18,1
1748424593963,VIS 85A,A04,944697,Staff,17,0,18,1
1748424593963,VIS 85A,A05,968082,Staff,17,0,18,1
1748424593963,VIS 85A,A06,968084,Staff,18,0,18,0
1748424593963,VIS 85A,A07,968085,Staff,17,0,18,1
1748424593963,VIS 85A,A08,968087,Staff,17,0,18,1
1748424594994,VIS 100,A00,944698,Cruz; Edwin Teddy,125,0,146,21
1748424596023,VIS 100A,A00,944699,D'Elena-Tweed; Jessica Erin,0,0,15,15
1748424597056,VIS 103D,A00,944767,Cartwright; Lisa,72,0,75,3
1748424598086,VIS 105A,A00,944769,Staff,9,0,30,21
1748424598086,VIS 105A,B00,944770,Staff,20,0,30,10
1748424599125,VIS 105B,A00,944773,Staff,16,0,30,14
1748424600160,VIS 105C,A00,944774,Ortiz-Torres; Ruben,1,0,15,14
1748424601203,VIS 106A,A00,944775,Staff,10,0,25,15
1748424602236,VIS 106B,A00,944776,Staff,0,0,25,25
1748424603284,VIS 107A,A00,944777,Staff,2,0,25,23
1748424604319,VIS 107C,A00,944780,Iglesias; Janelle Ann,11,0,15,4
1748424605369,VIS 108,A00,944781,Staff,0,0,15,15
1748424606397,VIS 110A,A00,944782,Staff,11,0,15,4
1748424607422,VIS 110G,A00,963093,Staff,14,0,15,1
1748424608448,VIS 113CN,A00,944783,Welchman; John C.,11,0,15,4
1748424609476,VIS 120A,A00,944784,Woods; Ann,118,0,146,28
1748424610507,VIS 121C,A00,944789,Tronzo; William,68,0,75,7
1748424611535,VIS 126F,A00,944793,Wardwell; Mariana Razo,74,0,75,1
1748424612561,VIS 128C,A00,944794,Staff,71,0,75,4
1748424613591,VIS 129A,A00,944799,Staff,7,0,15,8
1748424614623,VIS 132,A00,944800,Miller; Nicole L,6,0,15,9
1748424615653,VIS 133,A01,944806,Staff,32,0,34,2
1748424615653,VIS 133,A02,944809,Staff,34,0,34,0
1748424616683,VIS 133A,A00,944854,Staff,0,0,15,15
1748424617712,VIS 141A,A01,944856,Stalbaum; Brett,16,0,25,9
1748424617712,VIS 141A,A02,944858,Stalbaum; Brett,17,0,25,8
1748424617712,VIS 141A,A03,944859,Stalbaum; Brett,11,0,25,14
1748424617712,VIS 141A,A04,944861,Stalbaum; Brett,23,0,25,2
1748424618740,VIS 142,A01,944864,Stalbaum; Brett,11,0,15,4
1748424618740,VIS 142,A02,944865,Stalbaum; Brett,0,0,15,15
1748424618740,VIS 142,A03,944869,Stalbaum; Brett,11,0,15,4
1748424618740,VIS 142,A04,944873,Stalbaum; Brett,5,0,15,10
1748424618740,VIS 142,A05,944876,Stalbaum; Brett,15,0,15,0
1748424618740,VIS 142,A06,944878,Stalbaum; Brett,7,0,15,8
1748424619773,VIS 143,A00,969275,Akten; Mehmet,0,0,15,15
1748424620799,VIS 145B,A00,944879,Akten; Mehmet,0,0,15,15
1748424621829,VIS 146B,A00,944880,Twomey; Robert Daniel,14,0,15,1
1748424622857,VIS 147A,A01,944883,Staff,21,0,22,1
1748424622857,VIS 147A,A02,944923,Staff,12,0,22,10
1748424622857,VIS 147A,A03,944924,Staff,15,0,22,7
1748424622857,VIS 147A,A04,944925,Staff,17,0,22,5
1748424623883,VIS 147B,A00,944926,Staff,0,0,15,15
1748424623883,VIS 147B,B00,944927,Staff,1,0,15,14
1748424624913,VIS 149,A00,944928,Bratton; Benjamin H.,12,0,15,3
1748424624913,VIS 149,B00,944929,Crandall; Jordan,7,0,15,8
1748424625942,VIS 152D,A01,944931,Wardwell; Mariana Razo,19,0,24,5
1748424625942,VIS 152D,A02,945003,Wardwell; Mariana Razo,23,0,24,1
1748424625942,VIS 152D,A03,945007,Wardwell; Mariana Razo,24,0,24,0
1748424625942,VIS 152D,A04,945097,Wardwell; Mariana Razo,22,0,24,2
1748424626975,VIS 157,A01,945131,Cartwright; Lisa,23,0,24,1
1748424626975,VIS 157,A02,945167,Cartwright; Lisa,5,0,24,19
1748424628002,VIS 162,A00,945168,Bratton; Benjamin H.,6,0,15,9
1748424629031,VIS 163,A00,945169,Stone; Patricia,72,0,75,3
1748424630059,VIS 164,A00,945170,Sepuya; Paul Mpagi,19,0,22,3
1748424631084,VIS 165A,A00,945208,Staff,10,0,22,12
1748424632111,VIS 167,A00,945235,Staff,11,0,22,11
1748424633136,VIS 171,A00,945258,Staff,18,0,22,4
1748424634162,VIS 174,A00,945285,Cross; Brian R,0,0,22,22
1748424635188,VIS 175,A00,945286,Staff,18,0,22,4
1748424636216,VIS 179,A00,945287,Erdmann; Dean,20,0,22,2
1748424637247,VIS 180A,A00,945322,Cross; Brian R,9,0,22,13
1748424638278,VIS 180B,A00,945324,Gaines; Malik Julian,17,0,22,5
1748424639302,VIS 183B,A00,945329,Staff,4,0,22,18
1748424640327,VIS 203,A00,945331,Cruz; Edwin Teddy,4,0,15,11
1748424641353,VIS 204,A00,945333,Gaines; Malik Julian,11,0,15,4
1748424642401,VIS 205,A00,945334,Ortiz-Torres; Ruben,14,0,15,1
1748424643431,VIS 207,A00,971577,Staff,13,0,15,2
1748424644461,VIS 209,A00,945337,Welchman; John C.,10,0,15,5
1748424645486,VIS 243,A00,945340,Rose; Jordan M,8,0,15,7
1748424646514,VIS 255,A00,945342,Staff,9,0,15,6
1748424647556,VIS 295,001,971694,Miller; Nicole L,0,0,0,0
1748424647556,VIS 295,002,971695,Cruz; Edwin Teddy,0,0,0,0
1748424647556,VIS 295,003,971696,Segade; Alexandro Abraham,0,0,0,0
1748424647556,VIS 295,004,971697,Vangenderen; Monique Luise,0,0,0,0
1748424647556,VIS 295,005,971725,Sepuya; Paul Mpagi,0,0,0,0
1748424647556,VIS 295,006,971763,Sepuya; Paul Mpagi,0,0,0,0
1748424647556,VIS 295,007,971764,Mostajo; Lorena,0,0,0,0
1748424647556,VIS 295,008,971765,Akten; Mehmet,0,0,0,0
1748424648591,WCWP 10A,001,947782,Escobar; Jordan Christophe,20,0,20,0
1748424648591,WCWP 10A,002,947791,Escobar; Jordan Christophe,20,0,20,0
1748424648591,WCWP 10A,003,947792,Gagnon; Jeffrey C,0,0,0,0
1748424648591,WCWP 10A,004,947793,Escobar; Jordan Christophe,19,0,20,1
1748424648591,WCWP 10A,005,947794,Merryman; Walter,19,0,20,1
1748424648591,WCWP 10A,006,947840,Merryman; Walter,20,0,20,0
1748424648591,WCWP 10A,007,947841,Staff,0,0,0,0
1748424648591,WCWP 10A,008,947842,Staff,0,0,0,0
1748424648591,WCWP 10A,009,947843,Martiniuk; Jill,18,0,20,2
1748424648591,WCWP 10A,010,947844,Staff,0,0,0,0
1748424648591,WCWP 10A,011,947845,Martiniuk; Jill,19,0,20,1
1748424648591,WCWP 10A,012,947861,Martiniuk; Jill,20,0,20,0
1748424648591,WCWP 10A,013,947862,Staff,0,0,0,0
1748424648591,WCWP 10A,014,947863,Staff,0,0,0,0
1748424648591,WCWP 10A,015,947867,Staff,0,0,0,0
1748424648591,WCWP 10A,016,947868,Susi; Natalie,19,0,20,1
1748424648591,WCWP 10A,017,947869,Susi; Natalie,19,0,20,1
1748424648591,WCWP 10A,018,947870,Holloway Ii; Mathew,20,0,20,0
1748424648591,WCWP 10A,019,947912,Welji; Haleema Nazir,0,0,0,0
1748424648591,WCWP 10A,020,947941,Holloway Ii; Mathew,19,0,20,1
1748424648591,WCWP 10A,021,947954,Holloway Ii; Mathew,20,0,20,0
1748424648591,WCWP 10A,022,960902,Windham; Emily,19,0,20,1
1748424648591,WCWP 10A,023,960903,Windham; Emily,16,0,20,4
1748424648591,WCWP 10A,024,960904,Windham; Emily,18,0,20,2
1748424649627,WCWP 10B,001,948038,Dhir; Simrita,17,0,20,3
1748424649627,WCWP 10B,002,948042,Dhir; Simrita,13,0,20,7
1748424649627,WCWP 10B,003,948043,Uriarte; Emma,0,0,20,20
1748424649627,WCWP 10B,004,948044,Dhir; Simrita,12,0,20,8
1748424649627,WCWP 10B,005,948045,Uriarte; Emma,13,0,20,7
1748424649627,WCWP 10B,006,948046,Uriarte; Emma,13,0,20,7
1748424649627,WCWP 10B,007,948047,Staff,0,0,0,0
1748424649627,WCWP 10B,008,948075,Staff,0,0,0,0
1748424649627,WCWP 10B,009,948076,Ornelas; Tricia,15,0,20,5
1748424649627,WCWP 10B,010,948077,Staff,0,0,0,0
1748424649627,WCWP 10B,011,948096,Staff,0,0,0,0
1748424649627,WCWP 10B,012,948103,Staff,0,0,0,0
1748424649627,WCWP 10B,016,948169,Staff,0,0,0,0
1748424649627,WCWP 10B,017,948192,Ornelas; Tricia,12,0,20,8
1748424649627,WCWP 10B,018,948194,Ornelas; Tricia,14,0,20,6
1748424649627,WCWP 10B,019,948195,Staff,0,0,0,0
1748424650654,WCWP 100,A00,948196,McCleary; Keith Long,14,0,20,6
1748424650654,WCWP 100,B00,948198,McCleary; Keith Long,20,0,20,0
1748424650654,WCWP 100,C00,948199,McCleary; Keith Long,20,0,20,0
1748424650654,WCWP 100,D00,948200,Twohig; Niall Ivan,18,0,20,2
1748424650654,WCWP 100,E00,948201,Twohig; Niall Ivan,19,0,20,1
1748424650654,WCWP 100,F00,948202,Twohig; Niall Ivan,17,0,20,3
1748424650654,WCWP 100,G00,948203,Young; Mark T,18,0,20,2
1748424650654,WCWP 100,H00,948204,Young; Mark T,19,0,20,1
1748424650654,WCWP 100,I00,948205,Young; Mark T,19,0,20,1
1748424651681,WES 237C,A00,948206,Staff,15,0,15,0
1748424652709,WES 267,A00,948207,Staff,25,0,25,0
1748424653737,WES 268A,A01,948209,Staff,15,0,15,0
1748424655980,AAPI 87,A00,911745,Solomon; Amanda Lee Albaniel,20,0,20,0
1748424657008,AAS 10R,A01,912566,Butler; Elizabeth Annette,15,0,34,19
1748424657008,AAS 10R,A02,912567,Butler; Elizabeth Annette,20,0,34,14
1748424658032,AAS 170R,A00,912568,Butler; Elizabeth Annette,29,0,32,3
1748424659293,ANAR 104,A01,911408,Shtienberg; Gilad,11,0,20,9
1748424660322,ANAR 120,A00,911411,Staff,22,0,30,8
1748424661352,ANAR 166,A00,911412,Jimenez Cano; Nayeli Guada,21,0,30,9
1748424662379,ANAR 167,A01,911414,Dunseth; Zachary Clark,0,0,10,10
1748424663414,ANBI 100,A00,911416,Marchetto; Maria Carolina,36,0,40,4
1748424663414,ANBI 100,B00,961136,Staff,66,0,80,14
1748424664441,ANBI 112,A00,911417,Marchetto; Maria Carolina,0,0,20,20
1748424665468,ANBI 117,A01,961211,Fox; Patrick Keolu Ozer,33,0,40,7
1748424666496,ANBI 135,A01,911419,Non; Amy L,4,0,15,11
1748424667530,ANBI 141,A00,911420,Gagneux; Pascal,170,0,196,26
1748424668557,ANSC 108,A00,911460,Pedersen; David,38,0,40,2
1748424669585,ANSC 121,A00,911472,Sloane; Julia Kathryn,53,0,60,7
1748424670611,ANSC 124,A00,911473,Bialecki; Jon Anthony,32,0,40,8
1748424671638,ANSC 142,A00,911474,Stone; Annika Britt,31,0,40,9
1748424672668,ANSC 148,A00,911475,Walkover; Lillian B,46,0,46,0
1748424673695,ANSC 149,A00,911476,Varma; Saiba,56,0,60,4
1748424674720,ANSC 152,A00,961212,Staff,40,0,40,0
1748424675748,ANSC 190,A00,911479,Jassal; Aftab,41,0,50,9
1748424676777,ANTH 1,A00,910717,Jassal; Aftab,146,0,150,4
1748424677804,ANTH 2,A01,910719,Wilder; Linnea Lorene,31,0,36,5
1748424677804,ANTH 2,A02,910720,Wilder; Linnea Lorene,36,0,36,0
1748424677804,ANTH 2,A03,910722,Wilder; Linnea Lorene,32,0,36,4
1748424677804,ANTH 2,A04,910723,Wilder; Linnea Lorene,35,0,36,1
1748424677804,ANTH 2,A05,910724,Wilder; Linnea Lorene,35,0,36,1
1748424677804,ANTH 2,A06,910725,Wilder; Linnea Lorene,35,0,36,1
1748424677804,ANTH 2,A07,910726,Wilder; Linnea Lorene,33,0,34,1
1748424678831,ANTH 10,A00,910727,Stewart; Alexander B,148,0,175,27
1748424679860,ANTH 21,A01,910730,Stone; Annika Britt,35,0,36,1
1748424679860,ANTH 21,A02,910731,Stone; Annika Britt,34,0,36,2
1748424679860,ANTH 21,A03,910732,Stone; Annika Britt,34,0,36,2
1748424679860,ANTH 21,A04,910733,Stone; Annika Britt,30,0,36,6
1748424679860,ANTH 21,A05,910734,Stone; Annika Britt,35,0,36,1
1748424679860,ANTH 21,A06,910735,Stone; Annika Britt,30,0,36,6
1748424679860,ANTH 21,A07,910736,Stone; Annika Britt,24,0,34,10
1748424679860,ANTH 21,B01,910738,Kang; Byung Chu,36,0,36,0
1748424679860,ANTH 21,B02,910740,Kang; Byung Chu,36,0,36,0
1748424679860,ANTH 21,B03,910781,Kang; Byung Chu,34,0,36,2
1748424679860,ANTH 21,B04,910782,Kang; Byung Chu,34,0,36,2
1748424679860,ANTH 21,B05,910821,Kang; Byung Chu,36,0,36,0
1748424679860,ANTH 21,B06,910826,Kang; Byung Chu,34,0,36,2
1748424679860,ANTH 21,B07,910834,Kang; Byung Chu,34,0,34,0
1748424680893,ANTH 23,A01,910896,Stewart; Alexander B,25,0,25,0
1748424680893,ANTH 23,A02,910916,Stewart; Alexander B,25,0,25,0
1748424680893,ANTH 23,A03,910932,Stewart; Alexander B,25,0,25,0
1748424680893,ANTH 23,A04,910933,Stewart; Alexander B,24,0,25,1
1748424680893,ANTH 23,A05,910938,Stewart; Alexander B,25,0,25,0
1748424680893,ANTH 23,A06,911043,Stewart; Alexander B,25,0,25,0
1748424680893,ANTH 23,A07,911141,Stewart; Alexander B,24,0,25,1
1748424681920,ANTH 87,A00,911153,Jordan; David K.,20,0,20,0
1748424681920,ANTH 87,B00,911392,Jordan; David K.,20,0,20,0
1748424681920,ANTH 87,C00,911404,Varma; Saiba,20,0,20,0
1748424682948,ANTH 101,A01,911481,Staff,27,0,30,3
1748424682948,ANTH 101,A02,911482,Staff,15,0,30,15
1748424682948,ANTH 101,A03,911483,Staff,24,0,30,6
1748424682948,ANTH 101,A04,911484,Staff,17,0,30,13
1748424683974,ANTH 105,A00,911486,Staff,69,0,80,11
1748424685005,ANTH 108,A00,911487,Sloane; Julia Kathryn,31,0,35,4
1748424686032,ANTH 196A,A00,911488,Staff,14,0,15,1
1748424687064,ANTH 200,A00,911489,Non; Amy L,12,0,15,3
1748424688093,ANTH 203,A00,911490,Gagneux; Pascal,20,0,20,0
1748424689120,ANTH 208,A00,911491,Kang; Byung Chu,8,0,12,4
1748424690147,ANTH 268,A00,911492,McKenzie; Kerry V.,10,0,10,0
1748424691173,ANTH 273,A00,911493,McKenzie; Kerry V.,10,0,10,0
1748424692200,ANTH 281A,A00,911494,Pedersen; David,10,0,10,0
1748424693231,ANTH 285,A00,911495,Algaze; Guillermo,7,0,10,3
1748424694262,ASTR 1,A01,911506,Wright; Shelley Adams,282,0,300,18
1748424695288,ASTR 18,A01,911508,Arnold; Kam S,35,0,37,2
1748424696314,ASTR 20A,A01,911510,Theissen; Christopher Alexander,48,0,56,8
1748424697341,ASTR 65,A01,911512,Trumbo; Samantha Kathleen,49,0,50,1
1748424698372,ASTR 101,A01,911514,Burgasser; Adam Jonathan,25,0,32,7
1748424699399,ASTR 104,A01,911516,Lee; Eve Jihyun,29,0,32,3
1748424700431,ASTR 120,A01,911518,Tytler; David Robert,29,0,37,8
1748424701458,ASTR 124,A01,911520,Konopacky; Quinn Morgan,33,0,37,4
1748424702486,ASTR 150,A01,911522,Hosseinzadeh; Griffin Alex,34,0,40,6
1748424703518,ASTR 200,A00,911523,Sandstrom; Karin Marie,29,0,30,1
1748424704545,ASTR 201,A00,911524,Broekgaarden; Floor Suzan,30,0,30,0
1748424705578,ASTR 213,A00,911525,Keres; Dusan,28,0,30,2
1748424706610,ASTR 250,A00,911526,Theissen; Christopher Alexander & Hosseinzadeh; Griffin Alex,27,0,30,3
1748424707642,ASTR 251,A00,911527,Theissen; Christopher Alexander & Hosseinzadeh; Griffin Alex,27,0,30,3
1748424708687,AWP 3,001,910489,Staff,12,0,12,0
1748424708687,AWP 3,002,910490,Staff,12,0,12,0
1748424708687,AWP 3,003,910491,Staff,12,0,12,0
1748424708687,AWP 3,004,910492,Staff,12,0,12,0
1748424708687,AWP 3,005,910493,Staff,12,0,12,0
1748424708687,AWP 3,006,910495,Staff,12,0,12,0
1748424708687,AWP 3,007,910498,Staff,12,0,12,0
1748424708687,AWP 3,008,910509,Staff,12,0,12,0
1748424708687,AWP 3,009,910516,Staff,12,0,12,0
1748424708687,AWP 3,010,910525,Staff,12,0,12,0
1748424708687,AWP 3,011,910531,Staff,12,0,12,0
1748424708687,AWP 3,012,910532,Staff,12,0,12,0
1748424708687,AWP 3,013,910533,Staff,12,0,12,0
1748424708687,AWP 3,014,910534,Staff,12,0,12,0
1748424708687,AWP 3,015,910535,Staff,12,0,12,0
1748424708687,AWP 3,016,910536,Staff,12,0,12,0
1748424708687,AWP 3,017,910537,Staff,12,0,12,0
1748424708687,AWP 3,018,910538,Staff,12,0,12,0
1748424708687,AWP 3,019,910539,Staff,0,0,0,0
1748424708687,AWP 3,020,910540,Staff,0,0,0,0
1748424708687,AWP 3,021,910541,Staff,12,0,12,0
1748424708687,AWP 3,022,910542,Staff,0,0,0,0
1748424708687,AWP 3,023,910543,Staff,12,0,12,0
1748424708687,AWP 3,024,910545,Staff,12,0,12,0
1748424708687,AWP 3,025,910546,Staff,12,0,12,0
1748424708687,AWP 3,026,910547,Staff,12,0,12,0
1748424708687,AWP 3,027,910548,Staff,12,0,12,0
1748424708687,AWP 3,028,910549,Staff,12,0,12,0
1748424708687,AWP 3,029,910550,Staff,0,0,0,0
1748424708687,AWP 3,030,910551,Staff,0,0,0,0
1748424708687,AWP 3,031,910552,Staff,12,0,12,0
1748424708687,AWP 3,032,910553,Staff,12,0,12,0
1748424708687,AWP 3,033,910554,Staff,12,0,12,0
1748424708687,AWP 3,034,910555,Staff,12,0,12,0
1748424708687,AWP 3,035,910557,Staff,12,0,12,0
1748424708687,AWP 3,036,910558,Staff,12,0,12,0
1748424708687,AWP 3,037,910559,Staff,12,0,12,0
1748424708687,AWP 3,038,910560,Staff,12,0,12,0
1748424708687,AWP 3,039,910561,Staff,12,0,12,0
1748424708687,AWP 3,040,910562,Staff,12,0,12,0
1748424708687,AWP 3,041,910563,Staff,12,0,12,0
1748424708687,AWP 3,042,910564,Staff,12,0,12,0
1748424708687,AWP 3,043,910565,Staff,12,0,12,0
1748424708687,AWP 3,044,910566,Staff,12,0,12,0
1748424708687,AWP 3,045,910567,Staff,12,0,12,0
1748424708687,AWP 3,046,910568,Staff,12,0,12,0
1748424708687,AWP 3,047,910569,Staff,12,0,12,0
1748424708687,AWP 3,048,910570,Staff,12,0,12,0
1748424708687,AWP 3,049,910571,Staff,12,0,12,0
1748424708687,AWP 3,050,910576,Staff,12,0,12,0
1748424708687,AWP 3,051,910629,Staff,12,0,12,0
1748424708687,AWP 3,052,910630,Staff,12,0,12,0
1748424708687,AWP 3,053,910632,Staff,12,0,12,0
1748424708687,AWP 3,054,910633,Staff,12,0,12,0
1748424708687,AWP 3,055,910635,Staff,12,0,12,0
1748424708687,AWP 3,056,910636,Staff,12,0,12,0
1748424708687,AWP 3,057,910638,Staff,12,0,12,0
1748424708687,AWP 3,058,910640,Staff,0,0,0,0
1748424708687,AWP 3,059,910641,Staff,12,0,12,0
1748424708687,AWP 3,060,910645,Staff,12,0,12,0
1748424708687,AWP 3,061,910646,Staff,12,0,12,0
1748424708687,AWP 3,062,910648,Staff,12,0,12,0
1748424708687,AWP 3,063,910649,Staff,12,0,12,0
1748424708687,AWP 3,064,910653,Staff,12,0,12,0
1748424708687,AWP 3,065,910654,Staff,12,0,12,0
1748424708687,AWP 3,066,910656,Staff,12,0,12,0
1748424708687,AWP 3,067,910657,Staff,12,0,12,0
1748424708687,AWP 3,068,910659,Staff,15,0,15,0
1748424708687,AWP 3,069,910660,Staff,0,0,0,0
1748424708687,AWP 3,070,910662,Staff,12,0,12,0
1748424708687,AWP 3,071,910665,Staff,0,0,0,0
1748424708687,AWP 3,072,910667,Staff,12,0,12,0
1748424708687,AWP 3,073,970938,Staff,12,0,12,0
1748424708687,AWP 3,074,970939,Staff,12,0,12,0
1748424708687,AWP 3,075,970940,Staff,0,0,0,0
1748424708687,AWP 3,076,970941,Staff,12,0,12,0
1748424708687,AWP 3,077,970942,Staff,12,0,12,0
1748424708687,AWP 3,078,970943,Staff,0,0,0,0
1748424708687,AWP 3,079,970944,Staff,12,0,12,0
1748424708687,AWP 3,080,970945,Staff,0,0,0,0
1748424708687,AWP 3,081,971140,Staff,0,0,0,0
1748424708687,AWP 3,082,971141,Staff,0,0,0,0
1748424708687,AWP 3,083,971142,Staff,0,0,0,0
1748424708687,AWP 3,084,971152,Staff,0,0,0,0
1748424708687,AWP 3,085,971315,Staff,0,0,0,0
1748424709714,AWP 4B,B00,910682,Staff,0,0,0,0
1748424709714,AWP 4B,C00,910701,Staff,0,0,0,1
1748424710746,BENG 1,A01,911565,Khojah; Reem I,26,0,30,4
1748424710746,BENG 1,A02,911567,Khojah; Reem I,30,0,30,0
1748424710746,BENG 1,A03,911568,Khojah; Reem I,29,0,30,1
1748424711772,BENG 2,A00,911569,Khojah; Reem I,28,0,30,2
1748424712803,BENG 98,001,969809,Sah; Robert Lie-Yuan,9999,0,9999,0
1748424713828,BENG 99,001,969810,Sah; Robert Lie-Yuan,9999,0,9999,0
1748424714861,BENG 100,A01,911579,Taylor Amos; Alyssa C,35,0,50,15
1748424715890,BENG 110,A01,911582,Mc Culloch; Andrew Douglas,5,0,30,25
1748424715890,BENG 110,A02,911584,Mc Culloch; Andrew Douglas,17,0,30,13
1748424716917,BENG 122A,A01,958030,Cauwenberghs; Gert,54,0,70,16
1748424717944,BENG 133,A01,911589,Mali; Prashant Gulab Ram,33,0,40,7
1748424718971,BENG 135,A01,911653,Staff,32,0,40,8
1748424719998,BENG 141,A01,911674,Staff,29,0,40,11
1748424721027,BENG 161A,A01,911676,Fraley; Stephanie I.,16,0,35,19
1748424721027,BENG 161A,A02,957945,Fraley; Stephanie I.,29,0,35,6
1748424722056,BENG 162,A01,911682,Mali; Prashant Gulab Ram,0,0,30,30
1748424722056,BENG 162,A02,911683,Mali; Prashant Gulab Ram,25,0,30,5
1748424723085,BENG 166A,A02,911685,Sah; Robert Lie-Yuan,11,0,35,24
1748424724117,BENG 183,A01,911688,Zhong; Sheng,35,0,120,85
1748424725144,BENG 187B,A00,911689,Taylor Amos; Alyssa C,52,0,120,68
1748424726174,BENG 188A,A01,911691,Taylor Amos; Alyssa C,131,0,170,39
1748424727204,BENG 196,A00,911692,Cabrales; Pedro,5,0,5,0
1748424728232,BENG 197,A00,911693,Cabrales; Pedro,9999,0,9999,0
1748424729263,BENG 198,001,969812,Sah; Robert Lie-Yuan,9999,0,9999,0
1748424730296,BENG 211,A00,911720,Smarr; Benjamin,2,0,30,28
1748424731326,BENG 216,A01,911722,Cauwenberghs; Gert,1,0,40,39
1748424732353,BENG 219,A00,911723,Schoeneberg; Johannes,0,0,0,0
1748424733381,BENG 221,A00,911724,Valdez-Jasso; Daniela,27,0,70,43
1748424734407,BENG 226,A01,911727,Schmid-Schoenbein; Geert W,54,0,120,66
1748424735433,BENG 230A,A00,911728,Huang; Xiaohua,59,0,120,61
1748424736464,BENG 241A,A01,911730,Cyphert; Erika Leah,0,0,50,50
1748424737491,BENG 242,A00,911731,Cai; Shengqiang,16,0,40,24
1748424738519,BENG 247A,A00,911732,Shi; Lingyan,31,0,55,24
1748424739549,BENG 247B,A00,911733,Aran; Kiana,0,0,30,30
1748424740581,BENG 254,A01,911735,Hasty; Jeff M,0,0,20,20
1748424741612,BENG 260,A01,911737,Silva; Gabriel,15,0,45,30
1748424742646,BENG 280A,A00,911738,Liu; Thomas Tao-Ming & McVeigh; Elliot R.,34,0,70,36
1748424743675,BENG 281,A00,911739,Zhong; Sheng,5,0,90,85
1748424744700,BENG 282,A00,911740,Cabrales; Pedro,19,0,100,81
1748424745731,BENG 292,A01,911742,Ross; Camille,20,0,20,0
1748424746758,BENG 294A,A00,911743,King; Kevin R,25,0,50,25
1748424747786,BENG 295,A00,911744,Watson; John Thomas,9999,0,9999,0
1748424748815,BGGN 202,A00,943331,Kadonaga; James T,52,0,60,8
1748424749852,BGGN 204,A00,943332,Shurin; Jonathan,11,0,20,9
1748424750881,BGGN 206A,A00,943343,Bennett; Eric J,50,0,50,0
1748424751910,BGGN 208,A00,943344,Meyer; Justin Raymond & Bennett; Eric J,50,0,50,0
1748424752939,BGGN 213,A00,943349,Grant; Barry J,48,0,48,0
1748424753968,BGGN 214,A00,943351,Suel; Gurol Mehmet,23,0,50,27
1748424755006,BGGN 220,A00,943352,Dickinson; Alexandra Jazz & Pruneda-Paz; Jose L.,24,0,50,26
1748424756040,BGGN 227,A00,943372,Huffaker; Alisa,44,0,50,6
1748424757070,BGGN 249A,A01,969612,Bloodgood; Brenda Laurie,0,0,0,0
1748424757070,BGGN 249A,A02,969639,Bloodgood; Brenda Laurie,0,0,0,0
1748424758103,BGGN 260,A01,946423,Silva; Gabriel,15,0,15,0
1748424759369,BGGN 271,001,967097,Akbari; Omar Sultan,9999,0,9999,0
1748424759369,BGGN 271,002,967098,Allen; Nicola J,9999,0,9999,0
1748424759369,BGGN 271,003,967099,Alperin; Mariann,9999,0,9999,0
1748424759369,BGGN 271,004,967238,Antal; Corina Elena,9998,0,9999,1
1748424759369,BGGN 271,005,967365,Banghart; Matthew Ryan,9999,0,9999,0
1748424759369,BGGN 271,006,967368,Bier; Ethan,9999,0,9999,0
1748424759369,BGGN 271,007,967371,Boss; Gerard R.,9999,0,9999,0
1748424759369,BGGN 271,008,967375,Bouvet; Michael,9999,0,9999,0
1748424759369,BGGN 271,009,967376,Breen; Ellen C.,9999,0,9999,0
1748424759369,BGGN 271,010,967382,Bui; Jack D,9999,0,9999,0
1748424759369,BGGN 271,011,967391,Burnett; Lindsey,9998,0,9999,1
1748424759369,BGGN 271,012,967407,Caffrey; Conor,9999,0,9999,0
1748424759369,BGGN 271,013,967429,Castle; Michael James,9999,0,9999,0
1748424759369,BGGN 271,014,967431,Chang; John Tzu-yu,9999,0,9999,0
1748424759369,BGGN 271,015,967448,Chen; Xu,9999,0,9999,0
1748424759369,BGGN 271,016,967449,Cheng; Christine Shiang-Ling,9999,0,9999,0
1748424759369,BGGN 271,017,967464,Cheresh; David A.,9999,0,9999,0
1748424759369,BGGN 271,018,967496,Cherqui; Stephanie,9999,0,9999,0
1748424759369,BGGN 271,019,967500,Chu; Hiutung,9999,0,9999,0
1748424759369,BGGN 271,020,967559,Church; Kellie Breen,9999,0,9999,0
1748424759369,BGGN 271,021,967560,Cleland; Elsa Eleanor,9999,0,9999,0
1748424759369,BGGN 271,022,967561,Cohen; Shiran,9999,0,9999,0
1748424759369,BGGN 271,023,967562,Coufal; Nicole Gabriele,9999,0,9999,0
1748424759369,BGGN 271,024,967563,Croker; Ben Adam,9999,0,9999,0
1748424759369,BGGN 271,025,967564,Crotty Alexander; Laura E,9999,0,9999,0
1748424759369,BGGN 271,026,967565,Daugherty; Matthew Dorton,9998,0,9999,1
1748424759369,BGGN 271,027,967566,De Silva; Shermin,9999,0,9999,0
1748424759369,BGGN 271,028,967567,Dhar; Debanjan,9999,0,9999,0
1748424759369,BGGN 271,029,967568,Dixon; Jesse,9999,0,9999,0
1748424759369,BGGN 271,030,967569,Doherty; Taylor Alan,9998,0,9999,1
1748424759369,BGGN 271,031,967570,Dore; Kim Bohemie,9999,0,9999,0
1748424759369,BGGN 271,032,967571,Dorrestein; Pieter,9999,0,9999,0
1748424759369,BGGN 271,033,967572,Dulawa; Stephanie Carole,9999,0,9999,0
1748424759369,BGGN 271,034,967573,Fang; Xi,9999,0,9999,0
1748424759369,BGGN 271,035,967575,Farley; Emma Kristen,9998,0,9999,1
1748424759369,BGGN 271,036,967576,Ferguson; Cole John,9999,0,9999,0
1748424759369,BGGN 271,037,967578,Fisch; Kathleen Marie,9999,0,9999,0
1748424759369,BGGN 271,038,967579,George; Olivier,9999,0,9999,0
1748424759369,BGGN 271,039,967580,Ghosh; Pradipta,9998,0,9999,1
1748424759369,BGGN 271,040,967581,Glasgow; Stacey Marie,9999,0,9999,0
1748424759369,BGGN 271,041,967582,Golden; James W,9999,0,9999,0
1748424759369,BGGN 271,042,967583,Gonzalez Gamboa; Ivonne,9999,0,9999,0
1748424759369,BGGN 271,043,967584,Goren; Alon M,9999,0,9999,0
1748424759369,BGGN 271,044,967650,Guatelli; John C,9999,0,9999,0
1748424759369,BGGN 271,045,967651,Guma; Monica,9998,0,9999,1
1748424759369,BGGN 271,046,967652,Gustafsson; Asa Birgitta,9999,0,9999,0
1748424759369,BGGN 271,047,967655,Hamdoun; Amr,9999,0,9999,0
1748424759369,BGGN 271,048,967657,Hao; Nan,9999,0,9999,0
1748424759369,BGGN 271,049,967658,Hasty; Jeff M,9999,0,9999,0
1748424759369,BGGN 271,050,967660,Jiang; Qingfei,9998,0,9999,1
1748424759369,BGGN 271,051,967661,Jin; Chunyu,9999,0,9999,0
1748424759369,BGGN 271,052,967662,Jin; Yishi,9999,0,9999,0
1748424759369,BGGN 271,053,967663,Joshi; Shweta,9998,0,9999,1
1748424759369,BGGN 271,054,967664,Ju; Won-Kyu,9998,0,9999,1
1748424759369,BGGN 271,055,967665,Jun; Suckjoon,9999,0,9999,0
1748424759369,BGGN 271,056,967666,Kaech; Susan Michelle,9999,0,9999,0
1748424759369,BGGN 271,057,967668,Kauffman; Alexander,9998,0,9999,1
1748424759369,BGGN 271,058,967670,Kiger; Amy,9999,0,9999,0
1748424759369,BGGN 271,059,967720,Koloski; Miranda Jane,9998,0,9999,1
1748424759369,BGGN 271,060,967864,Komiyama; Takaki,9999,0,9999,0
1748424759369,BGGN 271,061,967865,Kronenberg; Mitchell E.,9998,0,9999,1
1748424759369,BGGN 271,062,967866,Kufareva; Irina,9999,0,9999,0
1748424759369,BGGN 271,063,967867,Lee; Yun Sok,9999,0,9999,0
1748424759369,BGGN 271,064,967869,Leutgeb; Stefan,9999,0,9999,0
1748424759369,BGGN 271,065,967870,Lewis; Warren G.,9999,0,9999,0
1748424759369,BGGN 271,066,967871,Li; Willis Xiaowei,9998,0,9999,1
1748424759369,BGGN 271,067,967872,Lim; Byungkook,9999,0,9999,0
1748424759369,BGGN 271,068,967873,Lo; Stanley M.,9998,0,9999,1
1748424759369,BGGN 271,069,967874,Lopez Ramirez; Miguel Alej,9999,0,9999,0
1748424759369,BGGN 271,070,967875,Lu; Li-Fan,9998,0,9999,1
1748424759369,BGGN 271,071,967877,Lu; Pengzhe,9999,0,9999,0
1748424759369,BGGN 271,072,967878,Lyons; Deirdre Colleen,9999,0,9999,0
1748424759369,BGGN 271,073,967879,Lyumkis; Dmitry Evgenievich,9999,0,9999,0
1748424759369,BGGN 271,074,967880,Mandyam; Chitra,9999,0,9999,0
1748424759369,BGGN 271,075,967881,McConville; Patrick James,9999,0,9999,0
1748424759369,BGGN 271,076,967882,Mertens; Jerome Stefan,9999,0,9999,0
1748424759369,BGGN 271,077,967884,Morris; Gerald P,9999,0,9999,0
1748424759369,BGGN 271,078,967885,Muroyama; Andrew David,9999,0,9999,0
1748424759369,BGGN 271,079,967886,Murre; Cornelis,9999,0,9999,0
1748424759369,BGGN 271,080,967887,Neal; Sonya E,9999,0,9999,0
1748424759369,BGGN 271,081,967889,Newton; Alexandra C.,9999,0,9999,0
1748424759369,BGGN 271,082,967890,Nieh; James Charles,9999,0,9999,0
1748424759369,BGGN 271,083,967893,Niwa; Maho,9999,0,9999,0
1748424759369,BGGN 271,084,967894,Pantham; Priyadarshini,9999,0,9999,0
1748424759369,BGGN 271,085,967895,Parast; Mana,9999,0,9999,0
1748424759369,BGGN 271,086,967899,Perry; Michael William,9999,0,9999,0
1748424759369,BGGN 271,087,967900,Pillus; Lorraine,9998,0,9999,1
1748424759369,BGGN 271,088,967902,Pogliano; Joseph,9999,0,9999,0
1748424759369,BGGN 271,089,967903,Pruneda-Paz; Jose L.,9999,0,9999,0
1748424759369,BGGN 271,090,967904,Raffatellu; Manuela,9999,0,9999,0
1748424759369,BGGN 271,091,967906,Rana; Tariq,9999,0,9999,0
1748424759369,BGGN 271,092,967907,Rao; Anjana,9998,0,9999,1
1748424759369,BGGN 271,093,967908,Raz; Eyal,9998,0,9999,1
1748424759369,BGGN 271,094,967909,Gaulton; Kyle J,9999,0,9999,0
1748424759369,BGGN 271,095,967910,Rifkin; Scott,9998,0,9999,1
1748424759369,BGGN 271,096,967912,Risbrough; Victoria Blythe,9999,0,9999,0
1748424759369,BGGN 271,097,967916,Rose; Noah Hartmann,9999,0,9999,0
1748424759369,BGGN 271,098,967917,Rouse; Gregory W.,9999,0,9999,0
1748424759369,BGGN 271,099,967918,Saier; Milton H.,9999,0,9999,0
1748424759369,BGGN 271,100,967919,Saltiel; Alan,9998,0,9999,1
1748424759369,BGGN 271,101,967920,Sanchez-Lopez; Elsa,9999,0,9999,0
1748424759369,BGGN 271,102,967921,Schenk; Simon,9999,0,9999,0
1748424759369,BGGN 271,103,967922,Schroeder; Julian I,9998,0,9999,1
1748424759369,BGGN 271,104,967923,Sebat; Lilia Mikhailovna,9999,0,9999,0
1748424759369,BGGN 271,105,967925,Sen; George L,9999,0,9999,0
1748424759369,BGGN 271,106,967926,Shaner; Nathan C.,9999,0,9999,0
1748424759369,BGGN 271,107,967927,Shao; Jianhua,9999,0,9999,0
1748424759369,BGGN 271,108,967928,Shurin; Jonathan,9998,0,9999,1
1748424759369,BGGN 271,109,967929,Sicklick; Jason Keith,9999,0,9999,0
1748424759369,BGGN 271,110,967931,Signer; Robert,9999,0,9999,0
1748424759369,BGGN 271,111,967932,Sigurdson; Christina,9999,0,9999,0
1748424759369,BGGN 271,112,967934,Simonson; Tatum Sasha Summ,9999,0,9999,0
1748424759369,BGGN 271,113,967935,Spitzer; Nicholas,9999,0,9999,0
1748424759369,BGGN 271,114,967936,Steinmetz; Nicole F,9999,0,9999,0
1748424759369,BGGN 271,115,967938,Su; Chih-Ying,9999,0,9999,0
1748424759369,BGGN 271,116,967939,Telese; Francesca,9999,0,9999,0
1748424759369,BGGN 271,117,967942,Towers; Christina Garlingt,9999,0,9999,0
1748424759369,BGGN 271,118,967943,Tye; Kay M,9999,0,9999,0
1748424759369,BGGN 271,119,967945,Wahlin; Karl Jonas,9997,0,9999,2
1748424759369,BGGN 271,120,967947,Wang; Shizhen,9999,0,9999,0
1748424759369,BGGN 271,121,967949,Wang; Jean Yin Jen,9999,0,9999,0
1748424759369,BGGN 271,122,967952,Webster; Nicholas J G,9999,0,9999,0
1748424759369,BGGN 271,123,967953,Weiskopf; Daniela,9998,0,9999,1
1748424759369,BGGN 271,124,967954,Welsbie; Derek,9999,0,9999,0
1748424759369,BGGN 271,125,967956,Wildonger; Jill Cathleen,9999,0,9999,0
1748424759369,BGGN 271,126,967957,Yelon; Deborah,9999,0,9999,0
1748424759369,BGGN 271,127,967958,Yeo; Eugene Wei-Ming,9998,0,9999,1
1748424759369,BGGN 271,128,967959,Ying; Wei,9998,0,9999,1
1748424759369,BGGN 271,129,967960,Young; Jared W.,9999,0,9999,0
1748424759369,BGGN 271,130,967961,Zage; Peter,9999,0,9999,0
1748424759369,BGGN 271,131,967962,Zengler; Karsten B,9999,0,9999,0
1748424759369,BGGN 271,132,967963,Zhang; Jin,9999,0,9999,0
1748424759369,BGGN 271,133,967964,Zhao; Yunde,9999,0,9999,0
1748424759369,BGGN 271,134,967965,Zheng; Ye,9998,0,9999,1
1748424759369,BGGN 271,135,967966,Zhou; Huilin,9998,0,9999,1
1748424759369,BGGN 271,136,967970,Zou; Yimin,9998,0,9999,1
1748424760455,BGGN 272,A00,943373,Lo; Stanley M.,14,0,15,1
1748424761486,BGGN 275,A00,943374,Pogliano; Joseph,0,0,0,0
1748424762512,BGGN 276,A00,943378,Pogliano; Joseph,0,0,0,0
1748424763543,BGJC 204,A00,943407,Lu; Li-Fan & Chang; John Tzu-yu,9998,0,9999,1
1748424764574,BGJC 215,A00,943417,Tour; Ella,9,0,10,1
1748424765822,BGRD 200,001,965406,Akbari; Omar Sultan,9999,0,9999,0
1748424765822,BGRD 200,002,965407,Allen; Eric,9999,0,9999,0
1748424765822,BGRD 200,003,965408,Allen; Nicola J,9998,0,9999,1
1748424765822,BGRD 200,004,965427,Alperin; Mariann,9999,0,9999,0
1748424765822,BGRD 200,005,965428,Amaro; Rommie E,9998,0,9999,1
1748424765822,BGRD 200,006,965429,Antal; Corina Elena,9998,0,9999,1
1748424765822,BGRD 200,007,965731,Asahina; Kenta,9999,0,9999,0
1748424765822,BGRD 200,008,965732,Augustine; Vineet,9999,0,9999,0
1748424765822,BGRD 200,009,965733,Ayres; Janelle Samantha,9998,0,9999,1
1748424765822,BGRD 200,010,965734,Banghart; Matthew Ryan,9999,0,9999,0
1748424765822,BGRD 200,011,965735,Barton; Andrew David,9999,0,9999,0
1748424765822,BGRD 200,012,965736,Bayless; Daniel Wilson,9999,0,9999,0
1748424765822,BGRD 200,013,965737,Benna; Marcus K,9999,0,9999,0
1748424765822,BGRD 200,014,965738,Bennett; Eric J,9999,0,9999,0
1748424765822,BGRD 200,015,965739,Bier; Ethan,9999,0,9999,0
1748424765822,BGRD 200,016,965740,Bloodgood; Brenda Laurie,9999,0,9999,0
1748424765822,BGRD 200,017,965741,Boss; Gerard R.,9999,0,9999,0
1748424765822,BGRD 200,018,966029,Bouvet; Michael,9999,0,9999,0
1748424765822,BGRD 200,019,966054,Breen; Ellen C.,9999,0,9999,0
1748424765822,BGRD 200,020,966072,Bui; Jack D,9999,0,9999,0
1748424765822,BGRD 200,021,966073,Burnett; Lindsey,9998,0,9999,1
1748424765822,BGRD 200,022,966080,Caffrey; Conor,9999,0,9999,0
1748424765822,BGRD 200,023,966082,Callaway; Edward M,9999,0,9999,0
1748424765822,BGRD 200,024,966087,Castle; Michael James,9999,0,9999,0
1748424765822,BGRD 200,025,966089,Chaim; Isaac,9999,0,9999,0
1748424765822,BGRD 200,026,966092,Chang; John Tzu-yu,9999,0,9999,0
1748424765822,BGRD 200,027,966094,Chen; Xu,9999,0,9999,0
1748424765822,BGRD 200,028,966095,Cheng; Christine Shiang-Ling,9999,0,9999,0
1748424765822,BGRD 200,029,966099,Cheresh; David A.,9999,0,9999,0
1748424765822,BGRD 200,030,966103,Cherqui; Stephanie,9999,0,9999,0
1748424765822,BGRD 200,031,966104,Chu; Hiutung,9999,0,9999,0
1748424765822,BGRD 200,032,966107,Church; Kellie Breen,9999,0,9999,0
1748424765822,BGRD 200,033,966108,Cleland; Elsa Eleanor,9997,0,9999,2
1748424765822,BGRD 200,034,966111,Cohen; Shiran,9999,0,9999,0
1748424765822,BGRD 200,035,966112,Cooper; Kimberly Lynn,9999,0,9999,0
1748424765822,BGRD 200,036,966114,Coufal; Nicole Gabriele,9999,0,9999,0
1748424765822,BGRD 200,037,966115,Croker; Ben Adam,9999,0,9999,0
1748424765822,BGRD 200,038,966116,Crotty Alexander; Laura E,9999,0,9999,0
1748424765822,BGRD 200,039,966117,Daugherty; Matthew Dorton,9997,0,9999,2
1748424765822,BGRD 200,040,966118,De Silva; Shermin,9998,0,9999,1
1748424765822,BGRD 200,041,966119,Desai; Arshad,9999,0,9999,0
1748424765822,BGRD 200,042,966120,Dhar; Debanjan,9999,0,9999,0
1748424765822,BGRD 200,043,966121,Dickinson; Alexandra Jazz,9999,0,9999,0
1748424765822,BGRD 200,044,966123,Dixon; Jesse,9999,0,9999,0
1748424765822,BGRD 200,045,966125,Doherty; Taylor Alan,9998,0,9999,1
1748424765822,BGRD 200,046,966128,Dore; Kim Bohemie,9999,0,9999,0
1748424765822,BGRD 200,047,966129,Dorrestein; Pieter,9999,0,9999,0
1748424765822,BGRD 200,048,966130,Dulawa; Stephanie Carole,9999,0,9999,0
1748424765822,BGRD 200,049,966131,Ecker; Joseph R,9999,0,9999,0
1748424765822,BGRD 200,050,966174,Engle; Dannielle D,9998,0,9999,1
1748424765822,BGRD 200,051,966179,Ernst; Andreas,9999,0,9999,0
1748424765822,BGRD 200,052,966182,Esko; Jeffrey D.,9999,0,9999,0
1748424765822,BGRD 200,053,966183,Fang; Xi,9999,0,9999,0
1748424765822,BGRD 200,054,966184,Farley; Emma Kristen,9998,0,9999,1
1748424765822,BGRD 200,055,966187,Ferguson; Cole John,9999,0,9999,0
1748424765822,BGRD 200,056,966190,Fisch; Kathleen Marie,9999,0,9999,0
1748424765822,BGRD 200,057,966193,Gage; Fred H,9999,0,9999,0
1748424765822,BGRD 200,058,966194,George; Monique Leana,9998,0,9999,1
1748424765822,BGRD 200,059,966196,George; Olivier,9999,0,9999,0
1748424765822,BGRD 200,060,966202,Ghosh; Pradipta,9998,0,9999,1
1748424765822,BGRD 200,061,966203,Glasgow; Stacey Marie,9999,0,9999,0
1748424765822,BGRD 200,062,966204,Glass; Christopher,9999,0,9999,0
1748424765822,BGRD 200,063,966226,Golden; James W,9999,0,9999,0
1748424765822,BGRD 200,064,966231,Goldrath; Ananda,9999,0,9999,0
1748424765822,BGRD 200,065,966232,Gonzalez Gamboa; Ivonne,9999,0,9999,0
1748424765822,BGRD 200,066,966233,Goren; Alon M,9999,0,9999,0
1748424765822,BGRD 200,067,966245,Guatelli; John C,9999,0,9999,0
1748424765822,BGRD 200,068,966247,Guma; Monica,9998,0,9999,1
1748424765822,BGRD 200,069,966253,Gustafsson; Asa Birgitta,9999,0,9999,0
1748424765822,BGRD 200,070,966255,Gutkind; Jorge Silvio,9998,0,9999,1
1748424765822,BGRD 200,071,966260,Hamdoun; Amr,9999,0,9999,0
1748424765822,BGRD 200,072,966262,Hampton; Randolph Y.,9998,0,9999,1
1748424765822,BGRD 200,073,966263,Hao; Nan,9999,0,9999,0
1748424765822,BGRD 200,074,966265,Hargreaves; Diana Clare,9997,0,9999,2
1748424765822,BGRD 200,075,966268,Hasty; Jeff M,9999,0,9999,0
1748424765822,BGRD 200,076,966270,Hollern; Daniel Patrick,9999,0,9999,0
1748424765822,BGRD 200,077,966271,Holway; David A.,9998,0,9999,1
1748424765822,BGRD 200,078,966272,Huffaker; Alisa,9999,0,9999,0
1748424765822,BGRD 200,079,966273,Hui; Enfu,9999,0,9999,0
1748424765822,BGRD 200,080,966275,Hwa; Terence T.,9999,0,9999,0
1748424765822,BGRD 200,081,966276,Jackrel; Sara,9998,0,9999,1
1748424765822,BGRD 200,082,966277,Jiang; Qingfei,9998,0,9999,1
1748424765822,BGRD 200,083,966281,Jin; Chunyu,9999,0,9999,0
1748424765822,BGRD 200,084,966283,Jin; Yishi,9999,0,9999,0
1748424765822,BGRD 200,085,966287,Joshi; Shweta,9999,0,9999,0
1748424765822,BGRD 200,086,966290,Ju; Won-Kyu,9998,0,9999,1
1748424765822,BGRD 200,087,966291,Jun; Suckjoon,9999,0,9999,0
1748424765822,BGRD 200,088,966292,Kadonaga; James T,9999,0,9999,0
1748424765822,BGRD 200,089,966293,Kaech; Susan Michelle,9999,0,9999,0
1748424765822,BGRD 200,090,966295,Kauffman; Alexander,9998,0,9999,1
1748424765822,BGRD 200,091,966301,Kendrick; Agnieszka Anasta,9999,0,9999,0
1748424765822,BGRD 200,092,966302,Kiger; Amy,9999,0,9999,0
1748424765822,BGRD 200,093,966314,Knight; Robin,9999,0,9999,0
1748424765822,BGRD 200,094,966315,Koloski; Miranda Jane,9998,0,9999,1
1748424765822,BGRD 200,095,966339,Komiyama; Takaki,9998,0,9999,1
1748424765822,BGRD 200,096,966351,Kosuri; Pallav,9999,0,9999,0
1748424765822,BGRD 200,097,966361,Kronenberg; Mitchell E.,9999,0,9999,0
1748424765822,BGRD 200,098,966374,Kryazhimskiy; Sergey A,9999,0,9999,0
1748424765822,BGRD 200,099,966377,Kufareva; Irina,9999,0,9999,0
1748424765822,BGRD 200,100,966380,Lee; Christopher Tingkuang,9999,0,9999,0
1748424765822,BGRD 200,101,966383,Lee; Kuo Fen,9999,0,9999,0
1748424765822,BGRD 200,102,966387,Lee; Yun Sok,9999,0,9999,0
1748424765822,BGRD 200,103,966397,Leutgeb; Jill K.,9999,0,9999,0
1748424765822,BGRD 200,104,966446,Leutgeb; Stefan,9998,0,9999,1
1748424765822,BGRD 200,105,966478,Lewis; Warren G.,9999,0,9999,0
1748424765822,BGRD 200,106,966490,Li; Willis Xiaowei,9998,0,9999,1
1748424765822,BGRD 200,107,966491,Lim; Byungkook,9998,0,9999,1
1748424765822,BGRD 200,108,966494,Lo; Stanley M.,9998,0,9999,1
1748424765822,BGRD 200,109,966499,Looger; Loren Lee,9998,0,9999,1
1748424765822,BGRD 200,110,966500,Lopez Ramirez; Miguel Alej,9999,0,9999,0
1748424765822,BGRD 200,111,966510,Lovett-Barron; Matthew Rod,9998,0,9999,1
1748424765822,BGRD 200,112,966513,Lu; Li-Fan,9998,0,9999,1
1748424765822,BGRD 200,113,966515,Lu; Pengzhe,9999,0,9999,0
1748424765822,BGRD 200,114,966522,Lykke-Andersen; Jens,9999,0,9999,0
1748424765822,BGRD 200,115,966526,Lyons; Deirdre Colleen,9999,0,9999,0
1748424765822,BGRD 200,116,966528,Lyumkis; Dmitry Evgenievich,9999,0,9999,0
1748424765822,BGRD 200,117,966531,Mandyam; Chitra,9999,0,9999,0
1748424765822,BGRD 200,118,966537,Manor; Uri,9999,0,9999,0
1748424765822,BGRD 200,119,966538,Mayfield; Stephen P.,9998,0,9999,1
1748424765822,BGRD 200,120,966539,McConville; Patrick James,9999,0,9999,0
1748424765822,BGRD 200,121,966546,Mertens; Jerome Stefan,9999,0,9999,0
1748424765822,BGRD 200,122,966586,Meyer; Justin Raymond,9999,0,9999,0
1748424765822,BGRD 200,123,966587,Morris; Gerald P,9999,0,9999,0
1748424765822,BGRD 200,124,966588,Mueller; Lena,9998,0,9999,1
1748424765822,BGRD 200,125,966590,Muroyama; Andrew David,9999,0,9999,0
1748424765822,BGRD 200,126,966591,Murre; Cornelis,9999,0,9999,0
1748424765822,BGRD 200,127,966593,Neal; Sonya E,9998,0,9999,1
1748424765822,BGRD 200,128,966594,Newton; Alexandra C.,9999,0,9999,0
1748424765822,BGRD 200,129,966596,Nieh; James Charles,9999,0,9999,0
1748424765822,BGRD 200,130,966597,Niwa; Maho,9999,0,9999,0
1748424765822,BGRD 200,131,966605,Nizet; Victor F.,9999,0,9999,0
1748424765822,BGRD 200,132,966606,Oegema; Karen,9999,0,9999,0
1748424765822,BGRD 200,133,966608,Panda; Satchidananda,9998,0,9999,1
1748424765822,BGRD 200,134,966610,Pantham; Priyadarshini,9999,0,9999,0
1748424765822,BGRD 200,135,966612,Parast; Mana,9999,0,9999,0
1748424765822,BGRD 200,136,966613,Pasquinelli; Amy,9999,0,9999,0
1748424765822,BGRD 200,137,966615,Pekkurnaz Banghart; Gulcin,9999,0,9999,0
1748424765822,BGRD 200,138,966639,Perry; Michael William,9998,0,9999,1
1748424765822,BGRD 200,139,966640,Pillus; Lorraine,9998,0,9999,1
1748424765822,BGRD 200,140,966654,Pogliano; Joseph,9999,0,9999,0
1748424765822,BGRD 200,141,966700,Pogliano; Kit J.,9999,0,9999,0
1748424765822,BGRD 200,142,966701,Pruneda-Paz; Jose L.,9999,0,9999,0
1748424765822,BGRD 200,143,966744,Raffatellu; Manuela,9999,0,9999,0
1748424765822,BGRD 200,144,966745,Ramanan; Deepshika,9998,0,9999,1
1748424765822,BGRD 200,145,966746,Rana; Tariq,9999,0,9999,0
1748424765822,BGRD 200,146,966747,Rao; Anjana,9999,0,9999,0
1748424765822,BGRD 200,147,966811,Raz; Eyal,9998,0,9999,1
1748424765822,BGRD 200,149,966817,Gaulton; Kyle J,9999,0,9999,0
1748424765822,BGRD 200,150,966824,Rennison; Diana,9999,0,9999,0
1748424765822,BGRD 200,151,966828,Reyes De Barboza; Nabora S,9999,0,9999,0
1748424765822,BGRD 200,152,966837,Rifkin; Scott,9998,0,9999,1
1748424765822,BGRD 200,153,966839,Risbrough; Victoria Blythe,9999,0,9999,0
1748424765822,BGRD 200,154,966846,Rivera; Fabian Chavez,9999,0,9999,0
1748424765822,BGRD 200,155,966851,Rohner; Patrick Thomas,9999,0,9999,0
1748424765822,BGRD 200,156,966859,Rose; Noah Hartmann,9999,0,9999,0
1748424765822,BGRD 200,157,966874,Rosenfeld; Michael G,9999,0,9999,0
1748424765822,BGRD 200,158,966882,Rouse; Gregory W.,9999,0,9999,0
1748424765822,BGRD 200,159,966885,Saier; Milton H.,9999,0,9999,0
1748424765822,BGRD 200,160,966923,Saltiel; Alan,9998,0,9999,1
1748424765822,BGRD 200,161,966926,Sanchez-Lopez; Elsa,9999,0,9999,0
1748424765822,BGRD 200,162,966927,Saphire; Erica Ollmann,9999,0,9999,0
1748424765822,BGRD 200,163,966931,Schenk; Simon,9999,0,9999,0
1748424765822,BGRD 200,164,966938,Schroeder; Julian I,9999,0,9999,0
1748424765822,BGRD 200,165,966966,Sebat; Lilia Mikhailovna,9999,0,9999,0
1748424765822,BGRD 200,166,966978,Sen; George L,9999,0,9999,0
1748424765822,BGRD 200,167,966981,Shah; Sameer B,9999,0,9999,0
1748424765822,BGRD 200,168,966982,Shaner; Nathan C.,9999,0,9999,0
1748424765822,BGRD 200,169,966983,Shao; Jianhua,9999,0,9999,0
1748424765822,BGRD 200,170,966984,Sharpee; Tatyana,9999,0,9999,0
1748424765822,BGRD 200,171,966985,Shaw; Reuben,9999,0,9999,0
1748424765822,BGRD 200,172,966986,Shurin; Jonathan,9997,0,9999,2
1748424765822,BGRD 200,173,966987,Sicklick; Jason Keith,9999,0,9999,0
1748424765822,BGRD 200,174,966988,Signer; Robert,9999,0,9999,0
1748424765822,BGRD 200,175,966989,Sigurdson; Christina,9999,0,9999,0
1748424765822,BGRD 200,176,966991,Simonson; Tatum Sasha Summ,9999,0,9999,0
1748424765822,BGRD 200,177,966992,Soncin; Francesca,9999,0,9999,0
1748424765822,BGRD 200,178,966993,Spitzer; Nicholas,9999,0,9999,0
1748424765822,BGRD 200,179,966994,Steinmetz; Nicole F,9999,0,9999,0
1748424765822,BGRD 200,180,966995,Su; Chih-Ying,9999,0,9999,0
1748424765822,BGRD 200,181,966996,Suel; Gurol Mehmet,9998,0,9999,1
1748424765822,BGRD 200,182,966997,Sun; Xin,9998,0,9999,1
1748424765822,BGRD 200,183,966998,Telese; Francesca,9998,0,9999,1
1748424765822,BGRD 200,184,966999,Towers; Christina Garlingt,9999,0,9999,0
1748424765822,BGRD 200,185,967000,Traver; David,9999,0,9999,0
1748424765822,BGRD 200,186,967001,Troemel; Emily Ruth,9998,0,9999,1
1748424765822,BGRD 200,187,967002,Tye; Kay M,9999,0,9999,0
1748424765822,BGRD 200,188,967003,Vijayanand; Pandurangan,9999,0,9999,0
1748424765822,BGRD 200,189,967004,Villa Rodriguez; Elizabeth,9999,0,9999,0
1748424765822,BGRD 200,190,967005,Wahlin; Karl Jonas,9997,0,9999,2
1748424765822,BGRD 200,191,967009,Wang; Shizhen,9999,0,9999,0
1748424765822,BGRD 200,192,967010,Wang; Jean Yin Jen,9999,0,9999,0
1748424765822,BGRD 200,193,967011,Webster; Nicholas J G,9999,0,9999,0
1748424765822,BGRD 200,194,967016,Weiskopf; Daniela,9998,0,9999,1
1748424765822,BGRD 200,195,967020,Welsbie; Derek,9999,0,9999,0
1748424765822,BGRD 200,196,967022,Wildonger; Jill Cathleen,9998,0,9999,1
1748424765822,BGRD 200,197,967027,Winzeler; Elizabeth A,9998,0,9999,1
1748424765822,BGRD 200,198,967029,Wodarz; Dominik Franz Xave,9999,0,9999,0
1748424765822,BGRD 200,199,967033,Yelon; Deborah,9998,0,9999,1
1748424765822,BGRD 200,200,967034,Yeo; Eugene Wei-Ming,9998,0,9999,1
1748424765822,BGRD 200,201,967040,Ying; Wei,9998,0,9999,1
1748424765822,BGRD 200,202,967052,Young; Jared W.,9999,0,9999,0
1748424765822,BGRD 200,203,967057,Zage; Peter,9999,0,9999,0
1748424765822,BGRD 200,204,967070,Zengler; Karsten B,9998,0,9999,1
1748424765822,BGRD 200,206,967081,Zhang; Jin,9999,0,9999,0
1748424765822,BGRD 200,207,967083,Zhao; Yunde,9999,0,9999,0
1748424765822,BGRD 200,208,967086,Zheng; Binhai,9999,0,9999,0
1748424765822,BGRD 200,209,967091,Zheng; Ye,9999,0,9999,0
1748424765822,BGRD 200,210,967093,Zhou; Huilin,9999,0,9999,0
1748424765822,BGRD 200,211,967095,Zou; Yimin,9998,0,9999,1
1748424765822,BGRD 200,212,967096,Zuniga; Elina I,9999,0,9999,0
1748424765822,BGRD 200,213,967978,Biering; Scott,9999,0,9999,0
1748424766850,BGSE 200,A00,943418,Tour; Ella & Petrie; Katherine Lynn,9999,0,9999,0
1748424767889,BGSE 205,A00,943419,Muroyama; Andrew David,46,0,50,4
1748424767889,BGSE 205,C00,943420,Russell; Alistair B,44,0,50,6
1748424767889,BGSE 205,D00,943421,Villa Rodriguez; Elizabeth,41,0,50,9
1748424767889,BGSE 205,E00,960271,Lim; Byungkook,45,0,50,5
1748424768921,BIBC 100,A01,959758,Flagg; Matthew Paul,0,0,38,38
1748424768921,BIBC 100,A02,959759,Flagg; Matthew Paul,0,0,38,38
1748424768921,BIBC 100,A03,959760,Flagg; Matthew Paul,0,0,38,38
1748424768921,BIBC 100,A04,959761,Flagg; Matthew Paul,0,0,36,36
1748424769958,BIBC 102,A01,959209,Pekkurnaz Banghart; Gulcin,0,0,34,34
1748424769958,BIBC 102,A02,959258,Pekkurnaz Banghart; Gulcin,0,0,34,34
1748424769958,BIBC 102,A03,959300,Pekkurnaz Banghart; Gulcin,0,0,35,35
1748424769958,BIBC 102,A04,959302,Pekkurnaz Banghart; Gulcin,0,0,34,34
1748424769958,BIBC 102,B01,959307,Pekkurnaz Banghart; Gulcin,0,0,34,34
1748424769958,BIBC 102,B02,959309,Pekkurnaz Banghart; Gulcin,0,0,34,34
1748424769958,BIBC 102,B03,959310,Pekkurnaz Banghart; Gulcin,0,0,33,33
1748424769958,BIBC 102,B04,959311,Pekkurnaz Banghart; Gulcin,0,0,34,34
1748424770997,BIBC 103,A01,942080,Grossman; Emily N,0,0,24,24
1748424770997,BIBC 103,A02,942081,Grossman; Emily N,0,0,24,24
1748424770997,BIBC 103,B01,942083,Grossman; Emily N,0,0,24,24
1748424770997,BIBC 103,B02,942129,Grossman; Emily N,0,0,24,24
1748424770997,BIBC 103,C01,942131,Burg; Michael,0,0,24,24
1748424770997,BIBC 103,C02,942152,Burg; Michael,0,0,24,24
1748424770997,BIBC 103,D01,942169,Burg; Michael,0,0,24,24
1748424770997,BIBC 103,D02,942170,Burg; Michael,0,0,24,24
1748424772025,BICD 100,A01,959831,Day; Christopher D,53,0,61,8
1748424772025,BICD 100,A02,959832,Day; Christopher D,49,0,61,12
1748424772025,BICD 100,A03,959833,Day; Christopher D,43,0,61,18
1748424772025,BICD 100,A04,959834,Day; Christopher D,57,0,61,4
1748424772025,BICD 100,B01,959749,McDonnell; Lisa Marie,0,0,61,61
1748424772025,BICD 100,B02,959750,McDonnell; Lisa Marie,0,0,61,61
1748424772025,BICD 100,B03,959751,McDonnell; Lisa Marie,0,0,61,61
1748424772025,BICD 100,B04,959752,McDonnell; Lisa Marie,37,0,61,24
1748424772025,BICD 100,C01,959835,Yelon; Deborah,0,0,61,61
1748424772025,BICD 100,C02,959836,Yelon; Deborah,54,0,61,7
1748424772025,BICD 100,C03,959837,Yelon; Deborah,61,0,61,0
1748424772025,BICD 100,C04,959838,Yelon; Deborah,57,0,61,4
1748424773058,BICD 110,A01,959312,Kiger; Amy,59,0,123,64
1748424773058,BICD 110,A02,959315,Kiger; Amy,94,0,122,28
1748424774085,BICD 130,A01,942207,Perry; Michael William,0,0,48,48
1748424774085,BICD 130,A02,942208,Perry; Michael William,37,0,48,11
1748424774085,BICD 130,A03,942209,Perry; Michael William,29,0,48,19
1748424774085,BICD 130,A04,942236,Perry; Michael William,19,0,48,29
1748424775113,BICD 140,A01,942372,Zuniga; Elina I,42,0,49,7
1748424775113,BICD 140,A02,942492,Zuniga; Elina I,45,0,49,4
1748424775113,BICD 140,A03,942493,Zuniga; Elina I,48,0,49,1
1748424775113,BICD 140,A04,942494,Zuniga; Elina I,46,0,49,3
1748424776146,BIEB 102,A01,942496,Butler; Shannon Rhey,182,0,248,66
1748424777175,BIEB 121,A00,942497,Holway; David A.,0,0,32,32
1748424777175,BIEB 121,B00,942498,Butler; Shannon Rhey,0,0,32,32
1748424778204,BIEB 141,A01,942500,Kryazhimskiy; Sergey A,23,0,40,17
1748424779229,BIEB 146,A01,942502,Petrie; Katherine Lynn,41,0,89,48
1748424779229,BIEB 146,A02,942503,Petrie; Katherine Lynn,0,0,88,88
1748424779229,BIEB 146,A03,942504,Petrie; Katherine Lynn,2,0,88,86
1748424779229,BIEB 146,A04,942505,Petrie; Katherine Lynn,21,0,89,68
1748424780256,BIEB 150,A01,942507,Rennison; Diana,28,0,41,13
1748424780256,BIEB 150,A02,942508,Rennison; Diana,32,0,41,9
1748424780256,BIEB 150,A03,942509,Rennison; Diana,36,0,41,5
1748424780256,BIEB 150,A04,942510,Rennison; Diana,6,0,40,34
1748424781286,BIEB 174,A01,942512,Cleland; Elsa Eleanor & Barton; Andrew David,9,0,41,32
1748424781286,BIEB 174,A02,942513,Cleland; Elsa Eleanor & Barton; Andrew David,37,0,41,4
1748424781286,BIEB 174,A03,942514,Cleland; Elsa Eleanor & Barton; Andrew David,35,0,41,6
1748424781286,BIEB 174,A04,942515,Cleland; Elsa Eleanor & Barton; Andrew David,30,0,40,10
1748424782323,BILD 1,A01,959729,Ochoa Mikrut; Stacy Daniel,50,0,60,10
1748424782323,BILD 1,A02,959730,Ochoa Mikrut; Stacy Daniel,47,0,59,12
1748424782323,BILD 1,A03,959731,Ochoa Mikrut; Stacy Daniel,48,0,59,11
1748424782323,BILD 1,A04,959732,Ochoa Mikrut; Stacy Daniel,50,0,59,9
1748424782323,BILD 1,B01,959733,Cooper; Andrew Michael,46,0,60,14
1748424782323,BILD 1,B02,959734,Cooper; Andrew Michael,58,0,59,1
1748424782323,BILD 1,B03,959735,Cooper; Andrew Michael,54,0,59,5
1748424782323,BILD 1,B04,959736,Cooper; Andrew Michael,50,0,59,9
1748424782323,BILD 1,C01,959737,Rusert; Jessica Marie,58,0,60,2
1748424782323,BILD 1,C02,959738,Rusert; Jessica Marie,59,0,59,0
1748424782323,BILD 1,C03,959739,Rusert; Jessica Marie,49,0,59,10
1748424782323,BILD 1,C04,959740,Rusert; Jessica Marie,55,0,59,4
1748424783355,BILD 2,A01,959013,Reyes Gonzalez; Catalina,28,0,57,29
1748424783355,BILD 2,A02,959016,Reyes Gonzalez; Catalina,51,0,57,6
1748424783355,BILD 2,A03,959017,Reyes Gonzalez; Catalina,46,0,56,10
1748424783355,BILD 2,A04,959018,Reyes Gonzalez; Catalina,51,0,55,4
1748424783355,BILD 2,B01,959078,Reyes Gonzalez; Catalina,42,0,57,15
1748424783355,BILD 2,B02,959095,Reyes Gonzalez; Catalina,50,0,57,7
1748424783355,BILD 2,B03,959165,Reyes Gonzalez; Catalina,55,0,56,1
1748424783355,BILD 2,B04,959169,Reyes Gonzalez; Catalina,54,0,55,1
1748424784388,BILD 3,A01,959741,Stockwell; Sarah R,56,0,60,4
1748424784388,BILD 3,A02,959742,Stockwell; Sarah R,57,0,59,2
1748424784388,BILD 3,A03,959743,Stockwell; Sarah R,59,0,59,0
1748424784388,BILD 3,A04,959744,Stockwell; Sarah R,55,0,59,4
1748424784388,BILD 3,B01,959745,Stockwell; Sarah R,55,0,60,5
1748424784388,BILD 3,B02,959746,Stockwell; Sarah R,59,0,59,0
1748424784388,BILD 3,B03,959747,Stockwell; Sarah R,56,0,59,3
1748424784388,BILD 3,B04,959748,Stockwell; Sarah R,58,0,59,1
1748424784388,BILD 3,C01,959823,Hammond; LaTisha Marie,47,0,60,13
1748424784388,BILD 3,C02,959824,Hammond; LaTisha Marie,48,0,59,11
1748424784388,BILD 3,C03,959825,Hammond; LaTisha Marie,56,0,59,3
1748424784388,BILD 3,C04,959826,Hammond; LaTisha Marie,58,0,59,1
1748424784388,BILD 3,D01,959827,Hammond; LaTisha Marie,43,0,60,17
1748424784388,BILD 3,D02,959828,Hammond; LaTisha Marie,49,0,59,10
1748424784388,BILD 3,D03,959829,Hammond; LaTisha Marie,52,0,59,7
1748424784388,BILD 3,D04,959830,Hammond; LaTisha Marie,56,0,59,3
1748424785436,BILD 4,A01,940749,Gonzalez Gamboa; Ivonne,0,0,0,0
1748424785436,BILD 4,A02,940750,Gonzalez Gamboa; Ivonne,0,0,0,0
1748424785436,BILD 4,A03,940909,Gonzalez Gamboa; Ivonne,0,0,0,0
1748424785436,BILD 4,A04,940922,Gonzalez Gamboa; Ivonne,0,0,0,0
1748424785436,BILD 4,A05,940925,Gonzalez Gamboa; Ivonne,0,0,0,0
1748424785436,BILD 4,A06,941008,Gonzalez Gamboa; Ivonne,0,0,0,0
1748424785436,BILD 4,A07,941009,Gonzalez Gamboa; Ivonne,0,0,0,0
1748424785436,BILD 4,A08,941114,Gonzalez Gamboa; Ivonne,0,0,0,0
1748424785436,BILD 4,B01,941116,Reuther; Keefe,0,0,0,0
1748424785436,BILD 4,B02,941119,Reuther; Keefe,0,0,0,0
1748424785436,BILD 4,B03,941120,Reuther; Keefe,0,0,0,0
1748424785436,BILD 4,B04,941143,Reuther; Keefe,0,0,0,0
1748424785436,BILD 4,B05,941182,Reuther; Keefe,0,0,0,0
1748424785436,BILD 4,B06,941183,Reuther; Keefe,0,0,0,0
1748424785436,BILD 4,B07,941184,Reuther; Keefe,0,0,0,0
1748424785436,BILD 4,B08,941202,Reuther; Keefe,0,0,0,0
1748424785436,BILD 4,C01,941209,Lo; Stanley M.,0,0,0,0
1748424785436,BILD 4,C02,941226,Lo; Stanley M.,0,0,0,0
1748424785436,BILD 4,C03,941228,Lo; Stanley M.,0,0,0,0
1748424785436,BILD 4,C04,941284,Lo; Stanley M.,0,0,0,0
1748424785436,BILD 4,C05,941394,Lo; Stanley M.,0,0,0,0
1748424785436,BILD 4,C06,941473,Lo; Stanley M.,0,0,0,0
1748424785436,BILD 4,C07,941905,Lo; Stanley M.,0,0,0,0
1748424785436,BILD 4,C08,941906,Lo; Stanley M.,0,0,0,0
1748424785436,BILD 4,D01,941908,Lo; Stanley M.,0,0,0,0
1748424785436,BILD 4,D02,941925,Lo; Stanley M.,0,0,0,0
1748424785436,BILD 4,D03,941926,Lo; Stanley M.,0,0,0,0
1748424785436,BILD 4,D04,941927,Lo; Stanley M.,0,0,0,0
1748424785436,BILD 4,D05,941928,Lo; Stanley M.,0,0,0,0
1748424785436,BILD 4,D06,941943,Lo; Stanley M.,0,0,0,0
1748424785436,BILD 4,D07,941944,Lo; Stanley M.,0,0,0,0
1748424785436,BILD 4,D08,941973,Lo; Stanley M.,0,0,0,0
1748424786466,BILD 5,A01,959177,Mueller; Liam O'Connor,0,0,0,0
1748424786466,BILD 5,A02,959178,Mueller; Liam O'Connor,0,0,0,0
1748424786466,BILD 5,A03,959179,Mueller; Liam O'Connor,0,0,0,0
1748424786466,BILD 5,A04,959181,Mueller; Liam O'Connor,0,0,0,0
1748424786466,BILD 5,B01,959183,Mueller; Liam O'Connor,0,0,0,0
1748424786466,BILD 5,B02,959184,Mueller; Liam O'Connor,0,0,0,0
1748424786466,BILD 5,B03,959188,Mueller; Liam O'Connor,0,0,0,0
1748424786466,BILD 5,B04,959189,Mueller; Liam O'Connor,0,0,0,0
1748424786466,BILD 5,C01,959190,Reuther; Keefe,0,0,0,0
1748424786466,BILD 5,C02,959191,Reuther; Keefe,0,0,0,0
1748424786466,BILD 5,C03,959196,Reuther; Keefe,0,0,0,0
1748424786466,BILD 5,C04,959199,Reuther; Keefe,0,0,0,0
1748424787494,BILD 10,A01,942020,Ochoa Mikrut; Stacy Daniel,40,0,40,0
1748424787494,BILD 10,A02,942033,Ochoa Mikrut; Stacy Daniel,35,0,39,4
1748424787494,BILD 10,A03,942045,Ochoa Mikrut; Stacy Daniel,32,0,39,7
1748424787494,BILD 10,A04,942046,Ochoa Mikrut; Stacy Daniel,30,0,39,9
1748424788525,BILD 87,A00,942047,Saier; Milton H.,20,0,20,0
1748424788525,BILD 87,B00,942060,Saier; Milton H.,20,0,20,0
1748424789555,BIMM 100,A01,959797,Lykke-Andersen; Jens,37,0,50,13
1748424789555,BIMM 100,A02,959798,Lykke-Andersen; Jens,5,0,50,45
1748424789555,BIMM 100,A03,959799,Lykke-Andersen; Jens,0,0,50,50
1748424789555,BIMM 100,A04,959800,Lykke-Andersen; Jens,3,0,50,47
1748424789555,BIMM 100,B01,959807,Pruneda-Paz; Jose L.,1,0,50,49
1748424789555,BIMM 100,B02,959808,Pruneda-Paz; Jose L.,0,0,50,50
1748424789555,BIMM 100,B03,959809,Pruneda-Paz; Jose L.,7,0,50,43
1748424789555,BIMM 100,B04,959810,Pruneda-Paz; Jose L.,37,0,50,13
1748424789555,BIMM 100,C01,959762,Pasquinelli; Amy,0,0,54,54
1748424789555,BIMM 100,C02,959763,Pasquinelli; Amy,20,0,54,34
1748424789555,BIMM 100,C03,959764,Pasquinelli; Amy,32,0,54,22
1748424789555,BIMM 100,C04,959765,Pasquinelli; Amy,47,0,54,7
1748424790585,BIMM 101,A01,942520,Meaders; Clara Leigh,0,0,24,24
1748424790585,BIMM 101,A02,942521,Meaders; Clara Leigh,0,0,24,24
1748424790585,BIMM 101,B01,942523,Meaders; Clara Leigh,0,0,24,24
1748424790585,BIMM 101,B02,942524,Meaders; Clara Leigh,0,0,24,24
1748424790585,BIMM 101,C01,942690,McDonnell; Lisa Marie,0,0,24,24
1748424790585,BIMM 101,C02,942755,McDonnell; Lisa Marie,0,0,24,24
1748424790585,BIMM 101,D01,942757,Day; Christopher D,0,0,24,24
1748424790585,BIMM 101,D02,942758,Day; Christopher D,12,0,24,12
1748424790585,BIMM 101,E01,942760,Cooper; Andrew Michael,0,0,24,24
1748424790585,BIMM 101,E02,942761,Cooper; Andrew Michael,0,0,24,24
1748424790585,BIMM 101,F01,942763,Rusert; Jessica Marie,14,0,24,10
1748424790585,BIMM 101,F02,942764,Rusert; Jessica Marie,19,0,24,5
1748424791611,BIMM 120,A01,942766,Saier; Milton H.,40,0,48,8
1748424791611,BIMM 120,A02,942767,Saier; Milton H.,40,0,48,8
1748424791611,BIMM 120,A03,942768,Saier; Milton H.,15,0,48,33
1748424791611,BIMM 120,A04,942769,Saier; Milton H.,0,0,48,48
1748424792640,BIMM 121,A01,942771,Gustafson-Brown; Cindy,0,0,24,24
1748424792640,BIMM 121,A02,942772,Gustafson-Brown; Cindy,0,0,24,24
1748424792640,BIMM 121,B01,942774,Gustafson-Brown; Cindy,0,0,24,24
1748424792640,BIMM 121,B02,942775,Gustafson-Brown; Cindy,5,0,24,19
1748424792640,BIMM 121,C01,942777,Pirino; Giorgia,0,0,24,24
1748424792640,BIMM 121,C02,942778,Pirino; Giorgia,0,0,24,24
1748424792640,BIMM 121,D01,942780,Pirino; Giorgia,0,0,24,24
1748424792640,BIMM 121,D02,942781,Pirino; Giorgia,0,0,24,24
1748424793667,BIMM 122,A01,942783,Russell; Alistair B,19,0,44,25
1748424793667,BIMM 122,A02,942784,Russell; Alistair B,29,0,44,15
1748424793667,BIMM 122,A03,942785,Russell; Alistair B,35,0,44,9
1748424793667,BIMM 122,A04,942786,Russell; Alistair B,30,0,44,14
1748424794698,BIMM 128,A01,942788,Hao; Nan,0,0,30,30
1748424794698,BIMM 128,A02,942789,Hao; Nan,0,0,31,31
1748424794698,BIMM 128,A03,942790,Hao; Nan,0,0,31,31
1748424794698,BIMM 128,A04,942791,Hao; Nan,0,0,31,31
1748424795727,BIMM 143,A01,942793,Grant; Barry J,13,0,40,27
1748424795727,BIMM 143,B01,942795,Bozinovic; Goran,21,0,40,19
1748424796759,BIMM 143R,A01,942797,Bozinovic; Goran,0,0,40,40
1748424797795,BIMM 194,A00,942798,Golden; Susan S.,5,0,32,27
1748424797795,BIMM 194,B00,942799,Golden; James W,21,0,32,11
1748424797795,BIMM 194,C00,942800,Karlseder; Jan & Saghatelian; Alan,0,0,32,32
1748424798822,BIOM 200A,A00,911746,Gordts; Philip,30,0,30,0
1748424799849,BIOM 200B,A00,911747,Gordts; Philip,35,0,35,0
1748424800875,BIOM 201,A00,911749,Daneman; Richard,35,0,35,0
1748424801907,BIOM 202,A01,911753,Corbett; Kevin Daniel,35,0,35,0
1748424802933,BIOM 203A,A00,911755,Corbett; Kevin Daniel,35,0,35,0
1748424803961,BIOM 218,A00,911756,Gagneux; Pascal,11,0,12,1
1748424804988,BIOM 219,A00,911757,Ross; Camille,20,0,20,0
1748424806019,BIOM 242,A00,911758,Hamilton; Bruce Alan,19,0,20,1
1748424807047,BIOM 293,A00,911759,Gustafsson; Asa Birgitta,35,0,35,0
1748424808079,BIOM 295,A00,911760,Joiner; William J.,0,0,0,0
1748424809106,BIOM 296,A00,911761,Yaksh; Tony L.,35,0,35,0
1748424810155,BIPN 100,A01,959801,Leutgeb; Stefan,0,0,36,36
1748424810155,BIPN 100,A02,959802,Leutgeb; Stefan,0,0,36,36
1748424810155,BIPN 100,A03,959803,Leutgeb; Stefan,3,0,36,33
1748424810155,BIPN 100,A04,959804,Leutgeb; Stefan,0,0,36,36
1748424810155,BIPN 100,B01,959766,Cooke; James Edward,33,0,41,8
1748424810155,BIPN 100,B02,959767,Cooke; James Edward,39,0,41,2
1748424810155,BIPN 100,B03,959768,Cooke; James Edward,37,0,40,3
1748424810155,BIPN 100,B04,959769,Cooke; James Edward,37,0,40,3
1748424810155,BIPN 100,C01,959770,Cooke; James Edward,35,0,41,6
1748424810155,BIPN 100,C02,959771,Cooke; James Edward,40,0,41,1
1748424810155,BIPN 100,C03,959772,Cooke; James Edward,37,0,40,3
1748424810155,BIPN 100,C04,959773,Cooke; James Edward,38,0,40,2
1748424810155,BIPN 100,D01,959811,Yang; Mingyu,0,0,41,41
1748424810155,BIPN 100,D02,959812,Yang; Mingyu,0,0,41,41
1748424810155,BIPN 100,D03,959813,Yang; Mingyu,0,0,40,40
1748424810155,BIPN 100,D04,959814,Yang; Mingyu,0,0,40,40
1748424811182,BIPN 103,A01,942981,Yang; Mingyu,0,0,48,48
1748424812217,BIPN 105,A01,942983,Armour; Jon Christopher,0,0,21,21
1748424812217,BIPN 105,A02,942984,Armour; Jon Christopher,0,0,21,21
1748424812217,BIPN 105,B01,942989,Armour; Jon Christopher,0,0,21,21
1748424812217,BIPN 105,B02,942990,Armour; Jon Christopher,0,0,21,21
1748424813256,BIPN 118,A01,960886,Banghart; Matthew Ryan,23,0,30,7
1748424813256,BIPN 118,A02,960889,Banghart; Matthew Ryan,24,0,30,6
1748424813256,BIPN 118,A03,960891,Banghart; Matthew Ryan,23,0,30,7
1748424813256,BIPN 118,A04,960892,Banghart; Matthew Ryan,27,0,30,3
1748424814295,BIPN 140,A01,942992,Owens; Melinda Tsao-Ying,8,0,32,24
1748424814295,BIPN 140,A02,942994,Owens; Melinda Tsao-Ying,0,0,32,32
1748424814295,BIPN 140,A03,942995,Owens; Melinda Tsao-Ying,1,0,32,31
1748424814295,BIPN 140,A04,942996,Owens; Melinda Tsao-Ying,9,0,30,21
1748424814295,BIPN 140,B01,942998,Owens; Melinda Tsao-Ying,4,0,32,28
1748424814295,BIPN 140,B02,942999,Owens; Melinda Tsao-Ying,3,0,32,29
1748424814295,BIPN 140,B03,943000,Owens; Melinda Tsao-Ying,18,0,32,14
1748424814295,BIPN 140,B04,943001,Owens; Melinda Tsao-Ying,23,0,30,7
1748424815324,BIPN 145,A01,943083,Maita; Isabella Vincenza,0,0,42,42
1748424815324,BIPN 145,B01,943085,Marino; Marc J,13,0,42,29
1748424815324,BIPN 145,C01,943108,Marino; Marc J,0,0,42,42
1748424816360,BIPN 148,A01,943119,Leutgeb; Jill K.,15,0,39,24
1748424816360,BIPN 148,A02,943120,Leutgeb; Jill K.,16,0,39,23
1748424816360,BIPN 148,A03,943121,Leutgeb; Jill K.,33,0,39,6
1748424816360,BIPN 148,A04,943201,Leutgeb; Jill K.,27,0,39,12
1748424817393,BIPN 189,A00,943247,Gentner; Tim,0,0,25,25
1748424818417,BISP 182,A00,943255,Pogliano; Joseph,9999,0,9999,0
1748424819448,BISP 194,A00,943261,Wertheim; Joel Okrent,0,0,32,32
1748424820484,BNFO 281,A00,961454,Gaasterland; Theresa,13,0,40,27
1748424821515,BNFO 283,A00,961457,Benner; Christopher William,69,0,100,31
1748424822543,BNFO 294,A01,961499,Ross; Camille,39,0,50,11
1748424823584,CAT 1,A01,915666,Bronstein; Phoebe Malan,13,0,16,3
1748424823584,CAT 1,A02,915673,Bronstein; Phoebe Malan,15,0,16,1
1748424823584,CAT 1,A03,915727,Bronstein; Phoebe Malan,16,0,16,0
1748424823584,CAT 1,A04,915728,Bronstein; Phoebe Malan,16,0,16,0
1748424823584,CAT 1,A05,915729,Bronstein; Phoebe Malan,16,0,16,0
1748424823584,CAT 1,A06,915730,Bronstein; Phoebe Malan,13,0,16,3
1748424823584,CAT 1,A07,915731,Bronstein; Phoebe Malan,16,0,16,0
1748424823584,CAT 1,A08,915732,Bronstein; Phoebe Malan,16,0,16,0
1748424823584,CAT 1,A09,915733,Bronstein; Phoebe Malan,14,0,16,2
1748424823584,CAT 1,A10,915734,Bronstein; Phoebe Malan,16,0,16,0
1748424823584,CAT 1,A11,915751,Bronstein; Phoebe Malan,16,0,16,0
1748424823584,CAT 1,A12,915752,Bronstein; Phoebe Malan,15,0,16,1
1748424823584,CAT 1,A13,915753,Bronstein; Phoebe Malan,15,0,16,1
1748424823584,CAT 1,A14,915754,Bronstein; Phoebe Malan,16,0,16,0
1748424823584,CAT 1,A15,915755,Bronstein; Phoebe Malan,16,0,16,0
1748424823584,CAT 1,A16,915756,Bronstein; Phoebe Malan,16,0,16,0
1748424823584,CAT 1,B01,915763,Bronstein; Phoebe Malan,15,0,16,1
1748424823584,CAT 1,B02,915764,Bronstein; Phoebe Malan,15,0,16,1
1748424823584,CAT 1,B03,915765,Bronstein; Phoebe Malan,14,0,16,2
1748424823584,CAT 1,B04,915766,Bronstein; Phoebe Malan,16,0,16,0
1748424823584,CAT 1,B05,915767,Bronstein; Phoebe Malan,12,0,16,4
1748424823584,CAT 1,B06,915768,Bronstein; Phoebe Malan,16,0,16,0
1748424823584,CAT 1,B07,915769,Bronstein; Phoebe Malan,16,0,16,0
1748424823584,CAT 1,B08,915770,Bronstein; Phoebe Malan,16,0,16,0
1748424823584,CAT 1,B09,915771,Bronstein; Phoebe Malan,16,0,16,0
1748424823584,CAT 1,B10,915772,Bronstein; Phoebe Malan,16,0,16,0
1748424823584,CAT 1,B11,915773,Bronstein; Phoebe Malan,16,0,16,0
1748424823584,CAT 1,B12,915774,Bronstein; Phoebe Malan,15,0,16,1
1748424823584,CAT 1,B13,915775,Bronstein; Phoebe Malan,16,0,16,0
1748424823584,CAT 1,B14,915776,Bronstein; Phoebe Malan,15,0,16,1
1748424823584,CAT 1,B15,915777,Bronstein; Phoebe Malan,14,0,16,2
1748424823584,CAT 1,B16,915778,Bronstein; Phoebe Malan,16,0,16,0
1748424823584,CAT 1,C01,915780,Algaze; Guillermo,11,0,16,5
1748424823584,CAT 1,C02,915781,Algaze; Guillermo,16,0,16,0
1748424823584,CAT 1,C03,915782,Algaze; Guillermo,15,0,16,1
1748424823584,CAT 1,C04,915783,Algaze; Guillermo,16,0,16,0
1748424823584,CAT 1,C05,915784,Algaze; Guillermo,16,0,16,0
1748424823584,CAT 1,C06,915785,Algaze; Guillermo,16,0,16,0
1748424823584,CAT 1,C07,915786,Algaze; Guillermo,16,0,16,0
1748424823584,CAT 1,C08,915787,Algaze; Guillermo,15,0,16,1
1748424823584,CAT 1,C09,915788,Algaze; Guillermo,16,0,16,0
1748424823584,CAT 1,C10,915790,Algaze; Guillermo,16,0,16,0
1748424823584,CAT 1,C11,915791,Algaze; Guillermo,16,0,16,0
1748424823584,CAT 1,C12,915792,Algaze; Guillermo,16,0,16,0
1748424823584,CAT 1,C13,915793,Algaze; Guillermo,16,0,16,0
1748424823584,CAT 1,C14,915794,Algaze; Guillermo,16,0,16,0
1748424823584,CAT 1,D01,915796,Marchisotto; Jennifer Anne,16,0,16,0
1748424823584,CAT 1,D02,915797,Marchisotto; Jennifer Anne,15,0,16,1
1748424823584,CAT 1,D03,915798,Marchisotto; Jennifer Anne,16,0,16,0
1748424823584,CAT 1,D04,915799,Marchisotto; Jennifer Anne,12,0,16,4
1748424823584,CAT 1,D05,915800,Marchisotto; Jennifer Anne,16,0,16,0
1748424823584,CAT 1,D06,915801,Marchisotto; Jennifer Anne,16,0,16,0
1748424823584,CAT 1,D07,915802,Marchisotto; Jennifer Anne,15,0,16,1
1748424823584,CAT 1,D08,915803,Marchisotto; Jennifer Anne,16,0,16,0
1748424823584,CAT 1,D09,915804,Marchisotto; Jennifer Anne,16,0,16,0
1748424823584,CAT 1,D10,915805,Marchisotto; Jennifer Anne,16,0,16,0
1748424823584,CAT 1,D11,915806,Marchisotto; Jennifer Anne,15,0,16,1
1748424823584,CAT 1,D12,915807,Marchisotto; Jennifer Anne,16,0,16,0
1748424823584,CAT 1,D13,915808,Marchisotto; Jennifer Anne,15,0,16,1
1748424823584,CAT 1,D14,915809,Marchisotto; Jennifer Anne,15,0,16,1
1748424824620,CAT 88,A00,969796,Popko; Elizabeth Ashley,0,0,0,0
1748424825647,CAT 90,A00,915812,Geibel; William,7,0,15,8
1748424826684,CAT 124,A01,915814,Rose; Becca Rae,0,0,20,20
1748424826684,CAT 124,B01,961453,Geibel; William,14,0,20,6
1748424827717,CAT 125,001,915815,Delaville; Romain,18,0,20,2
1748424827717,CAT 125,003,915817,Bigham; David Joseph,12,0,20,8
1748424827717,CAT 125,004,915818,Bigham; David Joseph,3,0,20,17
1748424827717,CAT 125,005,915819,Marchisotto; Jennifer Anne,11,0,20,9
1748424827717,CAT 125,006,915820,Marchisotto; Jennifer Anne,0,0,20,20
1748424827717,CAT 125,007,915821,Morales; Celeste Georgianna,12,0,20,8
1748424827717,CAT 125,008,915822,Morales; Celeste Georgianna,15,0,20,5
1748424827717,CAT 125,009,915823,Morales; Celeste Georgianna,18,0,20,2
1748424827717,CAT 125,010,915824,Irwin; Matthew Joseph,18,0,20,2
1748424827717,CAT 125,011,915825,Irwin; Matthew Joseph,15,0,20,5
1748424827717,CAT 125,012,915826,Irwin; Matthew Joseph,15,0,20,5
1748424827717,CAT 125,013,915827,Vanderschuit; Maya Alysia,16,0,20,4
1748424827717,CAT 125,014,915828,Vanderschuit; Maya Alysia,18,0,20,2
1748424827717,CAT 125,015,915829,Vanderschuit; Maya Alysia,15,0,20,5
1748424827717,CAT 125,016,915830,Rose; Becca Rae,5,0,20,15
1748424827717,CAT 125,017,915831,Rose; Becca Rae,4,0,20,16
1748424827717,CAT 125,018,915832,Hyland; Tina Mae,13,0,20,7
1748424827717,CAT 125,019,915833,Hyland; Tina Mae,17,0,20,3
1748424828754,CAT 125R,A00,915834,Hyland; Tina Mae,0,0,20,20
1748424828754,CAT 125R,B00,915835,Hyland; Tina Mae,0,0,20,20
1748424828754,CAT 125R,C00,915836,Hyland; Tina Mae,0,0,20,20
1748424828754,CAT 125R,D00,915837,Tosun; Adriana,0,0,20,20
1748424828754,CAT 125R,E00,915838,Smith; Lauryn Alissa,0,0,20,20
1748424828754,CAT 125R,F00,915839,Smith; Lauryn Alissa,0,0,20,20
1748424828754,CAT 125R,G00,915840,Smith; Lauryn Alissa,0,0,20,20
1748424829781,CAT 200,A00,915841,Popko; Elizabeth Ashley,17,0,20,3
1748424830809,CCE 1,A00,915063,Bigley; Michele Heather,30,0,40,10
1748424830809,CCE 1,B00,915064,Bigley; Michele Heather,36,0,40,4
1748424831843,CCE 2,001,915067,Santos; Vabianna Daria,0,0,20,20
1748424831843,CCE 2,002,915068,Santos; Vabianna Daria,0,0,20,20
1748424831843,CCE 2,003,915069,Santos; Vabianna Daria,18,0,20,2
1748424831843,CCE 2,004,915070,Staff,17,0,20,3
1748424831843,CCE 2,005,915071,Staff,15,0,20,5
1748424831843,CCE 2,006,915072,Staff,8,0,20,12
1748424831843,CCE 2,007,915073,Staff,10,0,20,10
1748424831843,CCE 2,008,915074,Staff,0,0,20,20
1748424831843,CCE 2,009,915090,Staff,5,0,20,15
1748424831843,CCE 2,010,915104,Merryman; Ashley,0,0,20,20
1748424831843,CCE 2,011,915114,Merryman; Ashley,0,0,20,20
1748424831843,CCE 2,012,915136,Merryman; Ashley,0,0,20,20
1748424831843,CCE 2,013,915176,Staff,13,0,20,7
1748424831843,CCE 2,014,915177,Staff,20,0,20,0
1748424831843,CCE 2,015,915178,Staff,17,0,20,3
1748424831843,CCE 2,016,915179,Staff,15,0,20,5
1748424832877,CCE 3,001,915194,Labat Ii; Michael Luis,13,0,20,7
1748424832877,CCE 3,002,915195,Labat Ii; Michael Luis,17,0,20,3
1748424832877,CCE 3,003,915196,Labat Ii; Michael Luis,17,0,20,3
1748424832877,CCE 3,004,915197,Lee; Kassandra,16,0,20,4
1748424832877,CCE 3,005,915198,Lee; Kassandra,6,0,20,14
1748424832877,CCE 3,006,915199,Lee; Kassandra,10,0,20,10
1748424832877,CCE 3,007,915200,Garcia; Kathryn Mary,0,0,20,20
1748424832877,CCE 3,008,915201,Garcia; Kathryn Mary,2,0,20,18
1748424833909,CCE 120,A01,915203,Quijada; David,26,0,30,4
1748424833909,CCE 120,B01,915205,Quijada; David,17,0,30,13
1748424833909,CCE 120,C01,915207,Williams; Danielle,21,0,30,9
1748424833909,CCE 120,D01,915275,Crawford; James,26,0,30,4
1748424833909,CCE 120,E01,915323,Kenley; Nicole,0,0,30,30
1748424833909,CCE 120,F01,915325,Kenley; Nicole,5,0,30,25
1748424834938,CENG 4,A01,913054,Li; Yanran,35,0,36,1
1748424834938,CENG 4,A02,913055,Li; Yanran,36,0,36,0
1748424834938,CENG 4,A03,913058,Li; Yanran,36,0,36,0
1748424834938,CENG 4,A04,913060,Li; Yanran,36,0,36,0
1748424835972,CENG 15,A01,913087,Lubarda; Vlado,69,0,70,1
1748424837008,CENG 100,A00,913088,Powell; Alyssa,108,0,120,12
1748424838036,CENG 101A,A00,913089,Opatkiewicz; Justin Paul,107,0,146,39
1748424839073,CENG 110,A01,913091,Powell; Alyssa,15,0,24,9
1748424840121,CENG 120,A00,913092,Opatkiewicz; Justin Paul,96,0,146,50
1748424841148,CENG 122,A00,913093,Li; Wan-Lu,120,0,140,20
1748424842178,CENG 170,A01,913196,Drews; Aaron,7,0,25,18
1748424842178,CENG 170,A02,913202,Drews; Aaron,4,0,25,21
1748424842178,CENG 170,A03,913204,Drews; Aaron,5,0,30,25
1748424843210,CENG 175,A00,913205,Steinmetz; Nicole F,14,0,35,21
1748424844242,CENG 205,A00,913207,Jahed Motlagh; Zeinab,54,0,70,16
1748424845270,CENG 210A,A00,913209,Shah; Nisarg,50,0,50,0
1748424846301,CENG 211,A00,913211,Sirbuly; Donald,23,0,25,2
1748424847329,CENG 213,A00,913213,Fenning; David,25,0,25,0
1748424848359,CENG 221A,A00,913214,Liu; Ping,38,0,50,12
1748424849390,CENG 252,A00,913215,Chen; Zheng,42,0,50,8
1748424850427,CGS 2A,A01,915347,Martin Sandino; Amanda Maria Yoland,11,0,15,4
1748424850427,CGS 2A,A02,915348,Martin Sandino; Amanda Maria Yoland,12,0,15,3
1748424850427,CGS 2A,A03,915375,Martin Sandino; Amanda Maria Yoland,11,0,15,4
1748424850427,CGS 2A,A04,915376,Martin Sandino; Amanda Maria Yoland,15,0,15,0
1748424851459,CGS 100A,A00,915379,Perez; Roy,16,0,31,15
1748424852494,CGS 109,A00,915458,Cuong; Marisol,36,0,40,4
1748424853524,CGS 110,A00,915463,Cuong; Marisol,27,0,30,3
1748424854554,CGS 113,A00,915465,Martin Sandino; Amanda Maria Yoland,8,0,16,8
1748424855582,CGS 134,A00,915498,Chatti; Deepti,17,0,32,15
1748424856610,CGS 150,A00,915508,Taylor-Garcia; Daphne,13,0,16,3
1748424857640,CGS 187,A00,915515,Martin Sandino; Amanda Maria Yoland,13,0,16,3
1748424858668,CGS 190,A00,915516,Taylor-Garcia; Daphne,7,0,7,0
1748424859696,CGS 208,A00,915517,Kang; Byung Chu,1,0,1,0
1748424860729,CHEM 4,A01,958051,Brydges; Stacey,39,0,40,1
1748424860729,CHEM 4,A02,958052,Brydges; Stacey,38,0,40,2
1748424860729,CHEM 4,A03,958053,Brydges; Stacey,37,0,40,3
1748424860729,CHEM 4,A04,958054,Brydges; Stacey,39,0,40,1
1748424860729,CHEM 4,A05,958055,Brydges; Stacey,40,0,40,0
1748424860729,CHEM 4,A06,958056,Brydges; Stacey,38,0,40,2
1748424860729,CHEM 4,A07,958057,Brydges; Stacey,40,0,40,0
1748424860729,CHEM 4,A08,958058,Brydges; Stacey,40,0,40,0
1748424860729,CHEM 4,B01,958059,Brydges; Stacey,40,0,40,0
1748424860729,CHEM 4,B02,958060,Brydges; Stacey,40,0,40,0
1748424860729,CHEM 4,B03,958061,Brydges; Stacey,40,0,40,0
1748424860729,CHEM 4,B04,958062,Brydges; Stacey,36,0,40,4
1748424860729,CHEM 4,B05,958063,Brydges; Stacey,38,0,40,2
1748424860729,CHEM 4,B06,958064,Brydges; Stacey,39,0,40,1
1748424860729,CHEM 4,B07,958065,Brydges; Stacey,40,0,40,0
1748424860729,CHEM 4,B08,958066,Brydges; Stacey,40,0,40,0
1748424861795,CHEM 6A,A01,958094,Stallings; Dontarie M,5,0,8,3
1748424861795,CHEM 6A,A02,958095,Stallings; Dontarie M,4,0,8,4
1748424861795,CHEM 6A,A03,958096,Stallings; Dontarie M,7,0,8,1
1748424861795,CHEM 6A,A04,958097,Stallings; Dontarie M,8,0,8,0
1748424861795,CHEM 6A,A05,958098,Stallings; Dontarie M,8,0,8,0
1748424861795,CHEM 6A,A06,958099,Stallings; Dontarie M,8,0,8,0
1748424861795,CHEM 6A,A07,958100,Stallings; Dontarie M,8,0,8,0
1748424861795,CHEM 6A,A08,958101,Stallings; Dontarie M,8,0,8,0
1748424861795,CHEM 6A,A09,958102,Stallings; Dontarie M,0,0,0,0
1748424861795,CHEM 6A,B01,958136,Stallings; Dontarie M,0,0,8,8
1748424861795,CHEM 6A,B02,958137,Stallings; Dontarie M,5,0,8,3
1748424861795,CHEM 6A,B03,958138,Stallings; Dontarie M,8,0,8,0
1748424861795,CHEM 6A,B04,958139,Stallings; Dontarie M,7,0,8,1
1748424861795,CHEM 6A,B05,958140,Stallings; Dontarie M,0,0,8,8
1748424861795,CHEM 6A,B06,958141,Stallings; Dontarie M,3,0,8,5
1748424861795,CHEM 6A,B07,958143,Stallings; Dontarie M,2,0,8,6
1748424861795,CHEM 6A,B08,958144,Stallings; Dontarie M,8,0,8,0
1748424861795,CHEM 6A,B09,958145,Stallings; Dontarie M,0,0,0,0
1748424861795,CHEM 6A,C01,958146,Schurmeier; Kimberly,6,0,8,2
1748424861795,CHEM 6A,C02,958147,Schurmeier; Kimberly,7,0,8,1
1748424861795,CHEM 6A,C03,958148,Schurmeier; Kimberly,8,0,8,0
1748424861795,CHEM 6A,C04,958149,Schurmeier; Kimberly,8,0,8,0
1748424861795,CHEM 6A,C05,958150,Schurmeier; Kimberly,8,0,8,0
1748424861795,CHEM 6A,C06,958151,Schurmeier; Kimberly,6,0,8,2
1748424861795,CHEM 6A,C07,958152,Schurmeier; Kimberly,8,0,8,0
1748424861795,CHEM 6A,C08,958153,Schurmeier; Kimberly,7,0,8,1
1748424861795,CHEM 6A,C09,958154,Schurmeier; Kimberly,0,0,0,0
1748424861795,CHEM 6A,D01,958155,Schurmeier; Kimberly,3,0,8,5
1748424861795,CHEM 6A,D02,958156,Schurmeier; Kimberly,3,0,8,5
1748424861795,CHEM 6A,D03,958157,Schurmeier; Kimberly,4,0,8,4
1748424861795,CHEM 6A,D04,958158,Schurmeier; Kimberly,6,0,8,2
1748424861795,CHEM 6A,D05,958159,Schurmeier; Kimberly,7,0,8,1
1748424861795,CHEM 6A,D06,958160,Schurmeier; Kimberly,7,0,8,1
1748424861795,CHEM 6A,D07,958161,Schurmeier; Kimberly,8,0,8,0
1748424861795,CHEM 6A,D08,958162,Schurmeier; Kimberly,8,0,8,0
1748424861795,CHEM 6A,D09,958195,Schurmeier; Kimberly,0,0,0,0
1748424861795,CHEM 6A,E01,958203,Zid; Brian M,0,0,8,8
1748424861795,CHEM 6A,E02,958206,Zid; Brian M,6,0,8,2
1748424861795,CHEM 6A,E03,958207,Zid; Brian M,7,0,8,1
1748424861795,CHEM 6A,E04,958350,Zid; Brian M,8,0,8,0
1748424861795,CHEM 6A,E05,958361,Zid; Brian M,7,0,8,1
1748424861795,CHEM 6A,E06,958373,Zid; Brian M,2,0,8,6
1748424861795,CHEM 6A,E07,958394,Zid; Brian M,7,0,8,1
1748424861795,CHEM 6A,E08,958395,Zid; Brian M,1,0,8,7
1748424861795,CHEM 6A,E09,958396,Zid; Brian M,0,0,0,0
1748424861795,CHEM 6A,F01,958397,Ortony; Julia Helen,8,0,8,0
1748424861795,CHEM 6A,F02,958407,Ortony; Julia Helen,0,0,8,8
1748424861795,CHEM 6A,F03,958409,Ortony; Julia Helen,2,0,8,6
1748424861795,CHEM 6A,F04,958417,Ortony; Julia Helen,6,0,8,2
1748424861795,CHEM 6A,F05,958422,Ortony; Julia Helen,8,0,8,0
1748424861795,CHEM 6A,F06,958425,Ortony; Julia Helen,8,0,8,0
1748424861795,CHEM 6A,F07,958428,Ortony; Julia Helen,7,0,8,1
1748424861795,CHEM 6A,F08,958442,Ortony; Julia Helen,8,0,8,0
1748424861795,CHEM 6A,F09,958488,Ortony; Julia Helen,0,0,0,0
1748424861795,CHEM 6A,G01,958489,Ortony; Julia Helen,7,0,8,1
1748424861795,CHEM 6A,G02,958490,Ortony; Julia Helen,8,0,8,0
1748424861795,CHEM 6A,G03,958491,Ortony; Julia Helen,3,0,8,5
1748424861795,CHEM 6A,G04,958499,Ortony; Julia Helen,2,0,8,6
1748424861795,CHEM 6A,G05,958500,Ortony; Julia Helen,4,0,8,4
1748424861795,CHEM 6A,G06,958501,Ortony; Julia Helen,8,0,8,0
1748424861795,CHEM 6A,G07,958502,Ortony; Julia Helen,8,0,8,0
1748424861795,CHEM 6A,G08,958636,Ortony; Julia Helen,8,0,8,0
1748424861795,CHEM 6A,G09,958637,Ortony; Julia Helen,0,0,0,0
1748424862827,CHEM 6B,A01,958638,Bussey; Thomas J,15,0,22,7
1748424862827,CHEM 6B,A02,958641,Bussey; Thomas J,0,0,22,22
1748424862827,CHEM 6B,A03,958646,Bussey; Thomas J,0,0,22,22
1748424862827,CHEM 6B,A04,958648,Bussey; Thomas J,11,0,22,11
1748424862827,CHEM 6B,A05,958650,Bussey; Thomas J,7,0,22,15
1748424862827,CHEM 6B,A06,958652,Bussey; Thomas J,18,0,22,4
1748424862827,CHEM 6B,A07,958653,Bussey; Thomas J,20,0,22,2
1748424862827,CHEM 6B,A08,958654,Bussey; Thomas J,19,0,22,3
1748424862827,CHEM 6B,A09,958710,Bussey; Thomas J,21,0,22,1
1748424862827,CHEM 6B,A10,958713,Bussey; Thomas J,21,0,22,1
1748424863855,CHEM 6C,A01,958743,Yuen Zhou; Joel,22,0,38,16
1748424863855,CHEM 6C,A02,958744,Yuen Zhou; Joel,20,0,38,18
1748424863855,CHEM 6C,A03,958745,Yuen Zhou; Joel,28,0,38,10
1748424863855,CHEM 6C,A04,958746,Yuen Zhou; Joel,30,0,38,8
1748424863855,CHEM 6C,A05,958747,Yuen Zhou; Joel,36,0,38,2
1748424863855,CHEM 6C,A06,958748,Yuen Zhou; Joel,23,0,38,15
1748424863855,CHEM 6C,A07,958749,Yuen Zhou; Joel,23,0,38,15
1748424863855,CHEM 6C,A08,958750,Yuen Zhou; Joel,12,0,38,26
1748424863855,CHEM 6C,A09,958751,Yuen Zhou; Joel,28,0,38,10
1748424864971,CHEM 7L,A01,912668,Leigh; Brian,0,0,24,24
1748424864971,CHEM 7L,A02,912669,Leigh; Brian,0,0,24,24
1748424864971,CHEM 7L,A03,912670,Leigh; Brian,0,0,24,24
1748424864971,CHEM 7L,A04,912671,Leigh; Brian,0,0,24,24
1748424864971,CHEM 7L,A05,912672,Leigh; Brian,0,0,24,24
1748424864971,CHEM 7L,A06,912673,Leigh; Brian,0,0,20,20
1748424864971,CHEM 7L,A07,912674,Leigh; Brian,0,0,24,24
1748424864971,CHEM 7L,A08,912675,Leigh; Brian,0,0,24,24
1748424864971,CHEM 7L,A09,912676,Leigh; Brian,0,0,24,24
1748424864971,CHEM 7L,A10,912677,Leigh; Brian,0,0,24,24
1748424864971,CHEM 7L,B01,912680,Leigh; Brian,0,0,24,24
1748424864971,CHEM 7L,B02,912681,Leigh; Brian,0,0,24,24
1748424864971,CHEM 7L,B03,912682,Leigh; Brian,0,0,24,24
1748424864971,CHEM 7L,B04,912683,Leigh; Brian,0,0,24,24
1748424864971,CHEM 7L,B05,912684,Leigh; Brian,0,0,24,24
1748424864971,CHEM 7L,B06,912685,Leigh; Brian,0,0,24,24
1748424864971,CHEM 7L,B07,912686,Leigh; Brian,0,0,24,24
1748424864971,CHEM 7L,B08,912687,Leigh; Brian,0,0,24,24
1748424864971,CHEM 7L,B09,912688,Leigh; Brian,0,0,24,24
1748424864971,CHEM 7L,B10,912689,Leigh; Brian,0,0,24,24
1748424866012,CHEM 40A,A01,958809,Bertrand; Guy,0,0,34,34
1748424866012,CHEM 40A,A02,958811,Bertrand; Guy,0,0,29,29
1748424866012,CHEM 40A,A03,958812,Bertrand; Guy,0,0,34,34
1748424866012,CHEM 40A,A04,958813,Bertrand; Guy,0,0,34,34
1748424866012,CHEM 40A,A05,958814,Bertrand; Guy,0,0,34,34
1748424866012,CHEM 40A,A06,958816,Bertrand; Guy,0,0,34,34
1748424866012,CHEM 40A,A07,958822,Bertrand; Guy,0,0,34,34
1748424866012,CHEM 40A,A08,958824,Bertrand; Guy,0,0,34,34
1748424866012,CHEM 40A,B01,958825,Bertrand; Guy,0,0,34,34
1748424866012,CHEM 40A,B02,958826,Bertrand; Guy,0,0,34,34
1748424866012,CHEM 40A,B03,958828,Bertrand; Guy,0,0,34,34
1748424866012,CHEM 40A,B04,958829,Bertrand; Guy,0,0,34,34
1748424866012,CHEM 40A,B05,958898,Bertrand; Guy,0,0,34,34
1748424866012,CHEM 40A,B06,958899,Bertrand; Guy,0,0,34,34
1748424866012,CHEM 40A,B07,958900,Bertrand; Guy,0,0,34,34
1748424866012,CHEM 40A,B08,958901,Bertrand; Guy,0,0,34,34
1748424866012,CHEM 40A,C01,958086,Yang; Jerry,29,0,34,5
1748424866012,CHEM 40A,C02,958087,Yang; Jerry,32,0,34,2
1748424866012,CHEM 40A,C03,958088,Yang; Jerry,31,0,34,3
1748424866012,CHEM 40A,C04,958089,Yang; Jerry,34,0,34,0
1748424866012,CHEM 40A,C05,958090,Yang; Jerry,34,0,34,0
1748424866012,CHEM 40A,C06,958091,Yang; Jerry,27,0,34,7
1748424866012,CHEM 40A,C07,958092,Yang; Jerry,29,0,34,5
1748424866012,CHEM 40A,C08,958093,Yang; Jerry,27,0,34,7
1748424866012,CHEM 40A,D01,958113,Albizati; Kim F.,0,0,34,34
1748424866012,CHEM 40A,D02,958114,Albizati; Kim F.,0,0,34,34
1748424866012,CHEM 40A,D03,958115,Albizati; Kim F.,0,0,34,34
1748424866012,CHEM 40A,D04,958116,Albizati; Kim F.,0,0,34,34
1748424866012,CHEM 40A,D05,958117,Albizati; Kim F.,0,0,34,34
1748424866012,CHEM 40A,D06,958118,Albizati; Kim F.,0,0,34,34
1748424866012,CHEM 40A,D07,958119,Albizati; Kim F.,0,0,34,34
1748424866012,CHEM 40A,D08,958120,Albizati; Kim F.,0,0,34,34
1748424867040,CHEM 40B,A01,958752,Molinski; Tadeusz,0,0,31,31
1748424867040,CHEM 40B,A02,958754,Molinski; Tadeusz,0,0,32,32
1748424867040,CHEM 40B,A03,958755,Molinski; Tadeusz,0,0,32,32
1748424867040,CHEM 40B,A04,958756,Molinski; Tadeusz,0,0,32,32
1748424867040,CHEM 40B,A05,958757,Molinski; Tadeusz,0,0,32,32
1748424867040,CHEM 40B,A06,958758,Molinski; Tadeusz,0,0,32,32
1748424867040,CHEM 40B,A07,958759,Molinski; Tadeusz,0,0,32,32
1748424867040,CHEM 40B,A08,958760,Molinski; Tadeusz,2,0,32,30
1748424867040,CHEM 40B,A09,958761,Molinski; Tadeusz,32,0,32,0
1748424868071,CHEM 41A,A01,958071,Klosterman; Jeremy K,0,0,22,22
1748424868071,CHEM 41A,A02,958072,Klosterman; Jeremy K,1,0,36,35
1748424868071,CHEM 41A,A03,958073,Klosterman; Jeremy K,16,0,36,20
1748424868071,CHEM 41A,A04,958074,Klosterman; Jeremy K,32,0,36,4
1748424868071,CHEM 41A,A05,958075,Klosterman; Jeremy K,0,0,0,0
1748424868071,CHEM 41A,A06,958076,Klosterman; Jeremy K,24,0,36,12
1748424868071,CHEM 41A,A07,958077,Klosterman; Jeremy K,3,0,36,33
1748424868071,CHEM 41A,A08,958078,Klosterman; Jeremy K,0,0,36,36
1748424868071,CHEM 41A,A09,958079,Klosterman; Jeremy K,36,0,36,0
1748424869104,CHEM 41C,A01,958105,Tor; Yitzhak,0,0,38,38
1748424869104,CHEM 41C,A02,958106,Tor; Yitzhak,0,0,40,40
1748424870136,CHEM 43A,A01,912711,Lam; Tin Yiu,0,0,24,24
1748424870136,CHEM 43A,A02,912712,Lam; Tin Yiu,0,0,24,24
1748424870136,CHEM 43A,A03,912713,Lam; Tin Yiu,0,0,24,24
1748424870136,CHEM 43A,A04,912714,Lam; Tin Yiu,0,0,24,24
1748424870136,CHEM 43A,A05,912715,Lam; Tin Yiu,0,0,24,24
1748424870136,CHEM 43A,A06,912716,Lam; Tin Yiu,0,0,24,24
1748424870136,CHEM 43A,A07,912717,Lam; Tin Yiu,0,0,24,24
1748424870136,CHEM 43A,A08,912718,Lam; Tin Yiu,0,0,24,24
1748424870136,CHEM 43A,A09,912719,Lam; Tin Yiu,0,0,24,24
1748424870136,CHEM 43A,A10,912720,Lam; Tin Yiu,0,0,24,24
1748424870136,CHEM 43A,B01,912722,Lam; Tin Yiu,0,0,24,24
1748424870136,CHEM 43A,B02,912723,Lam; Tin Yiu,0,0,24,24
1748424870136,CHEM 43A,B03,912724,Lam; Tin Yiu,0,0,19,19
1748424870136,CHEM 43A,B04,912725,Lam; Tin Yiu,0,0,24,24
1748424870136,CHEM 43A,B05,912726,Lam; Tin Yiu,0,0,24,24
1748424870136,CHEM 43A,B06,912727,Lam; Tin Yiu,0,0,24,24
1748424870136,CHEM 43A,B07,912728,Lam; Tin Yiu,0,0,24,24
1748424870136,CHEM 43A,B08,912729,Lam; Tin Yiu,0,0,24,24
1748424870136,CHEM 43A,B09,912730,Lam; Tin Yiu,0,0,24,24
1748424870136,CHEM 43A,B10,912731,Lam; Tin Yiu,0,0,24,24
1748424871164,CHEM 96,A00,960251,Bussey; Thomas J,15,0,20,5
1748424872191,CHEM 100A,A01,912734,Leigh; Brian,0,0,24,24
1748424872191,CHEM 100A,A02,912735,Leigh; Brian,0,0,24,24
1748424872191,CHEM 100A,A03,912736,Leigh; Brian,0,0,24,24
1748424872191,CHEM 100A,A04,912737,Leigh; Brian,0,0,24,24
1748424872191,CHEM 100A,A05,912738,Leigh; Brian,0,0,24,24
1748424872191,CHEM 100A,A06,912739,Leigh; Brian,0,0,24,24
1748424873226,CHEM 108,A01,912741,Ghosh; Gourisankar,0,0,24,24
1748424873226,CHEM 108,A02,912742,Ghosh; Gourisankar,0,0,24,24
1748424873226,CHEM 108,A03,912743,Ghosh; Gourisankar,13,0,24,11
1748424873226,CHEM 108,A04,912744,Ghosh; Gourisankar,23,0,24,1
1748424874255,CHEM 109,A01,912746,Muller; Ulrich K.,0,0,24,24
1748424874255,CHEM 109,A02,912747,Muller; Ulrich K.,0,0,24,24
1748424874255,CHEM 109,A03,912748,Muller; Ulrich K.,0,0,24,24
1748424874255,CHEM 109,A04,912749,Muller; Ulrich K.,15,0,24,9
1748424875290,CHEM 114A,A01,958067,Toor; Navtej,23,0,30,7
1748424875290,CHEM 114A,A02,958068,Toor; Navtej,18,0,30,12
1748424875290,CHEM 114A,A03,958069,Toor; Navtej,15,0,30,15
1748424875290,CHEM 114A,A04,958070,Toor; Navtej,0,0,30,30
1748424875290,CHEM 114A,B01,958080,Guseman; Alex,0,0,30,30
1748424875290,CHEM 114A,B02,958081,Guseman; Alex,0,0,30,30
1748424875290,CHEM 114A,B03,958082,Guseman; Alex,20,0,30,10
1748424875290,CHEM 114A,B04,958083,Guseman; Alex,24,0,30,6
1748424876318,CHEM 114D,A00,912752,Ghosh; Gourisankar,11,0,20,9
1748424877346,CHEM 116,A01,958121,Godula; Kamil,35,0,50,15
1748424877346,CHEM 116,A02,958122,Godula; Kamil,28,0,50,22
1748424878377,CHEM 117,A00,912754,Jones; Lisa Michelle,89,0,100,11
1748424879411,CHEM 126A,A01,958126,Schoeneberg; Johannes,14,0,35,21
1748424879411,CHEM 126A,A02,958127,Schoeneberg; Johannes,4,0,35,31
1748424879411,CHEM 126A,A03,958128,Schoeneberg; Johannes,0,0,35,35
1748424879411,CHEM 126A,A04,958129,Schoeneberg; Johannes,1,0,35,34
1748424879411,CHEM 126A,A05,958130,Schoeneberg; Johannes,34,0,35,1
1748424879411,CHEM 126A,A06,958131,Schoeneberg; Johannes,25,0,35,10
1748424880439,CHEM 130,A01,958084,Sinha; Amitabha,6,0,35,29
1748424880439,CHEM 130,A02,958085,Sinha; Amitabha,21,0,35,14
1748424881466,CHEM 142,A00,912758,Godula; Kamil,112,0,135,23
1748424882499,CHEM 143C,A01,912760,Klosterman; Jeremy K,8,0,24,16
1748424882499,CHEM 143C,A02,912761,Klosterman; Jeremy K,11,0,24,13
1748424883526,CHEM 152,A00,912762,Schmidt; Valerie A,18,0,30,12
1748424884553,CHEM 163,A00,912763,Jones; Lisa Michelle,1,0,10,9
1748424885587,CHEM 171,A01,958103,Slade; Jonathan,30,0,40,10
1748424885587,CHEM 171,A02,958104,Slade; Jonathan,36,0,40,4
1748424886620,CHEM 204,A00,912765,Ghosh; Partho,29,0,30,1
1748424887647,CHEM 209,A00,912766,Toor; Navtej,36,0,40,4
1748424888675,CHEM 213A,A00,912767,Guseman; Alex,46,0,50,4
1748424889701,CHEM 214,A00,912768,Ghosh; Gourisankar,18,0,20,2
1748424890727,CHEM 216,A00,912769,Godula; Kamil,28,0,30,2
1748424891756,CHEM 219A,A00,912770,Zid; Brian M,43,0,45,2
1748424892784,CHEM 222,A00,912771,Graeve; Olivia A,4,0,5,1
1748424893811,CHEM 224,A00,912772,Rinehart; Jeffrey Dennis,19,0,20,1
1748424894840,CHEM 227,A00,912773,Schimpf; Alina M,28,0,30,2
1748424896911,CHEM 231,A00,912775,Yong; Haiwang,20,0,20,0
1748424897944,CHEM 232A,A00,963071,Yuen Zhou; Joel,15,0,15,0
1748424898975,CHEM 234,A00,912776,Pun; Andrew Brian,39,0,40,1
1748424900008,CHEM 242,A00,912777,Godula; Kamil,22,0,25,3
1748424901036,CHEM 252,A00,912778,Schmidt; Valerie A,27,0,30,3
1748424902063,CHEM 263,A00,912779,Jones; Lisa Michelle,28,0,30,2
1748424903091,CHEM 291,A00,912780,Staff,20,0,20,0
1748424904121,CHEM 294,A00,912781,Staff,49,0,50,1
1748424905153,CHIN 10AD,A01,913381,Liu; Mingming,10,0,12,2
1748424905153,CHIN 10AD,A02,913382,Liu; Mingming,10,0,12,2
1748424906187,CHIN 10AM,A01,913384,Chen; Pei-Chia,9,0,12,3
1748424906187,CHIN 10AM,A02,913385,Chen; Pei-Chia,10,0,12,2
1748424907216,CHIN 10AN,A01,913387,Xu; Li,10,0,10,0
1748424907216,CHIN 10AN,A02,913388,Xu; Li,10,0,10,0
1748424907216,CHIN 10AN,B01,913390,Xu; Li,9,0,10,1
1748424907216,CHIN 10AN,B02,913391,Xu; Li,8,0,10,2
1748424907216,CHIN 10AN,C01,913393,Xu; Li,12,0,12,0
1748424907216,CHIN 10AN,C02,913394,Xu; Li,11,0,12,1
1748424908243,CHIN 20AD,A01,913396,Liu; Mingming,12,0,14,2
1748424908243,CHIN 20AD,A02,913397,Liu; Mingming,13,0,14,1
1748424909278,CHIN 20AM,A01,913399,Wang; Xiao,11,0,12,1
1748424909278,CHIN 20AM,A02,913400,Wang; Xiao,9,0,12,3
1748424909278,CHIN 20AM,B01,913402,Wang; Xiao,12,0,12,0
1748424909278,CHIN 20AM,B02,913403,Wang; Xiao,12,0,12,0
1748424910308,CHIN 20AN,A01,913405,Anderson; Qin-Hong,8,0,12,4
1748424910308,CHIN 20AN,A02,913406,Anderson; Qin-Hong,7,0,12,5
1748424910308,CHIN 20AN,B01,913408,Anderson; Qin-Hong,6,0,12,6
1748424910308,CHIN 20AN,B02,913409,Anderson; Qin-Hong,9,0,12,3
1748424910308,CHIN 20AN,C01,913411,Anderson; Qin-Hong,11,0,12,1
1748424911334,CHIN 100AM,A00,913412,Wang; Xiao,12,0,15,3
1748424912365,CHIN 100AN,A00,913413,Chen; Pei-Chia,8,0,15,7
1748424913393,CHIN 185A,A00,913414,Liu; Mingming,15,0,15,0
1748424914420,CLIN 294A,A00,914822,Weingarten; Amanda Gooding,10,0,10,0
1748424915455,CLIN 296,A00,914825,Moore; David Joseph,100,0,100,0
1748424915455,CLIN 296,B00,914826,Brookman; Lauren Irene,5,0,5,0
1748424916483,CLIN 297,A00,914827,Wall; Tamara Lynn,100,0,100,0
1748424917510,CLRE 254,A00,914830,Vaida; Florin,9997,0,9999,2
1748424918539,CLRE 255,A01,914832,Cuomo; Raphael Eduardo,9997,0,9999,2
1748424919566,CLRE 256,A01,914835,Morris; Sheldon,9996,0,9999,3
1748424920594,CLRE 257,A00,914836,Mehta; Ravindra L.,9997,0,9999,2
1748424921621,CLRE 258,A00,914839,Mehta; Ravindra L.,9997,0,9999,2
1748424922647,CLRE 260,A00,914840,Cuomo; Raphael Eduardo,9999,0,9999,0
1748424923675,CLRE 295A,A00,914845,Cuomo; Raphael Eduardo,9999,0,9999,0
1748424924707,CLRE 297,001,914847,Cuomo; Raphael Eduardo,9999,0,9999,0
1748424925740,CLX 87,A00,913379,Castro; Robert Jess,20,0,20,0
1748424926773,COGR 200A,A00,914800,Dewaard; Andrew Michael,5,0,5,0
1748424927808,COGR 200C,A00,914801,Irani; Lilly C,5,0,5,0
1748424928837,COGR 225A,A00,914803,McKenzie; Kerry V.,10,0,10,0
1748424929867,COGR 225C,A00,914804,McKenzie; Kerry V.,9,0,10,1
1748424930898,COGR 275,A00,914805,Jack; Caroline Sarah,9,0,10,1
1748424930898,COGR 275,B00,914807,Zilberg; Elana,9,0,10,1
1748424930898,COGR 275,C00,914809,Goldfarb; Brian,7,0,10,3
1748424931931,COGS 1,A01,913420,Beatty-Martinez; Anne,47,0,56,9
1748424931931,COGS 1,A02,913421,Beatty-Martinez; Anne,39,0,56,17
1748424931931,COGS 1,A03,913422,Beatty-Martinez; Anne,51,0,55,4
1748424931931,COGS 1,A04,913423,Beatty-Martinez; Anne,46,0,50,4
1748424931931,COGS 1,A05,913424,Beatty-Martinez; Anne,41,0,50,9
1748424931931,COGS 1,A06,913425,Beatty-Martinez; Anne,44,0,50,6
1748424931931,COGS 1,A07,913426,Beatty-Martinez; Anne,48,0,50,2
1748424931931,COGS 1,A08,913427,Beatty-Martinez; Anne,45,0,50,5
1748424932958,COGS 2,A01,913429,Boyle; Mary E. T.,49,0,50,1
1748424932958,COGS 2,A02,913430,Boyle; Mary E. T.,47,0,50,3
1748424932958,COGS 2,A03,913431,Boyle; Mary E. T.,46,0,50,4
1748424932958,COGS 2,A04,913432,Boyle; Mary E. T.,49,0,50,1
1748424932958,COGS 2,A05,913433,Boyle; Mary E. T.,47,0,50,3
1748424933987,COGS 3,A01,913435,Boyle; Mary E. T.,48,0,60,12
1748424933987,COGS 3,A02,913436,Boyle; Mary E. T.,52,0,60,8
1748424935017,COGS 9,A01,913439,Khosla; Meenakshi,48,0,50,2
1748424935017,COGS 9,A02,913440,Khosla; Meenakshi,49,0,50,1
1748424935017,COGS 9,A03,913441,Khosla; Meenakshi,48,0,50,2
1748424935017,COGS 9,A04,913442,Khosla; Meenakshi,46,0,50,4
1748424935017,COGS 9,A05,913443,Khosla; Meenakshi,44,0,50,6
1748424935017,COGS 9,A06,913444,Khosla; Meenakshi,46,0,50,4
1748424936046,COGS 10,A01,913446,Staff,41,0,50,9
1748424936046,COGS 10,A02,913447,Staff,46,0,50,4
1748424936046,COGS 10,A03,913448,Staff,47,0,50,3
1748424936046,COGS 10,A04,913449,Staff,47,0,50,3
1748424936046,COGS 10,A05,913450,Staff,50,0,50,0
1748424936046,COGS 10,A06,913451,Staff,45,0,50,5
1748424937078,COGS 11,A01,913453,Boroditsky; Lera,142,0,149,7
1748424938113,COGS 14A,A01,913455,Creel; Sarah,29,0,50,21
1748424938113,COGS 14A,A02,913456,Creel; Sarah,37,0,50,13
1748424938113,COGS 14A,A03,913457,Creel; Sarah,42,0,50,8
1748424938113,COGS 14A,A04,913458,Creel; Sarah,45,0,50,5
1748424938113,COGS 14A,A05,913459,Creel; Sarah,47,0,50,3
1748424938113,COGS 14A,A06,913460,Creel; Sarah,48,0,50,2
1748424938113,COGS 14A,A07,913461,Creel; Sarah,46,0,50,4
1748424939147,COGS 14B,A01,913463,Barrera; Steven James,32,0,50,18
1748424939147,COGS 14B,A02,913464,Barrera; Steven James,45,0,50,5
1748424939147,COGS 14B,A03,913465,Barrera; Steven James,40,0,50,10
1748424939147,COGS 14B,A04,913466,Barrera; Steven James,46,0,50,4
1748424939147,COGS 14B,A05,913467,Barrera; Steven James,40,0,50,10
1748424940175,COGS 15,A01,913469,Bergen; Benjamin,57,0,60,3
1748424940175,COGS 15,A02,913470,Bergen; Benjamin,57,0,60,3
1748424941204,COGS 17,A01,913472,Johnson; Christine M.,38,0,50,12
1748424941204,COGS 17,A02,913473,Johnson; Christine M.,47,0,50,3
1748424941204,COGS 17,A03,913474,Johnson; Christine M.,39,0,50,11
1748424941204,COGS 17,A04,913475,Johnson; Christine M.,42,0,50,8
1748424941204,COGS 17,A05,913476,Johnson; Christine M.,48,0,50,2
1748424941204,COGS 17,A06,913477,Johnson; Christine M.,48,0,50,2
1748424941204,COGS 17,A07,913478,Johnson; Christine M.,50,0,54,4
1748424941204,COGS 17,A08,913479,Johnson; Christine M.,43,0,56,13
1748424942234,COGS 18,A01,913481,Morgan; Eric,27,0,35,8
1748424942234,COGS 18,A02,913482,Morgan; Eric,30,0,35,5
1748424942234,COGS 18,A03,913483,Morgan; Eric,29,0,35,6
1748424942234,COGS 18,A04,913484,Morgan; Eric,32,0,35,3
1748424942234,COGS 18,A05,913485,Morgan; Eric,31,0,35,4
1748424942234,COGS 18,A06,913486,Morgan; Eric,31,0,35,4
1748424942234,COGS 18,A07,913487,Morgan; Eric,30,0,35,5
1748424942234,COGS 18,A08,913488,Morgan; Eric,31,0,35,4
1748424942234,COGS 18,A09,913520,Morgan; Eric,27,0,35,8
1748424942234,COGS 18,B01,968089,Morgan; Eric,34,0,35,1
1748424942234,COGS 18,B02,968090,Morgan; Eric,35,0,35,0
1748424942234,COGS 18,B03,968091,Morgan; Eric,35,0,35,0
1748424942234,COGS 18,B04,968092,Morgan; Eric,35,0,35,0
1748424942234,COGS 18,B05,968093,Morgan; Eric,35,0,35,0
1748424942234,COGS 18,B06,968094,Morgan; Eric,35,0,35,0
1748424942234,COGS 18,B07,968095,Morgan; Eric,35,0,35,0
1748424942234,COGS 18,B08,968096,Morgan; Eric,34,0,35,1
1748424942234,COGS 18,B09,968097,Morgan; Eric,34,0,35,1
1748424943262,COGS 100,A01,913580,Staff,58,0,60,2
1748424943262,COGS 100,A02,913581,Staff,55,0,60,5
1748424943262,COGS 100,A03,913621,Staff,55,0,60,5
1748424943262,COGS 100,A04,913622,Staff,55,0,60,5
1748424943262,COGS 100,A05,913663,Staff,54,0,60,6
1748424944295,COGS 101A,A01,913705,Barrera; Steven James,37,0,50,13
1748424944295,COGS 101A,A02,913709,Barrera; Steven James,35,0,50,15
1748424944295,COGS 101A,A03,913713,Barrera; Steven James,18,0,50,32
1748424944295,COGS 101A,A04,913715,Barrera; Steven James,25,0,50,25
1748424944295,COGS 101A,A05,913718,Barrera; Steven James,44,0,50,6
1748424944295,COGS 101A,A06,913721,Barrera; Steven James,36,0,50,14
1748424944295,COGS 101A,A07,913722,Barrera; Steven James,41,0,50,9
1748424945322,COGS 101B,A01,913725,Hoffman; Drew Ellen,26,0,50,24
1748424945322,COGS 101B,A02,913726,Hoffman; Drew Ellen,44,0,50,6
1748424945322,COGS 101B,A03,913727,Hoffman; Drew Ellen,47,0,50,3
1748424945322,COGS 101B,A04,913730,Hoffman; Drew Ellen,50,0,50,0
1748424946352,COGS 102A,A01,968009,Staff,41,0,48,7
1748424946352,COGS 102A,A02,968010,Staff,36,0,48,12
1748424946352,COGS 102A,A03,968011,Staff,47,0,50,3
1748424947380,COGS 107A,A01,913748,Rangel; Lara M,44,0,56,12
1748424947380,COGS 107A,A02,913750,Rangel; Lara M,43,0,54,11
1748424947380,COGS 107A,A03,913751,Rangel; Lara M,31,0,50,19
1748424947380,COGS 107A,A04,913754,Rangel; Lara M,20,0,50,30
1748424947380,COGS 107A,A05,913755,Rangel; Lara M,27,0,50,23
1748424947380,COGS 107A,A06,913756,Rangel; Lara M,0,0,50,50
1748424948407,COGS 107B,A01,968098,Staff,0,0,50,50
1748424948407,COGS 107B,A02,968099,Staff,6,0,50,44
1748424948407,COGS 107B,A03,968102,Staff,37,0,49,12
1748424949441,COGS 108,A01,913846,Fleischer; Jason G,0,0,56,56
1748424949441,COGS 108,A02,913847,Fleischer; Jason G,17,0,56,39
1748424949441,COGS 108,A03,913858,Fleischer; Jason G,20,0,50,30
1748424949441,COGS 108,A04,913899,Fleischer; Jason G,44,0,55,11
1748424949441,COGS 108,A05,913984,Fleischer; Jason G,29,0,50,21
1748424949441,COGS 108,A06,914035,Fleischer; Jason G,31,0,50,19
1748424949441,COGS 108,A07,914036,Fleischer; Jason G,36,0,50,14
1748424949441,COGS 108,A08,914037,Fleischer; Jason G,44,0,50,6
1748424949441,COGS 108,B01,914039,Fleischer; Jason G,38,0,50,12
1748424949441,COGS 108,B02,914040,Fleischer; Jason G,48,0,50,2
1748424949441,COGS 108,B03,914172,Fleischer; Jason G,32,0,50,18
1748424949441,COGS 108,B04,914182,Fleischer; Jason G,36,0,50,14
1748424949441,COGS 108,B05,914185,Fleischer; Jason G,28,0,50,22
1748424949441,COGS 108,B06,914188,Fleischer; Jason G,19,0,50,31
1748424949441,COGS 108,B07,914209,Fleischer; Jason G,39,0,54,15
1748424949441,COGS 108,B08,914210,Fleischer; Jason G,49,0,56,7
1748424950475,COGS 109,A01,968106,Mukamel; Eran A,30,0,48,18
1748424950475,COGS 109,A02,968107,Mukamel; Eran A,39,0,49,10
1748424950475,COGS 109,A03,968108,Mukamel; Eran A,47,0,49,2
1748424951504,COGS 111,A01,914261,Hoffman; Drew Ellen,34,0,50,16
1748424951504,COGS 111,A02,914262,Hoffman; Drew Ellen,49,0,50,1
1748424951504,COGS 111,A03,914263,Hoffman; Drew Ellen,46,0,50,4
1748424951504,COGS 111,A04,914264,Hoffman; Drew Ellen,28,0,50,22
1748424952531,COGS 115,A01,914266,Deak; Gedeon O.,35,0,70,35
1748424953565,COGS 116,A01,914268,Greene; Deanna Jacquelyn,49,0,70,21
1748424954598,COGS 118A,A01,914270,Tu; Zhuowen,30,0,50,20
1748424954598,COGS 118A,A02,914271,Tu; Zhuowen,31,0,50,19
1748424954598,COGS 118A,A03,914272,Tu; Zhuowen,7,0,50,43
1748424954598,COGS 118A,A04,914273,Tu; Zhuowen,6,0,50,44
1748424955635,COGS 118B,A01,969817,De Sa; Virginia,32,0,49,17
1748424955635,COGS 118B,A02,969818,De Sa; Virginia,34,0,49,15
1748424955635,COGS 118B,A03,969819,De Sa; Virginia,31,0,49,18
1748424955635,COGS 118B,A04,969822,De Sa; Virginia,43,0,49,6
1748424956663,COGS 125,A00,968043,Klemmer; Scott R,48,0,50,2
1748424957689,COGS 128,A01,914278,Staff,16,0,50,34
1748424957689,COGS 128,A02,914279,Staff,0,0,50,50
1748424958716,COGS 143,A01,914284,Johnson; Christine M.,16,0,40,24
1748424959744,COGS 150,A01,968112,Staff,36,0,50,14
1748424959744,COGS 150,A02,968113,Staff,44,0,49,5
1748424959744,COGS 150,A03,968114,Staff,43,0,48,5
1748424960773,COGS 151,A00,968044,Coulson; Seana M,48,0,50,2
1748424961802,COGS 160,A00,914286,Kirsh; David Joel,25,0,25,0
1748424962836,COGS 165,A01,914291,Kiyonaga; Anastasia,0,0,50,50
1748424963864,COGS 187A,A01,914293,Kirsh; David Joel,0,0,50,50
1748424963864,COGS 187A,A02,914294,Kirsh; David Joel,0,0,50,50
1748424963864,COGS 187A,A03,914295,Kirsh; David Joel,16,0,49,33
1748424964891,COGS 189,A00,914296,De Sa; Virginia,119,0,200,81
1748424965918,COGS 190A,A00,914297,Staff,9999,0,9999,0
1748424966946,COGS 194,A00,914298,Hill; Seth J,9999,0,9999,0
1748424967974,COGS 203,A00,914326,Zettersten; Martin,11,0,20,9
1748424969061,COGS 210A,001,914327,Kirsh; David Joel,9999,0,9999,0
1748424969061,COGS 210A,002,914328,Greene; Deanna Jacquelyn,9998,0,9999,1
1748424969061,COGS 210A,003,914329,Xia; Haijun,9998,0,9999,1
1748424969061,COGS 210A,004,914330,Nitz; Douglas A.,9999,0,9999,0
1748424969061,COGS 210A,005,914331,Hollan; James D.,9999,0,9999,0
1748424969061,COGS 210A,006,914332,De Sa; Virginia,9998,0,9999,1
1748424969061,COGS 210A,007,914333,Rossano; Federico,9999,0,9999,0
1748424969061,COGS 210A,008,914334,Kiyonaga; Anastasia,9999,0,9999,0
1748424969061,COGS 210A,009,914335,Coulson; Seana M,9998,0,9999,1
1748424970088,COGS 211A,A00,914336,Boroditsky; Lera,9995,0,9999,4
1748424971115,COGS 230,A00,914337,Munyaka; Imani N. S.,3,0,15,12
1748424972145,COGS 234,A00,970720,Xia; Haijun,4,0,20,16
1748424973172,COGS 260,A00,914340,Voytek; Bradley Thomas,9994,0,9999,5
1748424974204,COMM 10,A01,914366,Whitworth-Smith; Andrew C,6,0,10,4
1748424974204,COMM 10,A02,914367,Whitworth-Smith; Andrew C,7,0,10,3
1748424974204,COMM 10,A03,914368,Whitworth-Smith; Andrew C,9,0,10,1
1748424974204,COMM 10,A04,914369,Whitworth-Smith; Andrew C,6,0,10,4
1748424974204,COMM 10,A05,914370,Whitworth-Smith; Andrew C,10,0,10,0
1748424974204,COMM 10,A06,914371,Whitworth-Smith; Andrew C,9,0,10,1
1748424974204,COMM 10,A07,914372,Whitworth-Smith; Andrew C,9,0,10,1
1748424974204,COMM 10,A08,914373,Whitworth-Smith; Andrew C,7,0,10,3
1748424974204,COMM 10,A09,914374,Whitworth-Smith; Andrew C,9,0,10,1
1748424974204,COMM 10,A10,914375,Whitworth-Smith; Andrew C,10,0,10,0
1748424974204,COMM 10,A11,914376,Whitworth-Smith; Andrew C,6,0,10,4
1748424974204,COMM 10,A12,914377,Whitworth-Smith; Andrew C,10,0,10,0
1748424975238,COMM 20,A01,914385,Hill; Erin Truesdell,75,0,75,0
1748424976266,COMM 40,A00,914386,Jack; Caroline Sarah,61,0,75,14
1748424977296,COMM 50,A00,914387,Staff,21,0,25,4
1748424978325,COMM 80,A01,914389,Staff,77,0,80,3
1748424979354,COMM 100A,A01,914391,Harb; Anthony Joseph,1,0,10,9
1748424979354,COMM 100A,A02,914392,Harb; Anthony Joseph,0,0,10,10
1748424979354,COMM 100A,A03,914393,Harb; Anthony Joseph,0,0,10,10
1748424979354,COMM 100A,A04,914394,Harb; Anthony Joseph,0,0,10,10
1748424979354,COMM 100A,A05,914395,Harb; Anthony Joseph,0,0,10,10
1748424979354,COMM 100A,A06,914396,Harb; Anthony Joseph,0,0,10,10
1748424979354,COMM 100A,A07,914397,Harb; Anthony Joseph,1,0,10,9
1748424979354,COMM 100A,A08,914398,Harb; Anthony Joseph,6,0,10,4
1748424979354,COMM 100A,A09,914399,Harb; Anthony Joseph,7,0,10,3
1748424979354,COMM 100A,A10,914400,Harb; Anthony Joseph,7,0,10,3
1748424980387,COMM 101,A01,914404,Martinico; Daniel J,8,0,15,7
1748424980387,COMM 101,A02,914405,Martinico; Daniel J,2,0,15,13
1748424980387,COMM 101,A03,914406,Martinico; Daniel J,1,0,15,14
1748424980387,COMM 101,A04,914407,Martinico; Daniel J,13,0,15,2
1748424981414,COMM 101K,A00,914408,Staff,0,0,0,0
1748424982450,COMM 101M,A00,914409,Halm; Gavin Patrick,10,0,18,8
1748424983483,COMM 101N,A00,914410,Martinico; Daniel J,4,0,16,12
1748424984512,COMM 101T,A00,914411,Davis; Zeinabu I.,12,0,18,6
1748424985541,COMM 102C,A01,914417,Campion; Camille E,0,0,6,6
1748424985541,COMM 102C,A02,914423,Campion; Camille E,0,0,6,6
1748424985541,COMM 102C,A03,914432,Campion; Camille E,0,0,6,6
1748424986570,COMM 106,A00,914439,Kidman; Shawna F,54,0,70,16
1748424987595,COMM 106F,A00,914442,Hill; Erin Truesdell,23,0,42,19
1748424988623,COMM 106N,A00,914480,Hallin; Daniel C,46,0,70,24
1748424989650,COMM 108D,A00,914491,Goldfarb; Brian,45,0,46,1
1748424990678,COMM 113T,A00,914493,Dominguez Rubio; Fernando,43,0,46,3
1748424991706,COMM 114E,A00,914767,Pavon Aramburu; Maria Laur,41,0,44,3
1748424992733,COMM 114I,A00,914768,Rojo Solis; Juan Jose,39,0,44,5
1748424993761,COMM 115,A00,914769,Alac; Morana,35,0,46,11
1748424994791,COMM 119,A01,914771,Staff,50,0,50,0
1748424995818,COMM 120M,A00,914773,Abuelhiga; Soraya Jill,37,0,44,7
1748424996849,COMM 127,A00,914774,Abuelhiga; Soraya Jill,33,0,44,11
1748424997885,COMM 133,A00,914775,Dewey; Matthew D,35,0,44,9
1748424998915,COMM 134,A00,914777,Kidman; Shawna F,31,0,44,13
1748424999943,COMM 135,A00,914778,Davis; Zeinabu I.,43,0,46,3
1748425000970,COMM 142,A00,914779,McKenna; Denise,22,0,44,22
1748425001998,COMM 146,A00,914780,Halm; Gavin Patrick,34,0,44,10
1748425001998,COMM 146,B00,968068,Ybarra; Megan,41,0,44,3
1748425003028,COMM 148,A00,914785,Staff,0,0,0,0
1748425004056,COMM 164,A00,914786,Dominguez Rubio; Fernando,9,0,25,16
1748425005085,COMM 173,A00,914787,Alac; Morana,4,0,25,21
1748425006115,COMM 177,A00,914788,Rojo Solis; Juan Jose,2,0,25,23
1748425007145,COMM 185,A00,914792,Boateng; Boatema,21,0,25,4
1748425008180,COMM 190,B00,914793,Staff,0,0,23,23
1748425008180,COMM 190,C00,914794,Staff,10,0,23,13
1748425008180,COMM 190,D00,914795,Hassanpour; Anvar,4,0,23,19
1748425009214,COMM 194,A00,954115,Hill; Seth J,9999,0,9999,0
1748425010240,COMM 196A,A00,914796,Dewaard; Andrew Michael,0,0,0,1
1748425011269,CSE 3,A50,914849,Alvarado; Christine J.,49,0,50,1
1748425011269,CSE 3,A51,914850,Alvarado; Christine J.,49,0,50,1
1748425011269,CSE 3,A52,914852,Alvarado; Christine J.,46,0,46,0
1748425012306,CSE 6R,A01,914856,Soosai Raj; Adalbert Geral,238,0,250,12
1748425013342,CSE 8A,A50,914860,Soosai Raj; Adalbert Geral,2,0,3,1
1748425013342,CSE 8A,A51,914868,Soosai Raj; Adalbert Geral,0,0,3,3
1748425013342,CSE 8A,A52,914870,Soosai Raj; Adalbert Geral,1,0,3,2
1748425013342,CSE 8A,A53,914871,Soosai Raj; Adalbert Geral,1,0,3,2
1748425013342,CSE 8A,A54,914872,Soosai Raj; Adalbert Geral,2,0,3,1
1748425013342,CSE 8A,A55,914873,Soosai Raj; Adalbert Geral,2,0,3,1
1748425013342,CSE 8A,A56,914875,Soosai Raj; Adalbert Geral,3,0,3,0
1748425013342,CSE 8A,A57,914876,Soosai Raj; Adalbert Geral,1,0,3,2
1748425014370,CSE 11,A01,958990,Cao; Yingjun,0,0,50,50
1748425014370,CSE 11,B01,959775,Ochoa; Benjamin Lawrence,103,0,115,12
1748425015397,CSE 12,A01,958991,Cao; Yingjun,0,0,100,100
1748425016428,CSE 20,A01,959784,Jones; Miles E,0,0,25,25
1748425016428,CSE 20,A02,968053,Jones; Miles E,1,0,25,24
1748425017456,CSE 21,A01,959776,Jones; Miles E,0,0,30,30
1748425017456,CSE 21,A02,968059,Jones; Miles E,2,0,30,28
1748425018486,CSE 29,A50,914888,Politz; Joseph Gibbs,0,0,10,10
1748425018486,CSE 29,A51,914889,Politz; Joseph Gibbs,0,0,10,10
1748425018486,CSE 29,A52,914891,Politz; Joseph Gibbs,0,0,10,10
1748425018486,CSE 29,A53,914892,Politz; Joseph Gibbs,0,0,10,10
1748425018486,CSE 29,B50,914897,Shalev; Aaron D,0,0,10,10
1748425018486,CSE 29,B51,914898,Shalev; Aaron D,0,0,10,10
1748425018486,CSE 29,B52,914900,Shalev; Aaron D,0,0,10,10
1748425018486,CSE 29,B53,914901,Shalev; Aaron D,0,0,10,10
1748425019532,CSE 30,A01,959778,Eldon; John,0,0,15,15
1748425020559,CSE 87,A00,914904,Moshiri; Niema,20,0,20,0
1748425021591,CSE 89,A00,914906,Minnes Kemp; Mor Mia,100,0,100,0
1748425021591,CSE 89,B00,969276,Minnes Kemp; Mor Mia,100,0,100,0
1748425022617,CSE 95,A00,914907,Cao; Yingjun,100,0,100,0
1748425023651,CSE 100,A01,959787,Moshiri; Niema,0,0,75,75
1748425024682,CSE 100R,A01,914911,Moshiri; Niema,0,0,125,125
1748425025710,CSE 101,A01,958995,Impagliazzo; Russell,0,0,30,30
1748425025710,CSE 101,A02,958998,Impagliazzo; Russell,0,0,30,30
1748425025710,CSE 101,A03,959000,Impagliazzo; Russell,0,0,30,30
1748425025710,CSE 101,B01,959777,Liu; Qipeng,94,0,175,81
1748425026737,CSE 103,A01,959001,Freund; Yoav,69,0,96,27
1748425027764,CSE 105,A01,959785,Lovett; Shachar,0,0,45,45
1748425028790,CSE 107,A01,959002,Bellare; Mihir,81,0,96,15
1748425029818,CSE 110,A50,914923,Coblenz; Michael J,10,0,50,40
1748425029818,CSE 110,A51,914925,Coblenz; Michael J,18,0,50,32
1748425029818,CSE 110,A52,914926,Coblenz; Michael J,44,0,50,6
1748425029818,CSE 110,A53,914928,Coblenz; Michael J,33,0,50,17
1748425029818,CSE 110,A54,914930,Coblenz; Michael J,42,0,50,8
1748425029818,CSE 110,A55,914931,Coblenz; Michael J,36,0,45,9
1748425030847,CSE 118,A50,914934,Weibel; Nadir,16,0,25,9
1748425031874,CSE 120,A01,959780,Voelker; Geoffrey M.,130,0,295,165
1748425032902,CSE 127,A01,959795,Savage; Stefan,88,0,192,104
1748425033934,CSE 130,A01,959003,Polikarpova; Nadezhda,118,0,145,27
1748425034966,CSE 131,A01,914941,Politz; Joseph Gibbs,33,0,50,17
1748425036000,CSE 132A,A01,959790,Gupta; Amarnath,141,0,196,55
1748425037032,CSE 134B,A01,959005,Powell; Thomas Allan,115,0,146,31
1748425038064,CSE 140,A01,914947,Orailoglu; Alex,124,0,146,22
1748425039090,CSE 140L,A01,914949,Orailoglu; Alex,112,0,146,34
1748425040121,CSE 141,A01,959006,Pannuto; Patrick William,79,0,146,67
1748425041147,CSE 141L,A01,961134,Eldon; John,75,0,146,71
1748425042174,CSE 142,A01,959781,Swanson; Steven James,250,0,295,45
1748425043202,CSE 150A,A01,959774,Bonjour; Trevor,101,0,225,124
1748425044232,CSE 150B,A01,959791,Solares; Edwin A,187,0,196,9
1748425045261,CSE 151A,A01,959782,Dasgupta; Sanjoy,186,0,250,64
1748425045261,CSE 151A,B01,959783,Dasgupta; Sanjoy,226,0,250,24
1748425046288,CSE 152A,A01,959792,Su; Hao,0,0,0,0
1748425047314,CSE 158,A01,959793,McAuley; Julian John,100,0,196,96
1748425048342,CSE 158R,A01,914961,McAuley; Julian John,449,0,550,101
1748425048342,CSE 158R,B01,968064,McAuley; Julian John,100,0,100,0
1748425049373,CSE 167,A01,959796,Li; Tzumao,110,0,192,82
1748425050403,CSE 170,A01,914965,Vaccaro; Kristen Marie,13,0,20,7
1748425050403,CSE 170,A02,914967,Vaccaro; Kristen Marie,0,0,20,20
1748425050403,CSE 170,A03,914968,Vaccaro; Kristen Marie,17,0,20,3
1748425050403,CSE 170,A04,914969,Vaccaro; Kristen Marie,15,0,20,5
1748425050403,CSE 170,A05,914970,Vaccaro; Kristen Marie,17,0,20,3
1748425050403,CSE 170,A06,914971,Vaccaro; Kristen Marie,18,0,20,2
1748425050403,CSE 170,A07,914972,Vaccaro; Kristen Marie,16,0,19,3
1748425050403,CSE 170,A08,914973,Vaccaro; Kristen Marie,1,0,19,18
1748425050403,CSE 170,A09,914974,Vaccaro; Kristen Marie,8,0,19,11
1748425050403,CSE 170,A10,969577,Vaccaro; Kristen Marie,18,0,19,1
1748425051429,CSE 190,A00,914975,Vaccaro; Kristen Marie,146,0,146,0
1748425052458,CSE 191,A00,914976,Minnes Kemp; Mor Mia,9999,0,9999,0
1748425053489,CSE 193,A01,959007,Bonjour; Trevor,50,0,50,0
1748425054516,CSE 194,A01,959009,Munyaka; Imani N. S.,6,0,60,54
1748425055542,CSE 197,001,914980,Minnes Kemp; Mor Mia,9999,0,9999,0
1748425056568,CSE 202,A00,914981,Liu; Qipeng,0,0,0,0
1748425057594,CSE 206A,A00,914982,Micciancio; Daniele,0,0,0,0
1748425058622,CSE 207B,A00,914983,Heninger; Nadia A,0,0,0,0
1748425059648,CSE 209A,A00,914984,Impagliazzo; Russell,0,0,0,0
1748425060674,CSE 209B,A00,914985,Bellare; Mihir,0,0,0,0
1748425061702,CSE 210,A00,914986,Powell; Thomas Allan,0,0,0,0
1748425062734,CSE 216,A00,914987,Munyaka; Imani N. S.,0,0,0,0
1748425063761,CSE 221,A00,914988,Ousterhout; Amy,0,0,0,0
1748425064803,CSE 227,A00,914989,Fernandes; Earlence T,0,0,0,0
1748425065834,CSE 229A,A00,914990,Snoeren; Alex C.,0,0,0,0
1748425066864,CSE 229C,A00,914993,Fernandes; Earlence T,0,0,0,0
1748425067892,CSE 237C,A00,914994,Kastner; Ryan Charles,0,0,0,0
1748425068921,CSE 239B,A00,914996,D'Antoni; Loris,0,0,0,0
1748425069952,CSE 240A,A00,914997,Tullsen; Dean Michael,0,0,0,0
1748425070978,CSE 249E,A00,914998,Pannuto; Patrick William,0,0,0,0
1748425072012,CSE 250A,A00,914999,Bonjour; Trevor,0,0,0,0
1748425073091,CSE 252A,A00,915000,Ochoa; Benjamin Lawrence,0,0,0,0
1748425074122,CSE 258,A01,959794,McAuley; Julian John,0,0,0,0
1748425075154,CSE 258R,A01,915004,McAuley; Julian John,0,0,0,0
1748425076180,CSE 259,A00,915005,Prithviraj; Ammanabrolu,0,0,0,0
1748425077213,CSE 260,A01,959011,Chin; Bryan W.,0,0,0,0
1748425078239,CSE 270,A01,959012,Chern; Albert Ren-Haur,0,0,0,0
1748425079264,CSE 276A,A00,915009,Christensen; Henrik I,0,0,0,0
1748425080293,CSE 290,A00,915013,Bafna; Vineet,0,0,0,0
1748425080293,CSE 290,B00,915014,Nakashole; Ndapandula,0,0,0,0
1748425080293,CSE 290,C00,915015,Ramamoorthi; Ravi,0,0,0,0
1748425080293,CSE 290,D00,915017,Tullsen; Dean Michael,0,0,0,0
1748425080293,CSE 290,F00,915020,Vaccaro; Kristen Marie,0,0,0,0
1748425081331,CSE 291A,A00,915021,Yu; Qi,0,0,0,0
1748425081331,CSE 291A,B00,915022,Weibel; Nadir,0,0,0,0
1748425081331,CSE 291A,C00,915049,Munyaka; Imani N. S.,0,0,0,0
1748425081331,CSE 291A,D00,968730,Zhang; Yiying,0,0,0,0
1748425082357,CSE 291P,A00,915050,D'Antoni; Loris,0,0,0,0
1748425082357,CSE 291P,B00,915051,Ding; Yufei,0,0,0,0
1748425083384,CSE 291T,A00,915052,Grier; Daniel T,0,0,0,0
1748425083384,CSE 291T,B00,915053,Heninger; Nadia A,0,0,0,0
1748425084410,CSE 291Y,A00,915054,Fernandes; Earlence T,0,0,0,0
1748425085444,CSE 292,A00,968504,Ousterhout; Amy,0,0,0,0
1748425086486,CSE 293,001,968115,Bafna; Vineet,9999,0,9999,0
1748425086486,CSE 293,002,968116,Bellare; Mihir,9999,0,9999,0
1748425086486,CSE 293,003,968122,Berg-Kirkpatrick; Taylor D,9999,0,9999,0
1748425086486,CSE 293,004,968298,Chandraker; Manmohan Krishna,9999,0,9999,0
1748425086486,CSE 293,005,968317,Cheng; Chung Kuan,9999,0,9999,0
1748425086486,CSE 293,006,968334,Christensen; Henrik I,9999,0,9999,0
1748425086486,CSE 293,007,968339,Coblenz; Michael J,9999,0,9999,0
1748425086486,CSE 293,008,968345,Cottrell; Garrison W,9999,0,9999,0
1748425086486,CSE 293,009,968346,Deutsch; Alin Bernard,9999,0,9999,0
1748425086486,CSE 293,010,968357,Esmaeilzadeh; Hadi,9999,0,9999,0
1748425086486,CSE 293,011,968359,Freund; Yoav,9999,0,9999,0
1748425086486,CSE 293,012,968427,Griswold; William G.,9999,0,9999,0
1748425086486,CSE 293,013,968472,Gymrek; Melissa Ann,9999,0,9999,0
1748425086486,CSE 293,014,968473,Heninger; Nadia A,9999,0,9999,0
1748425086486,CSE 293,015,968480,Impagliazzo; Russell,9999,0,9999,0
1748425086486,CSE 293,016,968489,Jhala; Ranjit,9999,0,9999,0
1748425086486,CSE 293,017,968490,Kahng; Andrew Byun,9999,0,9999,0
1748425086486,CSE 293,018,968494,Kane; Daniel Mertz,9999,0,9999,0
1748425086486,CSE 293,019,968495,Kriegman; David J,9999,0,9999,0
1748425086486,CSE 293,020,968496,Kumar; Arun Kumar,9999,0,9999,0
1748425086486,CSE 293,021,968497,Lerner; Sorin,9999,0,9999,0
1748425086486,CSE 293,022,968498,Lovett; Shachar,9999,0,9999,0
1748425086486,CSE 293,023,968499,McAuley; Julian John,9999,0,9999,0
1748425086486,CSE 293,024,968501,Micciancio; Daniele,9999,0,9999,0
1748425086486,CSE 293,025,968502,Orailoglu; Alex,9999,0,9999,0
1748425086486,CSE 293,026,968503,Pannuto; Patrick William,9999,0,9999,0
1748425086486,CSE 293,027,968505,Paturi; Ramamohan,9999,0,9999,0
1748425086486,CSE 293,028,968506,Polikarpova; Nadezhda,9999,0,9999,0
1748425086486,CSE 293,029,968507,Politz; Joseph Gibbs,9999,0,9999,0
1748425086486,CSE 293,030,968508,Porter; George M,9999,0,9999,0
1748425086486,CSE 293,031,968509,Porter; Leonard Emerson,9999,0,9999,0
1748425086486,CSE 293,032,968510,Ramamoorthi; Ravi,9999,0,9999,0
1748425086486,CSE 293,033,968511,Riek; Laurel D,9999,0,9999,0
1748425086486,CSE 293,034,968512,Sahoo; Debashis,9999,0,9999,0
1748425086486,CSE 293,035,968513,Saul; Lawrence,9999,0,9999,0
1748425086486,CSE 293,036,968514,Savage; Stefan,9999,0,9999,0
1748425086486,CSE 293,037,968515,Schulze; Jurgen P.,9999,0,9999,0
1748425086486,CSE 293,038,968516,Snoeren; Alex C.,9999,0,9999,0
1748425086486,CSE 293,039,968517,Shang; Jingbo,9999,0,9999,0
1748425086486,CSE 293,040,968575,Stefan; Deian,9999,0,9999,0
1748425086486,CSE 293,041,968580,Su; Hao,9999,0,9999,0
1748425086486,CSE 293,042,968589,Swanson; Steven James,9999,0,9999,0
1748425086486,CSE 293,043,968639,Tullsen; Dean Michael,9999,0,9999,0
1748425086486,CSE 293,044,968674,Vaccaro; Kristen Marie,9999,0,9999,0
1748425086486,CSE 293,045,968681,Voelker; Geoffrey M.,9999,0,9999,0
1748425086486,CSE 293,046,968692,Zhao; Jishen,9999,0,9999,0
1748425086486,CSE 293,047,968694,Zhou; Yuan-Yuan,9999,0,9999,0
1748425086486,CSE 293,048,968702,Gao; Sicun,9999,0,9999,0
1748425086486,CSE 293,049,968703,Weibel; Nadir,9999,0,9999,0
1748425086486,CSE 293,050,968704,Gupta; Rajesh K.,9999,0,9999,0
1748425086486,CSE 293,051,968705,Soosai Raj; Adalbert Geral,9999,0,9999,0
1748425087515,CSE 294,A00,915055,Orailoglu; Alex,0,0,0,0
1748425088542,CSS 1,A01,958041,Staff,31,0,41,10
1748425088542,CSS 1,A02,958042,Staff,41,0,41,0
1748425088542,CSS 1,A03,958043,Staff,33,0,41,8
1748425088542,CSS 1,A04,958044,Staff,39,0,41,2
1748425089569,CSS 120,A01,915059,Staff,0,0,0,0
1748425090597,CSS 204,A01,915061,Long; Bria,0,0,0,0
1748425091626,CSS 209,A00,915062,Staff,14,0,40,26
1748425092658,DDPM 200,A00,919742,Ma; Joseph David,35,0,35,0
1748425093687,DDPM 201,A00,919743,Ma; Joseph David,35,0,35,0
1748425094714,DDPM 202,A00,919761,Reed; Chantal,35,0,35,0
1748425095744,DDPM 203,A00,963085,Momper; Jeremiah D,40,0,40,0
1748425096806,DOC 1,A01,916077,Staff,4,0,4,0
1748425096806,DOC 1,A02,916080,Staff,1,0,4,3
1748425096806,DOC 1,A03,916081,Staff,1,0,4,3
1748425096806,DOC 1,A04,916082,Staff,3,0,4,1
1748425096806,DOC 1,A05,916083,Staff,2,0,4,2
1748425096806,DOC 1,A06,916084,Staff,4,0,4,0
1748425096806,DOC 1,A07,916085,Staff,4,0,4,0
1748425096806,DOC 1,A08,916096,Staff,4,0,4,0
1748425096806,DOC 1,A09,916097,Staff,4,0,4,0
1748425096806,DOC 1,A10,916099,Staff,4,0,4,0
1748425096806,DOC 1,A11,916170,Staff,0,0,0,0
1748425096806,DOC 1,A12,916186,Staff,0,0,0,0
1748425096806,DOC 1,A13,916203,Staff,4,0,4,0
1748425096806,DOC 1,A14,916222,Staff,4,0,4,0
1748425096806,DOC 1,A15,916223,Staff,4,0,4,0
1748425096806,DOC 1,A16,916224,Staff,4,0,4,0
1748425096806,DOC 1,B01,916279,Staff,4,0,4,0
1748425096806,DOC 1,B02,916281,Staff,2,0,4,2
1748425096806,DOC 1,B03,916282,Staff,3,0,4,1
1748425096806,DOC 1,B04,916283,Staff,3,0,4,1
1748425096806,DOC 1,B05,916284,Staff,2,0,4,2
1748425096806,DOC 1,B06,916285,Staff,3,0,4,1
1748425096806,DOC 1,B07,916287,Staff,4,0,4,0
1748425096806,DOC 1,B08,916288,Staff,3,0,4,1
1748425096806,DOC 1,B09,916289,Staff,0,0,0,0
1748425096806,DOC 1,B10,916290,Staff,0,0,0,0
1748425096806,DOC 1,B11,916349,Staff,4,0,4,0
1748425096806,DOC 1,B12,916375,Staff,4,0,4,0
1748425096806,DOC 1,B13,916381,Staff,3,0,4,1
1748425096806,DOC 1,B14,916382,Staff,2,0,4,2
1748425096806,DOC 1,B15,916383,Staff,4,0,4,0
1748425096806,DOC 1,B16,916384,Staff,3,0,4,1
1748425096806,DOC 1,C01,916386,Staff,4,0,4,0
1748425096806,DOC 1,C02,916387,Staff,4,0,4,0
1748425096806,DOC 1,C03,916388,Staff,4,0,4,0
1748425096806,DOC 1,C04,916389,Staff,0,0,4,4
1748425096806,DOC 1,C05,916390,Staff,2,0,4,2
1748425096806,DOC 1,C06,916391,Staff,2,0,4,2
1748425096806,DOC 1,C07,916392,Staff,4,0,4,0
1748425096806,DOC 1,C08,916417,Staff,4,0,4,0
1748425096806,DOC 1,C09,916418,Staff,0,0,0,0
1748425096806,DOC 1,C10,916426,Staff,0,0,0,0
1748425096806,DOC 1,C11,916497,Staff,4,0,4,0
1748425096806,DOC 1,C12,916506,Staff,3,0,4,1
1748425096806,DOC 1,C13,916507,Staff,3,0,4,1
1748425096806,DOC 1,C14,916508,Staff,3,0,4,1
1748425096806,DOC 1,C15,916509,Staff,4,0,4,0
1748425096806,DOC 1,C16,916510,Staff,4,0,4,0
1748425096806,DOC 1,D01,916512,Staff,4,0,4,0
1748425096806,DOC 1,D02,916513,Staff,4,0,4,0
1748425096806,DOC 1,D03,916514,Staff,4,0,4,0
1748425096806,DOC 1,D04,916515,Staff,4,0,4,0
1748425096806,DOC 1,D05,916516,Staff,1,0,4,3
1748425096806,DOC 1,D06,916555,Staff,4,0,4,0
1748425096806,DOC 1,D07,916581,Staff,4,0,4,0
1748425096806,DOC 1,D08,916582,Staff,4,0,4,0
1748425096806,DOC 1,D09,916583,Staff,0,0,0,0
1748425096806,DOC 1,D10,916584,Staff,0,0,0,0
1748425096806,DOC 1,D11,916585,Staff,4,0,4,0
1748425096806,DOC 1,D12,916586,Staff,4,0,4,0
1748425096806,DOC 1,D13,916587,Staff,4,0,4,0
1748425096806,DOC 1,D14,916588,Staff,4,0,4,0
1748425096806,DOC 1,D15,916589,Staff,3,0,4,1
1748425096806,DOC 1,D16,916590,Staff,4,0,4,0
1748425097834,DOC 100D,A00,916591,Pass; Natalye,22,0,25,3
1748425097834,DOC 100D,B00,916838,Pass; Natalye,22,0,25,3
1748425098863,DSC 10,A01,915848,Tiefenbruck; Janine LoBue,0,0,0,0
1748425098863,DSC 10,B01,915851,Tiefenbruck; Janine LoBue,0,0,0,0
1748425098863,DSC 10,C01,915854,Tiefenbruck; Janine LoBue,0,0,0,0
1748425099893,DSC 20,A01,915857,Langlois; Marina,87,0,90,3
1748425100920,DSC 30,A01,915859,Liao; Soohyun Nam,175,0,180,5
1748425101951,DSC 40A,A01,915861,Mishne; Gal,167,0,180,13
1748425102983,DSC 40B,A01,915863,Langlois; Marina,126,0,149,23
1748425104010,DSC 80,A01,915865,Eldridge; Justin Matthew,117,0,145,28
1748425104010,DSC 80,B01,915867,Eldridge; Justin Matthew,140,0,145,5
1748425105041,DSC 95,A01,915869,Langlois; Marina,50,0,50,0
1748425106074,DSC 100,A01,915871,Shannon; Kyle Michael,97,0,150,53
1748425107107,DSC 102,A01,915890,Kolovos; Alexandros,128,0,150,22
1748425108135,DSC 106,A01,915892,Lau; Samuel Ethan,74,0,90,16
1748425108135,DSC 106,B01,915894,Lau; Samuel Ethan,53,0,90,37
1748425109161,DSC 140A,A01,915896,Ustun; Tevfik Berk,135,0,150,15
1748425110190,DSC 161,A00,968072,Roberts; Margaret Earling,24,0,25,1
1748425111236,DSC 180A,A01,915898,Bellur; Umesh,0,0,0,0
1748425111236,DSC 180A,A02,969828,Bellur; Umesh,0,0,0,0
1748425111236,DSC 180A,A03,969829,Bellur; Umesh,0,0,0,0
1748425111236,DSC 180A,A04,969830,Bellur; Umesh,0,0,0,0
1748425111236,DSC 180A,A05,969831,Bellur; Umesh,0,0,0,0
1748425111236,DSC 180A,A06,969833,Bellur; Umesh,0,0,0,0
1748425111236,DSC 180A,A07,969835,Bellur; Umesh,0,0,0,0
1748425111236,DSC 180A,A08,969836,Bellur; Umesh,0,0,0,0
1748425111236,DSC 180A,A09,969978,Bellur; Umesh,0,0,0,0
1748425111236,DSC 180A,A10,969985,Bellur; Umesh,0,0,0,0
1748425111236,DSC 180A,A11,969986,Bellur; Umesh,0,0,0,0
1748425111236,DSC 180A,A12,970002,Bellur; Umesh,0,0,0,0
1748425111236,DSC 180A,A13,970008,Bellur; Umesh,0,0,0,0
1748425111236,DSC 180A,A14,970011,Bellur; Umesh,0,0,0,0
1748425111236,DSC 180A,A15,970014,Bellur; Umesh,0,0,0,0
1748425111236,DSC 180A,A16,970019,Bellur; Umesh,0,0,0,0
1748425111236,DSC 180A,A17,970020,Bellur; Umesh,0,0,0,0
1748425111236,DSC 180A,B01,915901,Bellur; Umesh,0,0,0,0
1748425111236,DSC 180A,B02,915902,Bellur; Umesh,0,0,0,0
1748425111236,DSC 180A,B03,970021,Bellur; Umesh,0,0,0,0
1748425111236,DSC 180A,B04,970024,Bellur; Umesh,0,0,0,0
1748425111236,DSC 180A,B05,970025,Bellur; Umesh,0,0,0,0
1748425111236,DSC 180A,B06,970028,Bellur; Umesh,0,0,0,0
1748425111236,DSC 180A,B07,970030,Bellur; Umesh,0,0,0,0
1748425111236,DSC 180A,B08,970031,Bellur; Umesh,0,0,0,0
1748425111236,DSC 180A,B09,970034,Bellur; Umesh,0,0,0,0
1748425111236,DSC 180A,B10,970035,Bellur; Umesh,0,0,0,0
1748425111236,DSC 180A,B11,970042,Bellur; Umesh,0,0,0,0
1748425111236,DSC 180A,B12,970043,Bellur; Umesh,0,0,0,0
1748425111236,DSC 180A,B13,970047,Bellur; Umesh,0,0,0,0
1748425111236,DSC 180A,B14,970049,Bellur; Umesh,0,0,0,0
1748425111236,DSC 180A,B15,970050,Bellur; Umesh,0,0,0,0
1748425111236,DSC 180A,B16,970052,Bellur; Umesh,0,0,0,0
1748425111236,DSC 180A,B17,970057,Bellur; Umesh,0,0,0,0
1748425111236,DSC 180A,B18,970060,Bellur; Umesh,0,0,0,0
1748425111236,DSC 180A,B19,970063,Bellur; Umesh,0,0,0,0
1748425111236,DSC 180A,B20,970068,Bellur; Umesh,0,0,0,0
1748425111236,DSC 180A,B21,970070,Bellur; Umesh,0,0,0,0
1748425111236,DSC 180A,B22,970071,Bellur; Umesh,0,0,0,0
1748425111236,DSC 180A,B23,970075,Bellur; Umesh,0,0,0,0
1748425111236,DSC 180A,B24,970076,Bellur; Umesh,0,0,0,0
1748425111236,DSC 180A,B25,970083,Bellur; Umesh,0,0,0,0
1748425111236,DSC 180A,B26,970072,Bellur; Umesh,0,0,0,0
1748425112272,DSC 190,A01,915904,Schwartzman; Armin,176,0,200,24
1748425112272,DSC 190,C01,915908,Ma; Yian,48,0,60,12
1748425113304,DSC 197,001,971692,Eldridge; Justin Matthew,9999,0,9999,0
1748425114335,DSC 200,A00,915909,Watson-Parris; Duncan,0,0,100,100
1748425115371,DSC 204A,A00,915910,Zhang; Hao,65,0,90,25
1748425116396,DSC 207R,A01,915912,Soosai Raj; Adalbert Geral,99,0,100,1
1748425117425,DSC 209R,A01,915922,Lau; Samuel Ethan,34,0,75,41
1748425118452,DSC 210,A00,915979,Weng; Tsui-Wei (lily),0,0,100,100
1748425119480,DSC 212,A00,915984,Mazumdar; Arya,0,0,90,90
1748425120507,DSC 215R,A01,916032,Saab; Rayan,99,0,100,1
1748425122561,DSC 241,A00,916052,Aoi; Mikio C,81,0,90,9
1748425123591,DSC 256R,A01,916054,McAuley; Julian John,42,0,100,58
1748425124618,DSC 257R,A01,916057,Dasgupta; Sanjoy,50,0,75,25
1748425125645,DSC 261,A00,916058,Salimi; Babak,0,0,90,90
1748425126678,DSC 291,A00,916059,Rahman; Tauhidur,0,0,60,60
1748425126678,DSC 291,B00,916060,Wang; Yuxiang,0,0,60,60
1748425126678,DSC 291,C00,916061,Li; Aobo,0,0,40,40
1748425127706,DSC 293,A00,916062,Ustun; Tevfik Berk,9983,0,9999,16
1748425128737,DSC 294,001,970730,Danks; David J,9999,0,9999,0
1748425128737,DSC 294,002,970731,Hu; Zhiting,9999,0,9999,0
1748425128737,DSC 294,003,970732,Schwartzman; Armin,9999,0,9999,0
1748425128737,DSC 294,004,970739,Salimi; Babak,9999,0,9999,0
1748425128737,DSC 294,005,970742,Wang; Yuxiang,9999,0,9999,0
1748425128737,DSC 294,006,970749,Huang; Biwei,9999,0,9999,0
1748425128737,DSC 294,007,970751,Amariuta-Bartell; Tiffany,9999,0,9999,0
1748425128737,DSC 294,008,970754,Smarr; Benjamin,9999,0,9999,0
1748425128737,DSC 294,009,970755,Jin; Haojian,9999,0,9999,0
1748425128737,DSC 294,010,970758,Ma; Yian,9999,0,9999,0
1748425128737,DSC 294,011,970763,Warstadt; Alexander Scott,9999,0,9999,0
1748425128737,DSC 294,012,970764,Wang; Yusu,9999,0,9999,0
1748425128737,DSC 294,013,970766,Lau; Samuel Ethan,9999,0,9999,0
1748425128737,DSC 294,014,970771,Politis; Dimitris,9999,0,9999,0
1748425129768,DSE 200,A00,915842,Staff,30,0,30,0
1748425130795,DSE 203,A00,915844,Staff,20,0,20,0
1748425131824,DSE 220,A00,915845,Staff,20,0,20,0
1748425132851,DSE 290,A00,915846,Staff,30,0,30,0
1748425133888,DSGN 1,A01,913417,Meyer; Michael Wayne,0,0,50,50
1748425133888,DSGN 1,A02,913418,Meyer; Michael Wayne,15,0,50,35
1748425135943,DSGN 118,A01,914325,Xia; Haijun,0,0,50,50
1748425136972,DSGN 201,A00,970721,Eikey; Elizabeth Victoria,10,0,20,10
1748425138012,ECE 5,A01,917741,Morris; Karcher William,0,0,0,0
1748425138012,ECE 5,A02,917742,Morris; Karcher William,0,0,0,0
1748425138012,ECE 5,A03,917775,Morris; Karcher William,0,0,0,0
1748425138012,ECE 5,A04,917804,Morris; Karcher William,0,0,0,0
1748425138012,ECE 5,A05,917811,Morris; Karcher William,0,0,0,0
1748425138012,ECE 5,A06,917816,Morris; Karcher William,0,0,0,0
1748425139041,ECE 15,A01,917850,Schurgers; Curt,0,0,0,0
1748425139041,ECE 15,A02,917851,Schurgers; Curt,0,0,0,0
1748425140069,ECE 17,A01,917878,Sahay; Rajeev,61,0,65,4
1748425141099,ECE 18,A01,917886,Sahay; Rajeev,42,0,50,8
1748425142148,ECE 25,A50,917898,Liu; Zhaowei,0,0,0,0
1748425142148,ECE 25,A51,917900,Liu; Zhaowei,0,0,0,0
1748425142148,ECE 25,A52,917904,Liu; Zhaowei,0,0,0,0
1748425142148,ECE 25,A53,969573,Liu; Zhaowei,0,0,0,0
1748425143177,ECE 30,A50,917909,Mir Arabbaygi; Siavash,11,0,30,19
1748425143177,ECE 30,A51,917910,Mir Arabbaygi; Siavash,21,0,30,9
1748425143177,ECE 30,A52,917912,Mir Arabbaygi; Siavash,29,0,30,1
1748425144227,ECE 35,A50,917993,Schurgers; Curt,0,0,0,0
1748425144227,ECE 35,A51,917994,Schurgers; Curt,0,0,0,0
1748425144227,ECE 35,A52,918000,Schurgers; Curt,0,0,0,0
1748425144227,ECE 35,A53,918001,Schurgers; Curt,0,0,0,0
1748425144227,ECE 35,A54,918072,Schurgers; Curt,0,0,0,0
1748425144227,ECE 35,A55,918078,Schurgers; Curt,0,0,0,0
1748425144227,ECE 35,B50,918131,Schurgers; Curt,0,0,0,0
1748425144227,ECE 35,B51,918135,Schurgers; Curt,0,0,0,0
1748425144227,ECE 35,B52,918146,Schurgers; Curt,0,0,0,0
1748425144227,ECE 35,B53,918147,Schurgers; Curt,0,0,0,0
1748425144227,ECE 35,B54,918148,Schurgers; Curt,0,0,0,0
1748425144227,ECE 35,B55,918149,Schurgers; Curt,0,0,0,0
1748425145254,ECE 45,A01,918151,Zeger; Kenneth A.,94,0,120,26
1748425146284,ECE 65,A50,918356,Baghdadchi; Saharnaz,1,0,30,29
1748425146284,ECE 65,A51,918470,Baghdadchi; Saharnaz,17,0,30,13
1748425146284,ECE 65,A52,918477,Baghdadchi; Saharnaz,25,0,30,5
1748425147313,ECE 100,A01,918485,Baghdadchi; Saharnaz,0,0,30,30
1748425147313,ECE 100,A02,918486,Baghdadchi; Saharnaz,1,0,30,29
1748425147313,ECE 100,A03,918488,Baghdadchi; Saharnaz,0,0,30,30
1748425147313,ECE 100,A04,918490,Baghdadchi; Saharnaz,22,0,30,8
1748425148339,ECE 101,A01,918495,Zheng; Yang,21,0,75,54
1748425148339,ECE 101,A02,918497,Zheng; Yang,51,0,75,24
1748425149368,ECE 102,A00,918499,Hsueh; Tzu-Chien,52,0,100,48
1748425150400,ECE 103,A01,918621,Ng; Tse Nga,45,0,60,15
1748425151429,ECE 107,A01,918642,Fullerton; Eric E,31,0,70,39
1748425152485,ECE 108,A01,918661,Turakhia; Yatish Girish,6,0,70,64
1748425153519,ECE 109,A01,918758,Poveda Fonseca; Jorge,122,0,149,27
1748425154547,ECE 111,A01,918766,Koushanfar; Farinaz,46,0,75,29
1748425155578,ECE 121A,A50,918857,Esmaili; Gholamreza,11,0,24,13
1748425155578,ECE 121A,A51,918888,Esmaili; Gholamreza,15,0,24,9
1748425155578,ECE 121A,A52,918889,Esmaili; Gholamreza,2,0,24,22
1748425156610,ECE 128A,A00,918911,Esmaili; Gholamreza,53,0,75,22
1748425157638,ECE 135A,A01,918931,Kuzum; Duygu,24,0,40,16
1748425158665,ECE 143,A00,918936,Staff,0,0,0,3
1748425159693,ECE 148,A01,918940,Silberman; Jack,14,0,24,10
1748425160726,ECE 155,A01,919022,Gonzalez Prelcic; Nuria,20,0,25,5
1748425161758,ECE 158A,A01,919041,Javidi; Tara,58,0,70,12
1748425162789,ECE 161A,A01,919070,Meyer; Florian,65,0,80,15
1748425163818,ECE 164,A00,919098,Hall; Drew A.,100,0,146,46
1748425164848,ECE 166,A50,919250,Rebeiz; Gabriel,0,0,30,30
1748425164848,ECE 166,A51,919254,Rebeiz; Gabriel,23,0,30,7
1748425164848,ECE 166,A52,919262,Rebeiz; Gabriel,29,0,30,1
1748425164848,ECE 166,A53,919316,Rebeiz; Gabriel,28,0,30,2
1748425165877,ECE 171B,A01,919338,Shi; Yuanyuan,36,0,50,14
1748425166904,ECE 174,A01,919371,Wang; Jun-Kun,77,0,100,23
1748425167931,ECE 180,A00,968047,Fainman; Yeshaiahu,30,0,30,0
1748425168965,ECE 182,A01,962444,Fainman; Yeshaiahu,24,0,30,6
1748425169992,ECE 197,001,919379,Mercier; Patrick Philip,9999,0,9999,0
1748425171025,ECE 198,001,919418,Nguyen; Truong Quang,9999,0,9999,0
1748425172053,ECE 201,A00,919420,Lo; Yu-Hwa,0,0,0,0
1748425173087,ECE 203,A01,919506,Mercier; Patrick Philip,0,0,0,0
1748425174124,ECE 207A,A00,919507,Liu; Thomas Tao-Ming & McVeigh; Elliot R.,0,0,0,0
1748425175152,ECE 212AN,A00,919508,Nomura; Kenji,0,0,0,0
1748425176179,ECE 222A,A00,919524,Rebeiz; Gabriel,0,0,0,0
1748425177265,ECE 225A,A00,919525,Orlitsky; Alon,0,0,0,0
1748425178290,ECE 230A,A00,919526,Nomura; Kenji,0,0,0,0
1748425179324,ECE 238A,A00,919540,Luo; Jian,0,0,0,0
1748425180351,ECE 240A,A00,919541,Ndao; Abdoulaye,0,0,0,0
1748425181378,ECE 247A,A00,919553,Shi; Lingyan,0,0,0,0
1748425182406,ECE 247B,A00,919562,Aran; Kiana,0,0,0,0
1748425183433,ECE 250,A00,919563,Naghizadeh Ardabili; Parinaz,0,0,0,0
1748425184467,ECE 251C,A00,919583,Parhi; Rahul,0,0,0,0
1748425185493,ECE 253,A00,919597,Nguyen; Truong Quang,0,0,0,0
1748425186527,ECE 255A,A00,919638,Orlitsky; Alon,0,0,0,0
1748425187559,ECE 257A,A01,919640,Zhang; Xinyu,0,0,0,0
1748425188587,ECE 258A,A00,919653,Heath Jr.; Robert Wendell,0,0,0,0
1748425189615,ECE 260A,A01,919655,Eldon; John,0,0,0,0
1748425190642,ECE 264C,A00,919656,Galton; Ian A,0,0,0,0
1748425191669,ECE 265C,A00,919672,Staff,0,0,0,0
1748425192703,ECE 271A,A00,919673,Vasconcelos; Nuno,0,0,0,0
1748425193731,ECE 276C,A00,919674,Yip; Michael,0,0,0,0
1748425194759,ECE 283,A00,919675,Le; Hanh-Phuc,0,0,0,0
1748425194759,ECE 283,B00,919676,Hall; Drew A.,0,0,0,0
1748425195794,ECE 284,A00,919691,Kang; Mingu,0,0,0,0
1748425196820,ECE 285,A00,919718,Naghizadeh Ardabili; Parinaz,0,0,0,0
1748425197854,ECON 1,A01,917129,Famulari; Melissa,33,0,40,7
1748425197854,ECON 1,A02,917130,Famulari; Melissa,39,0,40,1
1748425197854,ECON 1,A03,917131,Famulari; Melissa,45,0,45,0
1748425197854,ECON 1,B01,917133,Famulari; Melissa,39,0,40,1
1748425197854,ECON 1,B02,917134,Famulari; Melissa,38,0,40,2
1748425197854,ECON 1,B03,917135,Famulari; Melissa,45,0,45,0
1748425197854,ECON 1,C01,917137,Levkoff; Steven B.,53,0,60,7
1748425197854,ECON 1,C02,917138,Levkoff; Steven B.,60,0,60,0
1748425197854,ECON 1,C03,917139,Levkoff; Steven B.,59,0,60,1
1748425197854,ECON 1,C04,917140,Levkoff; Steven B.,60,0,60,0
1748425197854,ECON 1,C05,917141,Levkoff; Steven B.,59,0,60,1
1748425197854,ECON 1,D01,917144,Levkoff; Steven B.,44,0,50,6
1748425197854,ECON 1,D02,917145,Levkoff; Steven B.,50,0,50,0
1748425197854,ECON 1,D03,917146,Levkoff; Steven B.,50,0,50,0
1748425197854,ECON 1,D04,917154,Levkoff; Steven B.,50,0,50,0
1748425198883,ECON 2,A01,917160,Crane; Meredith Helen,35,0,45,10
1748425198883,ECON 2,A02,917164,Crane; Meredith Helen,43,0,45,2
1748425199912,ECON 3,A01,917170,Ma; Alyson Chan,41,0,60,19
1748425200940,ECON 4,A01,917174,Brooks; Marcus Raymond,0,0,0,0
1748425201969,ECON 5,A01,917177,Staff,12,0,30,18
1748425201969,ECON 5,B01,917182,Staff,16,0,30,14
1748425201969,ECON 5,C01,917193,Dai; Yinlin,0,0,30,30
1748425202998,ECON 86,A00,917197,Muendler; Marc,95,0,100,5
1748425204030,ECON 100A,A01,917209,Newhouse; Herbert S,32,0,50,18
1748425204030,ECON 100A,A02,917212,Newhouse; Herbert S,34,0,50,16
1748425204030,ECON 100A,A03,917213,Newhouse; Herbert S,41,0,50,9
1748425204030,ECON 100A,B01,917216,Newhouse; Herbert S,0,0,50,50
1748425204030,ECON 100A,B02,917298,Newhouse; Herbert S,21,0,50,29
1748425204030,ECON 100A,B03,917301,Newhouse; Herbert S,44,0,50,6
1748425205066,ECON 100B,A01,917305,Crane; Meredith Helen,0,0,75,75
1748425205066,ECON 100B,B01,917309,Crane; Meredith Helen,0,0,75,75
1748425206093,ECON 100C,A01,917311,Staff,0,0,25,25
1748425207128,ECON 109,A01,917313,Shishkin; Denis,58,0,65,7
1748425207128,ECON 109,B01,917315,Shishkin; Denis,59,0,75,16
1748425208158,ECON 110A,A01,917336,Jaimovich; Nir,44,0,70,26
1748425208158,ECON 110A,B01,917339,Jaimovich; Nir,19,0,37,18
1748425208158,ECON 110A,B02,917341,Jaimovich; Nir,36,0,38,2
1748425209188,ECON 110B,A01,917388,Trottner; Fabian Gunter We,0,0,50,50
1748425209188,ECON 110B,A02,917389,Trottner; Fabian Gunter We,0,0,50,50
1748425209188,ECON 110B,A03,917390,Trottner; Fabian Gunter We,14,0,50,36
1748425209188,ECON 110B,B01,917396,Trottner; Fabian Gunter We,24,0,50,26
1748425210227,ECON 120A,A01,917401,Dai; Yinlin,21,0,50,29
1748425210227,ECON 120A,A02,917405,Dai; Yinlin,40,0,50,10
1748425210227,ECON 120A,B01,917408,Dai; Yinlin,0,0,40,40
1748425210227,ECON 120A,B02,917409,Dai; Yinlin,0,0,40,40
1748425210227,ECON 120A,B03,917410,Dai; Yinlin,30,0,40,10
1748425211257,ECON 120B,A01,917415,Candido; Maria Teresa,0,0,98,98
1748425211257,ECON 120B,A02,917418,Candido; Maria Teresa,78,0,98,20
1748425211257,ECON 120B,B01,917422,Candido; Maria Teresa,33,0,98,65
1748425211257,ECON 120B,B02,917423,Candido; Maria Teresa,75,0,98,23
1748425212285,ECON 120C,A01,917505,Candido; Maria Teresa,81,0,146,65
1748425213313,ECON 121,A00,917511,Vogl; Tom Saul,68,0,70,2
1748425213313,ECON 121,B00,917516,Vogl; Tom Saul,55,0,70,15
1748425214339,ECON 130,A00,917518,Staff,165,0,190,25
1748425215365,ECON 131,A00,917519,Jacobsen; Mark,56,0,120,64
1748425216392,ECON 139,A00,917520,Arnold; David Hall,21,0,50,29
1748425217420,ECON 152,A00,917523,Fadlon; Yizhak,87,0,90,3
1748425217420,ECON 152,B00,917524,Fadlon; Yizhak,88,0,90,2
1748425218450,ECON 181,A00,965256,Esfahani; Sara,88,0,100,12
1748425219477,ECON 186,A00,917525,Ross; Stephen Geoffrey,80,0,110,30
1748425220508,ECON 191B,A00,917527,Cullen; Julie,20,0,20,0
1748425221535,ECON 200A,A00,917529,Shishkin; Denis,20,0,20,0
1748425222562,ECON 204,A00,917531,Watson; Joel Christopher,25,0,25,0
1748425223589,ECON 205,A00,917532,Du; Songzi,20,0,20,0
1748425224620,ECON 210A,A00,917536,Alon; Titan Michael,20,0,20,0
1748425225648,ECON 220A,A00,917537,Elliott; Graham,20,0,20,0
1748425226676,ECON 220D,A00,917538,Hamilton; James D.,22,0,30,8
1748425227709,ECON 221,A00,960527,Zhu; Ying,20,0,20,0
1748425228735,ECON 232,A00,917539,Fadlon; Yizhak,18,0,20,2
1748425229766,ECON 242,A00,917540,Vogl; Tom Saul & Lee; Munseob,17,0,20,3
1748425230794,ECON 250A,A00,917544,Berman; Eli & Betts; Julian & Arnold; David Hall,21,0,25,4
1748425231827,ECON 262,A00,917546,Trevino; Isabel,20,0,20,0
1748425232857,ECON 268,A00,917547,Boomhower; Judson P,18,0,20,2
1748425233883,ECON 280,A00,917549,Arnold; David Hall,20,0,20,0
1748425234918,ECON 281,A00,917550,Jacobsen; Mark,20,0,20,0
1748425234918,ECON 281,B00,917553,Jaimovich; Nir,15,0,20,5
1748425235948,ECON 285,A00,917554,Bharadwaj; Prashant & Zhu; Ying,24,0,25,1
1748425236979,ECON 286,A00,917556,Ma; Xinwei,20,0,20,0
1748425236979,ECON 286,B00,917558,Eckert; Fabian Paul & Wu; Pak Yeung,20,0,20,0
1748425236979,ECON 286,C00,917559,Bharadwaj; Prashant,20,0,20,0
1748425236979,ECON 286,D00,969571,Cullen; Julie,20,0,20,0
1748425236979,ECON 286,E00,969572,Vespa; Emanuel Ignacio,19,0,20,1
1748425238006,ECON 296,A00,917565,Bharadwaj; Prashant & Zhu; Ying,24,0,25,1
1748425239042,EDS 31,A00,960270,Bussey; Thomas J,5,0,10,5
1748425240074,EDS 88,A00,960441,Bintliff; Amy S.V.,16,0,20,4
1748425241105,EDS 110R,A01,943452,Wishard Guerra; Alison G.,33,0,60,27
1748425241105,EDS 110R,B01,960792,Wishard Guerra; Alison G.,20,0,20,0
1748425242139,EDS 111,A00,969314,Cohen; Shana R,31,0,60,29
1748425243167,EDS 112,A00,969313,Chapman; Thandeka K,32,0,50,18
1748425244197,EDS 114,A01,943493,Eguchi; Emi,19,0,20,1
1748425244197,EDS 114,A02,943494,Eguchi; Emi,18,0,20,2
1748425245228,EDS 115,A00,943495,Jones; Gabrielle Anastasia,46,0,60,14
1748425246257,EDS 117,A01,943675,Jones; Makeba,17,0,37,20
1748425246257,EDS 117,A02,943682,Jones; Makeba,36,0,37,1
1748425246257,EDS 117,A03,943683,Jones; Makeba,33,0,38,5
1748425246257,EDS 117,A04,943691,Jones; Makeba,35,0,38,3
1748425246257,EDS 117,B01,943693,Jones; Gabrielle Anastasia,21,0,30,9
1748425246257,EDS 117,B02,943694,Jones; Gabrielle Anastasia,27,0,30,3
1748425246257,EDS 117,B03,943695,Jones; Gabrielle Anastasia,28,0,30,2
1748425246257,EDS 117,B04,943696,Jones; Gabrielle Anastasia,30,0,30,0
1748425247286,EDS 124AR,A00,943698,Simon; Elizabeth A,129,0,150,21
1748425247286,EDS 124AR,B00,943699,Simon; Elizabeth A,149,0,150,1
1748425247286,EDS 124AR,C00,961307,Simon; Elizabeth A,40,0,40,0
1748425248313,EDS 124BR,A00,943700,Eguchi; Emi,122,0,150,28
1748425248313,EDS 124BR,B00,961276,Eguchi; Emi,20,0,20,0
1748425249342,EDS 125,A00,943701,Jones; Gabrielle Anastasia,49,0,60,11
1748425250374,EDS 129A,A01,943703,Heinzman; Erica M.,48,0,50,2
1748425251402,EDS 130,A01,943705,Staff,6,0,20,14
1748425251402,EDS 130,A02,943706,Staff,18,0,20,2
1748425251402,EDS 130,A03,943707,Staff,20,0,20,0
1748425252430,EDS 131,A01,943709,Staff,8,0,20,12
1748425252430,EDS 131,A02,943710,Staff,17,0,20,3
1748425253460,EDS 133,A01,960443,Bintliff; Amy S.V.,20,0,25,5
1748425253460,EDS 133,A02,960447,Bintliff; Amy S.V.,15,0,15,0
1748425254496,EDS 139,A00,943725,Heinzman; Erica M.,40,0,50,10
1748425254496,EDS 139,B00,943726,Staff,29,0,50,21
1748425254496,EDS 139,C00,943788,Staff,34,0,50,16
1748425254496,EDS 139,E00,943802,Bintliff; Amy S.V.,42,0,50,8
1748425254496,EDS 139,F00,960448,Bintliff; Amy S.V.,40,0,40,0
1748425255524,EDS 149,A00,943814,Black; Alison Michelle,20,0,20,0
1748425256552,EDS 201,A00,943816,Fine; Sarah,44,0,45,1
1748425257580,EDS 203,A01,943818,Eguchi; Emi,44,0,45,1
1748425258610,EDS 205A,A00,943819,Staff,44,0,45,1
1748425259642,EDS 246,A01,943855,Cohen; Shana R,10,0,10,0
1748425260670,EDS 250,A00,943856,Chapman; Thandeka K,49,0,50,1
1748425261701,EDS 251,A00,943862,Wishard Guerra; Alison G.,10,0,10,0
1748425262729,EDS 257,A00,943863,Datnow; Amanda Lee,7,0,10,3
1748425263757,EDS 283,A00,943871,Daly; Alan J.,15,0,15,0
1748425264784,EDS 285,A00,943872,Daly; Alan J.,15,0,15,0
1748425265811,EDS 286,A00,943873,Daly; Alan J.,15,0,15,0
1748425266837,EDS 289D,A00,943874,Hofstetter; Carolyn,15,0,15,0
1748425267867,EDS 292,A00,943876,Hofstetter; Carolyn,15,0,15,0
1748425268917,EDS 296,001,970523,Aragon; Maria Jose,9999,0,9999,0
1748425268917,EDS 296,002,970539,Bintliff; Amy S.V.,9997,0,9999,2
1748425268917,EDS 296,003,970543,Chapman; Thandeka K,9999,0,9999,0
1748425268917,EDS 296,004,970544,Clarke; Sherice Nicole,9999,0,9999,0
1748425268917,EDS 296,005,970587,Cohen; Shana R,9998,0,9999,1
1748425268917,EDS 296,006,970606,Daly; Alan J.,9998,0,9999,1
1748425268917,EDS 296,007,970607,Datnow; Amanda Lee,9997,0,9999,2
1748425268917,EDS 296,008,970608,Eguchi; Emi,9999,0,9999,0
1748425268917,EDS 296,009,970609,Fine; Sarah,9999,0,9999,0
1748425268917,EDS 296,010,970614,Hofstetter; Carolyn,9998,0,9999,1
1748425268917,EDS 296,011,970615,Hopkins; Megan Beth,9998,0,9999,1
1748425268917,EDS 296,012,970616,Jones; Makeba,9999,0,9999,0
1748425268917,EDS 296,013,970631,Jones; Gabrielle Anastasia,9999,0,9999,0
1748425268917,EDS 296,014,970636,Mamas; Christoforos,9998,0,9999,1
1748425268917,EDS 296,015,970649,Phuong; Andrew,9999,0,9999,0
1748425268917,EDS 296,016,970670,Pollock; Mica,9999,0,9999,0
1748425268917,EDS 296,017,970671,Wishard Guerra; Alison G.,9998,0,9999,1
1748425269948,EDS 297,001,972987,Staff,1,0,1,0
1748425270980,ENG 5,A00,916064,Rodriguez; Ruben,70,0,70,0
1748425272012,ENG 10,A00,916066,Evdokimenko; Ekaterina,58,0,60,2
1748425273042,ENG 15,A00,916067,Evdokimenko; Ekaterina,24,0,30,6
1748425274069,ENG 100D,A00,916069,Ngo; Anh-Thu T.,23,0,50,27
1748425275100,ENG 100L,A00,916070,Kleissl; Jan,8,0,8,0
1748425275100,ENG 100L,B00,916071,Bratton; Maryann,8,0,8,0
1748425275100,ENG 100L,C00,916072,Goldberg; Charles G.,8,0,8,0
1748425275100,ENG 100L,D00,916073,de Oliveira; Mauricio,8,0,8,0
1748425275100,ENG 100L,E00,916074,Bratton; Maryann,8,0,8,0
1748425275100,ENG 100L,F00,916075,Boyle; Mary E. T.,8,0,8,0
1748425276130,ENVR 30,A01,959899,Amoa-Bosompem; Michael,17,0,30,13
1748425276130,ENVR 30,A02,959900,Amoa-Bosompem; Michael,27,0,30,3
1748425276130,ENVR 30,A03,959901,Amoa-Bosompem; Michael,26,0,30,4
1748425276130,ENVR 30,A04,959902,Amoa-Bosompem; Michael,28,0,30,2
1748425276130,ENVR 30,A05,959903,Amoa-Bosompem; Michael,29,0,30,1
1748425276130,ENVR 30,A06,959904,Amoa-Bosompem; Michael,30,0,30,0
1748425277158,ENVR 102,A00,960031,Laughing; Cheron,23,0,25,2
1748425278192,ERC 20,A00,921227,Evans; Ivan T,30,0,30,0
1748425278192,ERC 20,B00,921229,Evans; Ivan T,30,0,30,0
1748425279225,ERC 88,A00,961214,Peterson; Johanna L,19,0,20,1
1748425280252,ESYS 101,A01,921233,Taylor; Jennifer Rebecca,21,0,32,11
1748425280252,ESYS 101,A02,921234,Taylor; Jennifer Rebecca,14,0,32,18
1748425280252,ESYS 101,A03,921235,Taylor; Jennifer Rebecca,20,0,32,12
1748425280252,ESYS 101,A04,921241,Taylor; Jennifer Rebecca,26,0,32,6
1748425281350,ESYS 187A,A01,921248,Hetherington; Elizabeth Dorsey,30,0,40,10
1748425281350,ESYS 187A,B01,921250,Shipp; Lauren Elizabeth,27,0,40,13
1748425282384,ETHN 1,A01,919800,Wilson; Brenda K,13,0,15,2
1748425282384,ETHN 1,A02,919843,Wilson; Brenda K,14,0,15,1
1748425282384,ETHN 1,A03,920214,Wilson; Brenda K,15,0,15,0
1748425282384,ETHN 1,A04,920215,Wilson; Brenda K,14,0,15,1
1748425282384,ETHN 1,A05,920223,Wilson; Brenda K,15,0,15,0
1748425282384,ETHN 1,A06,920224,Wilson; Brenda K,15,0,15,0
1748425282384,ETHN 1,A07,920225,Wilson; Brenda K,15,0,15,0
1748425282384,ETHN 1,A08,920226,Wilson; Brenda K,12,0,15,3
1748425282384,ETHN 1,A09,920237,Wilson; Brenda K,15,0,15,0
1748425282384,ETHN 1,A10,920368,Wilson; Brenda K,15,0,15,0
1748425282384,ETHN 1,A11,920402,Wilson; Brenda K,15,0,15,0
1748425282384,ETHN 1,A12,920406,Wilson; Brenda K,15,0,15,0
1748425282384,ETHN 1,A13,920410,Wilson; Brenda K,14,0,15,1
1748425282384,ETHN 1,A14,920441,Wilson; Brenda K,14,0,15,1
1748425283409,ETHN 20R,A01,920461,Sasaki; Christen T,0,0,15,15
1748425283409,ETHN 20R,A02,920467,Sasaki; Christen T,0,0,15,15
1748425283409,ETHN 20R,A03,920468,Sasaki; Christen T,0,0,15,15
1748425283409,ETHN 20R,A04,920470,Sasaki; Christen T,0,0,15,15
1748425284437,ETHN 100A,A00,920489,Patel; Shaista,18,0,35,17
1748425285470,ETHN 101TV,A01,920518,Gallagher-Geurtsen; Tricia Meghan,21,0,25,4
1748425285470,ETHN 101TV,A02,920519,Gallagher-Geurtsen; Tricia Meghan,20,0,25,5
1748425285470,ETHN 101TV,A03,920522,Gallagher-Geurtsen; Tricia Meghan,24,0,25,1
1748425285470,ETHN 101TV,A04,920523,Gallagher-Geurtsen; Tricia Meghan,23,0,25,2
1748425286497,ETHN 110,A00,920528,Klann; Mary Cameron,27,0,35,8
1748425287524,ETHN 116,A00,920529,Cuong; Marisol,29,0,35,6
1748425288551,ETHN 120,A00,920542,Tran; Ly Thi Hai,31,0,35,4
1748425289577,ETHN 122A,A00,920559,Museus; Samuel David,30,0,35,5
1748425290607,ETHN 125R,A00,920694,Sasaki; Christen T,0,0,35,35
1748425291642,ETHN 130,A00,920703,Frank; Ross H.,28,0,30,2
1748425292677,ETHN 139,A00,920704,Ruiz; Ariana,18,0,20,2
1748425293708,ETHN 150,A00,920717,Taylor-Garcia; Daphne,16,0,16,0
1748425294741,ETHN 161,A00,920826,Browne; Errol Tsekani,33,0,35,2
1748425295767,ETHN 174,A00,963091,Staff,15,0,15,0
1748425296796,ETHN 186,A00,959881,Perez; Roy,25,0,30,5
1748425297840,ETHN 187,A00,920860,Martin Sandino; Amanda Maria Yoland,16,0,16,0
1748425298868,ETHN 189,A00,920861,Museus; Samuel David,18,0,20,2
1748425299901,ETHN 200A,A00,920862,Espiritu; Yen,7,0,10,3
1748425300930,ETHN 230,A00,920864,Perreira; Christopher Michael,8,0,10,2
1748425301957,ETIM 289,A00,921224,Patel; Shaista,10,0,10,0
1748425302985,EXPR 100,A00,964355,Staff,9999,0,9999,0
1748425304015,EXPR 105,A00,964356,Staff,9999,0,9999,0
1748425305045,EXPR 201,A00,964357,Staff,9999,0,9999,0
1748425306071,EXPR 205,A00,964358,Staff,9999,0,9999,0
1748425307101,FILM 71,A01,960804,Park; Joanne Moeun,0,0,11,11
1748425307101,FILM 71,B01,960877,Park; Joanne Moeun,3,0,11,8
1748425308130,FILM 72,A01,964349,Kroopf; Jackson Stanford,9,0,11,2
1748425308130,FILM 72,B01,964351,Kroopf; Jackson Stanford,9,0,11,2
1748425309157,FILM 73,A01,964345,Staff,0,0,0,0
1748425309157,FILM 73,B01,964347,Kroopf; Jackson Stanford,7,0,11,4
1748425310185,FMPH 291,A00,969582,Tsuyuki; Kiyomi,10,0,10,0
1748425311223,FPM 291,A00,922036,Rabin; Adrienn Borsika & Stadnick; Nicole & Aarons; Gregory A,12,0,12,0
1748425312250,GLBH 20,A00,921344,Elwardani; Nile Regina,137,0,146,9
1748425313278,GLBH 100,A00,921503,Jenkins; Janis A.,5,0,12,7
1748425313278,GLBH 100,B00,921504,Schonberg; Jeffrey,18,0,20,2
1748425314307,GLBH 111,A01,921733,Burgos; Jose L.,17,0,17,0
1748425314307,GLBH 111,B01,921862,Burgos; Jose L.,17,0,17,0
1748425315335,GLBH 114,A00,921864,Olivas Hernandez; Olga Lid,42,0,50,8
1748425316362,GLBH 116,A00,921865,Villarino; Margarita,41,0,45,4
1748425317393,GLBH 117,A00,921873,Villarino; Margarita,40,0,40,0
1748425318424,GLBH 118,A00,921884,Wilson; Brenda K,25,0,32,7
1748425319449,GLBH 119,A00,921956,Elwardani; Nile Regina,40,0,40,0
1748425320483,GLBH 148,A00,921961,Walkover; Lillian B,75,0,100,25
1748425321511,GLBH 181,A00,921962,Burgos; Jose L.,188,0,216,28
1748425322542,GLBH 200,A00,921963,Schonberg; Jeffrey,15,0,18,3
1748425323573,GLBH 201,A00,921982,Staff,16,0,18,2
1748425324599,GLBH 248,A00,921999,Kaiser; Bronwyn Nicole,16,0,18,2
1748425325632,GPEC 243,A00,946441,McCord; Gordon Carlos,96,0,100,4
1748425326667,GSS 20,A00,923030,Siapno; Jacqueline A,38,0,40,2
1748425326667,GSS 20,B00,923031,Siapno; Jacqueline A,36,0,40,4
1748425327697,HDS 1,A01,923033,Reese; Clarissa Jane,25,0,25,0
1748425327697,HDS 1,A02,923034,Reese; Clarissa Jane,20,0,25,5
1748425327697,HDS 1,A03,923035,Reese; Clarissa Jane,19,0,25,6
1748425327697,HDS 1,A04,923036,Reese; Clarissa Jane,22,0,25,3
1748425327697,HDS 1,A05,923037,Reese; Clarissa Jane,22,0,25,3
1748425327697,HDS 1,A06,923038,Reese; Clarissa Jane,23,0,25,2
1748425327697,HDS 1,A07,923039,Reese; Clarissa Jane,24,0,25,1
1748425328726,HDS 60,A01,923041,Staff,25,0,30,5
1748425328726,HDS 60,A02,923042,Staff,21,0,30,9
1748425329758,HDS 111,A00,923043,Staff,13,0,40,27
1748425330787,HDS 124,A00,923044,Staff,29,0,40,11
1748425331816,HDS 150,A00,923045,Staff,20,0,20,0
1748425332840,HDS 175,A00,923046,Staff,14,0,25,11
1748425333869,HDS 181,A01,923048,Staff,30,0,30,0
1748425334896,HDS 191,A01,923050,Reese; Clarissa Jane,25,0,25,0
1748425335925,HIEA 112,A00,922103,Matsumura; Wendy Y,92,0,115,23
1748425336952,HIEA 153,A00,922106,Henry; Todd A.,43,0,51,8
1748425337986,HIEU 108,A00,922108,Balberg; Mira,29,0,70,41
1748425339012,HIEU 114,A00,959889,Staff,59,0,70,11
1748425340047,HIEU 139,A00,922110,Strasser; Ulrike,40,0,51,11
1748425341075,HIEU 140,A00,922111,Radcliff; Pamela B.,58,0,65,7
1748425342104,HIEU 154,A00,922113,Hansen; Jan Eric,55,0,65,10
1748425343135,HIEU 158,A00,922116,Hertz; Deborah,61,0,70,9
1748425344165,HIEU 171,A00,922117,Hertz; Deborah,15,0,15,0
1748425345192,HIEU 271,A00,922189,Hertz; Deborah,0,0,0,0
1748425346220,HIGR 200,A00,922191,Matsumura; Wendy Y,10,0,10,0
1748425347247,HIGR 210,A00,922221,Muscolino; Micah S,8,0,10,2
1748425348275,HIGR 222,A00,963094,Biess; Frank Peter,10,0,10,0
1748425349309,HIGR 238,A00,922242,McKenzie; Kerry V.,9,0,10,1
1748425350336,HIGR 240,A00,922253,McKenzie; Kerry V.,10,0,10,0
1748425351363,HIGR 267A,A00,922256,Widener; Daniel,8,0,10,2
1748425353432,HILA 114,A00,922118,Cowan; Benjamin A,42,0,65,23
1748425354460,HILA 131,A00,922125,Vitz; Matthew,91,0,99,8
1748425355486,HILA 161,A00,922126,Cowan; Benjamin A,12,0,15,3
1748425356513,HILD 2A,A01,922043,Staff,31,0,32,1
1748425356513,HILD 2A,A02,922044,Staff,31,0,32,1
1748425356513,HILD 2A,A03,922046,Staff,28,0,32,4
1748425356513,HILD 2A,A04,922047,Staff,32,0,32,0
1748425356513,HILD 2A,A05,922051,Staff,30,0,32,2
1748425357540,HILD 7A,A01,922063,Widener; Daniel,31,0,32,1
1748425357540,HILD 7A,A02,922066,Widener; Daniel,31,0,32,1
1748425357540,HILD 7A,A03,922067,Widener; Daniel,32,0,32,0
1748425357540,HILD 7A,A04,922070,Widener; Daniel,28,0,32,4
1748425357540,HILD 7A,A05,922072,Widener; Daniel,32,0,32,0
1748425357540,HILD 7A,A06,922074,Widener; Daniel,32,0,32,0
1748425357540,HILD 7A,A07,922078,Widener; Daniel,29,0,32,3
1748425357540,HILD 7A,A08,922080,Widener; Daniel,32,0,32,0
1748425357540,HILD 7A,A09,922081,Widener; Daniel,32,0,32,0
1748425357540,HILD 7A,A10,922082,Widener; Daniel,32,0,32,0
1748425357540,HILD 7A,A11,922083,Widener; Daniel,32,0,32,0
1748425357540,HILD 7A,A12,922084,Widener; Daniel,32,0,32,0
1748425358567,HILD 10,A01,922089,Muscolino; Micah S,30,0,32,2
1748425358567,HILD 10,A02,922090,Muscolino; Micah S,28,0,32,4
1748425358567,HILD 10,A03,922092,Muscolino; Micah S,31,0,32,1
1748425358567,HILD 10,A04,922095,Muscolino; Micah S,30,0,32,2
1748425359598,HILD 14,A01,959886,Murillo; Dana V.,26,0,32,6
1748425359598,HILD 14,A02,959887,Murillo; Dana V.,32,0,32,0
1748425360630,HINE 144,A00,922132,Provence; Michael,40,0,45,5
1748425361657,HINE 186,A00,922133,Provence; Michael,15,0,15,0
1748425362685,HISA 110,A00,922136,De; Aniket,38,0,45,7
1748425363711,HISA 122,A00,959884,De; Aniket,12,0,15,3
1748425364738,HISC 107,A00,922137,Golan; Tal,41,0,45,4
1748425365764,HISC 131,A00,922148,Golan; Tal,45,0,51,6
1748425366796,HITO 87,A00,922097,Patterson; Patrick H.,0,0,0,0
1748425366796,HITO 87,B00,922098,Patterson; Patrick H.,0,0,0,0
1748425367824,HITO 100,A00,922150,Martinez-Matsuda; Veronica,0,0,17,17
1748425368852,HITO 193,A00,954127,Hill; Seth J,9999,0,9999,0
1748425369893,HITO 194,001,970059,Hertz; Deborah,1,0,1,0
1748425369893,HITO 194,002,970084,Daly; Heather Marie,1,0,1,0
1748425369893,HITO 194,003,970086,Plant; Rebecca Jo,1,0,1,0
1748425369893,HITO 194,004,970093,Henry; Todd A.,1,0,1,0
1748425369893,HITO 194,005,970094,Biess; Frank Peter,1,0,1,0
1748425369893,HITO 194,006,970095,Shafir; Nir,1,0,1,0
1748425369893,HITO 194,007,970099,Martinez-Matsuda; Veronica,1,0,1,0
1748425369893,HITO 194,008,970101,De; Aniket,1,0,1,0
1748425369893,HITO 194,009,970126,Kwak; Nancy,1,0,1,0
1748425369893,HITO 194,010,970128,Muscolino; Micah S,1,0,1,0
1748425369893,HITO 194,011,970129,Hendrickson; Gerald M.,1,0,1,0
1748425369893,HITO 194,012,970132,Balberg; Mira,1,0,1,0
1748425370922,HITO 196,A00,922151,Man; Simeon S,14,0,22,8
1748425371950,HIUS 105,A00,922152,Bermudez; Rosie Cano,22,0,35,13
1748425372977,HIUS 106,A00,922154,Bermudez; Rosie Cano,52,0,65,13
1748425374006,HIUS 144,A00,922156,Daly; Heather Marie,31,0,35,4
1748425375038,HIUS 158,A00,922163,Frank; Ross H.,12,0,20,8
1748425376067,HIUS 181,A00,922187,Daly; Heather Marie,8,0,15,7
1748425377097,HIUS 281,A00,922264,Daly; Heather Marie,0,0,0,0
1748425378128,HUM 1,A01,946360,Markman; Kristina,14,0,15,1
1748425378128,HUM 1,A02,946361,Markman; Kristina,12,0,15,3
1748425378128,HUM 1,A03,946362,Markman; Kristina,14,0,15,1
1748425378128,HUM 1,A04,946363,Markman; Kristina,11,0,15,4
1748425378128,HUM 1,A05,946364,Markman; Kristina,14,0,15,1
1748425378128,HUM 1,A06,946365,Markman; Kristina,14,0,15,1
1748425378128,HUM 1,A07,946366,Markman; Kristina,14,0,15,1
1748425378128,HUM 1,A08,946367,Markman; Kristina,12,0,15,3
1748425378128,HUM 1,A09,946368,Markman; Kristina,13,0,15,2
1748425378128,HUM 1,A10,946369,Markman; Kristina,11,0,15,4
1748425378128,HUM 1,A11,946370,Markman; Kristina,6,0,15,9
1748425378128,HUM 1,A12,946371,Markman; Kristina,15,0,15,0
1748425379163,HUM 3,A01,946373,West; Geoffrey Scott,20,0,28,8
1748425379163,HUM 3,A02,946374,West; Geoffrey Scott,14,0,28,14
1748425379163,HUM 3,A03,946375,West; Geoffrey Scott,13,0,28,15
1748425379163,HUM 3,A04,946376,West; Geoffrey Scott,9,0,28,19
1748425379163,HUM 3,A05,946377,West; Geoffrey Scott,8,0,28,20
1748425379163,HUM 3,A06,946378,West; Geoffrey Scott,22,0,28,6
1748425379163,HUM 3,A07,946379,West; Geoffrey Scott,23,0,28,5
1748425379163,HUM 3,A08,946380,West; Geoffrey Scott,15,0,28,13
1748425379163,HUM 3,A09,946381,West; Geoffrey Scott,0,0,0,0
1748425379163,HUM 3,A10,946382,West; Geoffrey Scott,0,0,0,0
1748425379163,HUM 3,C01,946393,Crum; Matthew Stephen,0,0,0,0
1748425379163,HUM 3,C02,946394,Crum; Matthew Stephen,0,0,0,0
1748425379163,HUM 3,C03,946395,Crum; Matthew Stephen,17,0,28,11
1748425379163,HUM 3,C04,946396,Crum; Matthew Stephen,25,0,28,3
1748425379163,HUM 3,C05,946397,Crum; Matthew Stephen,16,0,28,12
1748425379163,HUM 3,C06,946398,Crum; Matthew Stephen,20,0,28,8
1748425379163,HUM 3,C07,946399,Crum; Matthew Stephen,24,0,28,4
1748425379163,HUM 3,C08,946400,Crum; Matthew Stephen,26,0,28,2
1748425379163,HUM 3,C09,946401,Crum; Matthew Stephen,18,0,28,10
1748425379163,HUM 3,C10,946402,Crum; Matthew Stephen,22,0,28,6
1748425379163,HUM 3,D01,946404,Rodriguez; Bretton Sigfred,4,0,28,24
1748425379163,HUM 3,D02,946405,Rodriguez; Bretton Sigfred,16,0,28,12
1748425379163,HUM 3,D03,946406,Rodriguez; Bretton Sigfred,25,0,28,3
1748425379163,HUM 3,D04,946407,Rodriguez; Bretton Sigfred,12,0,28,16
1748425379163,HUM 3,D05,946408,Rodriguez; Bretton Sigfred,12,0,28,16
1748425379163,HUM 3,D06,946409,Rodriguez; Bretton Sigfred,19,0,28,9
1748425379163,HUM 3,D07,946410,Rodriguez; Bretton Sigfred,0,0,0,0
1748425379163,HUM 3,D08,946411,Rodriguez; Bretton Sigfred,0,0,0,0
1748425379163,HUM 3,D09,946412,Rodriguez; Bretton Sigfred,7,0,28,21
1748425379163,HUM 3,D10,946413,Rodriguez; Bretton Sigfred,20,0,28,8
1748425380190,HUM 88,A00,969578,Markman; Kristina,0,0,0,0
1748425381222,HUM 100,A00,946414,West; Geoffrey Scott,14,0,16,2
1748425381222,HUM 100,B00,946415,West; Geoffrey Scott,15,0,16,1
1748425381222,HUM 100,C00,946416,Zavodny; Tatiana Sophia,13,0,16,3
1748425381222,HUM 100,D00,946417,Zavodny; Tatiana Sophia,15,0,16,1
1748425381222,HUM 100,E00,946419,Zavodny; Tatiana Sophia,15,0,16,1
1748425381222,HUM 100,F00,946420,Crum; Matthew Stephen,0,0,0,0
1748425381222,HUM 100,G00,946421,Crum; Matthew Stephen,0,0,0,0
1748425381222,HUM 100,H00,946422,Crum; Matthew Stephen,16,0,16,0
1748425381222,HUM 100,I00,946424,Staff,0,0,0,0
1748425381222,HUM 100,J00,946425,Crum; Matthew Stephen,16,0,16,0
1748425381222,HUM 100,K00,946426,Staff,0,0,0,0
1748425382252,INTL 100,A01,960908,Feuer; Anna Stagg,9,0,20,11
1748425382252,INTL 100,A02,960964,Feuer; Anna Stagg,16,0,20,4
1748425382252,INTL 100,A03,961088,Feuer; Anna Stagg,15,0,20,5
1748425382252,INTL 100,A04,961091,Feuer; Anna Stagg,17,0,20,3
1748425382252,INTL 100,A05,961100,Feuer; Anna Stagg,16,0,20,4
1748425382252,INTL 100,A06,961130,Feuer; Anna Stagg,19,0,20,1
1748425383282,INTL 101,A01,923053,McIntosh; Justin,1,0,30,29
1748425383282,INTL 101,A02,923055,McIntosh; Justin,8,0,30,22
1748425383282,INTL 101,A03,923127,McIntosh; Justin,5,0,30,25
1748425383282,INTL 101,A04,923140,McIntosh; Justin,0,0,30,30
1748425383282,INTL 101,A05,923148,McIntosh; Justin,9,0,30,21
1748425383282,INTL 101,A06,923186,McIntosh; Justin,9,0,30,21
1748425384309,INTL 102,A01,923194,Prather; Lauren R,3,0,30,27
1748425384309,INTL 102,A02,923195,Prather; Lauren R,4,0,30,26
1748425384309,INTL 102,A03,923199,Prather; Lauren R,13,0,30,17
1748425384309,INTL 102,A04,923202,Prather; Lauren R,8,0,30,22
1748425385410,INTL 190,A00,923203,Segui; Alan S,0,0,0,5
1748425385410,INTL 190,B00,923205,Segui; Alan S,0,0,0,9
1748425385410,INTL 190,C00,923219,Lee; Munseob,0,0,0,5
1748425386436,INTL 190H,A00,923247,Feuer; Anna Stagg,0,0,0,1
1748425387495,JAPN 10A,A01,923258,Kamioka; Sachiko,22,0,23,1
1748425387495,JAPN 10A,B01,923261,Ross; Kayoko F,23,0,23,0
1748425387495,JAPN 10A,C01,923265,Sato; Kyoko,20,0,23,3
1748425387495,JAPN 10A,D01,923268,Inada; Minori,22,0,23,1
1748425387495,JAPN 10A,E01,923270,Tipton; Yuko,9,0,12,3
1748425387495,JAPN 10A,E02,923273,Tipton; Yuko,12,0,12,0
1748425387495,JAPN 10A,F01,923352,Ross; Kayoko F,11,0,12,1
1748425387495,JAPN 10A,F02,923355,Ross; Kayoko F,12,0,12,0
1748425387495,JAPN 10A,G01,923358,McKee; Mayumi Mochizuki,7,0,10,3
1748425387495,JAPN 10A,G02,923360,McKee; Mayumi Mochizuki,6,0,10,4
1748425387495,JAPN 10A,H01,923365,Sato; Kyoko,8,0,12,4
1748425387495,JAPN 10A,H02,923370,Sato; Kyoko,12,0,12,0
1748425387495,JAPN 10A,I01,923373,Inada; Minori,8,0,12,4
1748425387495,JAPN 10A,I02,923374,Inada; Minori,8,0,12,4
1748425387495,JAPN 10A,J01,923376,McKee; Mayumi Mochizuki,11,0,12,1
1748425387495,JAPN 10A,J02,923428,McKee; Mayumi Mochizuki,11,0,12,1
1748425387495,JAPN 10A,K01,923433,Tipton; Yuko,5,0,10,5
1748425387495,JAPN 10A,K02,923437,Tipton; Yuko,9,0,10,1
1748425387495,JAPN 10A,L01,923439,Sato; Kyoko,12,0,12,0
1748425387495,JAPN 10A,L02,923449,Sato; Kyoko,11,0,12,1
1748425387495,JAPN 10A,M01,923455,Kamioka; Sachiko,22,0,23,1
1748425387495,JAPN 10A,N01,923459,McKee; Mayumi Mochizuki,22,0,23,1
1748425388525,JAPN 10AR,A01,923462,Tipton; Yuko,17,0,20,3
1748425389556,JAPN 20A,A01,923470,Takeda; Izumi,21,0,23,2
1748425389556,JAPN 20A,B01,923473,Iwamoto; Naoki,9,0,12,3
1748425389556,JAPN 20A,B02,923475,Iwamoto; Naoki,6,0,12,6
1748425389556,JAPN 20A,C01,923519,Takeda; Izumi,0,0,12,12
1748425389556,JAPN 20A,C02,923520,Takeda; Izumi,4,0,12,8
1748425389556,JAPN 20A,D01,923623,Iwamoto; Naoki,11,0,12,1
1748425389556,JAPN 20A,D02,923625,Iwamoto; Naoki,11,0,12,1
1748425389556,JAPN 20A,E01,923627,Simpson; Junko Tokuda,12,0,20,8
1748425390584,JAPN 130A,A01,923630,Kamioka; Sachiko,14,0,15,1
1748425390584,JAPN 130A,B01,923634,Ross; Kayoko F,11,0,15,4
1748425391612,JAPN 135A,A00,923636,Iwamoto; Naoki,10,0,20,10
1748425392654,JAPN 137A,A00,923638,Simpson; Junko Tokuda,19,0,20,1
1748425393682,JAPN 140A,A00,923640,Takeda; Izumi,18,0,20,2
1748425394712,JWSP 1,A01,921258,Shuster; Alana,19,0,20,1
1748425395739,JWSP 104,A01,921340,Shuster; Alana,15,0,15,0
1748425396774,LATI 10,A01,923694,Kennemore; Amy Michelle,22,0,28,6
1748425396774,LATI 10,A02,923695,Kennemore; Amy Michelle,25,0,28,3
1748425396774,LATI 10,A03,923707,Kennemore; Amy Michelle,25,0,28,3
1748425396774,LATI 10,A04,923713,Kennemore; Amy Michelle,27,0,28,1
1748425396774,LATI 10,A05,923720,Kennemore; Amy Michelle,28,0,28,0
1748425396774,LATI 10,A06,923723,Kennemore; Amy Michelle,30,0,30,0
1748425396774,LATI 10,A07,923745,Kennemore; Amy Michelle,26,0,30,4
1748425397809,LATI 50,A01,923778,Kokinis; Troy Andreas,27,0,30,3
1748425397809,LATI 50,A02,923779,Kokinis; Troy Andreas,28,0,30,2
1748425397809,LATI 50,A03,923780,Kokinis; Troy Andreas,29,0,30,1
1748425397809,LATI 50,A04,923783,Kokinis; Troy Andreas,28,0,30,2
1748425397809,LATI 50,A05,923784,Kokinis; Troy Andreas,30,0,30,0
1748425398836,LATI 166,A00,923785,Kokinis; Troy Andreas,117,0,120,3
1748425399865,LATI 170,A00,923787,Kennemore; Amy Michelle,45,0,60,15
1748425400892,LATI 180,A00,923788,Kennemore; Amy Michelle,52,0,60,8
1748425401923,LATI 184,A00,923790,Jimenez Cano; Nayeli Guada,29,0,30,1
1748425402950,LATI 200,A00,923791,Martin-Cabrera; Luis,7,0,10,3
1748425403977,LIAB 1A,A00,923983,Saab; Dima,12,0,14,2
1748425403977,LIAB 1A,B00,923984,Saab; Dima,8,0,14,6
1748425405004,LIAB 1AX,A00,923992,El Cheddadi; Youniss,25,0,28,3
1748425406030,LIAB 1D,A00,923996,Saab; Dima,7,0,14,7
1748425407057,LIAB 1DX,A00,923998,El Cheddadi; Youniss,10,0,14,4
1748425408094,LIFR 1A,A00,923999,Van Moer; Vinciane G,14,0,14,0
1748425408094,LIFR 1A,B00,924001,Van Moer; Vinciane G,14,0,14,0
1748425408094,LIFR 1A,C00,924003,Van Moer; Vinciane G,13,0,14,1
1748425408094,LIFR 1A,D00,924039,Van Moer; Vinciane G,12,0,14,2
1748425408094,LIFR 1A,E00,924044,Van Moer; Vinciane G,12,0,14,2
1748425408094,LIFR 1A,F00,924100,Van Moer; Vinciane G,10,0,14,4
1748425409129,LIFR 1AX,A00,924134,Van Moer; Vinciane G,26,0,28,2
1748425409129,LIFR 1AX,B00,924138,Van Moer; Vinciane G,24,0,28,4
1748425409129,LIFR 1AX,C00,924196,Van Moer; Vinciane G,26,0,28,2
1748425410160,LIFR 1B,A00,924197,Van Moer; Vinciane G,11,0,14,3
1748425410160,LIFR 1B,B00,924199,Van Moer; Vinciane G,11,0,14,3
1748425411188,LIFR 1BX,A00,924215,Van Moer; Vinciane G,23,0,28,5
1748425412219,LIFR 1D,A00,924216,Van Moer; Vinciane G,11,0,14,3
1748425412219,LIFR 1D,B00,924217,Van Moer; Vinciane G,12,0,14,2
1748425412219,LIFR 1D,C00,924218,Van Moer; Vinciane G,3,0,14,11
1748425413246,LIFR 1DX,A00,924219,Van Moer; Vinciane G,14,0,21,7
1748425413246,LIFR 1DX,B00,924220,Van Moer; Vinciane G,13,0,21,8
1748425414274,LIFR 11,A00,924221,Goodall; Grant Todd,10,0,10,0
1748425415305,LIGM 1A,A00,924222,Fischer-Grunski; Eva K,11,0,14,3
1748425415305,LIGM 1A,B00,924223,Fischer-Grunski; Eva K,13,0,14,1
1748425415305,LIGM 1A,C00,924224,Fischer-Grunski; Eva K,11,0,14,3
1748425415305,LIGM 1A,D00,924227,Fischer-Grunski; Eva K,11,0,14,3
1748425416332,LIGM 1AX,A00,924228,Fischer-Grunski; Eva K,28,0,28,0
1748425416332,LIGM 1AX,B00,924229,Fischer-Grunski; Eva K,19,0,28,9
1748425417360,LIGM 1D,A00,924230,Fischer-Grunski; Eva K,0,0,0,0
1748425417360,LIGM 1D,B00,924231,Fischer-Grunski; Eva K,12,0,14,2
1748425418390,LIGM 1DX,A00,924232,Fischer-Grunski; Eva K,0,0,0,0
1748425419417,LIGM 11,A00,924233,Goodall; Grant Todd,10,0,10,0
1748425420448,LIGN 5,A00,923794,Goodall; Grant Todd,112,0,120,8
1748425421477,LIGN 7,A00,923796,Mayberry; Rachel,115,0,120,5
1748425422508,LIGN 8,A00,923797,McIntosh; Justin,231,0,245,14
1748425423537,LIGN 17,A00,923798,Staff,232,0,245,13
1748425424587,LIGN 101,A01,923929,Bakovic; Eric John,26,0,30,4
1748425424587,LIGN 101,A02,923930,Bakovic; Eric John,26,0,30,4
1748425424587,LIGN 101,A04,923935,Bakovic; Eric John,19,0,30,11
1748425424587,LIGN 101,A05,923940,Bakovic; Eric John,23,0,30,7
1748425425617,LIGN 108,A00,923942,Rose; Sharon,29,0,35,6
1748425426645,LIGN 110,A01,923944,Garellek; Marc,15,0,27,12
1748425426645,LIGN 110,A02,923947,Garellek; Marc,14,0,27,13
1748425426645,LIGN 110,A03,923948,Garellek; Marc,20,0,27,7
1748425426645,LIGN 110,A04,923949,Garellek; Marc,4,0,27,23
1748425427673,LIGN 152,A00,967971,Caballero; Gabriela Hernandez,17,0,30,13
1748425428700,LIGN 160,A00,963083,Dudley; Rachel,39,0,50,11
1748425429729,LIGN 167,A00,923951,Warstadt; Alexander Scott,0,0,90,90
1748425430756,LIGN 179,A00,923955,Kluender; Robert,0,0,35,35
1748425431783,LIGN 188R,A00,923956,Clem; Emily,40,0,40,0
1748425432815,LIGN 200,A00,973075,Staff,0,0,0,0
1748425433841,LIGN 210,A00,923962,Garellek; Marc,10,0,10,0
1748425434867,LIGN 221,A00,923964,Clem; Emily,9,0,10,1
1748425435895,LIGN 236,A00,923965,Clem; Emily,8,0,10,2
1748425436923,LIGN 293,A00,923971,Caballero; Gabriela Hernandez,0,0,0,0
1748425437956,LIGN 296,001,950061,Ackerman; Farrell,10,0,10,0
1748425437956,LIGN 296,002,950062,Bakovic; Eric John,10,0,10,0
1748425437956,LIGN 296,003,950063,Bergen; Leon,10,0,10,0
1748425437956,LIGN 296,004,950064,Caballero; Gabriela Hernandez,10,0,10,0
1748425437956,LIGN 296,005,950065,Caponigro; Ivano,10,0,10,0
1748425437956,LIGN 296,006,950066,Clem; Emily,10,0,10,0
1748425437956,LIGN 296,007,950067,Dudley; Rachel,10,0,10,0
1748425437956,LIGN 296,008,950068,Garellek; Marc,10,0,10,0
1748425437956,LIGN 296,009,950070,Goodall; Grant Todd,9,0,10,1
1748425437956,LIGN 296,010,950071,Kehler; Andrew Scott,10,0,10,0
1748425437956,LIGN 296,011,950072,Kluender; Robert,10,0,10,0
1748425437956,LIGN 296,012,950073,Rose; Sharon,10,0,10,0
1748425437956,LIGN 296,013,950074,Styler; William Francis,10,0,10,0
1748425437956,LIGN 296,014,950075,Caponigro; Ivano,10,0,10,0
1748425438983,LIHL 112F,A00,923972,Pagkalinawan; Leticia Cant,15,0,28,13
1748425440010,LIHL 114F,A00,923973,Nguyen; Hoan Thi,8,0,28,20
1748425441042,LIHL 117F,A00,923974,Sadegholvad; Elham,19,0,20,1
1748425442074,LIHL 118,A00,923975,Chen; Areana Yen,23,0,28,5
1748425443105,LIHL 124F,A00,923976,Nguyen; Hoan Thi,17,0,20,3
1748425444131,LIHL 132F,A00,923978,Pagkalinawan; Leticia Cant,18,0,20,2
1748425445160,LIHL 134F,A00,923980,Nguyen; Hoan Thi,19,0,20,1
1748425446187,LIHL 138,A00,923982,Chen; Areana Yen,28,0,28,0
1748425447214,LIIT 1A,A00,924234,Carnelos; Chiara,11,0,14,3
1748425447214,LIIT 1A,B00,924235,Carnelos; Chiara,11,0,14,3
1748425447214,LIIT 1A,C00,924236,Carnelos; Chiara,13,0,14,1
1748425447214,LIIT 1A,D00,924237,Carnelos; Chiara,12,0,14,2
1748425448241,LIIT 1AX,A00,924238,Carnelos; Chiara,28,0,28,0
1748425448241,LIIT 1AX,B00,924239,Carnelos; Chiara,24,0,28,4
1748425449275,LIPO 1A,A00,924241,Paladini; Denise,13,0,14,1
1748425449275,LIPO 1A,B00,924242,Paladini; Denise,14,0,14,0
1748425450304,LIPO 1AX,A00,924243,De Abreu; Cassia,13,0,14,1
1748425450304,LIPO 1AX,B00,924244,De Abreu; Cassia,14,0,14,0
1748425451335,LIPO 1D,A00,924245,Paladini; Denise,11,0,14,3
1748425452364,LIPO 1DX,A00,924248,De Abreu; Cassia,14,0,14,0
1748425453390,LISL 1A,A00,924249,Lott; Margaret S.,9,0,14,5
1748425453390,LISL 1A,B00,924250,Lott; Margaret S.,11,0,14,3
1748425453390,LISL 1A,C00,924252,Lott; Margaret S.,7,0,14,7
1748425453390,LISL 1A,D00,924253,Lott; Margaret S.,12,0,14,2
1748425453390,LISL 1A,E00,924254,Lott; Margaret S.,4,0,14,10
1748425453390,LISL 1A,F00,924255,Lott; Margaret S.,13,0,14,1
1748425454419,LISL 1AR,A00,924257,Lott; Margaret S.,11,0,15,4
1748425454419,LISL 1AR,B00,924258,Lott; Margaret S.,10,0,15,5
1748425454419,LISL 1AR,C00,924260,Lott; Margaret S.,9,0,15,6
1748425454419,LISL 1AR,D00,968060,Lott; Margaret S.,3,0,3,0
1748425454419,LISL 1AR,E00,968061,Lott; Margaret S.,3,0,3,0
1748425454419,LISL 1AR,F00,968062,Lott; Margaret S.,3,0,3,0
1748425455450,LISL 1AX,A00,924261,Lott; Margaret S.,28,0,28,0
1748425455450,LISL 1AX,B00,924262,Lott; Margaret S.,18,0,28,10
1748425455450,LISL 1AX,C00,924263,Lott; Margaret S.,21,0,28,7
1748425456480,LISL 1B,A00,924264,Lott; Margaret S.,13,0,14,1
1748425456480,LISL 1B,B00,924265,Lott; Margaret S.,6,0,14,8
1748425456480,LISL 1B,C00,924302,Lott; Margaret S.,9,0,14,5
1748425456480,LISL 1B,D00,924304,Lott; Margaret S.,7,0,14,7
1748425456480,LISL 1B,E00,924305,Lott; Margaret S.,10,0,14,4
1748425456480,LISL 1B,F00,964375,Lott; Margaret S.,12,0,14,2
1748425457506,LISL 1BX,A00,924307,Lott; Margaret S.,12,0,28,16
1748425457506,LISL 1BX,B00,924308,Lott; Margaret S.,20,0,28,8
1748425457506,LISL 1BX,C00,924314,Lott; Margaret S.,28,0,28,0
1748425458537,LISL 1D,A00,924316,Lott; Margaret S.,0,0,14,14
1748425458537,LISL 1D,B00,924317,Lott; Margaret S.,0,0,14,14
1748425458537,LISL 1D,C00,924319,Lott; Margaret S.,0,0,14,14
1748425458537,LISL 1D,D00,924321,Lott; Margaret S.,0,0,14,14
1748425459570,LISL 1DX,A00,924323,Lott; Margaret S.,0,0,28,28
1748425459570,LISL 1DX,B00,924365,Lott; Margaret S.,0,0,28,28
1748425460603,LISP 1A,A00,924370,Munoz Sanchez; Alicia,12,0,14,2
1748425460603,LISP 1A,B00,924372,Munoz Sanchez; Alicia,8,0,14,6
1748425460603,LISP 1A,C00,924401,Munoz Sanchez; Alicia,0,0,14,14
1748425460603,LISP 1A,D00,924406,Munoz Sanchez; Alicia,3,0,14,11
1748425460603,LISP 1A,E00,924471,Munoz Sanchez; Alicia,0,0,14,14
1748425460603,LISP 1A,F00,924472,Munoz Sanchez; Alicia,4,0,14,10
1748425460603,LISP 1A,G00,924473,Munoz Sanchez; Alicia,11,0,14,3
1748425460603,LISP 1A,H00,924474,Munoz Sanchez; Alicia,9,0,14,5
1748425461632,LISP 1AX,A00,924478,Munoz Sanchez; Alicia,16,0,28,12
1748425461632,LISP 1AX,B00,924479,Munoz Sanchez; Alicia,26,0,28,2
1748425461632,LISP 1AX,C00,924484,Munoz Sanchez; Alicia,12,0,28,16
1748425461632,LISP 1AX,D00,924491,Munoz Sanchez; Alicia,18,0,28,10
1748425462668,LISP 1B,A00,924492,Munoz Sanchez; Alicia,12,0,14,2
1748425462668,LISP 1B,B00,924493,Munoz Sanchez; Alicia,6,0,14,8
1748425462668,LISP 1B,C00,924498,Munoz Sanchez; Alicia,13,0,14,1
1748425462668,LISP 1B,D00,924501,Munoz Sanchez; Alicia,13,0,14,1
1748425462668,LISP 1B,E00,924505,Munoz Sanchez; Alicia,11,0,14,3
1748425462668,LISP 1B,F00,924506,Munoz Sanchez; Alicia,9,0,14,5
1748425462668,LISP 1B,G00,924507,Munoz Sanchez; Alicia,10,0,14,4
1748425462668,LISP 1B,H00,924549,Munoz Sanchez; Alicia,12,0,14,2
1748425462668,LISP 1B,I00,924566,Munoz Sanchez; Alicia,13,0,14,1
1748425462668,LISP 1B,J00,924572,Munoz Sanchez; Alicia,13,0,14,1
1748425462668,LISP 1B,K00,924576,Munoz Sanchez; Alicia,12,0,14,2
1748425462668,LISP 1B,L00,924577,Munoz Sanchez; Alicia,13,0,14,1
1748425463702,LISP 1BX,A00,924578,Munoz Sanchez; Alicia,26,0,28,2
1748425463702,LISP 1BX,B00,924618,Munoz Sanchez; Alicia,24,0,28,4
1748425463702,LISP 1BX,C00,924619,Munoz Sanchez; Alicia,20,0,28,8
1748425463702,LISP 1BX,D00,924629,Munoz Sanchez; Alicia,24,0,28,4
1748425463702,LISP 1BX,E00,924635,Munoz Sanchez; Alicia,24,0,28,4
1748425463702,LISP 1BX,F00,924640,Munoz Sanchez; Alicia,27,0,28,1
1748425464740,LISP 1D,A00,924641,Munoz Sanchez; Alicia,10,0,14,4
1748425464740,LISP 1D,B00,924649,Munoz Sanchez; Alicia,10,0,14,4
1748425464740,LISP 1D,C00,924654,Munoz Sanchez; Alicia,11,0,14,3
1748425464740,LISP 1D,D00,924660,Munoz Sanchez; Alicia,7,0,14,7
1748425464740,LISP 1D,E00,924671,Munoz Sanchez; Alicia,5,0,14,9
1748425464740,LISP 1D,F00,924722,Munoz Sanchez; Alicia,6,0,14,8
1748425464740,LISP 1D,G00,924724,Munoz Sanchez; Alicia,8,0,14,6
1748425464740,LISP 1D,H00,924726,Munoz Sanchez; Alicia,9,0,14,5
1748425464740,LISP 1D,I00,924728,Munoz Sanchez; Alicia,13,0,14,1
1748425464740,LISP 1D,J00,924732,Munoz Sanchez; Alicia,14,0,14,0
1748425464740,LISP 1D,K00,924739,Munoz Sanchez; Alicia,13,0,14,1
1748425464740,LISP 1D,L00,924745,Munoz Sanchez; Alicia,12,0,14,2
1748425465777,LISP 1DX,A00,924747,Munoz Sanchez; Alicia,23,0,28,5
1748425465777,LISP 1DX,B00,924818,Munoz Sanchez; Alicia,27,0,28,1
1748425465777,LISP 1DX,C00,924819,Munoz Sanchez; Alicia,16,0,28,12
1748425465777,LISP 1DX,D00,924820,Munoz Sanchez; Alicia,23,0,28,5
1748425465777,LISP 1DX,E00,924821,Munoz Sanchez; Alicia,16,0,28,12
1748425465777,LISP 1DX,F00,924822,Munoz Sanchez; Alicia,22,0,28,6
1748425466807,LISP 15,A00,924823,Munoz Sanchez; Alicia,17,0,20,3
1748425467832,LISP 18,A00,924824,Munoz Sanchez; Alicia,14,0,20,6
1748425468866,LTAF 120,A00,925431,Zhiri; Oumelbanine,37,0,40,3
1748425469898,LTAM 100,A00,925432,Villafuerte Vazquez; Nadia,33,0,40,7
1748425470926,LTCH 101,A00,964372,Liao; Ping H,35,0,40,5
1748425471954,LTCO 285,A00,925806,Glaser; Amelia,0,0,0,0
1748425472982,LTCS 10,A00,924830,Bessett; Ryan Matthew,39,0,40,1
1748425474011,LTCS 87,A00,969580,Nguyen; Hoang Tan,20,0,20,0
1748425474011,LTCS 87,B00,969581,Nguyen; Hoang Tan,20,0,20,0
1748425475039,LTCS 130,A00,925434,Kim; Joo Ok,36,0,40,4
1748425476066,LTCS 150,A00,925435,Mendoza; Andrea,36,0,40,4
1748425477093,LTCS 250,A00,925807,Sanchez Cruz; Jorge,9,0,15,6
1748425478124,LTEA 120A,A00,925438,Fiss; Geraldine Anna,16,0,40,24
1748425479154,LTEA 120B,A00,925439,Liao; Ping H,211,0,225,14
1748425480185,LTEA 132,A00,925441,Mendoza; Andrea,66,0,75,9
1748425481212,LTEA 143,A00,925443,Lee; Jin-Kyung,72,0,75,3
1748425482237,LTEA 145,A00,925444,Lee; Jin-Kyung,39,0,40,1
1748425483265,LTEN 21,A01,924832,Vitkus; Daniel J.,23,0,28,5
1748425483265,LTEN 21,A02,924833,Vitkus; Daniel J.,28,0,28,0
1748425484292,LTEN 28,A01,924835,Suzuki; Erin M.,26,0,28,2
1748425484292,LTEN 28,A02,924836,Suzuki; Erin M.,25,0,28,3
1748425484292,LTEN 28,A03,924837,Suzuki; Erin M.,25,0,28,3
1748425484292,LTEN 28,A04,924838,Suzuki; Erin M.,28,0,28,0
1748425484292,LTEN 28,A05,924839,Suzuki; Erin M.,28,0,28,0
1748425484292,LTEN 28,A06,924840,Suzuki; Erin M.,28,0,28,0
1748425484292,LTEN 28,A07,924841,Suzuki; Erin M.,28,0,28,0
1748425484292,LTEN 28,A08,924842,Suzuki; Erin M.,28,0,28,0
1748425485319,LTEN 113,A00,925449,Vitkus; Daniel J.,31,0,40,9
1748425486346,LTEN 152,A00,925450,Staff,13,0,40,27
1748425487376,LTEN 169,A00,925451,Ruiz; Ariana,34,0,40,6
1748425488403,LTEN 180,A00,925452,Ruiz; Ariana,9,0,20,11
1748425489484,LTEN 181,A00,925453,Suzuki; Erin M.,27,0,40,13
1748425490514,LTEN 185,A00,963086,Staff,23,0,25,2
1748425491540,LTEN 189,A00,925458,Vijay; Ameeth Varma,35,0,40,5
1748425492567,LTEN 271,A00,925808,Garofalo; Devin,13,0,15,2
1748425493600,LTEU 140,A00,925459,De Marchi Gherini; Adriana,33,0,40,7
1748425494628,LTEU 154,A00,925461,Morse; Ainsley,25,0,30,5
1748425495658,LTFR 2A,A01,924916,Ploye; Catherine,20,0,25,5
1748425496686,LTFR 2B,A01,924920,Ploye; Catherine,25,0,25,0
1748425497716,LTFR 104,A00,925462,Ploye; Catherine,25,0,25,0
1748425498747,LTGK 1,A00,924923,Murray; Kourtney Kristine,34,0,40,6
1748425499773,LTGK 104,A00,925465,Myerston Santana; Jacobo,29,0,30,1
1748425500800,LTGM 2A,A01,924926,Fischer-Grunski; Eva K,19,0,25,6
1748425501833,LTIT 2A,A01,925054,De Marchi Gherini; Adriana,19,0,25,6
1748425502877,LTKO 1A,A01,925085,Cho; Hye Jin,25,0,28,3
1748425502877,LTKO 1A,B01,925182,Cho; Hye Jin,25,0,28,3
1748425502877,LTKO 1A,C01,925210,Cho; Hye Jin,23,0,28,5
1748425502877,LTKO 1A,D01,925229,Staff,27,0,28,1
1748425502877,LTKO 1A,E01,925246,Staff,25,0,28,3
1748425502877,LTKO 1A,F01,925248,Yim; Nancy,26,0,28,2
1748425502877,LTKO 1A,G01,925323,Yim; Nancy,26,0,28,2
1748425502877,LTKO 1A,H01,925331,Yim; Nancy,25,0,28,3
1748425503905,LTKO 2A,A01,925333,Jung; Ji Yun,14,0,28,14
1748425503905,LTKO 2A,B01,925335,Jung; Ji Yun,24,0,28,4
1748425503905,LTKO 2A,C01,925338,Lee; Jeyseon,26,0,28,2
1748425504937,LTKO 130F,A00,925468,Lee; Jeyseon,22,0,25,3
1748425505967,LTLA 1,A00,925339,Murray; Kourtney Kristine,0,0,20,20
1748425506996,LTLA 100,A00,925470,Murray; Kourtney Kristine,39,0,40,1
1748425508023,LTRU 1A,A01,925342,Wells; Patricia Rebecca,22,0,28,6
1748425509052,LTRU 2A,A01,925345,Wells; Patricia Rebecca,19,0,20,1
1748425510083,LTRU 104B,A01,925473,Wells; Patricia Rebecca,20,0,20,0
1748425511113,LTRU 150,A00,925474,Morse; Ainsley,10,0,10,0
1748425512143,LTSP 2A,A01,925347,Staff,22,0,28,6
1748425512143,LTSP 2A,B01,925349,Staff,24,0,28,4
1748425513170,LTSP 2B,A01,925351,Staff,17,0,28,11
1748425514196,LTSP 2C,A01,925353,Mastromartino; Alexandra L,22,0,28,6
1748425515222,LTSP 2F,A00,925354,Mastromartino; Alexandra L,25,0,25,0
1748425516279,LTSP 3F,A00,925355,Dominguez; Noelia,24,0,25,1
1748425516279,LTSP 3F,B00,925356,Dominguez; Noelia,22,0,25,3
1748425517319,LTSP 87,A00,925357,Bessett; Ryan Matthew,20,0,20,0
1748425518348,LTSP 100A,A00,925595,Dominguez; Noelia,21,0,25,4
1748425519377,LTSP 100F,A00,925621,Bessett; Ryan Matthew,25,0,25,0
1748425519377,LTSP 100F,B00,925623,Bessett; Ryan Matthew,25,0,25,0
1748425519377,LTSP 100F,C00,925626,Martin-Cabrera; Luis,25,0,25,0
1748425520402,LTSP 116,A00,925629,Villafuerte Vazquez; Nadia,35,0,40,5
1748425521432,LTSP 172,A00,925637,Chacon; Gloria Elizabeth,36,0,40,4
1748425522459,LTSP 174,A00,925639,Chacon; Gloria Elizabeth,34,0,40,6
1748425523483,LTTH 210A,A00,925809,Fiss; Geraldine Anna,6,0,15,9
1748425524508,LTWL 10,A00,925358,Garofalo; Devin,40,0,40,0
1748425525537,LTWL 19A,A00,925360,Myerston Santana; Jacobo,39,0,40,1
1748425526618,LTWL 101,A00,925661,Kelting; Edward William,32,0,40,8
1748425527645,LTWL 165,A00,925748,Kim; Joo Ok,40,0,40,0
1748425528676,LTWL 167,A00,964371,Glaser; Amelia,40,0,40,0
1748425529705,LTWL 183,A00,925755,Cohen; Alain J. J.,34,0,40,6
1748425530742,LTWL 194,A00,925757,Vijay; Ameeth Varma,38,0,40,2
1748425531768,LTWR 8A,A01,925362,Springer; Anna Joy,28,0,28,0
1748425531768,LTWR 8A,A02,925363,Springer; Anna Joy,23,0,28,5
1748425531768,LTWR 8A,A03,925364,Springer; Anna Joy,23,0,28,5
1748425531768,LTWR 8A,A04,925365,Springer; Anna Joy,18,0,28,10
1748425532793,LTWR 8B,A01,925368,Lopez; Casandra,18,0,28,10
1748425532793,LTWR 8B,A02,925370,Lopez; Casandra,19,0,28,9
1748425532793,LTWR 8B,A03,925371,Lopez; Casandra,28,0,28,0
1748425532793,LTWR 8B,A04,925372,Lopez; Casandra,26,0,28,2
1748425533820,LTWR 100C,A00,925759,Staff,16,0,30,14
1748425534848,LTWR 100W,A00,925760,Forbes; Camille,0,0,15,15
1748425535875,LTWR 102W,A00,925761,Lopez; Casandra,6,0,15,9
1748425536899,LTWR 104AW,A00,925762,Hoang; Lily Kim,5,0,15,10
1748425537926,LTWR 106C,A00,925764,Ali; Mohammad Kazim,22,0,30,8
1748425538956,LTWR 113C,A00,925765,Wilkinson; Marco,28,0,30,2
1748425539984,LTWR 115C,A00,925766,Ali; Mohammad Kazim,23,0,30,7
1748425541009,LTWR 124C,A00,925801,Morse; Ainsley,29,0,30,1
1748425542039,LTWR 126C,A00,925802,Forbes; Camille,28,0,30,2
1748425543105,LTWR 148,A00,925804,Wilkinson; Marco,27,0,30,3
1748425544155,LTWR 194,A00,925805,Carroll; Amy Sara,30,0,40,10
1748425545182,LTWR 215,A00,925934,Hoang; Lily Kim,13,0,20,7
1748425546208,LTWR 220,A00,925935,Springer; Anna Joy,10,0,15,5
1748425547244,MAE 2,A01,931344,Anderson; Mark Ronald,0,0,1,1
1748425547244,MAE 2,A02,931345,Anderson; Mark Ronald,0,0,1,1
1748425547244,MAE 2,A03,931347,Anderson; Mark Ronald,0,0,1,1
1748425547244,MAE 2,B01,960499,Sadeghizadeh; Zahra,0,0,1,1
1748425547244,MAE 2,B02,960500,Sadeghizadeh; Zahra,0,0,1,1
1748425547244,MAE 2,B03,960501,Sadeghizadeh; Zahra,0,0,1,1
1748425548271,MAE 3,A01,931355,Delson; Nathan Joseph,8,0,11,3
1748425548271,MAE 3,A02,931356,Delson; Nathan Joseph,10,0,11,1
1748425548271,MAE 3,A03,931357,Delson; Nathan Joseph,10,0,11,1
1748425548271,MAE 3,A04,931358,Delson; Nathan Joseph,11,0,11,0
1748425548271,MAE 3,B01,931360,Qi; Huihui,0,0,11,11
1748425548271,MAE 3,B02,931361,Qi; Huihui,6,0,11,5
1748425548271,MAE 3,B03,931362,Qi; Huihui,9,0,11,2
1748425548271,MAE 3,B04,931364,Qi; Huihui,10,0,11,1
1748425549295,MAE 8,A01,931368,Pham; Hieu Tan,90,0,100,10
1748425550320,MAE 11,A00,931369,Nomura; Keiko K.,83,0,180,97
1748425551345,MAE 20,A00,931371,Graeve; Olivia A,79,0,100,21
1748425552383,MAE 21,A01,931373,Cai; Shengqiang,1,0,10,9
1748425552383,MAE 21,A02,931375,Cai; Shengqiang,7,0,10,3
1748425552383,MAE 21,A03,931376,Cai; Shengqiang,1,0,10,9
1748425552383,MAE 21,A04,931377,Cai; Shengqiang,5,0,10,5
1748425552383,MAE 21,A05,931378,Cai; Shengqiang,10,0,10,0
1748425552383,MAE 21,A06,931381,Cai; Shengqiang,10,0,10,0
1748425552383,MAE 21,A07,931382,Cai; Shengqiang,8,0,10,2
1748425552383,MAE 21,A08,931384,Cai; Shengqiang,7,0,10,3
1748425552383,MAE 21,A09,931385,Cai; Shengqiang,8,0,10,2
1748425552383,MAE 21,A10,931386,Cai; Shengqiang,9,0,10,1
1748425553408,MAE 30A,A00,931387,Lubarda; Marko,29,0,70,41
1748425554439,MAE 40,A00,931388,Cortes; Jorge,83,0,146,63
1748425555570,MAE 101A,A00,931389,Sarkar; Sutanu,94,0,150,56
1748425556598,MAE 101C,A00,931390,Seshadri; Kalyanasundaram,175,0,200,25
1748425557626,MAE 104,A00,931391,Pham; Hieu Tan,146,0,160,14
1748425558652,MAE 105,A00,931392,Bandaru; Prabhakar,135,0,180,45
1748425559685,MAE 107,A00,931393,Chen; Renkun,0,0,90,90
1748425559685,MAE 107,B00,931394,McEneaney; William Michael,45,0,90,45
1748425560710,MAE 108,A00,931395,Hao; Xuanting,91,0,120,29
1748425561734,MAE 113,A00,931396,Seshadri; Kalyanasundaram,92,0,130,38
1748425562759,MAE 114,A00,931399,Krasheninnikov; Sergei,37,0,40,3
1748425563793,MAE 120,A00,931400,Krasheninnikov; Sergei,36,0,50,14
1748425564819,MAE 122,A00,931402,Pawlak; Geno Ronald,43,0,70,27
1748425565844,MAE 131A,A00,931403,Lubarda; Marko,46,0,70,24
1748425566872,MAE 142,A00,931404,Anderson; Mark Ronald,21,0,60,39
1748425567899,MAE 143A,A00,931406,Diagne; Mamadou Lamine,98,0,125,27
1748425568988,MAE 148,A01,931409,Silberman; Jack,11,0,30,19
1748425570015,MAE 150,A00,931411,Friend; James Robert,139,0,192,53
1748425571040,MAE 153,A00,931413,Ghazinejad; Maziar,2,0,45,43
1748425572069,MAE 156A,A01,931416,Delson; Nathan Joseph,2,0,12,10
1748425572069,MAE 156A,A02,931417,Delson; Nathan Joseph,9,0,12,3
1748425572069,MAE 156A,A03,931418,Delson; Nathan Joseph,12,0,12,0
1748425572069,MAE 156A,A04,931419,Delson; Nathan Joseph,10,0,12,2
1748425572069,MAE 156A,A05,931420,Delson; Nathan Joseph,2,0,12,10
1748425572069,MAE 156A,A06,931421,Delson; Nathan Joseph,12,0,12,0
1748425573102,MAE 165,A00,931422,Scholtes Acevedo; Claire,19,0,30,11
1748425574132,MAE 170,A01,931424,Evdokimenko; Ekaterina,9,0,30,21
1748425574132,MAE 170,A02,931427,Evdokimenko; Ekaterina,14,0,30,16
1748425574132,MAE 170,A03,931428,Evdokimenko; Ekaterina,0,0,30,30
1748425574132,MAE 170,A04,931429,Evdokimenko; Ekaterina,14,0,30,16
1748425574132,MAE 170,A05,931430,Evdokimenko; Ekaterina,27,0,30,3
1748425574132,MAE 170,A06,931434,Evdokimenko; Ekaterina,23,0,30,7
1748425575160,MAE 180,A00,931436,Sadeghizadeh; Zahra,109,0,140,31
1748425576189,MAE 181,A00,931437,Bahadori; Mohammad Yousef,53,0,80,27
1748425577214,MAE 190,A00,971317,Marinoni; Alessandro & Krasheninnikov; Sergei,19,0,20,1
1748425578239,MAE 191,A01,931442,Qi; Huihui,19,0,20,1
1748425579263,MAE 201,A00,931445,Pawlak; Geno Ronald,36,0,90,54
1748425580288,MAE 202,A00,931452,Poulikakos; Lisa Voula,42,0,90,48
1748425581313,MAE 203,A00,931455,Frazier; Michael,26,0,90,64
1748425582338,MAE 205,A00,931456,Staff,9989,0,9999,10
1748425583367,MAE 208,A00,931457,Marinoni; Alessandro,52,0,150,98
1748425584391,MAE 210A,A00,931458,Saintillan; David,37,0,60,23
1748425585419,MAE 217A,A00,931459,Arefiev; Alexey,13,0,20,7
1748425586448,MAE 221A,A00,931460,Chen; Renkun,26,0,40,14
1748425587479,MAE 232A,A00,931464,Chen; Jiun-Shyan,3,0,35,32
1748425588505,MAE 233A,A00,931466,Luan; Haiwen,29,0,40,11
1748425589533,MAE 235,A00,954132,Krysl; Petr,0,0,0,0
1748425590565,MAE 249,A00,931472,Tolley; Michael Thomas,8,0,50,42
1748425591596,MAE 251,A00,931477,Graeve; Olivia A,12,0,15,3
1748425592622,MAE 257,A00,931478,Cai; Shengqiang,0,0,10,10
1748425593704,MAE 265A,A00,931480,Bandaru; Prabhakar,10,0,15,5
1748425594731,MAE 271A,A00,931481,Luo; Jian,9,0,10,1
1748425595757,MAE 280A,A00,931482,Kramer; Boris,61,0,110,49
1748425596784,MAE 283A,A00,931484,de Callafon; Raymond A,12,0,50,38
1748425597813,MAE 285,A00,931486,Friend; James Robert,30,0,30,0
1748425598843,MAE 287,A00,931488,Diagne; Mamadou Lamine,17,0,30,13
1748425599874,MAE 290A,A00,931490,Lindsey; Stephanie,42,0,70,28
1748425600904,MAE 294A,A00,931491,Becker; Janet Maria,14,0,20,6
1748425601933,MATH 2,A01,929271,Quarfoot; David James,22,0,25,3
1748425601933,MATH 2,B01,929278,Staff,21,0,25,4
1748425602961,MATH 3B,A01,929284,Hammock; Frances H,1,0,2,1
1748425602961,MATH 3B,A02,929312,Hammock; Frances H,1,0,2,1
1748425602961,MATH 3B,A03,967979,Hammock; Frances H,2,0,2,0
1748425602961,MATH 3B,A04,967980,Hammock; Frances H,1,0,2,1
1748425602961,MATH 3B,A05,967983,Hammock; Frances H,1,0,2,1
1748425602961,MATH 3B,A06,967984,Hammock; Frances H,2,0,2,0
1748425602961,MATH 3B,D01,929666,Staff,0,0,2,2
1748425602961,MATH 3B,D02,929667,Staff,0,0,2,2
1748425602961,MATH 3B,D03,929668,Staff,0,0,2,2
1748425602961,MATH 3B,D04,967987,Staff,0,0,2,2
1748425603994,MATH 3C,A01,929670,Staff,0,0,2,2
1748425603994,MATH 3C,A02,929671,Staff,0,0,2,2
1748425603994,MATH 3C,A03,929672,Staff,2,0,2,0
1748425603994,MATH 3C,A04,929673,Staff,2,0,2,0
1748425603994,MATH 3C,A05,967985,Staff,0,0,2,2
1748425603994,MATH 3C,A06,967986,Staff,1,0,2,1
1748425603994,MATH 3C,B01,929675,Staff,0,0,0,2
1748425603994,MATH 3C,B02,929676,Staff,0,0,2,2
1748425603994,MATH 3C,B03,929677,Staff,0,0,2,2
1748425603994,MATH 3C,B04,929679,Staff,0,0,2,2
1748425603994,MATH 3C,B05,967988,Staff,0,0,2,2
1748425603994,MATH 3C,B06,967989,Staff,0,0,2,2
1748425605027,MATH 4C,B01,929698,Anzaldo; Leesa B,0,0,0,2
1748425605027,MATH 4C,B02,929699,Anzaldo; Leesa B,4,0,4,0
1748425605027,MATH 4C,B03,929700,Anzaldo; Leesa B,3,0,4,1
1748425605027,MATH 4C,B04,929701,Anzaldo; Leesa B,4,0,4,0
1748425605027,MATH 4C,D01,929709,Staff,4,0,4,0
1748425605027,MATH 4C,D02,929710,Staff,3,0,4,1
1748425605027,MATH 4C,D03,967990,Staff,4,0,4,0
1748425605027,MATH 4C,D04,967991,Staff,4,0,4,0
1748425606058,MATH 10A,A01,929713,Staff,8,0,12,4
1748425606058,MATH 10A,A02,929715,Staff,12,0,12,0
1748425606058,MATH 10A,A03,929717,Staff,5,0,5,0
1748425606058,MATH 10A,A04,929718,Staff,5,0,5,0
1748425606058,MATH 10A,A05,929719,Staff,5,0,5,0
1748425606058,MATH 10A,A06,929720,Staff,4,0,5,1
1748425606058,MATH 10A,B01,929723,Eggers; John Dietrich,0,0,0,4
1748425606058,MATH 10A,B02,929724,Eggers; John Dietrich,0,0,4,4
1748425606058,MATH 10A,B03,929726,Eggers; John Dietrich,0,0,4,4
1748425606058,MATH 10A,B04,929727,Eggers; John Dietrich,0,0,4,4
1748425606058,MATH 10A,B05,929728,Eggers; John Dietrich,0,0,4,4
1748425606058,MATH 10A,B06,929729,Eggers; John Dietrich,1,0,4,3
1748425606058,MATH 10A,C01,929732,Staff,0,0,0,3
1748425606058,MATH 10A,C02,929734,Staff,0,0,4,4
1748425606058,MATH 10A,C03,929735,Staff,0,0,4,4
1748425606058,MATH 10A,C04,929736,Staff,0,0,4,4
1748425606058,MATH 10A,C05,929737,Staff,0,0,4,4
1748425606058,MATH 10A,C06,929739,Staff,0,0,4,4
1748425606058,MATH 10A,D01,929742,Staff,0,0,4,4
1748425606058,MATH 10A,D02,929743,Staff,0,0,4,4
1748425606058,MATH 10A,D03,929744,Staff,4,0,4,0
1748425606058,MATH 10A,D04,929746,Staff,4,0,4,0
1748425606058,MATH 10A,D05,929747,Staff,3,0,4,1
1748425606058,MATH 10A,D06,929748,Staff,4,0,4,0
1748425606058,MATH 10A,D07,968012,Staff,0,0,4,4
1748425606058,MATH 10A,D08,968013,Staff,3,0,4,1
1748425606058,MATH 10A,D09,968015,Staff,4,0,4,0
1748425606058,MATH 10A,D10,968017,Staff,2,0,4,2
1748425607088,MATH 10B,A01,929759,Bowers; Adam R.,0,0,10,10
1748425607088,MATH 10B,A02,929760,Bowers; Adam R.,0,0,10,10
1748425607088,MATH 10B,A03,929761,Bowers; Adam R.,0,0,10,10
1748425607088,MATH 10B,A04,929762,Bowers; Adam R.,0,0,10,10
1748425607088,MATH 10B,A05,929763,Bowers; Adam R.,0,0,10,10
1748425607088,MATH 10B,A06,929764,Bowers; Adam R.,0,0,10,10
1748425607088,MATH 10B,B01,929767,Staff,0,0,10,10
1748425607088,MATH 10B,B02,929770,Staff,7,0,10,3
1748425607088,MATH 10B,B03,929771,Staff,10,0,10,0
1748425607088,MATH 10B,B04,929772,Staff,9,0,10,1
1748425607088,MATH 10B,B05,929774,Staff,1,0,10,9
1748425607088,MATH 10B,B06,929775,Staff,10,0,10,0
1748425607088,MATH 10B,C01,929778,Huang; Lei,0,0,8,8
1748425607088,MATH 10B,C02,929779,Huang; Lei,0,0,10,10
1748425607088,MATH 10B,C03,929780,Huang; Lei,2,0,10,8
1748425607088,MATH 10B,C04,929781,Huang; Lei,8,0,10,2
1748425607088,MATH 10B,C05,929784,Huang; Lei,0,0,10,10
1748425607088,MATH 10B,C06,929785,Huang; Lei,2,0,10,8
1748425608116,MATH 10C,A01,929788,Staff,0,0,15,15
1748425608116,MATH 10C,A02,929789,Staff,0,0,15,15
1748425608116,MATH 10C,A03,929790,Staff,12,0,15,3
1748425608116,MATH 10C,A04,929791,Staff,13,0,15,2
1748425608116,MATH 10C,A05,929792,Staff,0,0,15,15
1748425608116,MATH 10C,A06,929793,Staff,0,0,15,15
1748425608116,MATH 10C,A07,929795,Staff,2,0,15,13
1748425608116,MATH 10C,A08,929796,Staff,15,0,15,0
1748425608116,MATH 10C,B01,929798,Staff,15,0,15,0
1748425608116,MATH 10C,B02,929799,Staff,0,0,15,15
1748425608116,MATH 10C,B03,929800,Staff,11,0,15,4
1748425608116,MATH 10C,B04,929802,Staff,14,0,15,1
1748425608116,MATH 10C,B05,929803,Staff,14,0,15,1
1748425608116,MATH 10C,B06,929805,Staff,15,0,15,0
1748425609144,MATH 11,A01,929807,Rava; Denise,0,0,25,25
1748425609144,MATH 11,A02,929808,Rava; Denise,0,0,25,25
1748425609144,MATH 11,A03,929809,Rava; Denise,0,0,25,25
1748425609144,MATH 11,A04,929811,Rava; Denise,0,0,25,25
1748425609144,MATH 11,B01,929816,Rava; Denise,0,0,25,25
1748425609144,MATH 11,B02,929817,Rava; Denise,0,0,25,25
1748425609144,MATH 11,B03,929818,Rava; Denise,0,0,25,25
1748425609144,MATH 11,B04,929819,Rava; Denise,0,0,25,25
1748425610185,MATH 18,C01,929841,Peca-Medlin; John Michael,4,0,10,6
1748425610185,MATH 18,C02,929843,Peca-Medlin; John Michael,7,0,10,3
1748425610185,MATH 18,C03,929844,Peca-Medlin; John Michael,3,0,10,7
1748425610185,MATH 18,C04,929845,Peca-Medlin; John Michael,0,0,10,10
1748425610185,MATH 18,C05,929846,Peca-Medlin; John Michael,2,0,10,8
1748425610185,MATH 18,C06,929848,Peca-Medlin; John Michael,0,0,10,10
1748425610185,MATH 18,D01,929852,Anzaldo; Leesa B,0,0,10,10
1748425610185,MATH 18,D02,929855,Anzaldo; Leesa B,0,0,10,10
1748425610185,MATH 18,D03,929856,Anzaldo; Leesa B,0,0,9,9
1748425610185,MATH 18,D04,929857,Anzaldo; Leesa B,0,0,10,10
1748425610185,MATH 18,D05,929858,Anzaldo; Leesa B,0,0,10,10
1748425610185,MATH 18,D06,929859,Anzaldo; Leesa B,0,0,10,10
1748425610185,MATH 18,E01,929862,Ganesan; Priyanga,0,0,10,10
1748425610185,MATH 18,E02,929863,Ganesan; Priyanga,0,0,10,10
1748425610185,MATH 18,E03,929865,Ganesan; Priyanga,0,0,10,10
1748425610185,MATH 18,E04,929866,Ganesan; Priyanga,8,0,10,2
1748425610185,MATH 18,E05,929867,Ganesan; Priyanga,10,0,10,0
1748425610185,MATH 18,E06,929869,Ganesan; Priyanga,10,0,10,0
1748425610185,MATH 18,F01,929872,Ganesan; Priyanga,12,0,20,8
1748425610185,MATH 18,F02,929873,Ganesan; Priyanga,17,0,20,3
1748425610185,MATH 18,F03,929874,Ganesan; Priyanga,19,0,20,1
1748425610185,MATH 18,F04,929875,Ganesan; Priyanga,19,0,20,1
1748425610185,MATH 18,F05,968018,Ganesan; Priyanga,12,0,12,0
1748425610185,MATH 18,F06,968019,Ganesan; Priyanga,11,0,12,1
1748425610185,MATH 18,F07,968020,Ganesan; Priyanga,10,0,12,2
1748425610185,MATH 18,F08,968022,Ganesan; Priyanga,11,0,12,1
1748425611214,MATH 20A,A01,929880,Bowers; Adam R.,23,0,25,2
1748425611214,MATH 20A,A02,929881,Bowers; Adam R.,24,0,25,1
1748425611214,MATH 20A,A03,929883,Bowers; Adam R.,1,0,5,4
1748425611214,MATH 20A,A04,929884,Bowers; Adam R.,4,0,5,1
1748425611214,MATH 20A,B01,929886,Staff,0,0,0,0
1748425611214,MATH 20A,B02,929887,Staff,3,0,5,2
1748425611214,MATH 20A,B03,929888,Staff,5,0,5,0
1748425611214,MATH 20A,B04,929889,Staff,5,0,5,0
1748425611214,MATH 20A,B05,929890,Staff,5,0,5,0
1748425611214,MATH 20A,B06,929891,Staff,5,0,5,0
1748425611214,MATH 20A,B07,967992,Staff,5,0,5,0
1748425611214,MATH 20A,B08,967993,Staff,5,0,5,0
1748425611214,MATH 20A,B09,967994,Staff,5,0,5,0
1748425611214,MATH 20A,B10,967995,Staff,5,0,5,0
1748425612255,MATH 20B,A01,929910,Staff,14,0,15,1
1748425612255,MATH 20B,A02,929911,Staff,15,0,15,0
1748425612255,MATH 20B,A03,929982,Staff,15,0,15,0
1748425612255,MATH 20B,A04,929983,Staff,15,0,15,0
1748425612255,MATH 20B,A05,929984,Staff,15,0,15,0
1748425612255,MATH 20B,A06,929985,Staff,15,0,15,0
1748425612255,MATH 20B,C01,930160,Staff,24,0,25,1
1748425612255,MATH 20B,C02,930186,Staff,25,0,25,0
1748425612255,MATH 20B,C03,930198,Staff,15,0,15,0
1748425612255,MATH 20B,C04,968000,Staff,15,0,15,0
1748425612255,MATH 20B,D01,930241,Chou; Raymond Oliver,13,0,25,12
1748425612255,MATH 20B,D02,930242,Chou; Raymond Oliver,23,0,25,2
1748425612255,MATH 20B,D03,930244,Chou; Raymond Oliver,0,0,15,15
1748425612255,MATH 20B,D04,968002,Chou; Raymond Oliver,0,0,13,13
1748425612255,MATH 20B,E01,930428,Wesley; William J,32,0,35,3
1748425612255,MATH 20B,E02,930529,Wesley; William J,35,0,35,0
1748425612255,MATH 20B,E03,968023,Wesley; William J,15,0,15,0
1748425612255,MATH 20B,E04,968024,Wesley; William J,15,0,15,0
1748425612255,MATH 20B,E05,968025,Wesley; William J,15,0,15,0
1748425612255,MATH 20B,E06,968026,Wesley; William J,15,0,15,0
1748425613292,MATH 20C,A01,930548,Staff,18,0,20,2
1748425613292,MATH 20C,A02,930554,Staff,19,0,20,1
1748425613292,MATH 20C,A03,930584,Staff,19,0,20,1
1748425613292,MATH 20C,A04,930606,Staff,20,0,20,0
1748425613292,MATH 20C,A05,930610,Staff,19,0,20,1
1748425613292,MATH 20C,A06,930641,Staff,20,0,20,0
1748425613292,MATH 20C,A07,968027,Staff,20,0,20,0
1748425613292,MATH 20C,A08,968028,Staff,20,0,20,0
1748425613292,MATH 20C,A09,968029,Staff,19,0,20,1
1748425613292,MATH 20C,A10,968031,Staff,20,0,20,0
1748425613292,MATH 20C,C01,930911,Staff,6,0,20,14
1748425613292,MATH 20C,C02,930940,Staff,16,0,20,4
1748425613292,MATH 20C,C03,930946,Staff,18,0,20,2
1748425613292,MATH 20C,C04,930959,Staff,20,0,20,0
1748425613292,MATH 20C,C05,930966,Staff,19,0,20,1
1748425613292,MATH 20C,C06,930974,Staff,16,0,20,4
1748425613292,MATH 20C,D01,931266,Hammock; Frances H,10,0,20,10
1748425613292,MATH 20C,D02,931267,Hammock; Frances H,14,0,17,3
1748425613292,MATH 20C,D03,931268,Hammock; Frances H,17,0,20,3
1748425613292,MATH 20C,D04,931269,Hammock; Frances H,19,0,20,1
1748425613292,MATH 20C,D05,931270,Hammock; Frances H,20,0,20,0
1748425613292,MATH 20C,D06,931271,Hammock; Frances H,18,0,20,2
1748425613292,MATH 20C,E01,931273,Staff,11,0,20,9
1748425613292,MATH 20C,E02,931274,Staff,19,0,20,1
1748425613292,MATH 20C,E03,931275,Staff,17,0,20,3
1748425613292,MATH 20C,E04,931276,Staff,19,0,20,1
1748425613292,MATH 20C,E05,931278,Staff,20,0,20,0
1748425613292,MATH 20C,E06,931279,Staff,20,0,20,0
1748425613292,MATH 20C,F01,931281,Staff,20,0,25,5
1748425613292,MATH 20C,F02,931282,Staff,22,0,25,3
1748425613292,MATH 20C,F03,931283,Staff,23,0,25,2
1748425613292,MATH 20C,F04,931285,Staff,24,0,25,1
1748425614320,MATH 20D,B01,931293,Upadrashta; Pranav Kumar,0,0,24,25
1748425614320,MATH 20D,B02,931294,Upadrashta; Pranav Kumar,0,0,30,30
1748425614320,MATH 20D,B03,931297,Upadrashta; Pranav Kumar,0,0,30,30
1748425614320,MATH 20D,B04,931298,Upadrashta; Pranav Kumar,8,0,30,22
1748425614320,MATH 20D,B05,931299,Upadrashta; Pranav Kumar,1,0,30,29
1748425614320,MATH 20D,B06,931300,Upadrashta; Pranav Kumar,25,0,30,5
1748425614320,MATH 20D,C01,931305,Upadrashta; Pranav Kumar,15,0,40,25
1748425614320,MATH 20D,C02,931306,Upadrashta; Pranav Kumar,38,0,40,2
1748425614320,MATH 20D,C03,931307,Upadrashta; Pranav Kumar,12,0,30,18
1748425614320,MATH 20D,C04,931308,Upadrashta; Pranav Kumar,26,0,30,4
1748425615348,MATH 20E,A01,931313,Staff,0,0,27,27
1748425615348,MATH 20E,A02,931315,Staff,19,0,27,8
1748425615348,MATH 20E,A03,931316,Staff,27,0,27,0
1748425615348,MATH 20E,A04,931317,Staff,27,0,27,0
1748425615348,MATH 20E,A05,968032,Staff,9,0,27,18
1748425615348,MATH 20E,A06,968033,Staff,24,0,27,3
1748425615348,MATH 20E,A07,968034,Staff,27,0,27,0
1748425615348,MATH 20E,A08,968035,Staff,26,0,27,1
1748425615348,MATH 20E,C01,931327,Staff,0,0,23,23
1748425615348,MATH 20E,C02,931329,Staff,0,0,27,27
1748425615348,MATH 20E,C03,931331,Staff,0,0,27,27
1748425615348,MATH 20E,C04,931332,Staff,0,0,27,27
1748425615348,MATH 20E,C05,931333,Staff,0,0,27,27
1748425615348,MATH 20E,C06,931334,Staff,7,0,27,20
1748425616374,MATH 31AH,A01,931337,Nandi; Achinta Kumar,5,0,5,0
1748425616374,MATH 31AH,A02,931340,Nandi; Achinta Kumar,5,0,5,0
1748425617408,MATH 87,A00,970775,Harel; Guershon,0,0,0,0
1748425617408,MATH 87,B00,970803,Meyer; David A.,0,0,0,0
1748425618435,MATH 88,A00,967999,Seward; Brandon M.,30,0,35,5
1748425619477,MATH 96,A00,931341,Kane; Daniel Mertz,0,0,0,0
1748425620512,MATH 100A,A01,927335,De Vleming; Kristin Elizab,21,0,30,9
1748425620512,MATH 100A,A02,927337,De Vleming; Kristin Elizab,24,0,30,6
1748425620512,MATH 100A,B01,927341,De Vleming; Kristin Elizab,2,0,30,28
1748425620512,MATH 100A,B02,927342,De Vleming; Kristin Elizab,8,0,30,22
1748425621539,MATH 102,B01,927348,Harel; Guershon,2,0,30,28
1748425621539,MATH 102,B02,927349,Harel; Guershon,22,0,30,8
1748425622575,MATH 103A,B01,927370,Staff,16,0,30,14
1748425622575,MATH 103A,B02,927378,Staff,29,0,30,1
1748425622575,MATH 103A,B03,969574,Staff,27,0,30,3
1748425622575,MATH 103A,C01,927381,Staff,13,0,30,17
1748425622575,MATH 103A,C02,927385,Staff,24,0,30,6
1748425622575,MATH 103A,D01,927388,Suk; Andrew Hoon,0,0,30,30
1748425622575,MATH 103A,D02,927389,Suk; Andrew Hoon,0,0,30,30
1748425623603,MATH 105,A01,927391,Ganapathy; Karthik,26,0,35,9
1748425623603,MATH 105,A02,927454,Ganapathy; Karthik,29,0,35,6
1748425624632,MATH 109,B01,927493,Xiao; Ming,0,0,5,5
1748425624632,MATH 109,B02,927494,Xiao; Ming,0,0,5,5
1748425624632,MATH 109,C01,927500,Xiao; Ming,0,0,5,5
1748425624632,MATH 109,C02,927501,Xiao; Ming,0,0,5,5
1748425624632,MATH 109,D01,927516,Buzaglo; Lucas,0,0,5,5
1748425624632,MATH 109,D02,927517,Buzaglo; Lucas,0,0,5,5
1748425624632,MATH 109,E01,927519,Buzaglo; Lucas,0,0,5,5
1748425624632,MATH 109,E02,927552,Buzaglo; Lucas,0,0,5,5
1748425625663,MATH 111A,A01,927559,Meyer; David A.,0,0,35,35
1748425626690,MATH 120A,A01,927572,Eggers; John Dietrich,13,0,30,17
1748425626690,MATH 120A,A02,927574,Eggers; John Dietrich,29,0,30,1
1748425627723,MATH 140A,A01,927580,Spolaor; Luca,0,0,30,30
1748425627723,MATH 140A,A02,927582,Spolaor; Luca,6,0,30,24
1748425627723,MATH 140A,B01,927588,Ioana; Adrian,0,0,30,30
1748425627723,MATH 140A,B02,927599,Ioana; Adrian,0,0,30,30
1748425628750,MATH 142A,B01,927620,Bejenaru; Ioan,0,0,30,30
1748425628750,MATH 142A,B02,927750,Bejenaru; Ioan,13,0,30,17
1748425628750,MATH 142A,C01,927789,Staff,25,0,30,5
1748425628750,MATH 142A,C02,927815,Staff,30,0,30,0
1748425628750,MATH 142A,C03,969575,Staff,25,0,30,5
1748425628750,MATH 142A,D01,927829,Staff,15,0,30,15
1748425628750,MATH 142A,D02,927832,Staff,30,0,30,0
1748425629778,MATH 153,A01,927862,Harel; Guershon,26,0,35,9
1748425630806,MATH 154,A01,928077,Kane; Daniel Mertz,27,0,35,8
1748425630806,MATH 154,A02,928083,Kane; Daniel Mertz,35,0,35,0
1748425630806,MATH 154,A03,928085,Kane; Daniel Mertz,0,0,35,35
1748425630806,MATH 154,A04,928086,Kane; Daniel Mertz,20,0,35,15
1748425631841,MATH 170A,A01,928146,Tian; Xiaochuan,0,0,30,30
1748425631841,MATH 170A,A02,928225,Tian; Xiaochuan,1,0,30,29
1748425631841,MATH 170A,A03,928231,Tian; Xiaochuan,26,0,30,4
1748425631841,MATH 170A,A04,928237,Tian; Xiaochuan,30,0,30,0
1748425631841,MATH 170A,B01,928244,Huang; Lei,23,0,30,7
1748425631841,MATH 170A,B02,928273,Huang; Lei,30,0,30,0
1748425631841,MATH 170A,B03,928274,Huang; Lei,18,0,30,12
1748425631841,MATH 170A,B04,928276,Huang; Lei,28,0,30,2
1748425632870,MATH 173A,A01,928278,Ding; Lijun,0,0,30,30
1748425632870,MATH 173A,A02,928319,Ding; Lijun,0,0,30,30
1748425632870,MATH 173A,A03,928322,Ding; Lijun,0,0,30,30
1748425632870,MATH 173A,A04,928377,Ding; Lijun,0,0,30,30
1748425632870,MATH 173A,B01,928383,Cloninger; Alexander,0,0,30,30
1748425632870,MATH 173A,B02,928384,Cloninger; Alexander,0,0,30,30
1748425632870,MATH 173A,B03,928385,Cloninger; Alexander,0,0,30,30
1748425632870,MATH 173A,B04,928386,Cloninger; Alexander,0,0,30,30
1748425633897,MATH 174,A01,928397,Cheng; Li-Tien,15,0,28,13
1748425633897,MATH 174,A02,928402,Cheng; Li-Tien,23,0,28,5
1748425634925,MATH 180A,A01,928408,Staff,0,0,25,25
1748425634925,MATH 180A,A02,928409,Staff,18,0,25,7
1748425634925,MATH 180A,A03,928416,Staff,23,0,25,2
1748425634925,MATH 180A,A04,928417,Staff,21,0,25,4
1748425634925,MATH 180A,B01,928428,Peca-Medlin; John Michael,0,0,25,25
1748425634925,MATH 180A,B02,928435,Peca-Medlin; John Michael,11,0,25,14
1748425634925,MATH 180A,B03,928436,Peca-Medlin; John Michael,20,0,25,5
1748425634925,MATH 180A,B04,928453,Peca-Medlin; John Michael,21,0,25,4
1748425634925,MATH 180A,C01,928466,Dixit; Rishabh,20,0,25,5
1748425634925,MATH 180A,C02,928467,Dixit; Rishabh,25,0,25,0
1748425634925,MATH 180A,C03,928506,Dixit; Rishabh,22,0,25,3
1748425634925,MATH 180A,C04,928511,Dixit; Rishabh,25,0,25,0
1748425635953,MATH 180C,A01,928520,Schweinsberg; Jason,0,0,35,35
1748425635953,MATH 180C,A02,928527,Schweinsberg; Jason,0,0,35,35
1748425636983,MATH 181B,A01,928538,Lou; Zhipeng,3,0,30,27
1748425636983,MATH 181B,A02,928539,Lou; Zhipeng,21,0,30,9
1748425636983,MATH 181B,A03,928543,Lou; Zhipeng,27,0,30,3
1748425638013,MATH 183,A01,928545,Quarfoot; David James,0,0,22,22
1748425638013,MATH 183,A02,928560,Quarfoot; David James,0,0,22,22
1748425638013,MATH 183,A03,928565,Quarfoot; David James,0,0,22,22
1748425638013,MATH 183,A04,928566,Quarfoot; David James,0,0,22,22
1748425638013,MATH 183,A05,928567,Quarfoot; David James,0,0,22,22
1748425638013,MATH 183,A06,928568,Quarfoot; David James,0,0,22,22
1748425639039,MATH 184,A01,928587,Chou; Raymond Oliver,13,0,35,22
1748425639039,MATH 184,A02,928592,Chou; Raymond Oliver,29,0,35,6
1748425639039,MATH 184,A03,928593,Chou; Raymond Oliver,32,0,35,3
1748425639039,MATH 184,A04,928594,Chou; Raymond Oliver,35,0,35,0
1748425640065,MATH 187A,A01,928609,Ganapathy; Karthik,0,0,25,25
1748425640065,MATH 187A,A02,928614,Ganapathy; Karthik,0,0,25,25
1748425640065,MATH 187A,A03,928615,Ganapathy; Karthik,0,0,25,25
1748425640065,MATH 187A,A04,928616,Ganapathy; Karthik,7,0,25,18
1748425640065,MATH 187A,A05,928617,Ganapathy; Karthik,0,0,25,25
1748425640065,MATH 187A,A06,928618,Ganapathy; Karthik,12,0,25,13
1748425641092,MATH 190A,A01,928685,Roberts; Justin Deritter,15,0,35,20
1748425642119,MATH 197,001,973284,Kedlaya; Kiran S.,9999,0,9999,0
1748425643148,MATH 200A,A00,928693,Salehi Golsefidy; Alireza,20,0,20,0
1748425644175,MATH 201A,A00,928694,Wenzl; Hans G,20,0,20,0
1748425645204,MATH 202A,A00,928732,Novak; Jonathan I,15,0,20,5
1748425646234,MATH 203A,A00,928743,Izadi; Elham,20,0,20,0
1748425647261,MATH 204A,A00,928764,Sorensen; Claus M,19,0,20,1
1748425648290,MATH 208,A00,928765,Staff,10,0,10,0
1748425649317,MATH 209,A00,928766,Staff,10,0,10,0
1748425650345,MATH 210A,A00,928808,Miller; Pearson,19,0,20,1
1748425651373,MATH 211A,A00,928809,Staff,10,0,10,0
1748425652399,MATH 211B,A00,928811,Staff,10,0,10,0
1748425653426,MATH 216A,A00,928812,Webber; Robert Jacobs,12,0,20,8
1748425654453,MATH 218,A00,928828,Staff,9,0,10,1
1748425655479,MATH 220A,A00,928829,Ebenfelt; Peter F,15,0,20,5
1748425656510,MATH 240A,A00,928830,Spolaor; Luca,17,0,20,3
1748425657538,MATH 241A,A00,928831,Zlatos; Andrej,14,0,20,6
1748425658567,MATH 242,A00,928903,Bejenaru; Ioan,16,0,20,4
1748425659596,MATH 243,A00,928911,Staff,10,0,10,0
1748425660625,MATH 248,A00,928919,Staff,10,0,10,0
1748425661659,MATH 251A,A00,928970,Sam; Steven V,18,0,20,2
1748425662685,MATH 258,A00,928973,Staff,10,0,10,0
1748425663711,MATH 259A,A00,929052,Staff,18,0,20,2
1748425664738,MATH 261A,A00,929059,Warnke; Lutz Peter,10,0,20,10
1748425665763,MATH 269,A00,929060,Staff,10,0,10,0
1748425666791,MATH 270A,A00,929061,Dumitriu; Ioana,8,0,20,12
1748425667818,MATH 273A,A00,929063,Leok; Melvin,17,0,20,3
1748425668845,MATH 274,A01,929069,Cheng; Li-Tien,5,0,5,0
1748425668845,MATH 274,A02,929071,Cheng; Li-Tien,5,0,5,0
1748425669878,MATH 277A,A00,929073,Grier; Daniel T,18,0,20,2
1748425669878,MATH 277A,B00,929080,Nie; Jiawang,20,0,20,0
1748425670906,MATH 278A,A00,929092,Staff,10,0,10,0
1748425671932,MATH 278B,A00,929105,Staff,10,0,10,0
1748425672960,MATH 278C,A00,929113,Staff,10,0,10,0
1748425673986,MATH 280A,A00,929117,Ang; Jie Jun,7,0,20,13
1748425675014,MATH 281A,A00,929120,Lou; Zhipeng,9,0,20,11
1748425676041,MATH 282A,A00,929138,Zhang; Danna,4,0,20,16
1748425677068,MATH 283,A00,929153,Tesler; Glenn,0,0,0,17
1748425678094,MATH 287A,A00,967998,Politis; Dimitris,9,0,15,6
1748425679121,MATH 288,A00,929158,Staff,9,0,10,1
1748425680152,MATH 290A,A00,929180,McKernan; James,18,0,20,2
1748425681178,MATH 292,A00,929185,Staff,10,0,10,0
1748425682204,MATH 295,A00,929189,Staff,15,0,15,0
1748425683235,MATH 297,001,929218,Gamst; Anthony Collins,0,0,0,0
1748425684266,MATS 200,A00,927075,Graeve; Olivia A,9983,0,9999,16
1748425685296,MATS 201A,A00,927076,Luo; Jian,36,0,50,14
1748425686326,MATS 202,A00,927102,Staff,37,0,50,13
1748425687353,MATS 227,A00,927103,Graeve; Olivia A,36,0,50,14
1748425688379,MATS 251A,A00,927139,Bandaru; Prabhakar,40,0,50,10
1748425689408,MATS 257,A00,927140,Cai; Shengqiang,8,0,20,12
1748425690439,MATS 295,A00,927151,Graeve; Olivia A,9999,0,9999,0
1748425690439,MATS 295,B00,927152,Kummel; Andrew C,9999,0,9999,0
1748425691482,MCWP 40,001,945345,Guillen; Melinda,3,0,3,0
1748425691482,MCWP 40,002,945347,Guillen; Melinda,0,0,3,3
1748425691482,MCWP 40,003,945348,Guillen; Melinda,0,0,3,3
1748425691482,MCWP 40,004,945379,Wastal; Carrie King,3,0,3,0
1748425691482,MCWP 40,005,945382,Wastal; Carrie King,2,0,3,1
1748425691482,MCWP 40,006,945383,Compas; Sean Matthew,0,0,3,3
1748425691482,MCWP 40,007,945387,Bartulis; Jason Michael,3,0,3,0
1748425691482,MCWP 40,008,945388,Wastal; Carrie King,2,0,3,1
1748425691482,MCWP 40,009,945391,Wastal; Carrie King,3,0,3,0
1748425691482,MCWP 40,011,945394,Bartulis; Jason Michael,3,0,3,0
1748425691482,MCWP 40,012,945395,Carter; Jennifer A,3,0,3,0
1748425691482,MCWP 40,013,945396,Carter; Jennifer A,2,0,3,1
1748425691482,MCWP 40,014,945429,Carter; Jennifer A,2,0,3,1
1748425691482,MCWP 40,015,945432,Smith; Haydee Marie,3,0,3,0
1748425691482,MCWP 40,016,945433,Smith; Haydee Marie,3,0,3,0
1748425691482,MCWP 40,017,945435,Smith; Haydee Marie,3,0,3,0
1748425691482,MCWP 40,018,945436,Pham; Vincent Minhduc,3,0,3,0
1748425691482,MCWP 40,019,945453,Pham; Vincent Minhduc,3,0,3,0
1748425691482,MCWP 40,020,945459,Pham; Vincent Minhduc,3,0,3,0
1748425691482,MCWP 40,023,945469,Montejo; Carolina,3,0,3,0
1748425691482,MCWP 40,024,945472,Montejo; Carolina,3,0,3,0
1748425691482,MCWP 40,026,945708,Compas; Sean Matthew,3,0,3,0
1748425691482,MCWP 40,027,945710,Duru; Nur,2,0,3,1
1748425691482,MCWP 40,028,945714,Duru; Nur,1,0,3,2
1748425691482,MCWP 40,029,945715,Duru; Nur,2,0,3,1
1748425691482,MCWP 40,030,945718,Compas; Sean Matthew,0,0,3,3
1748425692509,MCWP 40R,A00,945742,Miller; Elizabeth Deen,0,0,0,1
1748425692509,MCWP 40R,B00,945743,Miller; Elizabeth Deen,0,0,0,0
1748425692509,MCWP 40R,C00,945744,Miller; Elizabeth Deen,0,0,0,1
1748425693542,MCWP 50,001,945745,Wastal; Carrie King,2,0,15,13
1748425693542,MCWP 50,002,945746,Carter; Andrea L,18,0,20,2
1748425693542,MCWP 50,003,945788,Carter; Andrea L,11,0,20,9
1748425693542,MCWP 50,004,945887,Carter; Andrea L,7,0,20,13
1748425694573,MCWP 125,001,945901,Nies; Laurie Elizabeth,3,0,3,0
1748425694573,MCWP 125,002,945902,Nies; Laurie Elizabeth,3,0,3,0
1748425694573,MCWP 125,003,945904,Redela; Pamela Morgan,3,0,3,0
1748425694573,MCWP 125,004,945930,Redela; Pamela Morgan,3,0,3,0
1748425694573,MCWP 125,005,945931,Redela; Pamela Morgan,3,0,3,0
1748425694573,MCWP 125,006,945932,Silva; Kelly B,3,0,3,0
1748425694573,MCWP 125,007,945933,Silva; Kelly B,3,0,3,0
1748425694573,MCWP 125,009,945935,Krone; Jarret,3,0,3,0
1748425694573,MCWP 125,010,945940,Krone; Jarret,3,0,3,0
1748425694573,MCWP 125,011,945941,Krone; Jarret,3,0,3,0
1748425694573,MCWP 125,012,945942,Morshed; Michael James,3,0,3,0
1748425694573,MCWP 125,013,945943,Morshed; Michael James,3,0,3,0
1748425694573,MCWP 125,014,945944,Morshed; Michael James,3,0,3,0
1748425695606,MGT 3,A00,945992,Wagner; Timothy Ryan,96,0,98,2
1748425696636,MGT 4,A01,945994,Brooks; Marcus Raymond,80,0,90,10
1748425697734,MGT 5,A00,945995,Molloie Jr.; William H,134,0,150,16
1748425698761,MGT 12,A00,945996,Lindenberger; Wade Douglas,63,0,98,35
1748425698761,MGT 12,B00,945997,Pecore; Joseph P.,58,0,98,40
1748425699793,MGT 16,A00,945998,Buchanan; Harold G,96,0,98,2
1748425699793,MGT 16,B00,946005,Buchanan; Harold G,90,0,98,8
1748425699793,MGT 16,C00,946006,Campbell; Robert Harold,92,0,98,6
1748425699793,MGT 16,D00,946007,Campbell; Robert Harold,93,0,98,5
1748425699793,MGT 16,E00,946022,Lindenberger; Wade Douglas,42,0,98,56
1748425700824,MGT 18,A00,946040,McKay; Michael J,95,0,98,3
1748425700824,MGT 18,B00,946041,McKay; Michael J,96,0,98,2
1748425700824,MGT 18,C00,946044,McKay; Michael J,96,0,98,2
1748425700824,MGT 18,D00,946047,Chamberlain; Travis Dean,98,0,98,0
1748425700824,MGT 18,E00,946051,Chamberlain; Travis Dean,96,0,98,2
1748425700824,MGT 18,F00,960148,Chamberlain; Travis Dean,0,0,0,2
1748425701852,MGT 45,A00,946055,Pecore; Joseph P.,80,0,150,70
1748425701852,MGT 45,B00,946057,Pecore; Joseph P.,118,0,150,32
1748425702878,MGT 52,A00,946059,Staff,77,0,98,21
1748425703906,MGT 71,A00,946060,Goodarzi; Shadi,0,0,98,98
1748425703906,MGT 71,B00,946061,Erat; Sanjiv,0,0,98,98
1748425703906,MGT 71,D00,960149,Staff,0,0,98,98
1748425704936,MGT 100,A00,946069,Yavorsky; Daniel Ryan,0,0,98,98
1748425705962,MGT 103,A00,946081,Ehrich; Kristine R,96,0,98,2
1748425705962,MGT 103,C00,946083,Ehrich; Kristine R,75,0,98,23
1748425705962,MGT 103,D00,946084,Ehrich; Kristine R,57,0,98,41
1748425705962,MGT 103,E00,946138,Bates; Kenneth Walter,82,0,98,16
1748425706987,MGT 105,A00,946139,Bates; Kenneth Walter,0,0,98,98
1748425708012,MGT 108R,A00,946141,Amir; On,888,0,999,111
1748425709038,MGT 109,A00,946142,Staff,14,0,98,84
1748425710064,MGT 112,A00,960205,Zimmermann; Carsten,30,0,98,68
1748425711095,MGT 119,A00,946144,Schurr; Amos Shlomo,96,0,98,2
1748425711095,MGT 119,B00,946153,Staff,97,0,98,1
1748425712120,MGT 121A,A00,946154,Wang; Helen Shan,89,0,98,9
1748425712120,MGT 121A,B00,946188,Wang; Helen Shan,95,0,98,3
1748425713149,MGT 127R,A00,946197,Zhu; Kevin Xiaoguo,70,0,98,28
1748425714179,MGT 131A,A00,946227,Brooks; Marcus Raymond,91,0,98,7
1748425715210,MGT 132,A00,946230,Blakley; Bruce,76,0,98,22
1748425716240,MGT 135,A00,946234,Anderson; John Charles,1,0,40,39
1748425717270,MGT 137,A00,960206,Lindenberger; Wade Douglas,0,0,98,98
1748425718296,MGT 151R,A00,946235,Staff,64,0,98,34
1748425719322,MGT 153,A00,946242,Perols; Johan Lars,0,0,90,90
1748425719322,MGT 153,B00,946244,Perols; Johan Lars,0,0,90,90
1748425720348,MGT 158,A00,946247,Bliss; Barbara Ann,85,0,98,13
1748425721374,MGT 160,A00,946265,Johnson; Erik Barry,30,0,90,60
1748425721374,MGT 160,B00,946266,Johnson; Erik Barry,58,0,90,32
1748425722409,MGT 162,A00,946267,Demill; Burritt,85,0,98,13
1748425722409,MGT 162,B00,946269,Demill; Burritt,67,0,98,31
1748425723437,MGT 162R,A00,946270,Gneezy; Uri,0,0,150,150
1748425724465,MGT 164,A00,946271,McKay; Mary A,88,0,98,10
1748425724465,MGT 164,B00,946272,McKay; Mary A,80,0,98,18
1748425724465,MGT 164,C00,946273,McKay; Mary A,88,0,98,10
1748425724465,MGT 164,D00,946274,Meyer; Alison Bloomfield,0,0,98,98
1748425725499,MGT 166,A00,946276,Moran; Cathleen L.,40,0,60,20
1748425725499,MGT 166,B00,946277,Moran; Cathleen L.,84,0,98,14
1748425725499,MGT 166,C00,946278,Moran; Cathleen L.,94,0,98,4
1748425726526,MGT 167,A00,946279,Jacob; Jo Dee C,88,0,98,10
1748425726526,MGT 167,B00,946280,Klaas; Jeffrey David,97,0,98,1
1748425728580,MGT 172,A00,946282,Hedges; Kathleen & Royal; Rebecca,92,0,98,6
1748425728580,MGT 172,B00,946283,Hedges; Kathleen,73,0,98,25
1748425728580,MGT 172,C00,946284,Zimmermann; Carsten,0,0,0,3
1748425729606,MGT 172R,A00,946285,Erat; Sanjiv,134,0,150,16
1748425730632,MGT 173,A00,946286,Hayes; Sherry Lorine,66,0,98,32
1748425731663,MGT 175,A00,946287,Gopal; Christopher S.,81,0,90,9
1748425732690,MGT 180,A00,946288,Bliss; Barbara Ann,96,0,150,54
1748425732690,MGT 180,B00,946289,Buti; Krisztina,140,0,150,10
1748425732690,MGT 180,C00,960207,Buti; Krisztina,142,0,150,8
1748425733718,MGT 181,A00,946290,Buchanan; Harold G,17,0,120,103
1748425734747,MGT 183,A00,960208,Staff,53,0,98,45
1748425735775,MGT 185,A00,946291,Dunn; Louis Jean,69,0,98,29
1748425736802,MGT 187,A00,946292,Dunn; Louis Jean,43,0,98,55
1748425737827,MGT 189,A00,946293,Staff,88,0,98,10
1748425738858,MGT 228,A00,946294,Sadoff; Sally,16,0,20,4
1748425739884,MGT 286,A00,946295,Staff,20,0,20,0
1748425740916,MGT 296,001,969295,Gneezy; Ayelet,2,0,3,1
1748425740916,MGT 296,002,969296,Amir; On,3,0,3,0
1748425740916,MGT 296,003,969297,Amir; On & Karmarkar; Uma R,2,0,3,1
1748425740916,MGT 296,004,969298,Liu; Jun,3,0,3,0
1748425740916,MGT 296,005,969300,Hansen; Karsten T.,2,0,3,1
1748425740916,MGT 296,006,969301,Erat; Sanjiv,2,0,3,1
1748425740916,MGT 296,007,969302,Avenancio-Leon; Carlos,3,0,3,0
1748425740916,MGT 296,008,969303,Engelberg; Joseph Edward,3,0,3,0
1748425740916,MGT 296,009,969304,Zhang; Zhe,3,0,3,0
1748425740916,MGT 296,010,969305,Oveis; Christopher S,3,0,3,0
1748425740916,MGT 296,011,969306,Zhu; Kevin Xiaoguo & Gneezy; Ayelet,3,0,3,0
1748425740916,MGT 296,012,969307,Luo; Danqi,3,0,3,0
1748425740916,MGT 296,013,969309,Oveis; Christopher S & Campbell; Elizabeth L,3,0,3,0
1748425740916,MGT 296,014,969310,Serra Garcia; Marta & Gneezy; Uri,3,0,3,0
1748425740916,MGT 296,015,969311,Rai; Tage S,3,0,3,0
1748425741963,MMW 11,A01,925937,Herbst; Matthew,4,0,4,0
1748425741963,MMW 11,A02,925938,Herbst; Matthew,3,0,4,1
1748425741963,MMW 11,A03,925939,Herbst; Matthew,4,0,4,0
1748425741963,MMW 11,A04,925940,Herbst; Matthew,4,0,4,0
1748425741963,MMW 11,A05,925941,Herbst; Matthew,0,0,0,0
1748425741963,MMW 11,A06,925942,Herbst; Matthew,0,0,0,0
1748425741963,MMW 11,A07,925975,Herbst; Matthew,3,0,4,1
1748425741963,MMW 11,A08,926004,Herbst; Matthew,3,0,4,1
1748425741963,MMW 11,A09,926021,Herbst; Matthew,3,0,4,1
1748425741963,MMW 11,A10,926064,Herbst; Matthew,4,0,4,0
1748425741963,MMW 11,A11,926067,Herbst; Matthew,4,0,4,0
1748425741963,MMW 11,A12,926072,Herbst; Matthew,4,0,4,0
1748425741963,MMW 11,B01,926211,Chang; Edmond Yi-Teh,3,0,4,1
1748425741963,MMW 11,B02,926212,Chang; Edmond Yi-Teh,4,0,4,0
1748425741963,MMW 11,B03,926213,Chang; Edmond Yi-Teh,4,0,4,0
1748425741963,MMW 11,B04,926214,Chang; Edmond Yi-Teh,4,0,4,0
1748425741963,MMW 11,B05,926215,Chang; Edmond Yi-Teh,4,0,4,0
1748425741963,MMW 11,B06,926216,Chang; Edmond Yi-Teh,4,0,4,0
1748425741963,MMW 11,B07,926217,Chang; Edmond Yi-Teh,4,0,4,0
1748425741963,MMW 11,B08,926218,Chang; Edmond Yi-Teh,3,0,4,1
1748425741963,MMW 11,B09,926219,Chang; Edmond Yi-Teh,4,0,4,0
1748425741963,MMW 11,B10,926220,Chang; Edmond Yi-Teh,4,0,4,0
1748425741963,MMW 11,B11,926221,Chang; Edmond Yi-Teh,0,0,0,0
1748425741963,MMW 11,B12,926233,Chang; Edmond Yi-Teh,0,0,0,0
1748425741963,MMW 11,C01,926237,Chang; Edmond Yi-Teh,4,0,4,0
1748425741963,MMW 11,C02,926238,Chang; Edmond Yi-Teh,4,0,4,0
1748425741963,MMW 11,C03,926239,Chang; Edmond Yi-Teh,3,0,4,1
1748425741963,MMW 11,C04,926240,Chang; Edmond Yi-Teh,4,0,4,0
1748425741963,MMW 11,C05,926241,Chang; Edmond Yi-Teh,4,0,4,0
1748425741963,MMW 11,C06,926242,Chang; Edmond Yi-Teh,4,0,4,0
1748425741963,MMW 11,C07,926243,Chang; Edmond Yi-Teh,4,0,4,0
1748425741963,MMW 11,C08,926244,Chang; Edmond Yi-Teh,4,0,4,0
1748425741963,MMW 11,C09,926245,Chang; Edmond Yi-Teh,0,0,0,0
1748425741963,MMW 11,C10,926301,Chang; Edmond Yi-Teh,0,0,0,0
1748425741963,MMW 11,C11,926303,Chang; Edmond Yi-Teh,4,0,4,0
1748425741963,MMW 11,C12,926305,Chang; Edmond Yi-Teh,4,0,4,0
1748425742997,MMW 14,A01,926309,Carreras; Maria Victoria,0,0,0,0
1748425742997,MMW 14,A02,926470,Carreras; Maria Victoria,0,0,0,0
1748425742997,MMW 14,A03,926472,Carreras; Maria Victoria,0,0,28,28
1748425742997,MMW 14,A04,926474,Carreras; Maria Victoria,0,0,28,28
1748425742997,MMW 14,A05,926475,Carreras; Maria Victoria,0,0,28,28
1748425742997,MMW 14,A06,926476,Carreras; Maria Victoria,0,0,28,28
1748425742997,MMW 14,A07,926477,Carreras; Maria Victoria,0,0,28,28
1748425742997,MMW 14,A08,926513,Carreras; Maria Victoria,0,0,28,28
1748425742997,MMW 14,A09,926514,Carreras; Maria Victoria,0,0,0,0
1748425742997,MMW 14,A10,926515,Carreras; Maria Victoria,0,0,0,0
1748425744028,MMW 121,A01,926517,Adamiak; Patrick John,0,0,0,0
1748425744028,MMW 121,A02,926548,Adamiak; Patrick John,0,0,0,0
1748425744028,MMW 121,A03,926549,Adamiak; Patrick John,0,0,4,4
1748425744028,MMW 121,A04,926550,Adamiak; Patrick John,2,0,4,2
1748425744028,MMW 121,A05,926551,Adamiak; Patrick John,0,0,4,4
1748425744028,MMW 121,A06,926552,Adamiak; Patrick John,3,0,4,1
1748425744028,MMW 121,A07,926585,Adamiak; Patrick John,3,0,4,1
1748425744028,MMW 121,A08,926590,Adamiak; Patrick John,3,0,4,1
1748425744028,MMW 121,A09,926641,Adamiak; Patrick John,0,0,0,0
1748425744028,MMW 121,A10,926658,Adamiak; Patrick John,0,0,0,0
1748425744028,MMW 121,B01,926680,Adamiak; Patrick John,0,0,4,4
1748425744028,MMW 121,B02,926691,Adamiak; Patrick John,0,0,4,4
1748425744028,MMW 121,B03,926710,Adamiak; Patrick John,2,0,4,2
1748425744028,MMW 121,B04,926714,Adamiak; Patrick John,4,0,4,0
1748425744028,MMW 121,B05,926750,Adamiak; Patrick John,0,0,4,4
1748425744028,MMW 121,B06,926765,Adamiak; Patrick John,4,0,4,0
1748425744028,MMW 121,B07,926769,Adamiak; Patrick John,3,0,4,1
1748425744028,MMW 121,B08,926953,Adamiak; Patrick John,3,0,4,1
1748425744028,MMW 121,B09,926954,Adamiak; Patrick John,0,0,0,0
1748425744028,MMW 121,B10,926955,Adamiak; Patrick John,0,0,0,0
1748425745057,MSED 295,A00,927153,Staff,5,0,5,0
1748425746084,MSED 296A,A00,927181,Rabin; Jeffrey Mark,13,0,15,2
1748425747114,MUS 1A,A01,931495,Staff,24,0,25,1
1748425747114,MUS 1A,A02,931499,Staff,21,0,25,4
1748425747114,MUS 1A,A03,931502,Staff,21,0,25,4
1748425747114,MUS 1A,A04,931503,Staff,25,0,25,0
1748425747114,MUS 1A,A05,931504,Staff,19,0,25,6
1748425747114,MUS 1A,A06,931505,Staff,22,0,25,3
1748425747114,MUS 1A,B01,931507,Staff,25,0,25,0
1748425747114,MUS 1A,B02,931530,Staff,22,0,25,3
1748425747114,MUS 1A,B03,931534,Staff,23,0,25,2
1748425747114,MUS 1A,B04,931536,Staff,24,0,25,1
1748425747114,MUS 1A,B05,931539,Staff,17,0,25,8
1748425747114,MUS 1A,B06,931541,Staff,13,0,25,12
1748425748146,MUS 2A,A01,931544,Carlson; Erik,40,0,40,0
1748425749170,MUS 2AK,A00,931545,Ohnishi; Takae,15,0,15,0
1748425749170,MUS 2AK,B00,931546,Ohnishi; Takae,15,0,15,0
1748425750202,MUS 4,A01,931551,Staff,24,0,25,1
1748425750202,MUS 4,A02,931552,Staff,25,0,25,0
1748425750202,MUS 4,A03,931553,Staff,24,0,25,1
1748425750202,MUS 4,A04,931554,Staff,25,0,25,0
1748425750202,MUS 4,A05,931558,Staff,24,0,25,1
1748425750202,MUS 4,A06,931561,Staff,25,0,25,0
1748425750202,MUS 4,A07,931562,Staff,25,0,25,0
1748425750202,MUS 4,A08,931563,Staff,25,0,25,0
1748425750202,MUS 4,A09,931564,Staff,25,0,25,0
1748425750202,MUS 4,A10,931566,Staff,25,0,25,0
1748425751231,MUS 6,A01,931573,Freitas Caetano; Marcelo,27,0,30,3
1748425751231,MUS 6,A02,931574,Freitas Caetano; Marcelo,28,0,30,2
1748425751231,MUS 6,A03,931677,Freitas Caetano; Marcelo,28,0,30,2
1748425751231,MUS 6,A04,931696,Freitas Caetano; Marcelo,30,0,30,0
1748425752261,MUS 8,A01,931732,Smythe; Cory Benjamin,12,0,25,13
1748425752261,MUS 8,A02,931737,Smythe; Cory Benjamin,17,0,25,8
1748425752261,MUS 8,A03,931761,Smythe; Cory Benjamin,25,0,25,0
1748425752261,MUS 8,A04,931920,Smythe; Cory Benjamin,23,0,25,2
1748425752261,MUS 8,A05,931925,Smythe; Cory Benjamin,21,0,25,4
1748425752261,MUS 8,A06,931943,Smythe; Cory Benjamin,19,0,25,6
1748425752261,MUS 8,A07,931948,Smythe; Cory Benjamin,22,0,25,3
1748425752261,MUS 8,A08,931955,Smythe; Cory Benjamin,18,0,25,7
1748425752261,MUS 8,A09,931964,Smythe; Cory Benjamin,25,0,25,0
1748425752261,MUS 8,A10,931974,Smythe; Cory Benjamin,24,0,25,1
1748425753303,MUS 13,A01,961328,Guy; Nancy,28,0,30,2
1748425753303,MUS 13,A02,961333,Guy; Nancy,30,0,30,0
1748425753303,MUS 13,A03,961343,Guy; Nancy,28,0,30,2
1748425753303,MUS 13,A04,961351,Guy; Nancy,30,0,30,0
1748425754335,MUS 14,A01,932176,McCormack; Timothy Matthew,29,0,30,1
1748425754335,MUS 14,A02,932183,McCormack; Timothy Matthew,29,0,30,1
1748425754335,MUS 14,A03,932186,McCormack; Timothy Matthew,30,0,30,0
1748425754335,MUS 14,A04,932190,McCormack; Timothy Matthew,29,0,30,1
1748425755374,MUS 15,A01,932270,Lou; Michelle Siulai,28,0,30,2
1748425755374,MUS 15,A02,932315,Lou; Michelle Siulai,29,0,30,1
1748425755374,MUS 15,A03,932316,Lou; Michelle Siulai,28,0,30,2
1748425755374,MUS 15,A04,932323,Lou; Michelle Siulai,30,0,30,0
1748425755374,MUS 15,A05,932325,Lou; Michelle Siulai,27,0,30,3
1748425755374,MUS 15,A06,932326,Lou; Michelle Siulai,27,0,30,3
1748425755374,MUS 15,A07,932327,Lou; Michelle Siulai,30,0,30,0
1748425755374,MUS 15,A08,932328,Lou; Michelle Siulai,28,0,30,2
1748425755374,MUS 15,A09,932366,Lou; Michelle Siulai,29,0,30,1
1748425755374,MUS 15,A10,932380,Lou; Michelle Siulai,25,0,30,5
1748425756407,MUS 17,A01,932416,Staff,0,0,0,0
1748425756407,MUS 17,A02,932423,Staff,0,0,0,0
1748425756407,MUS 17,A03,932437,Staff,0,0,0,0
1748425756407,MUS 17,A04,932447,Staff,0,0,0,0
1748425756407,MUS 17,A05,932460,Staff,0,0,0,0
1748425756407,MUS 17,A06,932466,Staff,0,0,0,0
1748425756407,MUS 17,A07,932475,Staff,0,0,0,0
1748425756407,MUS 17,A08,932479,Staff,0,0,0,0
1748425756407,MUS 17,A09,932480,Staff,0,0,0,0
1748425756407,MUS 17,A10,932481,Staff,0,0,0,0
1748425756407,MUS 17,A11,932487,Staff,0,0,0,9
1748425756407,MUS 17,A12,932490,Staff,0,0,0,1
1748425757434,MUS 19R,A01,932494,Britt; King James,7,0,25,18
1748425757434,MUS 19R,A02,932500,Britt; King James,20,0,25,5
1748425757434,MUS 19R,A03,932503,Britt; King James,24,0,25,1
1748425757434,MUS 19R,A04,932504,Britt; King James,23,0,25,2
1748425757434,MUS 19R,A05,932512,Britt; King James,25,0,25,0
1748425757434,MUS 19R,A06,932513,Britt; King James,17,0,25,8
1748425757434,MUS 19R,A07,932517,Britt; King James,22,0,25,3
1748425757434,MUS 19R,A08,932522,Britt; King James,20,0,25,5
1748425757434,MUS 19R,A09,960795,Britt; King James,25,0,25,0
1748425757434,MUS 19R,A10,960796,Britt; King James,15,0,25,10
1748425757434,MUS 19R,B01,960808,Britt; King James,5,0,5,0
1748425757434,MUS 19R,B02,960810,Britt; King James,4,0,5,1
1748425757434,MUS 19R,B03,960812,Britt; King James,5,0,5,0
1748425757434,MUS 19R,B04,960815,Britt; King James,5,0,5,0
1748425757434,MUS 19R,B05,960861,Britt; King James,5,0,5,0
1748425757434,MUS 19R,B06,960863,Britt; King James,5,0,5,0
1748425757434,MUS 19R,B07,960866,Britt; King James,5,0,5,0
1748425757434,MUS 19R,B08,960870,Britt; King James,5,0,5,0
1748425757434,MUS 19R,B09,960871,Britt; King James,5,0,5,0
1748425757434,MUS 19R,B10,960872,Britt; King James,5,0,5,0
1748425758462,MUS 32,001,931432,Dresser; Mark Stuart,5,0,5,0
1748425758462,MUS 32,002,931433,Smythe; Cory Benjamin,5,0,5,0
1748425758462,MUS 32,003,931438,Kenyatta; Kamau,5,0,5,0
1748425758462,MUS 32,004,931441,Curtis; Charles Rector,5,0,5,0
1748425758462,MUS 32,005,931443,Staff,5,0,5,0
1748425758462,MUS 32,006,931447,Terrazas Perez; Wilfrido D,5,0,5,0
1748425758462,MUS 32,007,931448,Ohnishi; Takae,5,0,5,0
1748425758462,MUS 32,008,931453,Burr; Anthony I,5,0,5,0
1748425758462,MUS 32,009,931454,Carlson; Erik,5,0,5,0
1748425759490,MUS 32V,A00,932529,Staff,5,0,5,0
1748425759490,MUS 32V,B00,932532,Staff,5,0,5,0
1748425760518,MUS 32VM,A00,932533,Staff,15,0,15,0
1748425761546,MUS 33A,A00,932538,Liang; Lei,16,0,17,1
1748425762574,MUS 43,A00,932540,Staff,79,0,96,17
1748425763601,MUS 95C,A00,932544,Staff,30,0,40,10
1748425764628,MUS 95D,A00,932547,Staff,30,0,30,0
1748425765859,MUS 95E,A00,932548,Staff,45,0,45,0
1748425766885,MUS 95F,A00,932549,Staff,40,0,40,0
1748425767912,MUS 95G,A00,932550,Anderson; Kenneth,374,0,395,21
1748425767912,MUS 95G,B00,932553,Anderson; Kenneth,381,0,395,14
1748425768941,MUS 95JC,A00,932555,Kenyatta; Kamau,25,0,25,0
1748425769968,MUS 95L,A00,932556,Staff,65,0,65,0
1748425770995,MUS 95P,A00,932564,Nourai; Keyavash,17,0,20,3
1748425770995,MUS 95P,B00,932565,Nourai; Keyavash,18,0,20,2
1748425772021,MUS 95W,A00,932567,Seshadri; Kartik,26,0,30,4
1748425772021,MUS 95W,B00,932570,Seshadri; Kartik,30,0,30,0
1748425773048,MUS 101A,A01,932575,Burr; Anthony I,31,0,35,4
1748425774077,MUS 107,A00,932578,Terrazas Perez; Wilfrido D,14,0,15,1
1748425775106,MUS 111,A00,932580,Liang; Lei,135,0,140,5
1748425776133,MUS 113,A00,932584,Curtis; Charles Rector,48,0,50,2
1748425777159,MUS 115,A00,932585,Narucki; Susan M,32,0,40,8
1748425778185,MUS 120A,A01,932593,Leslie Santana; Myrta,27,0,30,3
1748425779211,MUS 130,A00,932600,Ohnishi; Takae,35,0,35,0
1748425780238,MUS 132,001,931462,Dresser; Mark Stuart,5,0,5,0
1748425780238,MUS 132,002,931463,Smythe; Cory Benjamin,5,0,5,0
1748425780238,MUS 132,003,931465,Kenyatta; Kamau,5,0,5,0
1748425780238,MUS 132,004,931467,Curtis; Charles Rector,5,0,5,0
1748425780238,MUS 132,005,931468,Staff,5,0,5,0
1748425780238,MUS 132,006,931470,Terrazas Perez; Wilfrido D,5,0,5,0
1748425780238,MUS 132,007,931471,Ohnishi; Takae,5,0,5,0
1748425780238,MUS 132,008,931473,Burr; Anthony I,5,0,5,0
1748425780238,MUS 132,009,931474,Carlson; Erik,5,0,5,0
1748425781264,MUS 132R,A00,961401,Narucki; Susan M,5,0,5,0
1748425782290,MUS 132V,A00,961362,Narucki; Susan M,10,0,10,0
1748425782290,MUS 132V,B00,961397,Staff,10,0,10,0
1748425783316,MUS 134,A00,932601,Staff,30,0,30,0
1748425784343,MUS 137A,A00,932604,Kenyatta; Kamau,31,0,35,4
1748425785373,MUS 143,A00,932617,Staff,10,0,30,20
1748425786399,MUS 170,A01,932620,Freitas Caetano; Marcelo,45,0,50,5
1748425786399,MUS 170,A02,932623,Freitas Caetano; Marcelo,41,0,50,9
1748425787424,MUS 173A,A00,932625,Britt; King James,27,0,65,38
1748425788450,MUS 174A,A00,932649,Erbe; Tom,0,0,25,25
1748425789481,MUS 175,A00,932810,Smyth; Tamara R.,29,0,30,1
1748425790512,MUS 176,A00,932811,Yadegari; Shahrokh D,29,0,30,1
1748425791542,MUS 201A,A00,932812,Carlson; Erik,14,0,15,1
1748425792569,MUS 201C,A00,932818,Schick; Steven,15,0,15,0
1748425793596,MUS 203A,A00,932821,Lou; Michelle Siulai,15,0,15,0
1748425794627,MUS 203D,A00,932825,Davis; Anthony Curtis,10,0,10,0
1748425794627,MUS 203D,B00,932827,Liang; Lei,10,0,10,0
1748425794627,MUS 203D,C00,932828,Lou; Michelle Siulai,9,0,10,1
1748425794627,MUS 203D,D00,932830,Obermueller; Karola,9,0,10,1
1748425794627,MUS 203D,E00,932831,Steiger; Rand,10,0,10,0
1748425794627,MUS 203D,F00,961402,McCormack; Timothy Matthew,10,0,10,0
1748425795654,MUS 204,A00,932832,Obermueller; Karola,29,0,30,1
1748425796681,MUS 205,A00,932833,Guy; Nancy,15,0,15,0
1748425797708,MUS 206,B00,961403,Obermueller; Karola,14,0,15,1
1748425797708,MUS 206,C00,932839,Davis; Anthony Curtis,14,0,15,1
1748425798734,MUS 215A,A00,932985,Cimini; Amy Marie,15,0,15,0
1748425799761,MUS 228,A00,933096,Schick; Steven,13,0,15,2
1748425800788,MUS 229,A00,933148,McCormack; Timothy Matthew,14,0,15,1
1748425801879,MUS 232,001,931483,Dresser; Mark Stuart,5,0,5,0
1748425801879,MUS 232,002,931485,Kenyatta; Kamau,5,0,5,0
1748425801879,MUS 232,003,931487,Narucki; Susan M,4,0,5,1
1748425801879,MUS 232,004,931489,Schick; Steven,5,0,5,0
1748425801879,MUS 232,005,964353,Terrazas Perez; Wilfrido D,3,0,3,0
1748425802909,MUS 234,A00,933176,Erbe; Tom,20,0,20,0
1748425803939,MUS 270D,A00,969315,Smyth; Tamara R.,0,0,0,0
1748425804968,MUS 291,A00,933192,Curtis; Charles Rector,15,0,15,0
1748425805997,NANO 4,A01,912573,Vazquez Mena; Oscar,21,0,24,3
1748425805997,NANO 4,B01,912575,Vazquez Mena; Oscar,24,0,24,0
1748425805997,NANO 4,C01,912577,Vazquez Mena; Oscar,21,0,24,3
1748425805997,NANO 4,D01,912579,Vazquez Mena; Oscar,23,0,24,1
1748425807024,NANO 11,A00,912580,Fenning; David,143,0,146,3
1748425808055,NANO 15,A01,912583,Lubarda; Vlado,26,0,30,4
1748425809082,NANO 20L,A00,912584,Sirbuly; Donald,0,0,30,30
1748425809082,NANO 20L,B00,912585,Sirbuly; Donald,20,0,30,10
1748425810113,NANO 102,A00,912586,Tao; Andrea Rae,99,0,115,16
1748425811141,NANO 103,A00,912587,Jahed Motlagh; Zeinab,49,0,50,1
1748425812168,NANO 111,A00,912588,Vecchio; Kenneth S,50,0,60,10
1748425813194,NANO 119,A00,912589,Jokerst; Jesse Vincent,6,0,28,22
1748425813194,NANO 119,B00,912590,Jokerst; Jesse Vincent,26,0,28,2
1748425814220,NANO 148,A00,912591,Luo; Jian,55,0,70,15
1748425815246,NANO 150,A00,912592,Lubarda; Vlado,48,0,50,2
1748425816276,NANO 159,A00,912593,Wang; Joseph,44,0,50,6
1748425817303,NANO 175,A00,912594,Steinmetz; Nicole F,13,0,35,22
1748425818336,NANO 200,A00,912595,Jahed Motlagh; Zeinab,110,0,120,10
1748425819363,NANO 201,A00,912596,Sirbuly; Donald,49,0,60,11
1748425820387,NANO 202,A00,912597,Pascal; Tod A,60,0,60,0
1748425821417,NANO 203,A00,912598,Fenning; David,95,0,100,5
1748425822444,NANO 227,A00,912599,Graeve; Olivia A,14,0,15,1
1748425823470,NANO 247A,A00,912600,Shi; Lingyan,9,0,15,6
1748425824496,NANO 247B,A00,912601,Aran; Kiana,11,0,15,4
1748425825525,NANO 257,A00,912602,Cai; Shengqiang,32,0,35,3
1748425826551,NANO 265,A00,912603,Luo; Jian,9,0,10,1
1748425827577,NEU 276,A00,969333,Staff,0,0,0,0
1748425827577,NEU 276,A01,969334,Staff,0,0,0,0
1748425828609,NEUG 200A,A01,969326,Bloodgood; Brenda Laurie,0,0,0,0
1748425828609,NEUG 200A,A02,969327,Bloodgood; Brenda Laurie,0,0,0,0
1748425829634,NEUG 221,A00,969330,Dore; Kim Bohemie,6,0,6,0
1748425829634,NEUG 221,B00,969331,Bloodgood; Brenda Laurie,0,0,0,0
1748425830661,NEUG 265,A00,969329,Yaksh; Tony L.,10,0,10,0
1748425831686,NEUG 296,A00,969336,Bloodgood; Brenda Laurie,12,0,12,0
1748425832721,PH 40,A00,922279,Trinidad; Dennis Ryan,136,0,150,14
1748425832721,PH 40,B00,922283,Trinidad; Dennis Ryan,148,0,150,2
1748425833748,PH 50,A00,922284,Glockner; Susan Mariscal,160,0,175,15
1748425834780,PH 90,A00,964352,Larsen; Britta Ann,0,0,0,0
1748425835806,PH 91,A00,922286,Harrell; Maralee Mae,48,0,50,2
1748425836833,PH 101,A00,922287,Brouwer; Kimberly,0,0,50,50
1748425837864,PH 102,A01,922307,Rana; Brinda Kanti,0,0,25,25
1748425837864,PH 102,A02,922310,Rana; Brinda Kanti,0,0,25,25
1748425838893,PH 110,A00,922333,Zoumas-Morse; Christine E.,0,0,50,50
1748425839920,PH 120,A00,922392,McMenamin; Sara B,0,0,50,50
1748425840946,PH 120R,A00,922393,McMenamin; Sara B,0,0,50,50
1748425841972,PH 130,A00,922441,Kayser; Georgia Lyn,0,0,60,60
1748425843002,PH 157,A00,922444,Campbell; Chadwick Karl,29,0,50,21
1748425844027,PH 161,A00,922445,Zoumas-Morse; Christine E.,0,0,50,50
1748425845054,PH 193,A00,922468,Zoumas-Morse; Christine E.,0,0,0,0
1748425846082,PH 231,A00,970937,Hurst; Samantha,12,0,12,0
1748425847111,PH 258,A00,960659,Bazzi; Angela Robertson,15,0,15,0
1748425848139,PH 259,A00,960660,Bandoli; Gretchen,10,0,10,0
1748425849170,PH 275,A00,922474,Groessl; Erik Joseph,10,0,10,0
1748425850198,PH 280,A00,960661,Strong; David R & Skaathun; Britt Paige,10,0,10,0
1748425851225,PHAR 219,A00,954131,Ross; Camille,0,0,0,0
1748425852252,PHAR 236,A00,934403,Chen; Shu-Juan,10,0,10,0
1748425853280,PHAR 295,A00,934404,Joiner; William J.,14,0,15,1
1748425854307,PHB 221,A00,922708,Zou; Jingjing,22,0,39,17
1748425855340,PHB 224,A00,922793,Jain; Sonia,9,0,30,21
1748425856370,PHB 227,A00,922796,Liu; Lin,14,0,37,23
1748425857397,PHB 241,A00,970723,Vaida; Florin,9998,0,9999,1
1748425858423,PHB 243A,A01,922822,Tu; Xin,20,0,45,25
1748425859449,PHB 244A,A00,922870,Zhang; Xinlian,20,0,35,15
1748425860475,PHB 280,A00,922875,Messer; Karen Sue,69,0,70,1
1748425861501,PHB 281,A00,923029,Staff,62,0,65,3
1748425862526,PHIL 1,A00,934405,Sher; Gila,38,0,40,2
1748425863552,PHIL 10,A01,934409,Rudolph; Rachel Etta,34,0,39,5
1748425863552,PHIL 10,A02,934410,Rudolph; Rachel Etta,32,0,40,8
1748425863552,PHIL 10,A03,934414,Rudolph; Rachel Etta,31,0,40,9
1748425863552,PHIL 10,A04,934415,Rudolph; Rachel Etta,39,0,40,1
1748425863552,PHIL 10,A05,934416,Rudolph; Rachel Etta,35,0,40,5
1748425863552,PHIL 10,A06,934417,Rudolph; Rachel Etta,39,0,40,1
1748425864583,PHIL 12,A01,934419,Harrell; Maralee Mae,0,0,0,0
1748425864583,PHIL 12,A02,934422,Harrell; Maralee Mae,0,0,0,0
1748425864583,PHIL 12,A03,934423,Harrell; Maralee Mae,30,0,35,5
1748425864583,PHIL 12,A04,934425,Harrell; Maralee Mae,32,0,35,3
1748425865610,PHIL 13,A01,934427,Lamey; Andy M.,32,0,34,2
1748425865610,PHIL 13,A02,934429,Lamey; Andy M.,31,0,34,3
1748425865610,PHIL 13,A03,934430,Lamey; Andy M.,31,0,34,3
1748425865610,PHIL 13,A04,934432,Lamey; Andy M.,34,0,34,0
1748425866635,PHIL 25,A00,934434,Chen; Keming,65,0,70,5
1748425867666,PHIL 27,A01,934442,Brandt; Reuven A,0,0,33,33
1748425867666,PHIL 27,A02,934443,Brandt; Reuven A,7,0,33,26
1748425867666,PHIL 27,A03,934444,Brandt; Reuven A,10,0,33,23
1748425867666,PHIL 27,A04,934448,Brandt; Reuven A,0,0,33,33
1748425867666,PHIL 27,A05,934450,Brandt; Reuven A,19,0,33,14
1748425867666,PHIL 27,A06,934452,Brandt; Reuven A,0,0,33,33
1748425867666,PHIL 27,A07,934499,Brandt; Reuven A,0,0,33,33
1748425867666,PHIL 27,A08,934500,Brandt; Reuven A,6,0,33,27
1748425868697,PHIL 28,A01,934502,Brink; David O.,26,0,33,7
1748425868697,PHIL 28,A02,934506,Brink; David O.,26,0,33,7
1748425868697,PHIL 28,A03,934507,Brink; David O.,27,0,33,6
1748425868697,PHIL 28,A04,934512,Brink; David O.,8,0,33,25
1748425868697,PHIL 28,A05,934517,Brink; David O.,20,0,33,13
1748425868697,PHIL 28,A06,934518,Brink; David O.,0,0,33,33
1748425868697,PHIL 28,A07,934519,Brink; David O.,16,0,33,17
1748425868697,PHIL 28,A08,934520,Brink; David O.,27,0,33,6
1748425869722,PHIL 35,A00,934521,Vargas; Manuel Rogelio,138,0,140,2
1748425870746,PHIL 50,A00,934524,Nelkin; Dana Kay,124,0,140,16
1748425871772,PHIL 65,A00,934526,Rudolph; Rachel Etta,37,0,40,3
1748425872802,PHIL 110,A00,934529,Shields; Christopher John,38,0,42,4
1748425873840,PHIL 115,A00,934530,Nelkin; Dana Kay,15,0,20,5
1748425874868,PHIL 120,A00,934533,Kocurek; Alexander William,45,0,60,15
1748425875895,PHIL 125,A00,934534,Carr; Jennifer Rose,38,0,40,2
1748425876923,PHIL 138,A00,934535,Brink; David O.,29,0,40,11
1748425877958,PHIL 143,A00,934579,Cohen; Jonathan David,40,0,40,0
1748425878986,PHIL 148,A00,934580,Callender; Craig Adam,126,0,140,14
1748425880011,PHIL 149,A00,934581,Fulkerson; Matthew Todd,37,0,70,33
1748425881040,PHIL 158,A00,934593,Chen; Keming,20,0,40,20
1748425882070,PHIL 166,A00,934675,Lamey; Andy M.,27,0,40,13
1748425883097,PHIL 180,A00,934688,Hardimon; Michael O.,32,0,40,8
1748425884126,PHIL 200,A00,934719,Kovaka; Karenc,20,0,20,0
1748425885152,PHIL 201A,A00,934736,Shields; Christopher John,18,0,20,2
1748425886184,PHIL 209A,A00,934772,McKenzie; Kerry V.,10,0,10,0
1748425887209,PHIL 209C,A00,934787,McKenzie; Kerry V.,10,0,10,0
1748425888234,PHIL 222,A00,934789,Kocurek; Alexander William & Carr; Jennifer Rose,19,0,20,1
1748425889258,PHIL 260,A00,934791,Bazargan-Forward; Saba,18,0,20,2
1748425890284,PHIL 271,A00,934793,Vargas; Manuel Rogelio & Nelkin; Dana Kay & Fulkerson; Matthew Todd,9999,0,9999,0
1748425891312,PHIL 275,A00,934819,Watkins; Eric,9998,0,9999,1
1748425892338,PHIL 277,A00,934820,Tolley; Clinton,9997,0,9999,2
1748425893366,PHIL 278,A00,934821,Cohen; Jonathan David & Fulkerson; Matthew Todd,9999,0,9999,0
1748425894393,PHIL 280,A00,934827,Kovaka; Karenc,9999,0,9999,0
1748425895418,PHIL 281,A00,934828,Tolley; Clinton,9999,0,9999,0
1748425896443,PHIL 282,A00,934869,Bazargan-Forward; Saba,9999,0,9999,0
1748425897477,PHIL 283,A00,934870,Vargas; Manuel Rogelio & Tolley; Clinton,9999,0,9999,0
1748425898502,PHIL 286,A00,934871,Callender; Craig Adam & Chen; Keming,9999,0,9999,0
1748425899532,PHIL 287,A00,934872,Shields; Christopher John,9999,0,9999,0
1748425900566,PHIL 290,001,963258,Bazargan-Forward; Saba,9999,0,9999,0
1748425900566,PHIL 290,002,963281,Brandt; Reuven A,9999,0,9999,0
1748425900566,PHIL 290,003,963724,Brink; David O.,9999,0,9999,0
1748425900566,PHIL 290,004,963726,Callender; Craig Adam,9999,0,9999,0
1748425900566,PHIL 290,005,963740,Carr; Jennifer Rose,9999,0,9999,0
1748425900566,PHIL 290,006,963878,Cartwright; Nancy D.,9999,0,9999,0
1748425900566,PHIL 290,007,963888,Chen; Keming,9999,0,9999,0
1748425900566,PHIL 290,008,963889,Cohen; Jonathan David,9999,0,9999,0
1748425900566,PHIL 290,009,964028,Danks; David J,9999,0,9999,0
1748425900566,PHIL 290,010,964036,Fulkerson; Matthew Todd,9999,0,9999,0
1748425900566,PHIL 290,011,964044,Hardimon; Michael O.,9999,0,9999,0
1748425900566,PHIL 290,012,964084,Harrell; Maralee Mae,9999,0,9999,0
1748425900566,PHIL 290,013,964086,Johnson; Monte,9999,0,9999,0
1748425900566,PHIL 290,014,964093,Kocurek; Alexander William,9999,0,9999,0
1748425900566,PHIL 290,015,964101,Kovaka; Karenc,9999,0,9999,0
1748425900566,PHIL 290,016,964107,Lamey; Andy M.,9999,0,9999,0
1748425900566,PHIL 290,017,964113,Marechal; Patricia,9999,0,9999,0
1748425900566,PHIL 290,018,964125,McKenzie; Kerry V.,9999,0,9999,0
1748425900566,PHIL 290,019,964131,Nelkin; Dana Kay,9999,0,9999,0
1748425900566,PHIL 290,020,964132,Rickless; Samuel Charles,9999,0,9999,0
1748425900566,PHIL 290,021,964133,Rudolph; Rachel Etta,9999,0,9999,0
1748425900566,PHIL 290,022,964141,Sher; Gila,9999,0,9999,0
1748425900566,PHIL 290,023,964142,Shields; Christopher John,9999,0,9999,0
1748425900566,PHIL 290,024,964181,Tolley; Clinton,9999,0,9999,0
1748425900566,PHIL 290,025,964182,Vargas; Manuel Rogelio,9999,0,9999,0
1748425900566,PHIL 290,026,964232,Watkins; Eric,9999,0,9999,0
1748425900566,PHIL 290,027,964233,Yuan; Yuan,9999,0,9999,0
1748425901594,PHIL 295,001,964259,Bazargan-Forward; Saba,9999,0,9999,0
1748425901594,PHIL 295,002,964262,Brandt; Reuven A,9999,0,9999,0
1748425901594,PHIL 295,003,964263,Brink; David O.,9999,0,9999,0
1748425901594,PHIL 295,004,964264,Callender; Craig Adam,9999,0,9999,0
1748425901594,PHIL 295,005,964265,Carr; Jennifer Rose,9999,0,9999,0
1748425901594,PHIL 295,006,964266,Cartwright; Nancy D.,9999,0,9999,0
1748425901594,PHIL 295,007,964267,Chen; Keming,9999,0,9999,0
1748425901594,PHIL 295,008,964268,Cohen; Jonathan David,9999,0,9999,0
1748425901594,PHIL 295,009,964269,Danks; David J,9999,0,9999,0
1748425901594,PHIL 295,010,964270,Fulkerson; Matthew Todd,9999,0,9999,0
1748425901594,PHIL 295,011,964271,Hardimon; Michael O.,9999,0,9999,0
1748425901594,PHIL 295,012,964272,Harrell; Maralee Mae,9999,0,9999,0
1748425901594,PHIL 295,013,964273,Johnson; Monte,9999,0,9999,0
1748425901594,PHIL 295,014,964274,Kocurek; Alexander William,9999,0,9999,0
1748425901594,PHIL 295,015,964275,Kovaka; Karenc,9999,0,9999,0
1748425901594,PHIL 295,016,964276,Lamey; Andy M.,9999,0,9999,0
1748425901594,PHIL 295,017,964277,Marechal; Patricia,9999,0,9999,0
1748425901594,PHIL 295,018,964278,McKenzie; Kerry V.,9999,0,9999,0
1748425901594,PHIL 295,019,964279,Nelkin; Dana Kay,9999,0,9999,0
1748425901594,PHIL 295,020,964280,Rickless; Samuel Charles,9999,0,9999,0
1748425901594,PHIL 295,021,964281,Rudolph; Rachel Etta,9999,0,9999,0
1748425901594,PHIL 295,022,964282,Sher; Gila,9999,0,9999,0
1748425901594,PHIL 295,023,964283,Shields; Christopher John,9999,0,9999,0
1748425901594,PHIL 295,024,964284,Tolley; Clinton,9999,0,9999,0
1748425901594,PHIL 295,025,964285,Vargas; Manuel Rogelio,9999,0,9999,0
1748425901594,PHIL 295,026,964286,Watkins; Eric,9999,0,9999,0
1748425901594,PHIL 295,027,964287,Yuan; Yuan,9999,0,9999,0
1748425902622,PHYS 1A,A00,935435,Groisman; Alexander,434,0,589,155
1748425902622,PHYS 1A,B00,935437,Groisman; Alexander,456,0,600,144
1748425903663,PHYS 1AL,001,935439,Bal; Gurleen K & Frano Pereira; Alex M,18,0,30,12
1748425903663,PHYS 1AL,002,935440,Bal; Gurleen K & Frano Pereira; Alex M,25,0,30,5
1748425903663,PHYS 1AL,003,935443,Bal; Gurleen K & Frano Pereira; Alex M,0,0,30,30
1748425903663,PHYS 1AL,004,935445,Bal; Gurleen K & Frano Pereira; Alex M,0,0,30,30
1748425903663,PHYS 1AL,005,935448,Bal; Gurleen K & Frano Pereira; Alex M,0,0,30,30
1748425903663,PHYS 1AL,006,935449,Bal; Gurleen K & Frano Pereira; Alex M,0,0,30,30
1748425903663,PHYS 1AL,007,935451,Bal; Gurleen K & Frano Pereira; Alex M,0,0,30,30
1748425903663,PHYS 1AL,008,935452,Bal; Gurleen K & Frano Pereira; Alex M,1,0,30,29
1748425903663,PHYS 1AL,009,935454,Bal; Gurleen K & Frano Pereira; Alex M,9,0,30,21
1748425903663,PHYS 1AL,010,935589,Bal; Gurleen K & Frano Pereira; Alex M,17,0,30,13
1748425903663,PHYS 1AL,011,935590,Bal; Gurleen K & Frano Pereira; Alex M,15,0,19,4
1748425903663,PHYS 1AL,012,935591,Bal; Gurleen K & Frano Pereira; Alex M,29,0,30,1
1748425903663,PHYS 1AL,013,935652,Bal; Gurleen K & Frano Pereira; Alex M,0,0,30,30
1748425903663,PHYS 1AL,014,935675,Bal; Gurleen K & Frano Pereira; Alex M,0,0,30,30
1748425903663,PHYS 1AL,015,935680,Bal; Gurleen K & Frano Pereira; Alex M,0,0,30,30
1748425903663,PHYS 1AL,016,935703,Bal; Gurleen K & Frano Pereira; Alex M,0,0,30,30
1748425903663,PHYS 1AL,017,935704,Bal; Gurleen K & Frano Pereira; Alex M,9,0,30,21
1748425903663,PHYS 1AL,018,935729,Bal; Gurleen K & Frano Pereira; Alex M,12,0,30,18
1748425903663,PHYS 1AL,019,935825,Bal; Gurleen K & Frano Pereira; Alex M,23,0,30,7
1748425903663,PHYS 1AL,020,935826,Bal; Gurleen K & Frano Pereira; Alex M,27,0,30,3
1748425903663,PHYS 1AL,021,935946,Bal; Gurleen K & Frano Pereira; Alex M,28,0,30,2
1748425903663,PHYS 1AL,022,935947,Bal; Gurleen K & Frano Pereira; Alex M,30,0,30,0
1748425903663,PHYS 1AL,023,936029,Bal; Gurleen K & Frano Pereira; Alex M,4,0,30,26
1748425903663,PHYS 1AL,024,936031,Bal; Gurleen K & Frano Pereira; Alex M,12,0,30,18
1748425903663,PHYS 1AL,025,936033,Bal; Gurleen K & Frano Pereira; Alex M,19,0,30,11
1748425903663,PHYS 1AL,026,936034,Bal; Gurleen K & Frano Pereira; Alex M,19,0,30,11
1748425903663,PHYS 1AL,027,936036,Bal; Gurleen K & Frano Pereira; Alex M,6,0,30,24
1748425903663,PHYS 1AL,028,936038,Bal; Gurleen K & Frano Pereira; Alex M,22,0,30,8
1748425903663,PHYS 1AL,029,936044,Bal; Gurleen K & Frano Pereira; Alex M,20,0,30,10
1748425903663,PHYS 1AL,030,936045,Bal; Gurleen K & Frano Pereira; Alex M,27,0,30,3
1748425903663,PHYS 1AL,031,936054,Bal; Gurleen K & Frano Pereira; Alex M,28,0,30,2
1748425903663,PHYS 1AL,032,936056,Bal; Gurleen K & Frano Pereira; Alex M,28,0,30,2
1748425903663,PHYS 1AL,033,936057,Bal; Gurleen K & Frano Pereira; Alex M,0,0,30,30
1748425903663,PHYS 1AL,034,936059,Bal; Gurleen K & Frano Pereira; Alex M,1,0,30,29
1748425903663,PHYS 1AL,035,936060,Bal; Gurleen K & Frano Pereira; Alex M,11,0,30,19
1748425903663,PHYS 1AL,036,936063,Bal; Gurleen K & Frano Pereira; Alex M,21,0,30,9
1748425903663,PHYS 1AL,037,960551,Bal; Gurleen K & Frano Pereira; Alex M,25,0,30,5
1748425903663,PHYS 1AL,038,960592,Bal; Gurleen K & Frano Pereira; Alex M,28,0,30,2
1748425903663,PHYS 1AL,039,960618,Bal; Gurleen K & Frano Pereira; Alex M,29,0,30,1
1748425903663,PHYS 1AL,040,960644,Bal; Gurleen K & Frano Pereira; Alex M,30,0,30,0
1748425904687,PHYS 1B,A00,936064,Staff,216,0,360,144
1748425905789,PHYS 1BL,001,936066,Bal; Gurleen K & Frano Pereira; Alex M,1,0,29,28
1748425905789,PHYS 1BL,002,936067,Bal; Gurleen K & Frano Pereira; Alex M,0,0,30,30
1748425905789,PHYS 1BL,003,936068,Bal; Gurleen K & Frano Pereira; Alex M,5,0,30,25
1748425905789,PHYS 1BL,004,936072,Bal; Gurleen K & Frano Pereira; Alex M,0,0,30,30
1748425905789,PHYS 1BL,005,936074,Bal; Gurleen K & Frano Pereira; Alex M,0,0,30,30
1748425905789,PHYS 1BL,006,936075,Bal; Gurleen K & Frano Pereira; Alex M,0,0,30,30
1748425905789,PHYS 1BL,007,936116,Bal; Gurleen K & Frano Pereira; Alex M,7,0,30,23
1748425905789,PHYS 1BL,008,936125,Bal; Gurleen K & Frano Pereira; Alex M,14,0,30,16
1748425905789,PHYS 1BL,009,936128,Bal; Gurleen K & Frano Pereira; Alex M,12,0,30,18
1748425905789,PHYS 1BL,010,936145,Bal; Gurleen K & Frano Pereira; Alex M,14,0,30,16
1748425905789,PHYS 1BL,011,936146,Bal; Gurleen K & Frano Pereira; Alex M,0,0,30,30
1748425905789,PHYS 1BL,012,936147,Bal; Gurleen K & Frano Pereira; Alex M,6,0,30,24
1748425906846,PHYS 1C,A00,936148,Tsai; Philbert S,220,0,360,140
1748425907873,PHYS 1CL,001,936149,Bal; Gurleen K & Frano Pereira; Alex M,0,0,30,30
1748425907873,PHYS 1CL,002,936150,Bal; Gurleen K & Frano Pereira; Alex M,0,0,30,30
1748425907873,PHYS 1CL,003,936152,Bal; Gurleen K & Frano Pereira; Alex M,0,0,30,30
1748425907873,PHYS 1CL,004,936153,Bal; Gurleen K & Frano Pereira; Alex M,0,0,30,30
1748425907873,PHYS 1CL,005,936154,Bal; Gurleen K & Frano Pereira; Alex M,0,0,30,30
1748425907873,PHYS 1CL,006,936156,Bal; Gurleen K & Frano Pereira; Alex M,0,0,24,24
1748425907873,PHYS 1CL,007,936157,Bal; Gurleen K & Frano Pereira; Alex M,22,0,30,8
1748425907873,PHYS 1CL,008,936158,Bal; Gurleen K & Frano Pereira; Alex M,0,0,30,30
1748425907873,PHYS 1CL,009,936159,Bal; Gurleen K & Frano Pereira; Alex M,0,0,30,30
1748425907873,PHYS 1CL,010,936160,Bal; Gurleen K & Frano Pereira; Alex M,0,0,30,30
1748425907873,PHYS 1CL,011,936161,Bal; Gurleen K & Frano Pereira; Alex M,0,0,30,30
1748425907873,PHYS 1CL,012,936162,Bal; Gurleen K & Frano Pereira; Alex M,0,0,30,30
1748425908899,PHYS 2A,A01,936165,Shotwell; Brian,30,0,30,0
1748425908899,PHYS 2A,A02,936167,Shotwell; Brian,28,0,30,2
1748425908899,PHYS 2A,A03,936168,Shotwell; Brian,25,0,30,5
1748425908899,PHYS 2A,A04,936169,Shotwell; Brian,30,0,30,0
1748425908899,PHYS 2A,A05,936170,Shotwell; Brian,16,0,25,9
1748425908899,PHYS 2A,A06,936171,Shotwell; Brian,26,0,30,4
1748425908899,PHYS 2A,A07,936172,Shotwell; Brian,18,0,30,12
1748425908899,PHYS 2A,A08,936174,Shotwell; Brian,24,0,30,6
1748425908899,PHYS 2A,A09,936175,Shotwell; Brian,25,0,30,5
1748425908899,PHYS 2A,A10,936176,Shotwell; Brian,25,0,30,5
1748425908899,PHYS 2A,A11,936177,Shotwell; Brian,21,0,30,9
1748425908899,PHYS 2A,A12,936179,Shotwell; Brian,25,0,30,5
1748425909928,PHYS 2B,A01,936182,Barreiro Guerrero; Julio,13,0,30,17
1748425909928,PHYS 2B,A02,936183,Barreiro Guerrero; Julio,20,0,30,10
1748425909928,PHYS 2B,A03,936184,Barreiro Guerrero; Julio,20,0,30,10
1748425909928,PHYS 2B,A04,936185,Barreiro Guerrero; Julio,26,0,29,3
1748425909928,PHYS 2B,A05,936187,Barreiro Guerrero; Julio,27,0,30,3
1748425909928,PHYS 2B,A06,936217,Barreiro Guerrero; Julio,26,0,30,4
1748425909928,PHYS 2B,A07,936219,Barreiro Guerrero; Julio,23,0,30,7
1748425909928,PHYS 2B,A08,936220,Barreiro Guerrero; Julio,26,0,30,4
1748425909928,PHYS 2B,A09,936221,Barreiro Guerrero; Julio,29,0,30,1
1748425909928,PHYS 2B,A10,936224,Barreiro Guerrero; Julio,29,0,30,1
1748425909928,PHYS 2B,A11,936229,Barreiro Guerrero; Julio,28,0,30,2
1748425909928,PHYS 2B,A12,936231,Barreiro Guerrero; Julio,27,0,30,3
1748425910955,PHYS 2C,A01,936235,Tan; Tzer Han,23,0,30,7
1748425910955,PHYS 2C,A02,936236,Tan; Tzer Han,27,0,30,3
1748425910955,PHYS 2C,A03,936237,Tan; Tzer Han,22,0,30,8
1748425910955,PHYS 2C,A04,936246,Tan; Tzer Han,17,0,30,13
1748425910955,PHYS 2C,A05,936292,Tan; Tzer Han,16,0,28,12
1748425910955,PHYS 2C,A06,936300,Tan; Tzer Han,19,0,30,11
1748425910955,PHYS 2C,A07,936301,Tan; Tzer Han,8,0,30,22
1748425910955,PHYS 2C,A08,936302,Tan; Tzer Han,20,0,30,10
1748425910955,PHYS 2C,A09,936303,Tan; Tzer Han,26,0,30,4
1748425910955,PHYS 2C,A10,936304,Tan; Tzer Han,26,0,30,4
1748425910955,PHYS 2C,A11,936305,Tan; Tzer Han,12,0,30,18
1748425910955,PHYS 2C,A12,936332,Tan; Tzer Han,27,0,30,3
1748425910955,PHYS 2C,B01,936337,Tan; Tzer Han,0,0,30,30
1748425910955,PHYS 2C,B02,936470,Tan; Tzer Han,1,0,30,29
1748425910955,PHYS 2C,B03,936503,Tan; Tzer Han,21,0,30,9
1748425910955,PHYS 2C,B04,936533,Tan; Tzer Han,22,0,30,8
1748425910955,PHYS 2C,B05,936534,Tan; Tzer Han,20,0,30,10
1748425910955,PHYS 2C,B06,936535,Tan; Tzer Han,23,0,30,7
1748425910955,PHYS 2C,B07,936536,Tan; Tzer Han,25,0,30,5
1748425910955,PHYS 2C,B08,936537,Tan; Tzer Han,22,0,30,8
1748425910955,PHYS 2C,B09,936539,Tan; Tzer Han,26,0,30,4
1748425910955,PHYS 2C,B10,936540,Tan; Tzer Han,27,0,30,3
1748425910955,PHYS 2C,B11,936544,Tan; Tzer Han,28,0,30,2
1748425910955,PHYS 2C,B12,936548,Tan; Tzer Han,28,0,30,2
1748425911982,PHYS 2CL,A01,936555,Ni; Kaixuan,0,0,28,28
1748425911982,PHYS 2CL,A02,936556,Ni; Kaixuan,0,0,28,28
1748425911982,PHYS 2CL,A03,936557,Ni; Kaixuan,0,0,28,28
1748425911982,PHYS 2CL,A04,936559,Ni; Kaixuan,0,0,28,28
1748425911982,PHYS 2CL,A05,936566,Ni; Kaixuan,0,0,28,28
1748425911982,PHYS 2CL,A06,936582,Ni; Kaixuan,0,0,28,28
1748425911982,PHYS 2CL,A07,936583,Ni; Kaixuan,0,0,28,28
1748425913021,PHYS 2D,A01,936615,Sharma; Vivek A.,0,0,27,27
1748425914050,PHYS 2DL,A01,936627,Butov; Leonid,14,0,17,3
1748425914050,PHYS 2DL,A02,936628,Butov; Leonid,0,0,17,17
1748425914050,PHYS 2DL,A03,936629,Butov; Leonid,3,0,15,12
1748425914050,PHYS 2DL,A04,936630,Butov; Leonid,10,0,17,7
1748425914050,PHYS 2DL,A05,936631,Butov; Leonid,17,0,17,0
1748425914050,PHYS 2DL,A06,936632,Butov; Leonid,7,0,17,10
1748425914050,PHYS 2DL,A07,936633,Butov; Leonid,8,0,18,10
1748425915080,PHYS 4C,A01,936635,Chivukula; Raja S,22,0,43,21
1748425915080,PHYS 4C,A02,936636,Chivukula; Raja S,33,0,45,12
1748425915080,PHYS 4C,A03,936637,Chivukula; Raja S,38,0,45,7
1748425915080,PHYS 4C,A04,936638,Chivukula; Raja S,44,0,45,1
1748425916107,PHYS 12,A01,936640,Branson; James G,187,0,192,5
1748425917141,PHYS 87,A00,936641,Grinstein; Benjamin,20,0,20,0
1748425918166,PHYS 100A,A01,936643,Green; Daniel Richard,111,0,146,35
1748425919194,PHYS 110A,A01,936645,Dudko; Olga,107,0,146,39
1748425920220,PHYS 116,A00,936646,Diamond; Patrick H & Vergassola; Massimo,12,0,15,3
1748425921246,PHYS 130B,A01,936648,Keating; Brian,56,0,60,4
1748425922274,PHYS 133,A00,936649,Allen; Monica T,20,0,32,12
1748425923299,PHYS 136,A00,936650,Grinstein; Benjamin,42,0,50,8
1748425924327,PHYS 139,A00,936651,Hirsch; Jorge Eduardo,13,0,15,2
1748425924327,PHYS 139,B00,936663,Duarte; Javier Mauricio,0,0,0,10
1748425925354,PHYS 140A,A01,936723,Parker; Daniel E,54,0,60,6
1748425926380,PHYS 161,A01,936727,Fuller; George Michael,53,0,60,7
1748425927407,PHYS 175,A00,936728,Koslover; Elena F,11,0,15,4
1748425928433,PHYS 191,A00,936730,Yang; Liang,68,0,75,7
1748425929463,PHYS 200A,A01,936733,Di Ventra; Massimiliano,20,0,30,10
1748425930488,PHYS 201,A01,936736,Vergassola; Massimo,23,0,30,7
1748425931513,PHYS 210B,A00,936737,McGreevy; John A.,29,0,30,1
1748425932537,PHYS 211A,A00,936740,Butov; Leonid,28,0,30,2
1748425933566,PHYS 212A,A01,936873,Fogler; Michael M.,38,0,50,12
1748425934710,PHYS 215A,A00,936878,Shotwell; Brian,30,0,30,0
1748425935734,PHYS 216,A00,936879,Diamond; Patrick H & Vergassola; Massimo,15,0,15,0
1748425936758,PHYS 219,A00,936903,Allen; Monica T,5,0,5,0
1748425937824,PHYS 220,A01,936910,Arovas; Daniel P,30,0,30,0
1748425938851,PHYS 225A,A00,936911,Flauger; Raphael M,28,0,30,2
1748425939877,PHYS 239,A00,937172,Hirsch; Jorge Eduardo,14,0,15,1
1748425939877,PHYS 239,B00,937176,Duarte; Javier Mauricio,15,0,15,0
1748425939877,PHYS 239,C00,959883,Intriligator; Kenneth Arthur,30,0,30,0
1748425940901,PHYS 250,A00,937178,Hirsch; Jorge Eduardo,14,0,15,1
1748425941928,PHYS 251,A00,937182,Grinstein; Benjamin,15,0,15,0
1748425942953,PHYS 252,A00,937183,Diamond; Patrick H,15,0,15,0
1748425943979,PHYS 253,A00,937184,Fuller; George Michael,15,0,15,0
1748425945025,PHYS 254,A00,937185,Serra; Mattia,15,0,15,0
1748425946054,PHYS 255,A00,937186,Hwa; Terence T.,14,0,15,1
1748425947081,PHYS 260,A00,937187,Shpyrko; Oleg,49,0,50,1
1748425948108,PHYS 275,A00,937190,Koslover; Elena F,15,0,15,0
1748425949134,PHYS 279,A01,946429,Silva; Gabriel,0,0,0,0
1748425950158,PHYS 282,A00,937194,Hwa; Terence T.,20,0,20,0
1748425951187,POLI 5D,A01,937210,Staff,4,0,5,1
1748425951187,POLI 5D,B01,937219,Staff,5,0,5,0
1748425951187,POLI 5D,C01,937225,Dai; Yinlin,0,0,5,5
1748425952215,POLI 10D,A01,937228,Noble; Benjamin S,20,0,28,8
1748425952215,POLI 10D,A02,937229,Noble; Benjamin S,24,0,28,4
1748425952215,POLI 10D,A03,937230,Noble; Benjamin S,24,0,27,3
1748425952215,POLI 10D,A04,937231,Noble; Benjamin S,25,0,27,2
1748425952215,POLI 10D,A05,937238,Noble; Benjamin S,27,0,28,1
1748425952215,POLI 10D,A06,937243,Noble; Benjamin S,26,0,28,2
1748425953241,POLI 11D,A01,937360,Desposato; Scott,20,0,29,9
1748425953241,POLI 11D,A02,937430,Desposato; Scott,22,0,29,7
1748425953241,POLI 11D,A03,937445,Desposato; Scott,25,0,29,4
1748425953241,POLI 11D,A04,937446,Desposato; Scott,29,0,29,0
1748425953241,POLI 11D,A05,937447,Desposato; Scott,27,0,29,2
1748425953241,POLI 11D,A06,937463,Desposato; Scott,27,0,29,2
1748425954269,POLI 12D,A01,937472,Roeder; Philip G,16,0,20,4
1748425954269,POLI 12D,A02,937475,Roeder; Philip G,18,0,20,2
1748425954269,POLI 12D,A03,937485,Roeder; Philip G,17,0,19,2
1748425954269,POLI 12D,A04,937490,Roeder; Philip G,17,0,20,3
1748425954269,POLI 12D,A05,937500,Roeder; Philip G,19,0,20,1
1748425954269,POLI 12D,A06,937507,Roeder; Philip G,20,0,20,0
1748425955298,POLI 30D,A01,937510,Desposato; Scott,0,0,23,23
1748425955298,POLI 30D,A02,937530,Desposato; Scott,0,0,23,23
1748425955298,POLI 30D,A03,937531,Desposato; Scott,11,0,23,12
1748425955298,POLI 30D,A04,937532,Desposato; Scott,18,0,23,5
1748425955298,POLI 30D,A05,937591,Desposato; Scott,5,0,23,18
1748425955298,POLI 30D,A06,937592,Desposato; Scott,19,0,23,4
1748425956323,POLI 100H,A00,937593,Stout; Christopher Timothy,114,0,183,69
1748425957349,POLI 100I,A00,937594,Gause; LaGina,47,0,56,9
1748425958377,POLI 100V,A00,937596,Gause; LaGina,56,0,68,12
1748425959402,POLI 101A,A00,937597,Stout; Christopher Timothy,84,0,115,31
1748425960432,POLI 104A,A00,937598,Smith; Glenn Chatmas,207,0,290,83
1748425961460,POLI 104N,A00,937599,Stephens; Mattheus E,168,0,245,77
1748425962489,POLI 110A,A00,937600,Wiens; David,61,0,70,9
1748425963517,POLI 118,A00,937601,Wiens; David,69,0,94,25
1748425964544,POLI 122D,A00,937602,Strom; Kaare,15,0,70,55
1748425965570,POLI 125B,A00,937603,Naoi; Megumi,128,0,158,30
1748425966601,POLI 125D,A00,937604,Nichter; Simeon C,103,0,158,55
1748425967626,POLI 126,A00,937607,Nichter; Simeon C,43,0,120,77
1748425968653,POLI 133A,A00,937608,Naoi; Megumi,202,0,216,14
1748425969679,POLI 134D,A00,937609,Saiegh; Sebastian,62,0,75,13
1748425970711,POLI 143A,A00,937610,Slantchev; Branislav,147,0,158,11
1748425971740,POLI 145C,A00,937611,Fisk; David Lee,152,0,190,38
1748425972768,POLI 154,A00,937612,Fisk; David Lee,28,0,90,62
1748425973794,POLI 163,A00,937613,Saiegh; Sebastian,103,0,120,17
1748425974826,POLI 176,A00,968071,Roberts; Margaret Earling,23,0,45,22
1748425975857,POLI 191A,A00,937617,Stout; Christopher Timothy & Saiegh; Sebastian,25,0,25,0
1748425976883,POLI 194,A00,954111,Hill; Seth J,9999,0,9999,0
1748425977910,POLI 204A,A00,937618,Schneider; Christina,20,0,25,5
1748425978937,POLI 204B,A00,937619,Desposato; Scott,7,0,12,5
1748425979968,POLI 220B,A00,937621,Strom; Kaare,20,0,25,5
1748425980994,POLI 225,A00,937622,Thomas; Jakana,18,0,25,7
1748425982023,POLI 251,A00,937623,Noble; Benjamin S,24,0,25,1
1748425983050,POLI 252,A00,937624,Hajnal; Zoltan Lloyd,24,0,25,1
1748425985108,POLI 270,A00,973288,Roberts; Margaret Earling,24,0,25,1
1748425986134,POLI 279,A00,937626,Staff,8,0,12,4
1748425987163,POLI 280,A00,937628,Hafner-Burton; Emilie,21,0,25,4
1748425988192,POLI 281,A00,937629,Stout; Christopher Timothy,13,0,15,2
1748425989218,POLI 282,A00,937630,Roeder; Philip G,20,0,25,5
1748425990245,POLI 283,A00,937631,Slantchev; Branislav,18,0,25,7
1748425991271,POLI 285,A00,937632,Wiens; David,12,0,12,0
1748425992298,PSYC 1,A00,937633,Hurwitz; Ethan Scott,175,0,200,25
1748425993329,PSYC 2,A00,937634,Rose; Fred E.,133,0,150,17
1748425994357,PSYC 3R,A00,937693,Pilegard; Celeste Cristine,195,0,200,5
1748425995387,PSYC 6,A00,937694,McCullough; Michael E,142,0,150,8
1748425996419,PSYC 60,A01,957947,Lowe; Angela Beth,10,0,25,15
1748425996419,PSYC 60,A02,957948,Lowe; Angela Beth,17,0,25,8
1748425996419,PSYC 60,A03,957949,Lowe; Angela Beth,18,0,25,7
1748425996419,PSYC 60,A04,957950,Lowe; Angela Beth,24,0,25,1
1748425996419,PSYC 60,A05,957951,Lowe; Angela Beth,22,0,25,3
1748425996419,PSYC 60,A06,957952,Lowe; Angela Beth,22,0,25,3
1748425996419,PSYC 60,A07,957953,Lowe; Angela Beth,24,0,25,1
1748425996419,PSYC 60,B01,957954,Rickard; Timothy C.,24,0,25,1
1748425996419,PSYC 60,B02,957955,Rickard; Timothy C.,24,0,25,1
1748425996419,PSYC 60,B03,957956,Rickard; Timothy C.,25,0,25,0
1748425996419,PSYC 60,B04,957957,Rickard; Timothy C.,25,0,25,0
1748425996419,PSYC 60,B05,957958,Rickard; Timothy C.,24,0,25,1
1748425996419,PSYC 60,B06,957959,Rickard; Timothy C.,22,0,25,3
1748425996419,PSYC 60,B07,957960,Rickard; Timothy C.,22,0,25,3
1748425997450,PSYC 70,A01,957961,Pilegard; Celeste Cristine,6,0,25,19
1748425997450,PSYC 70,A02,957962,Pilegard; Celeste Cristine,19,0,25,6
1748425997450,PSYC 70,A03,957963,Pilegard; Celeste Cristine,19,0,25,6
1748425997450,PSYC 70,A04,957964,Pilegard; Celeste Cristine,21,0,25,4
1748425997450,PSYC 70,A05,957965,Pilegard; Celeste Cristine,24,0,25,1
1748425997450,PSYC 70,A06,957966,Pilegard; Celeste Cristine,23,0,25,2
1748425998480,PSYC 71,A01,937700,Geller; Emma Harlan,0,0,30,30
1748425998480,PSYC 71,A02,937701,Geller; Emma Harlan,0,0,30,30
1748425998480,PSYC 71,B01,937704,Steiner; Eric Tomas,0,0,25,25
1748425998480,PSYC 71,B02,937705,Steiner; Eric Tomas,0,0,25,25
1748425999506,PSYC 88,A00,937706,Dobkins; Karen R.,49,0,65,16
1748426000531,PSYC 100,A00,937707,Dickenson; Janna Alene,0,0,175,175
1748426001558,PSYC 101,A00,937709,Heyman; Gail D.,0,0,170,170
1748426002586,PSYC 104,A00,937711,Staff,0,0,175,175
1748426003613,PSYC 105,A00,937712,Geller; Emma Harlan,17,0,170,153
1748426004644,PSYC 106,A00,937713,Gremel; Christina M,89,0,170,81
1748426005671,PSYC 108,A00,937714,Adrian; Julia Anna,145,0,170,25
1748426006702,PSYC 114,A01,937720,Winkielman; Piotr,0,0,50,50
1748426007730,PSYC 122,A00,937724,Moranton; Nirelia Melbina-,241,0,250,9
1748426008761,PSYC 124,A00,937726,Chapman; Eddie Nathaniel,276,0,348,72
1748426009863,PSYC 137,A00,937727,Jolly; Eshin,249,0,295,46
1748426010890,PSYC 145,A00,937732,Lau; Aubrey,277,0,295,18
1748426011916,PSYC 154,A00,937734,Lacefield; Katharine I,18,0,300,282
1748426012942,PSYC 155,A00,937735,Dickenson; Janna Alene,139,0,295,156
1748426013970,PSYC 167,A00,937750,Walker; Caren Michelle,0,0,25,25
1748426014996,PSYC 169,A00,937751,Staff,212,0,250,38
1748426016028,PSYC 171,A00,937752,Mukku; Dhananjaya,149,0,216,67
1748426017055,PSYC 174,A00,937784,Staff,141,0,146,5
1748426018083,PSYC 178,A00,937788,Glaser; Dale,100,0,146,46
1748426019110,PSYC 181,A00,937814,Anagnostaras; Stephan,140,0,300,160
1748426020142,PSYC 184,A00,937816,Staff,267,0,295,28
1748426021169,PSYC 189,A00,937868,Gentner; Tim,14,0,55,41
1748426022197,PSYC 193,A00,937897,Chapman; Eddie Nathaniel,27,0,35,8
1748426022197,PSYC 193,B00,937917,Gorman; Michael R.,35,0,35,0
1748426022197,PSYC 193,C00,937918,Powell; Lindsey Jane,22,0,24,2
1748426023229,PSYC 193L,A01,937930,Brown; Sandra A,64,0,65,1
1748426023229,PSYC 193L,B01,937939,Lacefield; Katharine I,194,0,216,22
1748426024255,PSYC 194A,A01,937949,Heyman; Gail D.,35,0,35,0
1748426025281,PSYC 201A,A01,937954,Long; Bria,8,0,15,7
1748426026312,PSYC 205,A00,937976,Harris; Christine Renee,12,0,20,8
1748426027338,PSYC 217,A00,937977,Barner; David A.,16,0,20,4
1748426028366,PSYC 221,A00,937979,Dobkins; Karen R.,16,0,20,4
1748426029397,PSYC 224,A00,938013,Mukku; Dhananjaya,28,0,30,2
1748426030424,PSYC 242,A00,938016,Powell; Lindsey Jane,26,0,30,4
1748426031454,PSYC 244,A00,938017,Ferreira; Victor,15,0,20,5
1748426032485,PSYC 269,A00,938024,Schachner; Adena,19,0,20,1
1748426033511,PSYC 270A,A00,938028,Dobkins; Karen R.,13,0,20,7
1748426034546,PSYC 272,A00,938029,Lin; Chujun,14,0,20,6
1748426034546,PSYC 272,B00,938039,Wixted; John T,18,0,20,2
1748426035573,PSYC 274,A00,938042,McCullough; Michael E,26,0,30,4
1748426036600,PSYC 275,A00,938043,Brady; Timothy Francis,28,0,30,2
1748426037629,PSYC 280,A00,938055,Serences; John Thomas,70,0,80,10
1748426038663,PSYC 296,001,952632,Anagnostaras; Stephan,9999,0,9999,0
1748426038663,PSYC 296,002,952633,Aron; Adam,9999,0,9999,0
1748426038663,PSYC 296,003,952634,Mukku; Dhananjaya,9999,0,9999,0
1748426038663,PSYC 296,004,952635,Barner; David A.,9999,0,9999,0
1748426038663,PSYC 296,005,952636,Schachner; Adena,9999,0,9999,0
1748426038663,PSYC 296,006,952637,Brady; Timothy Francis,9999,0,9999,0
1748426038663,PSYC 296,007,952639,Brashier; Nadia Marie,9999,0,9999,0
1748426038663,PSYC 296,008,952640,Brown; Sandra A,9999,0,9999,0
1748426038663,PSYC 296,009,952641,Carver; Leslie J.,9998,0,9999,1
1748426038663,PSYC 296,010,952642,Chapman; Eddie Nathaniel,9999,0,9999,0
1748426038663,PSYC 296,011,952643,Dickenson; Janna Alene,9999,0,9999,0
1748426038663,PSYC 296,012,952644,Dobkins; Karen R.,9997,0,9999,2
1748426038663,PSYC 296,013,952646,Ferreira; Victor,9999,0,9999,0
1748426038663,PSYC 296,014,952647,Geller; Emma Harlan,9999,0,9999,0
1748426038663,PSYC 296,015,952648,Gentner; Tim,9999,0,9999,0
1748426038663,PSYC 296,016,952650,Gorman; Michael R.,9999,0,9999,0
1748426038663,PSYC 296,017,952651,Gremel; Christina M,9999,0,9999,0
1748426038663,PSYC 296,018,952652,Harris; Christine Renee,9999,0,9999,0
1748426038663,PSYC 296,019,952654,Heyman; Gail D.,9999,0,9999,0
1748426038663,PSYC 296,020,952655,Lin; Chujun,9999,0,9999,0
1748426038663,PSYC 296,021,952659,Long; Bria,9999,0,9999,0
1748426038663,PSYC 296,022,952660,McCullough; Michael E,9999,0,9999,0
1748426038663,PSYC 296,023,952661,Mc Kenzie; Craig R.M.,9999,0,9999,0
1748426038663,PSYC 296,024,952663,Miller; Cory T.,9998,0,9999,1
1748426038663,PSYC 296,025,952664,Oesch; Nicholas W,9999,0,9999,0
1748426038663,PSYC 296,026,952665,Pilegard; Celeste Cristine,9999,0,9999,0
1748426038663,PSYC 296,027,952666,Powell; Lindsey Jane,9999,0,9999,0
1748426038663,PSYC 296,028,952667,Rickard; Timothy C.,9999,0,9999,0
1748426038663,PSYC 296,029,952668,Serences; John Thomas,9999,0,9999,0
1748426038663,PSYC 296,030,952669,Walker; Caren Michelle,9998,0,9999,1
1748426038663,PSYC 296,031,952670,Winkielman; Piotr,9999,0,9999,0
1748426038663,PSYC 296,032,952671,Wixted; John T,9998,0,9999,1
1748426038663,PSYC 296,033,952673,Jolly; Eshin,9998,0,9999,1
1748426039691,REV 20,A00,946356,Yu; Paul K L,30,0,30,0
1748426039691,REV 20,B00,946357,Yu; Paul K L,30,0,30,0
1748426040716,REV 87,B00,969668,Rodriguez; Bretton Sigfred,20,0,20,0
1748426041752,SE 1,A01,938060,Van Den Einde; Yael Dahlia,0,0,9,9
1748426041752,SE 1,A02,938076,Van Den Einde; Yael Dahlia,0,0,8,8
1748426041752,SE 1,A03,938077,Van Den Einde; Yael Dahlia,0,0,8,8
1748426041752,SE 1,B01,938097,Van Den Einde; Yael Dahlia,0,0,9,9
1748426041752,SE 1,B02,938098,Van Den Einde; Yael Dahlia,0,0,8,8
1748426041752,SE 1,B03,938109,Van Den Einde; Yael Dahlia,0,0,8,8
1748426042785,SE 101A,A01,938120,Morrison; Machel Leigh,165,0,250,85
1748426043811,SE 101C,A01,938148,Zhu; Qiang,178,0,250,72
1748426044839,SE 105,A01,938153,Qiao; Yu,78,0,120,42
1748426045866,SE 125,A01,938218,Conte; Joel P,166,0,210,44
1748426046896,SE 130A,A00,938219,Loh; Kenneth J. H.,69,0,165,96
1748426047923,SE 131B,A01,938221,Krysl; Petr,119,0,210,91
1748426048952,SE 142,A01,938223,Kim; Hyonny,20,0,27,7
1748426048952,SE 142,A02,938236,Kim; Hyonny,23,0,27,4
1748426048952,SE 142,A03,938237,Kim; Hyonny,19,0,27,8
1748426048952,SE 142,A04,938238,Kim; Hyonny,19,0,22,3
1748426049980,SE 163,A01,938240,Lanza Di Scalea; Francesco,17,0,19,2
1748426049980,SE 163,A02,938241,Lanza Di Scalea; Francesco,16,0,19,3
1748426049980,SE 163,A03,938254,Lanza Di Scalea; Francesco,16,0,17,1
1748426051011,SE 180,A00,938255,Elgamal; Ahmed,142,0,170,28
1748426052041,SE 181,A01,938280,McCartney; John Scott,1,0,24,23
1748426052041,SE 181,A02,938281,McCartney; John Scott,6,0,24,18
1748426052041,SE 181,A03,938296,McCartney; John Scott,0,0,24,24
1748426052041,SE 181,A04,938297,McCartney; John Scott,0,0,24,24
1748426052041,SE 181,A05,938299,McCartney; John Scott,20,0,24,4
1748426052041,SE 181,A06,938320,McCartney; John Scott,22,0,24,2
1748426052041,SE 181,A07,938324,McCartney; John Scott,9,0,24,15
1748426053071,SE 201A,A00,938329,Mosqueda; Gilberto,35,0,65,30
1748426054103,SE 203A,A00,938331,Tsampras; Georgios,32,0,65,33
1748426055134,SE 212,A00,938332,Uang; Chia-Ming,28,0,68,40
1748426056165,SE 220,A00,965249,Mosqueda; Gilberto,28,0,36,8
1748426057189,SE 223,A00,969767,Staff,19,0,25,6
1748426058217,SE 233,A00,938555,Krysl; Petr,19,0,50,31
1748426059244,SE 241,A00,938333,Elgamal; Ahmed,0,0,20,20
1748426060271,SE 244,A00,938334,Elgamal; Ahmed,39,0,40,1
1748426061300,SE 248,A00,938363,McCartney; John Scott,20,0,30,10
1748426062332,SE 253A,A01,938448,Kim; Hyonny,2,0,5,3
1748426062332,SE 253A,A02,938451,Kim; Hyonny,3,0,5,2
1748426062332,SE 253A,A03,938452,Kim; Hyonny,3,0,5,2
1748426062332,SE 253A,A04,938453,Kim; Hyonny,2,0,2,0
1748426063358,SE 263,A01,938460,Lanza Di Scalea; Francesco,15,0,17,2
1748426063358,SE 263,A02,938461,Lanza Di Scalea; Francesco,11,0,17,6
1748426063358,SE 263,A03,938462,Lanza Di Scalea; Francesco,10,0,16,6
1748426064385,SE 271,A00,938464,Asaro; Robert J,25,0,32,7
1748426065411,SE 276A,A00,938465,Chen; Jiun-Shyan,18,0,35,17
1748426066441,SE 285,A00,938466,Kim; Hyunsun Alicia,18,0,20,2
1748426067468,SE 286,A00,938523,Kim; Hyunsun Alicia,13,0,20,7
1748426068494,SE 290,A00,938524,Lanza Di Scalea; Francesco,41,0,100,59
1748426069536,SE 296,001,953990,Asaro; Robert J,9999,0,9999,0
1748426069536,SE 296,002,953992,Chen; Jiun-Shyan,9999,0,9999,0
1748426069536,SE 296,003,953998,Conte; Joel P,9999,0,9999,0
1748426069536,SE 296,004,953999,Elgamal; Ahmed,9999,0,9999,0
1748426069536,SE 296,005,954001,Hutchinson; Tara,9999,0,9999,0
1748426069536,SE 296,006,954003,Jandaghi Semnani; Shabnam,9999,0,9999,0
1748426069536,SE 296,007,954004,Kim; Hyonny,9999,0,9999,0
1748426069536,SE 296,008,954005,Kim; Hyunsun Alicia,9999,0,9999,0
1748426069536,SE 296,009,954007,Kosmatka; John B,9999,0,9999,0
1748426069536,SE 296,010,954009,Krysl; Petr,9999,0,9999,0
1748426069536,SE 296,011,954011,Kuester; Falko,9999,0,9999,0
1748426069536,SE 296,012,954014,Lanza Di Scalea; Francesco,9999,0,9999,0
1748426069536,SE 296,013,954015,Loh; Kenneth J. H.,9999,0,9999,0
1748426069536,SE 296,014,954021,McCartney; John Scott,9999,0,9999,0
1748426069536,SE 296,015,954023,Morrison; Machel Leigh,9999,0,9999,0
1748426069536,SE 296,016,954024,Mosqueda; Gilberto,9999,0,9999,0
1748426069536,SE 296,017,954028,Qiao; Yu,9999,0,9999,0
1748426069536,SE 296,018,954030,Shing; P. Benson,9999,0,9999,0
1748426069536,SE 296,019,954031,Todd; Michael,9998,0,9999,1
1748426069536,SE 296,020,954033,Tomac; Ingrid,9999,0,9999,0
1748426069536,SE 296,021,954037,Tsampras; Georgios,9999,0,9999,0
1748426069536,SE 296,022,954040,Uang; Chia-Ming,9999,0,9999,0
1748426069536,SE 296,023,954043,Van Den Einde; Yael Dahlia,9999,0,9999,0
1748426069536,SE 296,024,954044,Zhu; Qiang,9999,0,9999,0
1748426069536,SE 296,025,954046,Tehrani; Mehran,9999,0,9999,0
1748426069536,SE 296,026,954047,Palermo; Alessandro,9999,0,9999,0
1748426069536,SE 296,027,954049,Chadha; Mayank,9999,0,9999,0
1748426070563,SIO 3,A01,938657,Hetherington; Elizabeth Dorsey,33,0,37,4
1748426070563,SIO 3,A02,938665,Hetherington; Elizabeth Dorsey,36,0,37,1
1748426071590,SIO 15,A00,938667,Laske; Gabi,292,0,348,56
1748426072618,SIO 20R,A01,938679,Russell; Lynn M.,144,0,200,56
1748426073653,SIO 25,A01,938684,Hildebrand; John A,33,0,40,7
1748426073653,SIO 25,A02,938685,Hildebrand; John A,39,0,40,1
1748426073653,SIO 25,A03,938963,Hildebrand; John A,40,0,40,0
1748426073653,SIO 25,A04,939110,Hildebrand; John A,40,0,40,0
1748426073653,SIO 25,A05,939116,Hildebrand; John A,40,0,40,0
1748426073653,SIO 25,A06,939149,Hildebrand; John A,40,0,40,0
1748426073653,SIO 25,A07,939158,Hildebrand; John A,40,0,40,0
1748426073653,SIO 25,A08,939173,Hildebrand; John A,40,0,40,0
1748426073653,SIO 25,A09,939180,Hildebrand; John A,40,0,40,0
1748426073653,SIO 25,A10,939228,Hildebrand; John A,40,0,40,0
1748426074691,SIO 30,A01,939230,Aluwihare; Lihini & Gille; Sarah T,33,0,37,4
1748426074691,SIO 30,A02,939231,Aluwihare; Lihini & Baumann-Pickering ; Simone,37,0,37,0
1748426074691,SIO 30,A03,939232,Aluwihare; Lihini & Gille; Sarah T,34,0,37,3
1748426074691,SIO 30,A04,939233,Aluwihare; Lihini & Gille; Sarah T,31,0,37,6
1748426074691,SIO 30,A05,939234,Aluwihare; Lihini & Gille; Sarah T,38,0,38,0
1748426074691,SIO 30,A06,939235,Aluwihare; Lihini & Gille; Sarah T,37,0,38,1
1748426074691,SIO 30,A07,939236,Aluwihare; Lihini & Gille; Sarah T,36,0,38,2
1748426074691,SIO 30,A08,939237,Aluwihare; Lihini & Gille; Sarah T,36,0,38,2
1748426075719,SIO 50,A01,939239,Cook; Geoffrey W,8,0,20,12
1748426075719,SIO 50,A02,939240,Cook; Geoffrey W,11,0,20,9
1748426076748,SIO 87,A00,939242,Norris; Joel Roland,20,0,20,0
1748426076748,SIO 87,B00,939306,Cook; Geoffrey W,20,0,20,0
1748426076748,SIO 87,C00,939327,Cook; Geoffrey W,20,0,20,0
1748426077774,SIO 100,A00,939328,Odlum; Margaret Larkin,0,0,30,30
1748426078802,SIO 101,A01,939330,Aluwihare; Lihini & Decima; Moira R.,0,0,35,35
1748426078802,SIO 101,A02,939331,Aluwihare; Lihini & Decima; Moira R.,12,0,35,23
1748426079832,SIO 103,A01,939371,Parnell-Turner; Ross Ernes,6,0,20,14
1748426080860,SIO 105,A00,939372,Driscoll; Neal W.,8,0,20,12
1748426081887,SIO 117,A01,939375,Keeling; Ralph F.,14,0,25,11
1748426082917,SIO 122,A01,939377,Lyons; Deirdre Colleen,6,0,30,24
1748426083945,SIO 124,A00,961131,Lukowski; April Lynn,34,0,65,31
1748426084974,SIO 132,A01,939379,Kacev; David & Hechinger; Ryan F.,9,0,34,25
1748426084974,SIO 132,A02,939380,Kacev; David & Hechinger; Ryan F.,28,0,34,6
1748426084974,SIO 132,A03,939381,Kacev; David & Hechinger; Ryan F.,19,0,34,15
1748426084974,SIO 132,A04,939480,Kacev; David & Hechinger; Ryan F.,26,0,34,8
1748426084974,SIO 132,A05,939481,Kacev; David & Hechinger; Ryan F.,18,0,34,16
1748426084974,SIO 132,A06,939482,Kacev; David & Hechinger; Ryan F.,25,0,34,9
1748426086004,SIO 136,A01,939562,Kacev; David & Shipp; Lauren Elizabeth,6,0,34,28
1748426086004,SIO 136,A02,939563,Kacev; David & Shipp; Lauren Elizabeth,24,0,34,10
1748426087031,SIO 147,A01,939566,Betancur Rodriguez; Ricard,0,0,30,30
1748426088058,SIO 166,A00,939567,Jimenez Cano; Nayeli Guada,13,0,30,17
1748426089085,SIO 167,A01,939569,Dunseth; Zachary Clark,9,0,10,1
1748426090116,SIO 170,A00,939571,Cook; Geoffrey W,39,0,45,6
1748426091143,SIO 171,A01,939573,Rudnick; Daniel Lars,44,0,50,6
1748426092173,SIO 177,A00,939574,Becker; Janet Maria,19,0,20,1
1748426093200,SIO 179,A01,939611,Martz; Todd R.,2,0,15,13
1748426094229,SIO 189,A00,939616,Staff,0,0,0,0
1748426095255,SIO 194,A00,954130,Hill; Seth J,9999,0,9999,0
1748426096282,SIOB 218,A01,960525,Staff,13,0,20,7
1748426097314,SIOB 262,A00,939617,Lukowski; April Lynn,15,0,20,5
1748426098344,SIOB 273,A00,939618,Leichter; James J.,9,0,15,6
1748426099369,SIOB 274,A01,939679,Leichter; James J.,15,0,20,5
1748426100399,SIOB 276,A01,939703,Sugihara; George,19,0,20,1
1748426101425,SIOB 279,A00,939717,Barton; Andrew David,19,0,25,6
1748426102451,SIOB 280,A00,939722,Allen; Andrew Ellis & Baumann-Pickering ; Simone,54,0,70,16
1748426103481,SIOB 296,A00,939790,Lyons; Deirdre Colleen,0,0,0,0
1748426104512,SIOB 297,A00,939795,Allen; Eric,57,0,65,8
1748426105539,SIOC 200A,A00,939821,Lin; Ying-Tsong,16,0,20,4
1748426106566,SIOC 203A,A00,939827,Becker; Janet Maria,18,0,20,2
1748426107592,SIOC 207A,A01,939909,Meyer; Florian,12,0,20,8
1748426108622,SIOC 208,A00,939913,Merrifield; Mark A,11,0,20,9
1748426109652,SIOC 210,A00,939917,Purkey; Sarah Michelle G.,25,0,35,10
1748426109652,SIOC 210,B00,939973,Purkey; Sarah Michelle G.,31,0,35,4
1748426110677,SIOC 217A,A00,940015,Evan; Amato Tomas,18,0,25,7
1748426111708,SIOC 221A,A00,940020,Alford; Matthew Hudson,16,0,20,4
1748426112735,SIOG 200C,A00,940290,Fan; Wenyuan,23,0,25,2
1748426113815,SIOG 223A,A00,940333,Constable; Catherine G,22,0,25,3
1748426114844,SIOG 225,A00,940334,Fialko; Yuri A.,19,0,20,1
1748426115870,SIOG 228,A00,940338,Diaz; Julia Michelle,15,0,40,25
1748426116901,SIOG 238,A00,940339,May; David Alexander,20,0,20,0
1748426117931,SIOG 239,A00,940340,Fan; Wenyuan,20,0,20,0
1748426117931,SIOG 239,B00,940342,Sandwell; David T,19,0,20,1
1748426118961,SIOG 240,A00,940409,Parnell-Turner; Ross Ernes,34,0,40,6
1748426119988,SIOG 249,A00,940442,Norris; Richard D.,25,0,25,0
1748426121013,SIOG 267,A01,940444,Martz; Todd R.,15,0,15,0
1748426122040,SIOG 288,A01,940446,Diaz; Julia Michelle,22,0,25,3
1748426123065,SOCE 194,A00,954128,Hill; Seth J,9999,0,9999,0
1748426124093,SOCG 200,A00,935260,Rona-Tas; Akos,2,0,12,10
1748426125123,SOCG 201,A00,935264,Shafir; Gershon,0,0,12,12
1748426126149,SOCG 203,A00,935265,Gong; Neil M,0,0,10,10
1748426127178,SOCG 207,A00,935267,Navon; Daniel,0,0,10,10
1748426128206,SOCG 208A,A00,935269,Blair-Loy; Mary,2,0,12,10
1748426129231,SOCG 226,A00,935302,Skrentny; John David,0,0,10,10
1748426130258,SOCG 227,A00,935303,Jules-Rosette; Bennetta W.,7,0,10,3
1748426131286,SOCG 244,A00,935305,Ribas Norris; Janet Vanesa,0,0,10,10
1748426132310,SOCG 252,A00,935307,Turner; Christena L.,2,0,10,8
1748426133342,SOCG 253,A00,935313,Evans; John Hyde,7,0,10,3
1748426134372,SOCG 255A,A00,934873,McKenzie; Kerry V.,10,0,10,0
1748426135398,SOCG 255C,A00,934874,McKenzie; Kerry V.,9,0,10,1
1748426136427,SOCG 271,A00,935434,Estefan; Michel,4,0,10,6
1748426137455,SOCI 1,A01,934878,Skrentny; John David,20,0,22,2
1748426137455,SOCI 1,A02,934879,Skrentny; John David,21,0,22,1
1748426137455,SOCI 1,A03,934880,Skrentny; John David,22,0,23,1
1748426137455,SOCI 1,A04,934881,Skrentny; John David,12,0,23,11
1748426137455,SOCI 1,A05,934883,Skrentny; John David,23,0,23,0
1748426137455,SOCI 1,A06,934884,Skrentny; John David,23,0,23,0
1748426137455,SOCI 1,A07,934885,Skrentny; John David,22,0,23,1
1748426137455,SOCI 1,A08,934886,Skrentny; John David,22,0,23,1
1748426137455,SOCI 1,A09,934887,Skrentny; John David,22,0,23,1
1748426138481,SOCI 30,A01,934889,Ruiz; Jonathan Joseph,18,0,20,2
1748426138481,SOCI 30,A02,934890,Ruiz; Jonathan Joseph,15,0,20,5
1748426139513,SOCI 60,A01,934892,Ribas Norris; Janet Vanesa,6,0,17,11
1748426139513,SOCI 60,A02,934896,Ribas Norris; Janet Vanesa,17,0,17,0
1748426139513,SOCI 60,A03,934965,Ribas Norris; Janet Vanesa,12,0,17,5
1748426139513,SOCI 60,A04,934974,Ribas Norris; Janet Vanesa,17,0,17,0
1748426140540,SOCI 70,A01,934984,Payne; Christine Anna,4,0,15,11
1748426140540,SOCI 70,A02,934988,Payne; Christine Anna,14,0,15,1
1748426140540,SOCI 70,A03,935006,Payne; Christine Anna,11,0,15,4
1748426140540,SOCI 70,A04,935047,Payne; Christine Anna,15,0,15,0
1748426141565,SOCI 88,A00,935058,Estefan; Michel,0,0,20,20
1748426142592,SOCI 100,A01,935065,Estefan; Michel,6,0,15,9
1748426142592,SOCI 100,A02,935068,Estefan; Michel,4,0,15,11
1748426142592,SOCI 100,A03,935069,Estefan; Michel,5,0,15,10
1748426142592,SOCI 100,A04,935071,Estefan; Michel,0,0,15,15
1748426143618,SOCI 103M,A00,935073,Kilpatrick; Kevin,22,0,30,8
1748426144645,SOCI 104,A00,935077,Arnal; Maud Marie Leonie,18,0,30,12
1748426145673,SOCI 104Q,A00,935079,Rogers; Julia,20,0,30,10
1748426146700,SOCI 105,A01,935083,Jules-Rosette; Bennetta W.,20,0,25,5
1748426147726,SOCI 109,A00,935084,Kilpatrick; Kevin,25,0,30,5
1748426148754,SOCI 112,A00,935085,Pitt; Richard Norris,61,0,65,4
1748426149781,SOCI 113,A00,935086,Rogers; Julia,68,0,75,7
1748426150811,SOCI 117,A01,935151,Jones; Makeba,0,0,13,13
1748426150811,SOCI 117,A02,935153,Jones; Makeba,4,0,13,9
1748426150811,SOCI 117,A03,935155,Jones; Makeba,11,0,12,1
1748426150811,SOCI 117,A04,935156,Jones; Makeba,10,0,12,2
1748426150811,SOCI 117,B01,935158,Jones; Gabrielle Anastasia,7,0,15,8
1748426150811,SOCI 117,B02,935159,Jones; Gabrielle Anastasia,15,0,15,0
1748426150811,SOCI 117,B03,935161,Jones; Gabrielle Anastasia,15,0,15,0
1748426150811,SOCI 117,B04,935162,Jones; Gabrielle Anastasia,15,0,15,0
1748426151838,SOCI 122,A00,935166,Lewis; Kevin Michael,101,0,120,19
1748426152865,SOCI 129,A00,935167,Pitt; Richard Norris,50,0,65,15
1748426153889,SOCI 135,A00,935170,Payne; Christine Anna,112,0,120,8
1748426154917,SOCI 136F,A00,935171,Gong; Neil M,52,0,56,4
1748426155943,SOCI 137,A00,935173,Crofts; Christine,53,0,100,47
1748426156973,SOCI 138,A00,935174,Navon; Daniel,111,0,135,24
1748426158000,SOCI 140,A00,935175,Ng; Kwai,47,0,65,18
1748426159029,SOCI 140K,A00,935176,Ng; Kwai,39,0,56,17
1748426160057,SOCI 142,A00,935177,Crofts; Christine,24,0,75,51
1748426161084,SOCI 143V,A00,935222,Lewis; Kevin Michael,99,0,140,41
1748426162112,SOCI 148,A00,935227,Shafir; Gershon,115,0,120,5
1748426163138,SOCI 148E,A00,935231,Calderon-Zaks; Michael Aar,44,0,56,12
1748426164165,SOCI 150,A00,935232,Victoria Torres; Pablo,14,0,50,36
1748426165191,SOCI 153,A00,935233,Ruiz; Jonathan Joseph,46,0,50,4
1748426166217,SOCI 166,A00,935243,Lampland; Martha,34,0,35,1
1748426167244,SOCI 170,A00,935247,Lampland; Martha,29,0,30,1
1748426168269,SOCI 172,A00,935249,Rona-Tas; Akos,40,0,45,5
1748426169297,SOCI 173,A00,935252,Arnal; Maud Marie Leonie,67,0,75,8
1748426170327,SOCI 180,A00,935253,Calderon-Zaks; Michael Aar,46,0,56,10
1748426171354,SOCI 184,A00,935254,Victoria Torres; Pablo,21,0,56,35
1748426172382,SOCI 196A,A00,935256,Turner; Christena L.,20,0,20,0
1748426173410,SPPS 200B,A00,959322,Luli; Alex J,99,0,99,0
1748426174440,SPPS 201,A00,959324,Mnatzaganian; Christina L,99,0,99,0
1748426175472,SPPS 202A,A00,959400,Tsunoda; Shirley M.,99,0,99,0
1748426176499,SPPS 204,A01,959405,Jones; John,99,0,99,0
1748426177528,SPPS 206,A00,959406,Bounthavong; Mark,80,0,80,0
1748426178557,SPPS 212A,A01,959408,Feist; Ashley,81,0,99,18
1748426179585,SPPS 213A,A00,959409,Namba; Jennifer Mariko,82,0,99,17
1748426180612,SPPS 219,A00,959410,Ma; Joseph David,81,0,99,18
1748426181642,SPPS 221,A01,959412,Siegel; Dionicio R.,80,0,80,0
1748426182669,SPPS 231,A00,959413,Penny; William F.,79,0,99,20
1748426183696,SPPS 232,A00,959415,Simonson; Tatum Sasha Summ,79,0,99,20
1748426184723,SPPS 233,A00,959417,Eckmann; Lars,79,0,99,20
1748426185749,SPPS 247,A00,959419,Brandl; Katharina,79,0,99,20
1748426186779,SPPS 251,A00,959420,Chen; Timothy,99,0,99,0
1748426187810,SPPS 264A,A00,959421,Tsunoda; Shirley M.,99,0,99,0
1748426189862,SPPS 267,A01,959426,Tsunoda; Shirley M.,25,0,25,0
1748426190900,SPPS 269,A00,959427,Atayee; Rabia Samady,29,0,30,1
1748426191927,SPPS 270A,A00,959430,Fricovsky; Eduardo Santiago,99,0,99,0
1748426192953,SPPS 271,A00,959432,Tsunoda; Shirley M.,99,0,99,0
1748426193980,SPPS 278,A00,959433,Fricovsky; Eduardo Santiago,98,0,99,1
1748426195006,SPPS 279,A00,959434,Painter; Nathan A.,99,0,99,0
1748426196042,SYN 2,001,946469,Girard; Gabrielle,3,0,20,17
1748426196042,SYN 2,002,946470,Girard; Gabrielle,0,0,20,20
1748426196042,SYN 2,003,946471,Rock; Martin,0,0,20,20
1748426196042,SYN 2,004,946472,Rock; Martin,0,0,20,20
1748426196042,SYN 2,005,946473,Iatarola; Briana Marie,0,0,20,20
1748426196042,SYN 2,006,946474,Tawater; Hanna Jean,0,0,20,20
1748426196042,SYN 2,007,946475,Browne; Emily,6,0,20,14
1748426196042,SYN 2,008,946476,Browne; Emily,0,0,20,20
1748426196042,SYN 2,009,946477,Staff,0,0,20,20
1748426196042,SYN 2,010,946478,Staff,9,0,20,11
1748426196042,SYN 2,012,946480,Deavenport; James Cary,0,0,20,20
1748426196042,SYN 2,013,946481,Deavenport; James Cary,0,0,20,20
1748426196042,SYN 2,014,946482,Staff,0,0,20,20
1748426196042,SYN 2,015,946483,Staff,0,0,20,20
1748426196042,SYN 2,016,946484,Staff,0,0,20,20
1748426196042,SYN 2,017,946485,Staff,5,0,20,15
1748426196042,SYN 2,019,946487,Atkinson; Arthur Laird,0,0,20,20
1748426196042,SYN 2,020,946488,Staff,0,0,20,20
1748426196042,SYN 2,021,946489,Staff,0,0,20,20
1748426196042,SYN 2,030,946498,Iatarola; Briana Marie,0,0,20,20
1748426196042,SYN 2,036,946587,Bishop; Graham,0,0,20,20
1748426197069,SYN 2R,001,946588,Bishop; Graham,0,0,20,20
1748426198102,SYN 100,A01,946594,Rock; Martin,0,0,15,15
1748426198102,SYN 100,A02,946595,Rock; Martin,0,0,15,15
1748426198102,SYN 100,B01,946598,Browne; Emily,0,0,15,15
1748426198102,SYN 100,B02,946600,Browne; Emily,0,0,15,15
1748426198102,SYN 100,C01,946606,Tawater; Hanna Jean,0,0,15,15
1748426198102,SYN 100,C02,946607,Tawater; Hanna Jean,0,0,15,15
1748426198102,SYN 100,D01,946610,Tawater; Hanna Jean,0,0,15,15
1748426198102,SYN 100,D02,946613,Tawater; Hanna Jean,0,0,15,15
1748426198102,SYN 100,E01,946617,Vega; Adrian,0,0,24,24
1748426198102,SYN 100,G01,946714,Iatarola; Briana Marie,0,0,15,15
1748426198102,SYN 100,G02,946721,Iatarola; Briana Marie,0,0,15,15
1748426198102,SYN 100,I01,946735,Gormally; Brenna,0,0,15,15
1748426198102,SYN 100,I02,946736,Gormally; Brenna,0,0,15,15
1748426198102,SYN 100,J01,946738,Hom; Kirstyn Courtney,0,0,15,15
1748426198102,SYN 100,J02,946739,Hom; Kirstyn Courtney,0,0,15,15
1748426198102,SYN 100,K01,946741,Hom; Kirstyn Courtney,0,0,15,15
1748426198102,SYN 100,K02,946742,Hom; Kirstyn Courtney,0,0,15,15
1748426198102,SYN 100,L01,946745,Difruscio; Mark,0,0,15,15
1748426198102,SYN 100,L02,946746,Difruscio; Mark,0,0,15,15
1748426198102,SYN 100,M01,946748,Difruscio; Mark,0,0,15,15
1748426198102,SYN 100,M02,946749,Difruscio; Mark,0,0,15,15
1748426198102,SYN 100,P01,946759,Atkinson; Arthur Laird,0,0,15,15
1748426198102,SYN 100,P02,946760,Atkinson; Arthur Laird,0,0,15,15
1748426198102,SYN 100,Q01,946763,Bishop; Graham,0,0,15,15
1748426198102,SYN 100,Q02,946764,Bishop; Graham,0,0,15,15
1748426198102,SYN 100,R01,946766,Deavenport; James Cary,0,0,15,15
1748426198102,SYN 100,R02,946767,Deavenport; James Cary,0,0,15,15
1748426199135,SYN 150,001,946771,Gladstein; Jill M,19,0,20,1
1748426199135,SYN 150,002,946772,Lagapa; Jason,17,0,20,3
1748426199135,SYN 150,003,946773,Fish; Gwendolyn Anne,19,0,20,1
1748426199135,SYN 150,004,946774,Fish; Gwendolyn Anne,20,0,20,0
1748426199135,SYN 150,006,946782,Lagapa; Jason,18,0,20,2
1748426199135,SYN 150,007,946783,Lagapa; Jason,19,0,20,1
1748426199135,SYN 150,008,946784,Fish; Gwendolyn Anne,19,0,20,1
1748426200161,SYN 150R,001,946786,Vega; Adrian,19,0,20,1
1748426201189,TDAC 1,A00,946788,Walsh; Kim C.,0,0,12,12
1748426201189,TDAC 1,B00,946789,Walsh; Kim C.,0,0,12,12
1748426201189,TDAC 1,C00,946790,Walsh; Kim C.,0,0,12,12
1748426201189,TDAC 1,D00,946791,Walsh; Kim C.,0,0,12,12
1748426201189,TDAC 1,E00,946792,Walsh; Kim C.,0,0,12,12
1748426201189,TDAC 1,F00,946793,Walsh; Kim C.,0,0,12,12
1748426202223,TDAC 101,A00,946887,Harting; Carla Kelso,3,0,12,9
1748426202223,TDAC 101,B00,946970,Salovey; Todd,9,0,12,3
1748426202223,TDAC 101,C00,946977,Walsh; Kim C.,10,0,12,2
1748426203249,TDAC 102,A00,946979,Celik; Aysan Karagasli,7,0,15,8
1748426204276,TDAC 104,A00,946994,Meyer; Ursula,14,0,15,1
1748426205307,TDAC 107,A00,946997,Stalling; Vanessa,0,0,0,0
1748426206334,TDAC 108,A00,947021,Basso; Beatrice,19,0,20,1
1748426206334,TDAC 108,B00,947025,Caban; Andrea Chudnow,12,0,20,8
1748426206334,TDAC 108,C00,968049,Buescher; Stephen W.,16,0,20,4
1748426207361,TDAC 115,A00,947050,Buescher; Stephen W.,14,0,20,6
1748426208387,TDAC 122,A00,947091,Stalling; Vanessa,30,0,30,0
1748426208387,TDAC 122,B00,947092,Perry; Lamar,30,0,30,0
1748426209417,TDAC 123,A00,947093,Castro; Robert Jess,30,0,30,0
1748426210443,TDDE 1,A01,946795,Guirguis; Mark C,10,0,11,1
1748426210443,TDDE 1,A02,946796,Guirguis; Mark C,10,0,11,1
1748426210443,TDDE 1,A03,946797,Guirguis; Mark C,7,0,11,4
1748426210443,TDDE 1,A04,946798,Guirguis; Mark C,8,0,11,3
1748426210443,TDDE 1,A05,946799,Guirguis; Mark C,11,0,11,0
1748426211472,TDDE 130,A00,947094,Guirguis; Mark C,20,0,20,0
1748426212500,TDDE 131,A00,947095,Guirguis; Mark C,17,0,20,3
1748426213529,TDDE 132,A00,947096,Guirguis; Mark C,20,0,20,0
1748426214555,TDDE 141,A00,947097,McElver; Robert Harrison,20,0,20,0
1748426215584,TDDM 1,A00,946800,Johnston; Holly,7,0,18,11
1748426216610,TDDM 100,A00,947098,Brown; Bernard Joseph,28,0,30,2
1748426217699,TDDR 101,A00,947099,Powell; Lora,4,0,20,16
1748426218725,TDDR 102,A00,947100,Powell; Lora,19,0,20,1
1748426219752,TDDR 111,A00,947101,Castro; Robert Jess,12,0,15,3
1748426220783,TDDR 190,A00,947102,Stalling; Vanessa,35,0,35,0
1748426221817,TDGE 1,A01,946802,Salovey; Todd,12,0,12,0
1748426221817,TDGE 1,A02,946803,Salovey; Todd,11,0,12,1
1748426221817,TDGE 1,A03,946804,Salovey; Todd,12,0,12,0
1748426221817,TDGE 1,A04,946806,Salovey; Todd,12,0,12,0
1748426221817,TDGE 1,A05,946807,Salovey; Todd,10,0,12,2
1748426221817,TDGE 1,A06,946808,Salovey; Todd,12,0,12,0
1748426222843,TDGE 10,A00,946810,Havis; Allan,208,0,225,17
1748426223874,TDGE 11,A00,946811,Fulton; Julia,205,0,245,40
1748426224906,TDGE 25,A00,946812,Harting; Carla Kelso,1,0,20,19
1748426224906,TDGE 25,B00,946813,Harting; Carla Kelso,5,0,20,15
1748426224906,TDGE 25,C00,946814,Harting; Carla Kelso,10,0,20,10
1748426224906,TDGE 25,D00,946815,Harting; Carla Kelso,12,0,20,8
1748426225932,TDGE 124,A00,947103,Fulton; Julia,190,0,245,55
1748426226964,TDGE 133,A00,947104,Brill; Robert L.,19,0,20,1
1748426227993,TDGR 201,A00,947268,Newcomb; James,8,0,8,0
1748426229019,TDGR 210A,A00,947269,Staff,8,0,8,0
1748426230048,TDGR 211A,A00,947270,Caban; Andrea Chudnow,8,0,8,0
1748426231076,TDGR 212,A00,947271,Meyer; Ursula,17,0,17,0
1748426231076,TDGR 212,B00,947272,Caban; Andrea Chudnow,17,0,17,0
1748426232103,TDGR 213A,A00,947273,Buescher; Stephen W.,8,0,8,0
1748426233133,TDGR 214A,A00,947274,Meyer; Ursula,8,0,8,0
1748426234159,TDGR 219,A00,947276,Stalling; Vanessa,3,0,5,2
1748426235188,TDGR 229,A00,947277,Meyer; Ursula,7,0,7,0
1748426236219,TDGR 231A,A00,947278,Meyer; Ursula,9,0,9,0
1748426237245,TDGR 233,A00,947279,Richard; Keiana Nikole,9,0,9,0
1748426238274,TDGR 235,A00,947280,Blair; Kyle Adam,9,0,9,0
1748426239304,TDGR 239,A00,947281,Staff,8,0,8,0
1748426239304,TDGR 239,B00,947282,Meyer; Ursula,9,0,9,0
1748426239304,TDGR 239,C00,947283,Staff,9,0,9,0
1748426240334,TDGR 240,A00,947284,Stalling; Vanessa,3,0,5,2
1748426241362,TDGR 244,A00,947285,Iizuka; Naomi Hisako,19,0,20,1
1748426242401,TDGR 245,A00,947287,Stalling; Vanessa,4,0,5,1
1748426243425,TDGR 250,A00,947289,Stein; Deborah Isobel,5,0,5,0
1748426244457,TDGR 251,A00,947296,Iizuka; Naomi Hisako,5,0,5,0
1748426244457,TDGR 251,B00,947355,Stein; Deborah Isobel,5,0,5,0
1748426245487,TDGR 274,A00,947358,Brill; Robert L.,19,0,20,1
1748426246514,TDGR 275,A00,947361,Staff,10,0,10,0
1748426247545,TDGR 276,A00,947362,Bokovikova; Alina V,10,0,10,0
1748426248573,TDGR 278,A00,947363,Petrovich; Victoria A.,12,0,12,0
1748426248573,TDGR 278,B00,947366,Staff,9,0,10,1
1748426249607,TDGR 279,A00,947367,Petrovich; Victoria A.,3,0,3,0
1748426249607,TDGR 279,B00,947368,Brill; Robert L.,2,0,3,1
1748426249607,TDGR 279,C00,947369,McElver; Robert Harrison,3,0,3,0
1748426249607,TDGR 279,D00,967973,Staff,0,0,0,0
1748426249607,TDGR 279,E00,967974,Bokovikova; Alina V,0,0,0,0
1748426250634,TDGR 282,A00,947370,McElver; Robert Harrison,10,0,10,0
1748426251662,TDGR 289,A00,947371,Power; Jade Yukana,10,0,10,0
1748426252688,TDGR 289C,A00,947373,Burelle; Julie Sara Veronique,10,0,10,0
1748426253716,TDGR 289D,A00,947374,Anderson; Mysia Anyse,5,0,5,0
1748426254743,TDGR 292,A00,947375,Yapp; Hentyle T,14,0,15,1
1748426255769,TDGR 295,A00,947376,Celik; Aysan Karagasli,8,0,8,0
1748426256796,TDGR 296,A00,947379,Powell; Lora,5,0,5,0
1748426257825,TDGR 297,001,947381,Meyer; Ursula,9,0,9,0
1748426258855,TDHT 10,A00,946817,Burelle; Julie Sara Veronique,23,0,25,2
1748426259882,TDHT 21,A02,946821,Power; Jade Yukana,11,0,15,4
1748426259882,TDHT 21,A03,946822,Power; Jade Yukana,8,0,15,7
1748426260911,TDHT 101,A00,947106,Perry; Lamar,19,0,25,6
1748426261939,TDHT 103,A00,947107,Yapp; Hentyle T,8,0,25,17
1748426262971,TDHT 115,A00,947108,Portes; Elizabeth Marie,16,0,25,9
1748426264002,TDMV 1,A00,946823,Arcidiacono; Kristin,18,0,30,12
1748426265030,TDMV 2,A00,946824,Wilson; Terry A.,24,0,30,6
1748426265030,TDMV 2,B00,946825,Brown; Bernard Joseph,23,0,30,7
1748426266056,TDMV 3,A00,946826,Mack; Kara Shanai',23,0,40,17
1748426267087,TDMV 11,A00,946827,Arcidiacono; Kristin,36,0,40,4
1748426267087,TDMV 11,B00,946828,Fyall; Daunte Edward,28,0,30,2
1748426268121,TDMV 20,A00,946830,Alvarez; Ana Maria,38,0,40,2
1748426268121,TDMV 20,B00,946831,Smith; Alison D,20,0,20,0
1748426269152,TDMV 110,A00,947109,Smith; Alison D,25,0,30,5
1748426270184,TDMV 120,A00,947110,Weinberg; Sadie,17,0,18,1
1748426270184,TDMV 120,B00,964374,Johnston; Holly,18,0,18,0
1748426271216,TDMV 123,A00,947111,Duran; Marcos Antonio,29,0,30,1
1748426272242,TDMV 138,A00,947113,Jun; Grace Shin Hae,4,0,40,36
1748426273270,TDMV 140,A00,947114,Corrales; Joseph Bernales,29,0,30,1
1748426273270,TDMV 140,B00,947138,Lima; Paulo Henrique,30,0,30,0
1748426273270,TDMV 140,C00,947139,Staff,25,0,30,5
1748426274297,TDMV 141,A00,947140,Caligagan; Tony,29,0,30,1
1748426275323,TDMV 142,A00,947225,Alvarez; Ana Maria,28,0,40,12
1748426275323,TDMV 142,B00,947226,Blanco; Juan Carlos,27,0,30,3
1748426276349,TDMV 143,A00,947227,Fyall; Daunte Edward,28,0,30,2
1748426277376,TDMV 144,A00,947261,Camaya; Michelle Ann,28,0,30,2
1748426277376,TDMV 144,B00,947262,Patnaik; Shibani,28,0,30,2
1748426278403,TDMV 146,A00,947263,Caligagan; Tony,30,0,30,0
1748426279432,TDPF 160,A00,947264,Mack; Kara Shanai',40,0,40,0
1748426280459,TDPR 6,A01,946869,Guirguis; Mark C,25,0,25,0
1748426280459,TDPR 6,A02,946870,Guirguis; Mark C,25,0,25,0
1748426281491,TDPR 102,A00,947265,Guirguis; Mark C,20,0,20,0
1748426282519,TDPR 104,A00,947266,Powell; Lora,15,0,15,0
1748426283546,TDPW 1,A00,946873,Stein; Deborah Isobel,6,0,10,4
1748426283546,TDPW 1,B00,946878,Stein; Deborah Isobel,10,0,10,0
1748426283546,TDPW 1,C00,946879,Stein; Deborah Isobel,10,0,10,0
1748426283546,TDPW 1,D00,946880,Stein; Deborah Isobel,7,0,10,3
1748426283546,TDPW 1,E00,946882,Stein; Deborah Isobel,7,0,10,3
1748426284570,TDPW 104,A00,947267,Loo; Eric James,13,0,20,7
1748426285600,TDTR 10,A00,946883,Wilson; Terry A.,14,0,20,6
1748426286625,TDTR 15,A00,946885,Smith; Alison D,30,0,30,0
1748426287652,TDTR 20,A00,946886,Duran; Marcos Antonio,25,0,30,5
1748426288678,USP 1,A01,943915,Garcia; Guadalupe,23,0,23,0
1748426288678,USP 1,A02,943916,Garcia; Guadalupe,19,0,23,4
1748426288678,USP 1,A03,943927,Garcia; Guadalupe,23,0,23,0
1748426288678,USP 1,A04,943933,Garcia; Guadalupe,22,0,23,1
1748426288678,USP 1,A05,943942,Garcia; Guadalupe,23,0,23,0
1748426288678,USP 1,A06,943951,Garcia; Guadalupe,22,0,23,1
1748426289709,USP 2,A01,943956,Pezzoli; Keith,15,0,23,8
1748426289709,USP 2,A02,943958,Pezzoli; Keith,20,0,22,2
1748426290739,USP 4,A00,943961,Schwaller; Nora Louise,2,0,18,16
1748426290739,USP 4,B00,943966,Schwaller; Nora Louise,12,0,18,6
1748426291766,USP 5,A01,943968,Boomhower; Matthew Charles,16,0,20,4
1748426291766,USP 5,A02,943969,Boomhower; Matthew Charles,16,0,20,4
1748426292799,USP 15,A01,943971,Anderson; William Raymond,18,0,20,2
1748426292799,USP 15,A02,944015,Anderson; William Raymond,19,0,20,1
1748426293825,USP 25,A00,944021,Shenkman; Michael Thomas,16,0,25,9
1748426294852,USP 50,A00,944025,Sun; Feiyang,3,0,30,27
1748426295878,USP 60,A01,944056,Wali; Behram,26,0,30,4
1748426296910,USP 105,A00,944057,Ruiz; Jonathan Joseph,9,0,15,6
1748426297940,USP 108,A00,944058,Pezzoli; Keith,10,0,21,11
1748426298967,USP 124,A00,944060,Devereux; Christina Schopp,16,0,35,19
1748426299992,USP 125,A00,944063,Lerner; Amy M,21,0,28,7
1748426301020,USP 136,A00,944064,Staff,27,0,35,8
1748426302048,USP 141A,A00,960658,Lewis; Leslie R,0,0,0,0
1748426303075,USP 143,A00,944065,Hinds; Juli Beth,200,0,250,50
1748426304102,USP 144,A00,944066,Chowdhury; Muhammed Zohir,94,0,100,6
1748426305130,USP 150,A00,944067,Devereux; Christina Schopp,68,0,75,7
1748426306156,USP 151,A00,944068,Clark; Christopher N,58,0,70,12
1748426307183,USP 152B,A00,944069,Moeder; Nathan L,14,0,25,11
1748426308209,USP 153,A00,944070,Shenkman; Michael Thomas,19,0,35,16
1748426309235,USP 161,A00,944071,Wartell; Julie Dara,27,0,35,8
1748426310262,USP 165C,A00,944072,Wali; Behram,25,0,30,5
1748426311288,USP 170,A00,944142,Entezam; Maryam,60,0,70,10
1748426312317,USP 171,A00,944153,Lerner; Amy M,24,0,65,41
1748426313343,USP 175,A00,944172,Peerson; Susan,0,0,25,25
1748426314370,USP 177A,A00,944173,Peerson; Susan,0,0,23,23
1748426316425,USP 185A,A01,944198,Boomhower; Matthew Charles,26,0,40,14
1748426316425,USP 185A,B01,944201,Sun; Feiyang,0,0,40,40
1748426317452,USP 186,A01,944255,Bussell; Mirle Rabinowitz,28,0,38,10
1748426317452,USP 186,A02,944262,Bussell; Mirle Rabinowitz,11,0,37,26
1748426318478,USP 189,A00,944269,Garcia; Guadalupe,35,0,35,0
1748426319509,USP 191A,A00,944270,McTague; Sarah,13,0,30,17
1748426320542,USP 193,A00,944271,Shilon; Mor,10,0,23,13
1748426321643,USP 194,A00,954112,Hill; Seth J,9999,0,9999,0
1748426322669,USP 265C,A00,944277,Wali; Behram,3,0,4,1
1748426323695,USP 271,A00,944280,Lerner; Amy M,5,0,5,0
1748426324723,VIS 1,A01,944283,Staff,4,0,12,8
1748426324723,VIS 1,A02,944284,Staff,0,0,12,12
1748426324723,VIS 1,A03,944286,Staff,0,0,12,12
1748426324723,VIS 1,A04,944288,Staff,0,0,12,12
1748426324723,VIS 1,A05,944290,Staff,0,0,12,12
1748426324723,VIS 1,A06,944292,Staff,1,0,12,11
1748426324723,VIS 1,A07,944293,Staff,9,0,12,3
1748426324723,VIS 1,A08,944300,Staff,0,0,12,12
1748426324723,VIS 1,A09,944302,Staff,12,0,12,0
1748426324723,VIS 1,A10,944303,Staff,0,0,12,12
1748426324723,VIS 1,A11,944307,Staff,0,0,12,12
1748426324723,VIS 1,A12,944309,Staff,0,0,12,12
1748426324723,VIS 1,A13,944310,Staff,0,0,12,12
1748426324723,VIS 1,A14,944312,Staff,0,0,12,12
1748426324723,VIS 1,A15,944316,Staff,7,0,12,5
1748426324723,VIS 1,A16,944319,Staff,0,0,12,12
1748426325758,VIS 20,A01,944323,Woods; Ann,14,0,16,2
1748426325758,VIS 20,A02,944325,Woods; Ann,15,0,16,1
1748426325758,VIS 20,A03,944326,Woods; Ann,14,0,16,2
1748426325758,VIS 20,A04,944328,Woods; Ann,14,0,16,2
1748426325758,VIS 20,A05,944330,Woods; Ann,16,0,16,0
1748426325758,VIS 20,A06,944334,Woods; Ann,16,0,16,0
1748426325758,VIS 20,A07,944336,Woods; Ann,14,0,16,2
1748426325758,VIS 20,A08,944337,Woods; Ann,16,0,16,0
1748426325758,VIS 20,A09,944338,Woods; Ann,15,0,16,1
1748426325758,VIS 20,A10,944339,Woods; Ann,16,0,16,0
1748426325758,VIS 20,A11,944340,Woods; Ann,15,0,16,1
1748426325758,VIS 20,A12,944342,Woods; Ann,15,0,16,1
1748426326786,VIS 23,A00,944343,Rose; Jordan M,0,0,5,5
1748426327814,VIS 30,A01,944346,Stone; Patricia,11,0,11,0
1748426327814,VIS 30,A02,944351,Stone; Patricia,0,0,11,11
1748426327814,VIS 30,A03,944353,Stone; Patricia,7,0,11,4
1748426327814,VIS 30,A04,944354,Stone; Patricia,9,0,11,2
1748426327814,VIS 30,A05,944356,Stone; Patricia,10,0,11,1
1748426327814,VIS 30,A06,944359,Stone; Patricia,6,0,11,5
1748426328842,VIS 41,A01,944391,D'Elena-Tweed; Jessica Erin,10,0,12,2
1748426328842,VIS 41,A02,944392,D'Elena-Tweed; Jessica Erin,11,0,12,1
1748426328842,VIS 41,A03,944393,D'Elena-Tweed; Jessica Erin,12,0,12,0
1748426328842,VIS 41,A04,944396,D'Elena-Tweed; Jessica Erin,9,0,12,3
1748426328842,VIS 41,A05,944397,D'Elena-Tweed; Jessica Erin,12,0,12,0
1748426328842,VIS 41,A06,944399,D'Elena-Tweed; Jessica Erin,8,0,12,4
1748426328842,VIS 41,A07,944405,D'Elena-Tweed; Jessica Erin,10,0,12,2
1748426328842,VIS 41,A08,944411,D'Elena-Tweed; Jessica Erin,10,0,12,2
1748426328842,VIS 41,A09,944412,D'Elena-Tweed; Jessica Erin,12,0,12,0
1748426328842,VIS 41,A10,944415,D'Elena-Tweed; Jessica Erin,10,0,12,2
1748426328842,VIS 41,A11,944428,D'Elena-Tweed; Jessica Erin,12,0,12,0
1748426328842,VIS 41,A12,944430,D'Elena-Tweed; Jessica Erin,11,0,12,1
1748426329869,VIS 42,A00,969576,Twomey; Robert Daniel,86,0,100,14
1748426330897,VIS 60,A01,944432,Sepuya; Paul Mpagi,10,0,12,2
1748426330897,VIS 60,A02,944434,Sepuya; Paul Mpagi,12,0,12,0
1748426330897,VIS 60,A03,944436,Sepuya; Paul Mpagi,12,0,12,0
1748426330897,VIS 60,A04,944438,Sepuya; Paul Mpagi,12,0,12,0
1748426331924,VIS 70N,A01,944456,Garnett; Mariah J,11,0,11,0
1748426331924,VIS 70N,A02,944461,Garnett; Mariah J,9,0,11,2
1748426331924,VIS 70N,A03,944462,Garnett; Mariah J,8,0,11,3
1748426331924,VIS 70N,A04,944500,Garnett; Mariah J,10,0,11,1
1748426331924,VIS 70N,A05,944501,Garnett; Mariah J,11,0,11,0
1748426331924,VIS 70N,A06,944502,Garnett; Mariah J,11,0,11,0
1748426331924,VIS 70N,A07,944503,Garnett; Mariah J,11,0,11,0
1748426331924,VIS 70N,A08,944507,Garnett; Mariah J,11,0,11,0
1748426332958,VIS 80,A01,944513,Adler; Amy,12,0,12,0
1748426332958,VIS 80,A02,944515,Adler; Amy,9,0,12,3
1748426332958,VIS 80,A03,944517,Adler; Amy,10,0,12,2
1748426332958,VIS 80,A04,944518,Adler; Amy,10,0,12,2
1748426332958,VIS 80,A05,944519,Adler; Amy,12,0,12,0
1748426332958,VIS 80,A06,944520,Adler; Amy,11,0,12,1
1748426332958,VIS 80,A07,944525,Adler; Amy,11,0,12,1
1748426332958,VIS 80,A08,944526,Adler; Amy,9,0,12,3
1748426333987,VIS 85A,A01,944694,Staff,18,0,18,0
1748426333987,VIS 85A,A02,944695,Staff,18,0,18,0
1748426333987,VIS 85A,A03,944696,Staff,17,0,18,1
1748426333987,VIS 85A,A04,944697,Staff,17,0,18,1
1748426333987,VIS 85A,A05,968082,Staff,17,0,18,1
1748426333987,VIS 85A,A06,968084,Staff,18,0,18,0
1748426333987,VIS 85A,A07,968085,Staff,17,0,18,1
1748426333987,VIS 85A,A08,968087,Staff,17,0,18,1
1748426335013,VIS 100,A00,944698,Cruz; Edwin Teddy,125,0,146,21
1748426336042,VIS 100A,A00,944699,D'Elena-Tweed; Jessica Erin,0,0,15,15
1748426337068,VIS 103D,A00,944767,Cartwright; Lisa,72,0,75,3
1748426338097,VIS 105A,A00,944769,Staff,8,0,30,22
1748426338097,VIS 105A,B00,944770,Staff,20,0,30,10
1748426339128,VIS 105B,A00,944773,Staff,16,0,30,14
1748426340155,VIS 105C,A00,944774,Ortiz-Torres; Ruben,1,0,15,14
1748426341182,VIS 106A,A00,944775,Staff,10,0,25,15
1748426342212,VIS 106B,A00,944776,Staff,0,0,25,25
1748426343239,VIS 107A,A00,944777,Staff,2,0,25,23
1748426344266,VIS 107C,A00,944780,Iglesias; Janelle Ann,11,0,15,4
1748426345296,VIS 108,A00,944781,Staff,0,0,15,15
1748426346322,VIS 110A,A00,944782,Staff,11,0,15,4
1748426347348,VIS 110G,A00,963093,Staff,14,0,15,1
1748426348379,VIS 113CN,A00,944783,Welchman; John C.,11,0,15,4
1748426349410,VIS 120A,A00,944784,Woods; Ann,118,0,146,28
1748426350442,VIS 121C,A00,944789,Tronzo; William,68,0,75,7
1748426351469,VIS 126F,A00,944793,Wardwell; Mariana Razo,74,0,75,1
1748426352499,VIS 128C,A00,944794,Staff,71,0,75,4
1748426353529,VIS 129A,A00,944799,Staff,7,0,15,8
1748426354556,VIS 132,A00,944800,Miller; Nicole L,6,0,15,9
1748426355584,VIS 133,A01,944806,Staff,32,0,34,2
1748426355584,VIS 133,A02,944809,Staff,34,0,34,0
1748426356613,VIS 133A,A00,944854,Staff,0,0,15,15
1748426357639,VIS 141A,A01,944856,Stalbaum; Brett,16,0,25,9
1748426357639,VIS 141A,A02,944858,Stalbaum; Brett,17,0,25,8
1748426357639,VIS 141A,A03,944859,Stalbaum; Brett,11,0,25,14
1748426357639,VIS 141A,A04,944861,Stalbaum; Brett,23,0,25,2
1748426358672,VIS 142,A01,944864,Stalbaum; Brett,11,0,15,4
1748426358672,VIS 142,A02,944865,Stalbaum; Brett,0,0,15,15
1748426358672,VIS 142,A03,944869,Stalbaum; Brett,11,0,15,4
1748426358672,VIS 142,A04,944873,Stalbaum; Brett,5,0,15,10
1748426358672,VIS 142,A05,944876,Stalbaum; Brett,15,0,15,0
1748426358672,VIS 142,A06,944878,Stalbaum; Brett,7,0,15,8
1748426359699,VIS 143,A00,969275,Akten; Mehmet,0,0,15,15
1748426360726,VIS 145B,A00,944879,Akten; Mehmet,0,0,15,15
1748426361755,VIS 146B,A00,944880,Twomey; Robert Daniel,14,0,15,1
1748426362786,VIS 147A,A01,944883,Staff,21,0,22,1
1748426362786,VIS 147A,A02,944923,Staff,12,0,22,10
1748426362786,VIS 147A,A03,944924,Staff,15,0,22,7
1748426362786,VIS 147A,A04,944925,Staff,17,0,22,5
1748426363812,VIS 147B,A00,944926,Staff,0,0,15,15
1748426363812,VIS 147B,B00,944927,Staff,1,0,15,14
1748426364847,VIS 149,A00,944928,Bratton; Benjamin H.,12,0,15,3
1748426364847,VIS 149,B00,944929,Crandall; Jordan,7,0,15,8
1748426365876,VIS 152D,A01,944931,Wardwell; Mariana Razo,19,0,24,5
1748426365876,VIS 152D,A02,945003,Wardwell; Mariana Razo,23,0,24,1
1748426365876,VIS 152D,A03,945007,Wardwell; Mariana Razo,24,0,24,0
1748426365876,VIS 152D,A04,945097,Wardwell; Mariana Razo,22,0,24,2
1748426366903,VIS 157,A01,945131,Cartwright; Lisa,23,0,24,1
1748426366903,VIS 157,A02,945167,Cartwright; Lisa,5,0,24,19
1748426367930,VIS 162,A00,945168,Bratton; Benjamin H.,6,0,15,9
1748426368959,VIS 163,A00,945169,Stone; Patricia,72,0,75,3
1748426369987,VIS 164,A00,945170,Sepuya; Paul Mpagi,19,0,22,3
1748426371014,VIS 165A,A00,945208,Staff,10,0,22,12
1748426372044,VIS 167,A00,945235,Staff,11,0,22,11
1748426373073,VIS 171,A00,945258,Staff,18,0,22,4
1748426374101,VIS 174,A00,945285,Cross; Brian R,0,0,22,22
1748426375130,VIS 175,A00,945286,Staff,18,0,22,4
1748426376155,VIS 179,A00,945287,Erdmann; Dean,20,0,22,2
1748426377181,VIS 180A,A00,945322,Cross; Brian R,9,0,22,13
1748426378206,VIS 180B,A00,945324,Gaines; Malik Julian,17,0,22,5
1748426379233,VIS 183B,A00,945329,Staff,4,0,22,18
1748426380261,VIS 203,A00,945331,Cruz; Edwin Teddy,4,0,15,11
1748426381288,VIS 204,A00,945333,Gaines; Malik Julian,11,0,15,4
1748426382317,VIS 205,A00,945334,Ortiz-Torres; Ruben,14,0,15,1
1748426383350,VIS 207,A00,971577,Staff,13,0,15,2
1748426384377,VIS 209,A00,945337,Welchman; John C.,10,0,15,5
1748426385404,VIS 243,A00,945340,Rose; Jordan M,8,0,15,7
1748426386433,VIS 255,A00,945342,Staff,9,0,15,6
1748426387462,VIS 295,001,971694,Miller; Nicole L,0,0,0,0
1748426387462,VIS 295,002,971695,Cruz; Edwin Teddy,0,0,0,0
1748426387462,VIS 295,003,971696,Segade; Alexandro Abraham,0,0,0,0
1748426387462,VIS 295,004,971697,Vangenderen; Monique Luise,0,0,0,0
1748426387462,VIS 295,005,971725,Sepuya; Paul Mpagi,0,0,0,0
1748426387462,VIS 295,006,971763,Sepuya; Paul Mpagi,0,0,0,0
1748426387462,VIS 295,007,971764,Mostajo; Lorena,0,0,0,0
1748426387462,VIS 295,008,971765,Akten; Mehmet,0,0,0,0
1748426388515,WCWP 10A,001,947782,Escobar; Jordan Christophe,20,0,20,0
1748426388515,WCWP 10A,002,947791,Escobar; Jordan Christophe,20,0,20,0
1748426388515,WCWP 10A,003,947792,Gagnon; Jeffrey C,0,0,0,0
1748426388515,WCWP 10A,004,947793,Escobar; Jordan Christophe,19,0,20,1
1748426388515,WCWP 10A,005,947794,Merryman; Walter,19,0,20,1
1748426388515,WCWP 10A,006,947840,Merryman; Walter,20,0,20,0
1748426388515,WCWP 10A,007,947841,Staff,0,0,0,0
1748426388515,WCWP 10A,008,947842,Staff,0,0,0,0
1748426388515,WCWP 10A,009,947843,Martiniuk; Jill,18,0,20,2
1748426388515,WCWP 10A,010,947844,Staff,0,0,0,0
1748426388515,WCWP 10A,011,947845,Martiniuk; Jill,19,0,20,1
1748426388515,WCWP 10A,012,947861,Martiniuk; Jill,20,0,20,0
1748426388515,WCWP 10A,013,947862,Staff,0,0,0,0
1748426388515,WCWP 10A,014,947863,Staff,0,0,0,0
1748426388515,WCWP 10A,015,947867,Staff,0,0,0,0
1748426388515,WCWP 10A,016,947868,Susi; Natalie,19,0,20,1
1748426388515,WCWP 10A,017,947869,Susi; Natalie,19,0,20,1
1748426388515,WCWP 10A,018,947870,Holloway Ii; Mathew,20,0,20,0
1748426388515,WCWP 10A,019,947912,Welji; Haleema Nazir,0,0,0,0
1748426388515,WCWP 10A,020,947941,Holloway Ii; Mathew,19,0,20,1
1748426388515,WCWP 10A,021,947954,Holloway Ii; Mathew,20,0,20,0
1748426388515,WCWP 10A,022,960902,Windham; Emily,19,0,20,1
1748426388515,WCWP 10A,023,960903,Windham; Emily,16,0,20,4
1748426388515,WCWP 10A,024,960904,Windham; Emily,18,0,20,2
1748426389544,WCWP 10B,001,948038,Dhir; Simrita,17,0,20,3
1748426389544,WCWP 10B,002,948042,Dhir; Simrita,13,0,20,7
1748426389544,WCWP 10B,003,948043,Uriarte; Emma,0,0,20,20
1748426389544,WCWP 10B,004,948044,Dhir; Simrita,12,0,20,8
1748426389544,WCWP 10B,005,948045,Uriarte; Emma,13,0,20,7
1748426389544,WCWP 10B,006,948046,Uriarte; Emma,13,0,20,7
1748426389544,WCWP 10B,007,948047,Staff,0,0,0,0
1748426389544,WCWP 10B,008,948075,Staff,0,0,0,0
1748426389544,WCWP 10B,009,948076,Ornelas; Tricia,15,0,20,5
1748426389544,WCWP 10B,010,948077,Staff,0,0,0,0
1748426389544,WCWP 10B,011,948096,Staff,0,0,0,0
1748426389544,WCWP 10B,012,948103,Staff,0,0,0,0
1748426389544,WCWP 10B,016,948169,Staff,0,0,0,0
1748426389544,WCWP 10B,017,948192,Ornelas; Tricia,12,0,20,8
1748426389544,WCWP 10B,018,948194,Ornelas; Tricia,14,0,20,6
1748426389544,WCWP 10B,019,948195,Staff,0,0,0,0
1748426390574,WCWP 100,A00,948196,McCleary; Keith Long,14,0,20,6
1748426390574,WCWP 100,B00,948198,McCleary; Keith Long,20,0,20,0
1748426390574,WCWP 100,C00,948199,McCleary; Keith Long,20,0,20,0
1748426390574,WCWP 100,D00,948200,Twohig; Niall Ivan,18,0,20,2
1748426390574,WCWP 100,E00,948201,Twohig; Niall Ivan,19,0,20,1
1748426390574,WCWP 100,F00,948202,Twohig; Niall Ivan,17,0,20,3
1748426390574,WCWP 100,G00,948203,Young; Mark T,18,0,20,2
1748426390574,WCWP 100,H00,948204,Young; Mark T,19,0,20,1
1748426390574,WCWP 100,I00,948205,Young; Mark T,19,0,20,1
1748426391600,WES 237C,A00,948206,Staff,15,0,15,0
1748426392628,WES 267,A00,948207,Staff,25,0,25,0
1748426393653,WES 268A,A01,948209,Staff,15,0,15,0
1748426395834,AAPI 87,A00,911745,Solomon; Amanda Lee Albaniel,20,0,20,0
1748426396863,AAS 10R,A01,912566,Butler; Elizabeth Annette,15,0,34,19
1748426396863,AAS 10R,A02,912567,Butler; Elizabeth Annette,20,0,34,14
1748426397893,AAS 170R,A00,912568,Butler; Elizabeth Annette,29,0,32,3
1748426398922,ANAR 104,A01,911408,Shtienberg; Gilad,11,0,20,9
1748426399951,ANAR 120,A00,911411,Staff,22,0,30,8
1748426400982,ANAR 166,A00,911412,Jimenez Cano; Nayeli Guada,21,0,30,9
1748426402013,ANAR 167,A01,911414,Dunseth; Zachary Clark,0,0,10,10
1748426403046,ANBI 100,A00,911416,Marchetto; Maria Carolina,36,0,40,4
1748426403046,ANBI 100,B00,961136,Staff,66,0,80,14
1748426404077,ANBI 112,A00,911417,Marchetto; Maria Carolina,0,0,20,20
1748426405108,ANBI 117,A01,961211,Fox; Patrick Keolu Ozer,33,0,40,7
1748426406134,ANBI 135,A01,911419,Non; Amy L,4,0,15,11
1748426407164,ANBI 141,A00,911420,Gagneux; Pascal,170,0,196,26
1748426408192,ANSC 108,A00,911460,Pedersen; David,38,0,40,2
1748426409221,ANSC 121,A00,911472,Sloane; Julia Kathryn,53,0,60,7
1748426410253,ANSC 124,A00,911473,Bialecki; Jon Anthony,32,0,40,8
1748426411281,ANSC 142,A00,911474,Stone; Annika Britt,31,0,40,9
1748426412309,ANSC 148,A00,911475,Walkover; Lillian B,46,0,46,0
1748426413335,ANSC 149,A00,911476,Varma; Saiba,56,0,60,4
1748426414361,ANSC 152,A00,961212,Staff,40,0,40,0
1748426415390,ANSC 190,A00,911479,Jassal; Aftab,41,0,50,9
1748426416417,ANTH 1,A00,910717,Jassal; Aftab,146,0,150,4
1748426417445,ANTH 2,A01,910719,Wilder; Linnea Lorene,31,0,36,5
1748426417445,ANTH 2,A02,910720,Wilder; Linnea Lorene,36,0,36,0
1748426417445,ANTH 2,A03,910722,Wilder; Linnea Lorene,32,0,36,4
1748426417445,ANTH 2,A04,910723,Wilder; Linnea Lorene,35,0,36,1
1748426417445,ANTH 2,A05,910724,Wilder; Linnea Lorene,35,0,36,1
1748426417445,ANTH 2,A06,910725,Wilder; Linnea Lorene,35,0,36,1
1748426417445,ANTH 2,A07,910726,Wilder; Linnea Lorene,33,0,34,1
1748426418471,ANTH 10,A00,910727,Stewart; Alexander B,148,0,175,27
1748426419500,ANTH 21,A01,910730,Stone; Annika Britt,35,0,36,1
1748426419500,ANTH 21,A02,910731,Stone; Annika Britt,34,0,36,2
1748426419500,ANTH 21,A03,910732,Stone; Annika Britt,34,0,36,2
1748426419500,ANTH 21,A04,910733,Stone; Annika Britt,30,0,36,6
1748426419500,ANTH 21,A05,910734,Stone; Annika Britt,35,0,36,1
1748426419500,ANTH 21,A06,910735,Stone; Annika Britt,30,0,36,6
1748426419500,ANTH 21,A07,910736,Stone; Annika Britt,24,0,34,10
1748426419500,ANTH 21,B01,910738,Kang; Byung Chu,36,0,36,0
1748426419500,ANTH 21,B02,910740,Kang; Byung Chu,36,0,36,0
1748426419500,ANTH 21,B03,910781,Kang; Byung Chu,34,0,36,2
1748426419500,ANTH 21,B04,910782,Kang; Byung Chu,34,0,36,2
1748426419500,ANTH 21,B05,910821,Kang; Byung Chu,36,0,36,0
1748426419500,ANTH 21,B06,910826,Kang; Byung Chu,34,0,36,2
1748426419500,ANTH 21,B07,910834,Kang; Byung Chu,34,0,34,0
1748426420528,ANTH 23,A01,910896,Stewart; Alexander B,25,0,25,0
1748426420528,ANTH 23,A02,910916,Stewart; Alexander B,25,0,25,0
1748426420528,ANTH 23,A03,910932,Stewart; Alexander B,25,0,25,0
1748426420528,ANTH 23,A04,910933,Stewart; Alexander B,24,0,25,1
1748426420528,ANTH 23,A05,910938,Stewart; Alexander B,25,0,25,0
1748426420528,ANTH 23,A06,911043,Stewart; Alexander B,25,0,25,0
1748426420528,ANTH 23,A07,911141,Stewart; Alexander B,24,0,25,1
1748426421559,ANTH 87,A00,911153,Jordan; David K.,20,0,20,0
1748426421559,ANTH 87,B00,911392,Jordan; David K.,20,0,20,0
1748426421559,ANTH 87,C00,911404,Varma; Saiba,20,0,20,0
1748426422586,ANTH 101,A01,911481,Staff,27,0,30,3
1748426422586,ANTH 101,A02,911482,Staff,15,0,30,15
1748426422586,ANTH 101,A03,911483,Staff,24,0,30,6
1748426422586,ANTH 101,A04,911484,Staff,17,0,30,13
1748426423615,ANTH 105,A00,911486,Staff,69,0,80,11
1748426424647,ANTH 108,A00,911487,Sloane; Julia Kathryn,31,0,35,4
1748426425733,ANTH 196A,A00,911488,Staff,14,0,15,1
1748426426763,ANTH 200,A00,911489,Non; Amy L,12,0,15,3
1748426427791,ANTH 203,A00,911490,Gagneux; Pascal,20,0,20,0
1748426428819,ANTH 208,A00,911491,Kang; Byung Chu,8,0,12,4
1748426429845,ANTH 268,A00,911492,McKenzie; Kerry V.,10,0,10,0
1748426430871,ANTH 273,A00,911493,McKenzie; Kerry V.,10,0,10,0
1748426431899,ANTH 281A,A00,911494,Pedersen; David,10,0,10,0
1748426432931,ANTH 285,A00,911495,Algaze; Guillermo,7,0,10,3
1748426433958,ASTR 1,A01,911506,Wright; Shelley Adams,282,0,300,18
1748426434983,ASTR 18,A01,911508,Arnold; Kam S,35,0,37,2
1748426436015,ASTR 20A,A01,911510,Theissen; Christopher Alexander,48,0,56,8
1748426437045,ASTR 65,A01,911512,Trumbo; Samantha Kathleen,49,0,50,1
1748426438071,ASTR 101,A01,911514,Burgasser; Adam Jonathan,25,0,32,7
1748426439101,ASTR 104,A01,911516,Lee; Eve Jihyun,29,0,32,3
1748426440129,ASTR 120,A01,911518,Tytler; David Robert,29,0,37,8
1748426441158,ASTR 124,A01,911520,Konopacky; Quinn Morgan,33,0,37,4
1748426442185,ASTR 150,A01,911522,Hosseinzadeh; Griffin Alex,34,0,40,6
1748426443213,ASTR 200,A00,911523,Sandstrom; Karin Marie,29,0,30,1
1748426444242,ASTR 201,A00,911524,Broekgaarden; Floor Suzan,30,0,30,0
1748426445271,ASTR 213,A00,911525,Keres; Dusan,28,0,30,2
1748426446297,ASTR 250,A00,911526,Theissen; Christopher Alexander & Hosseinzadeh; Griffin Alex,27,0,30,3
1748426447323,ASTR 251,A00,911527,Theissen; Christopher Alexander & Hosseinzadeh; Griffin Alex,27,0,30,3
1748426448391,AWP 3,001,910489,Staff,12,0,12,0
1748426448391,AWP 3,002,910490,Staff,12,0,12,0
1748426448391,AWP 3,003,910491,Staff,12,0,12,0
1748426448391,AWP 3,004,910492,Staff,12,0,12,0
1748426448391,AWP 3,005,910493,Staff,12,0,12,0
1748426448391,AWP 3,006,910495,Staff,12,0,12,0
1748426448391,AWP 3,007,910498,Staff,12,0,12,0
1748426448391,AWP 3,008,910509,Staff,12,0,12,0
1748426448391,AWP 3,009,910516,Staff,12,0,12,0
1748426448391,AWP 3,010,910525,Staff,12,0,12,0
1748426448391,AWP 3,011,910531,Staff,12,0,12,0
1748426448391,AWP 3,012,910532,Staff,12,0,12,0
1748426448391,AWP 3,013,910533,Staff,12,0,12,0
1748426448391,AWP 3,014,910534,Staff,12,0,12,0
1748426448391,AWP 3,015,910535,Staff,12,0,12,0
1748426448391,AWP 3,016,910536,Staff,12,0,12,0
1748426448391,AWP 3,017,910537,Staff,12,0,12,0
1748426448391,AWP 3,018,910538,Staff,12,0,12,0
1748426448391,AWP 3,019,910539,Staff,0,0,0,0
1748426448391,AWP 3,020,910540,Staff,0,0,0,0
1748426448391,AWP 3,021,910541,Staff,12,0,12,0
1748426448391,AWP 3,022,910542,Staff,0,0,0,0
1748426448391,AWP 3,023,910543,Staff,12,0,12,0
1748426448391,AWP 3,024,910545,Staff,12,0,12,0
1748426448391,AWP 3,025,910546,Staff,12,0,12,0
1748426448391,AWP 3,026,910547,Staff,12,0,12,0
1748426448391,AWP 3,027,910548,Staff,12,0,12,0
1748426448391,AWP 3,028,910549,Staff,12,0,12,0
1748426448391,AWP 3,029,910550,Staff,0,0,0,0
1748426448391,AWP 3,030,910551,Staff,0,0,0,0
1748426448391,AWP 3,031,910552,Staff,12,0,12,0
1748426448391,AWP 3,032,910553,Staff,12,0,12,0
1748426448391,AWP 3,033,910554,Staff,12,0,12,0
1748426448391,AWP 3,034,910555,Staff,12,0,12,0
1748426448391,AWP 3,035,910557,Staff,12,0,12,0
1748426448391,AWP 3,036,910558,Staff,12,0,12,0
1748426448391,AWP 3,037,910559,Staff,12,0,12,0
1748426448391,AWP 3,038,910560,Staff,12,0,12,0
1748426448391,AWP 3,039,910561,Staff,12,0,12,0
1748426448391,AWP 3,040,910562,Staff,12,0,12,0
1748426448391,AWP 3,041,910563,Staff,12,0,12,0
1748426448391,AWP 3,042,910564,Staff,12,0,12,0
1748426448391,AWP 3,043,910565,Staff,12,0,12,0
1748426448391,AWP 3,044,910566,Staff,12,0,12,0
1748426448391,AWP 3,045,910567,Staff,12,0,12,0
1748426448391,AWP 3,046,910568,Staff,12,0,12,0
1748426448391,AWP 3,047,910569,Staff,12,0,12,0
1748426448391,AWP 3,048,910570,Staff,12,0,12,0
1748426448391,AWP 3,049,910571,Staff,12,0,12,0
1748426448391,AWP 3,050,910576,Staff,12,0,12,0
1748426448391,AWP 3,051,910629,Staff,12,0,12,0
1748426448391,AWP 3,052,910630,Staff,12,0,12,0
1748426448391,AWP 3,053,910632,Staff,12,0,12,0
1748426448391,AWP 3,054,910633,Staff,12,0,12,0
1748426448391,AWP 3,055,910635,Staff,12,0,12,0
1748426448391,AWP 3,056,910636,Staff,12,0,12,0
1748426448391,AWP 3,057,910638,Staff,12,0,12,0
1748426448391,AWP 3,058,910640,Staff,0,0,0,0
1748426448391,AWP 3,059,910641,Staff,12,0,12,0
1748426448391,AWP 3,060,910645,Staff,12,0,12,0
1748426448391,AWP 3,061,910646,Staff,12,0,12,0
1748426448391,AWP 3,062,910648,Staff,12,0,12,0
1748426448391,AWP 3,063,910649,Staff,12,0,12,0
1748426448391,AWP 3,064,910653,Staff,12,0,12,0
1748426448391,AWP 3,065,910654,Staff,12,0,12,0
1748426448391,AWP 3,066,910656,Staff,12,0,12,0
1748426448391,AWP 3,067,910657,Staff,12,0,12,0
1748426448391,AWP 3,068,910659,Staff,15,0,15,0
1748426448391,AWP 3,069,910660,Staff,0,0,0,0
1748426448391,AWP 3,070,910662,Staff,12,0,12,0
1748426448391,AWP 3,071,910665,Staff,0,0,0,0
1748426448391,AWP 3,072,910667,Staff,12,0,12,0
1748426448391,AWP 3,073,970938,Staff,12,0,12,0
1748426448391,AWP 3,074,970939,Staff,12,0,12,0
1748426448391,AWP 3,075,970940,Staff,0,0,0,0
1748426448391,AWP 3,076,970941,Staff,12,0,12,0
1748426448391,AWP 3,077,970942,Staff,12,0,12,0
1748426448391,AWP 3,078,970943,Staff,0,0,0,0
1748426448391,AWP 3,079,970944,Staff,12,0,12,0
1748426448391,AWP 3,080,970945,Staff,0,0,0,0
1748426448391,AWP 3,081,971140,Staff,0,0,0,0
1748426448391,AWP 3,082,971141,Staff,0,0,0,0
1748426448391,AWP 3,083,971142,Staff,0,0,0,0
1748426448391,AWP 3,084,971152,Staff,0,0,0,0
1748426448391,AWP 3,085,971315,Staff,0,0,0,0
1748426449419,AWP 4B,B00,910682,Staff,0,0,0,0
1748426449419,AWP 4B,C00,910701,Staff,0,0,0,1
1748426450450,BENG 1,A01,911565,Khojah; Reem I,26,0,30,4
1748426450450,BENG 1,A02,911567,Khojah; Reem I,30,0,30,0
1748426450450,BENG 1,A03,911568,Khojah; Reem I,29,0,30,1
1748426451479,BENG 2,A00,911569,Khojah; Reem I,28,0,30,2
1748426452508,BENG 98,001,969809,Sah; Robert Lie-Yuan,9999,0,9999,0
1748426453532,BENG 99,001,969810,Sah; Robert Lie-Yuan,9999,0,9999,0
1748426454560,BENG 100,A01,911579,Taylor Amos; Alyssa C,35,0,50,15
1748426455590,BENG 110,A01,911582,Mc Culloch; Andrew Douglas,5,0,30,25
1748426455590,BENG 110,A02,911584,Mc Culloch; Andrew Douglas,17,0,30,13
1748426456619,BENG 122A,A01,958030,Cauwenberghs; Gert,54,0,70,16
1748426457650,BENG 133,A01,911589,Mali; Prashant Gulab Ram,33,0,40,7
1748426458681,BENG 135,A01,911653,Staff,32,0,40,8
1748426459708,BENG 141,A01,911674,Staff,29,0,40,11
1748426460734,BENG 161A,A01,911676,Fraley; Stephanie I.,16,0,35,19
1748426460734,BENG 161A,A02,957945,Fraley; Stephanie I.,29,0,35,6
1748426461766,BENG 162,A01,911682,Mali; Prashant Gulab Ram,0,0,30,30
1748426461766,BENG 162,A02,911683,Mali; Prashant Gulab Ram,25,0,30,5
1748426462799,BENG 166A,A02,911685,Sah; Robert Lie-Yuan,11,0,35,24
1748426463826,BENG 183,A01,911688,Zhong; Sheng,35,0,120,85
1748426464852,BENG 187B,A00,911689,Taylor Amos; Alyssa C,52,0,120,68
1748426465880,BENG 188A,A01,911691,Taylor Amos; Alyssa C,131,0,170,39
1748426466907,BENG 196,A00,911692,Cabrales; Pedro,5,0,5,0
1748426467937,BENG 197,A00,911693,Cabrales; Pedro,9999,0,9999,0
1748426468966,BENG 198,001,969812,Sah; Robert Lie-Yuan,9999,0,9999,0
1748426469996,BENG 211,A00,911720,Smarr; Benjamin,2,0,30,28
1748426471027,BENG 216,A01,911722,Cauwenberghs; Gert,1,0,40,39
1748426472054,BENG 219,A00,911723,Schoeneberg; Johannes,0,0,0,0
1748426473081,BENG 221,A00,911724,Valdez-Jasso; Daniela,27,0,70,43
1748426474108,BENG 226,A01,911727,Schmid-Schoenbein; Geert W,54,0,120,66
1748426475135,BENG 230A,A00,911728,Huang; Xiaohua,59,0,120,61
1748426476162,BENG 241A,A01,911730,Cyphert; Erika Leah,0,0,50,50
1748426477189,BENG 242,A00,911731,Cai; Shengqiang,16,0,40,24
1748426478217,BENG 247A,A00,911732,Shi; Lingyan,31,0,55,24
1748426479244,BENG 247B,A00,911733,Aran; Kiana,0,0,30,30
1748426480273,BENG 254,A01,911735,Hasty; Jeff M,0,0,20,20
1748426481301,BENG 260,A01,911737,Silva; Gabriel,15,0,45,30
1748426482336,BENG 280A,A00,911738,Liu; Thomas Tao-Ming & McVeigh; Elliot R.,34,0,70,36
1748426483361,BENG 281,A00,911739,Zhong; Sheng,5,0,90,85
1748426484387,BENG 282,A00,911740,Cabrales; Pedro,19,0,100,81
1748426485414,BENG 292,A01,911742,Ross; Camille,20,0,20,0
1748426486441,BENG 294A,A00,911743,King; Kevin R,25,0,50,25
1748426487468,BENG 295,A00,911744,Watson; John Thomas,9999,0,9999,0
1748426488496,BGGN 202,A00,943331,Kadonaga; James T,52,0,60,8
1748426489522,BGGN 204,A00,943332,Shurin; Jonathan,11,0,20,9
1748426490548,BGGN 206A,A00,943343,Bennett; Eric J,50,0,50,0
1748426491580,BGGN 208,A00,943344,Meyer; Justin Raymond & Bennett; Eric J,50,0,50,0
1748426492610,BGGN 213,A00,943349,Grant; Barry J,48,0,48,0
1748426493637,BGGN 214,A00,943351,Suel; Gurol Mehmet,23,0,50,27
1748426494669,BGGN 220,A00,943352,Dickinson; Alexandra Jazz & Pruneda-Paz; Jose L.,24,0,50,26
1748426495700,BGGN 227,A00,943372,Huffaker; Alisa,44,0,50,6
1748426496733,BGGN 249A,A01,969612,Bloodgood; Brenda Laurie,0,0,0,0
1748426496733,BGGN 249A,A02,969639,Bloodgood; Brenda Laurie,0,0,0,0
1748426497760,BGGN 260,A01,946423,Silva; Gabriel,15,0,15,0
1748426499012,BGGN 271,001,967097,Akbari; Omar Sultan,9999,0,9999,0
1748426499012,BGGN 271,002,967098,Allen; Nicola J,9999,0,9999,0
1748426499012,BGGN 271,003,967099,Alperin; Mariann,9999,0,9999,0
1748426499012,BGGN 271,004,967238,Antal; Corina Elena,9998,0,9999,1
1748426499012,BGGN 271,005,967365,Banghart; Matthew Ryan,9999,0,9999,0
1748426499012,BGGN 271,006,967368,Bier; Ethan,9999,0,9999,0
1748426499012,BGGN 271,007,967371,Boss; Gerard R.,9999,0,9999,0
1748426499012,BGGN 271,008,967375,Bouvet; Michael,9999,0,9999,0
1748426499012,BGGN 271,009,967376,Breen; Ellen C.,9999,0,9999,0
1748426499012,BGGN 271,010,967382,Bui; Jack D,9999,0,9999,0
1748426499012,BGGN 271,011,967391,Burnett; Lindsey,9998,0,9999,1
1748426499012,BGGN 271,012,967407,Caffrey; Conor,9999,0,9999,0
1748426499012,BGGN 271,013,967429,Castle; Michael James,9999,0,9999,0
1748426499012,BGGN 271,014,967431,Chang; John Tzu-yu,9999,0,9999,0
1748426499012,BGGN 271,015,967448,Chen; Xu,9999,0,9999,0
1748426499012,BGGN 271,016,967449,Cheng; Christine Shiang-Ling,9999,0,9999,0
1748426499012,BGGN 271,017,967464,Cheresh; David A.,9999,0,9999,0
1748426499012,BGGN 271,018,967496,Cherqui; Stephanie,9999,0,9999,0
1748426499012,BGGN 271,019,967500,Chu; Hiutung,9999,0,9999,0
1748426499012,BGGN 271,020,967559,Church; Kellie Breen,9999,0,9999,0
1748426499012,BGGN 271,021,967560,Cleland; Elsa Eleanor,9999,0,9999,0
1748426499012,BGGN 271,022,967561,Cohen; Shiran,9999,0,9999,0
1748426499012,BGGN 271,023,967562,Coufal; Nicole Gabriele,9999,0,9999,0
1748426499012,BGGN 271,024,967563,Croker; Ben Adam,9999,0,9999,0
1748426499012,BGGN 271,025,967564,Crotty Alexander; Laura E,9999,0,9999,0
1748426499012,BGGN 271,026,967565,Daugherty; Matthew Dorton,9998,0,9999,1
1748426499012,BGGN 271,027,967566,De Silva; Shermin,9999,0,9999,0
1748426499012,BGGN 271,028,967567,Dhar; Debanjan,9999,0,9999,0
1748426499012,BGGN 271,029,967568,Dixon; Jesse,9999,0,9999,0
1748426499012,BGGN 271,030,967569,Doherty; Taylor Alan,9998,0,9999,1
1748426499012,BGGN 271,031,967570,Dore; Kim Bohemie,9999,0,9999,0
1748426499012,BGGN 271,032,967571,Dorrestein; Pieter,9999,0,9999,0
1748426499012,BGGN 271,033,967572,Dulawa; Stephanie Carole,9999,0,9999,0
1748426499012,BGGN 271,034,967573,Fang; Xi,9999,0,9999,0
1748426499012,BGGN 271,035,967575,Farley; Emma Kristen,9998,0,9999,1
1748426499012,BGGN 271,036,967576,Ferguson; Cole John,9999,0,9999,0
1748426499012,BGGN 271,037,967578,Fisch; Kathleen Marie,9999,0,9999,0
1748426499012,BGGN 271,038,967579,George; Olivier,9999,0,9999,0
1748426499012,BGGN 271,039,967580,Ghosh; Pradipta,9998,0,9999,1
1748426499012,BGGN 271,040,967581,Glasgow; Stacey Marie,9999,0,9999,0
1748426499012,BGGN 271,041,967582,Golden; James W,9999,0,9999,0
1748426499012,BGGN 271,042,967583,Gonzalez Gamboa; Ivonne,9999,0,9999,0
1748426499012,BGGN 271,043,967584,Goren; Alon M,9999,0,9999,0
1748426499012,BGGN 271,044,967650,Guatelli; John C,9999,0,9999,0
1748426499012,BGGN 271,045,967651,Guma; Monica,9998,0,9999,1
1748426499012,BGGN 271,046,967652,Gustafsson; Asa Birgitta,9999,0,9999,0
1748426499012,BGGN 271,047,967655,Hamdoun; Amr,9999,0,9999,0
1748426499012,BGGN 271,048,967657,Hao; Nan,9999,0,9999,0
1748426499012,BGGN 271,049,967658,Hasty; Jeff M,9999,0,9999,0
1748426499012,BGGN 271,050,967660,Jiang; Qingfei,9998,0,9999,1
1748426499012,BGGN 271,051,967661,Jin; Chunyu,9999,0,9999,0
1748426499012,BGGN 271,052,967662,Jin; Yishi,9999,0,9999,0
1748426499012,BGGN 271,053,967663,Joshi; Shweta,9998,0,9999,1
1748426499012,BGGN 271,054,967664,Ju; Won-Kyu,9998,0,9999,1
1748426499012,BGGN 271,055,967665,Jun; Suckjoon,9999,0,9999,0
1748426499012,BGGN 271,056,967666,Kaech; Susan Michelle,9999,0,9999,0
1748426499012,BGGN 271,057,967668,Kauffman; Alexander,9998,0,9999,1
1748426499012,BGGN 271,058,967670,Kiger; Amy,9999,0,9999,0
1748426499012,BGGN 271,059,967720,Koloski; Miranda Jane,9998,0,9999,1
1748426499012,BGGN 271,060,967864,Komiyama; Takaki,9999,0,9999,0
1748426499012,BGGN 271,061,967865,Kronenberg; Mitchell E.,9998,0,9999,1
1748426499012,BGGN 271,062,967866,Kufareva; Irina,9999,0,9999,0
1748426499012,BGGN 271,063,967867,Lee; Yun Sok,9999,0,9999,0
1748426499012,BGGN 271,064,967869,Leutgeb; Stefan,9999,0,9999,0
1748426499012,BGGN 271,065,967870,Lewis; Warren G.,9999,0,9999,0
1748426499012,BGGN 271,066,967871,Li; Willis Xiaowei,9998,0,9999,1
1748426499012,BGGN 271,067,967872,Lim; Byungkook,9999,0,9999,0
1748426499012,BGGN 271,068,967873,Lo; Stanley M.,9998,0,9999,1
1748426499012,BGGN 271,069,967874,Lopez Ramirez; Miguel Alej,9999,0,9999,0
1748426499012,BGGN 271,070,967875,Lu; Li-Fan,9998,0,9999,1
1748426499012,BGGN 271,071,967877,Lu; Pengzhe,9999,0,9999,0
1748426499012,BGGN 271,072,967878,Lyons; Deirdre Colleen,9999,0,9999,0
1748426499012,BGGN 271,073,967879,Lyumkis; Dmitry Evgenievich,9999,0,9999,0
1748426499012,BGGN 271,074,967880,Mandyam; Chitra,9999,0,9999,0
1748426499012,BGGN 271,075,967881,McConville; Patrick James,9999,0,9999,0
1748426499012,BGGN 271,076,967882,Mertens; Jerome Stefan,9999,0,9999,0
1748426499012,BGGN 271,077,967884,Morris; Gerald P,9999,0,9999,0
1748426499012,BGGN 271,078,967885,Muroyama; Andrew David,9999,0,9999,0
1748426499012,BGGN 271,079,967886,Murre; Cornelis,9999,0,9999,0
1748426499012,BGGN 271,080,967887,Neal; Sonya E,9999,0,9999,0
1748426499012,BGGN 271,081,967889,Newton; Alexandra C.,9999,0,9999,0
1748426499012,BGGN 271,082,967890,Nieh; James Charles,9999,0,9999,0
1748426499012,BGGN 271,083,967893,Niwa; Maho,9999,0,9999,0
1748426499012,BGGN 271,084,967894,Pantham; Priyadarshini,9999,0,9999,0
1748426499012,BGGN 271,085,967895,Parast; Mana,9999,0,9999,0
1748426499012,BGGN 271,086,967899,Perry; Michael William,9999,0,9999,0
1748426499012,BGGN 271,087,967900,Pillus; Lorraine,9998,0,9999,1
1748426499012,BGGN 271,088,967902,Pogliano; Joseph,9999,0,9999,0
1748426499012,BGGN 271,089,967903,Pruneda-Paz; Jose L.,9999,0,9999,0
1748426499012,BGGN 271,090,967904,Raffatellu; Manuela,9999,0,9999,0
1748426499012,BGGN 271,091,967906,Rana; Tariq,9999,0,9999,0
1748426499012,BGGN 271,092,967907,Rao; Anjana,9998,0,9999,1
1748426499012,BGGN 271,093,967908,Raz; Eyal,9998,0,9999,1
1748426499012,BGGN 271,094,967909,Gaulton; Kyle J,9999,0,9999,0
1748426499012,BGGN 271,095,967910,Rifkin; Scott,9998,0,9999,1
1748426499012,BGGN 271,096,967912,Risbrough; Victoria Blythe,9999,0,9999,0
1748426499012,BGGN 271,097,967916,Rose; Noah Hartmann,9999,0,9999,0
1748426499012,BGGN 271,098,967917,Rouse; Gregory W.,9999,0,9999,0
1748426499012,BGGN 271,099,967918,Saier; Milton H.,9999,0,9999,0
1748426499012,BGGN 271,100,967919,Saltiel; Alan,9998,0,9999,1
1748426499012,BGGN 271,101,967920,Sanchez-Lopez; Elsa,9999,0,9999,0
1748426499012,BGGN 271,102,967921,Schenk; Simon,9999,0,9999,0
1748426499012,BGGN 271,103,967922,Schroeder; Julian I,9998,0,9999,1
1748426499012,BGGN 271,104,967923,Sebat; Lilia Mikhailovna,9999,0,9999,0
1748426499012,BGGN 271,105,967925,Sen; George L,9999,0,9999,0
1748426499012,BGGN 271,106,967926,Shaner; Nathan C.,9999,0,9999,0
1748426499012,BGGN 271,107,967927,Shao; Jianhua,9999,0,9999,0
1748426499012,BGGN 271,108,967928,Shurin; Jonathan,9998,0,9999,1
1748426499012,BGGN 271,109,967929,Sicklick; Jason Keith,9999,0,9999,0
1748426499012,BGGN 271,110,967931,Signer; Robert,9999,0,9999,0
1748426499012,BGGN 271,111,967932,Sigurdson; Christina,9999,0,9999,0
1748426499012,BGGN 271,112,967934,Simonson; Tatum Sasha Summ,9999,0,9999,0
1748426499012,BGGN 271,113,967935,Spitzer; Nicholas,9999,0,9999,0
1748426499012,BGGN 271,114,967936,Steinmetz; Nicole F,9999,0,9999,0
1748426499012,BGGN 271,115,967938,Su; Chih-Ying,9999,0,9999,0
1748426499012,BGGN 271,116,967939,Telese; Francesca,9999,0,9999,0
1748426499012,BGGN 271,117,967942,Towers; Christina Garlingt,9999,0,9999,0
1748426499012,BGGN 271,118,967943,Tye; Kay M,9999,0,9999,0
1748426499012,BGGN 271,119,967945,Wahlin; Karl Jonas,9997,0,9999,2
1748426499012,BGGN 271,120,967947,Wang; Shizhen,9999,0,9999,0
1748426499012,BGGN 271,121,967949,Wang; Jean Yin Jen,9999,0,9999,0
1748426499012,BGGN 271,122,967952,Webster; Nicholas J G,9999,0,9999,0
1748426499012,BGGN 271,123,967953,Weiskopf; Daniela,9998,0,9999,1
1748426499012,BGGN 271,124,967954,Welsbie; Derek,9999,0,9999,0
1748426499012,BGGN 271,125,967956,Wildonger; Jill Cathleen,9999,0,9999,0
1748426499012,BGGN 271,126,967957,Yelon; Deborah,9999,0,9999,0
1748426499012,BGGN 271,127,967958,Yeo; Eugene Wei-Ming,9998,0,9999,1
1748426499012,BGGN 271,128,967959,Ying; Wei,9998,0,9999,1
1748426499012,BGGN 271,129,967960,Young; Jared W.,9999,0,9999,0
1748426499012,BGGN 271,130,967961,Zage; Peter,9999,0,9999,0
1748426499012,BGGN 271,131,967962,Zengler; Karsten B,9999,0,9999,0
1748426499012,BGGN 271,132,967963,Zhang; Jin,9999,0,9999,0
1748426499012,BGGN 271,133,967964,Zhao; Yunde,9999,0,9999,0
1748426499012,BGGN 271,134,967965,Zheng; Ye,9998,0,9999,1
1748426499012,BGGN 271,135,967966,Zhou; Huilin,9998,0,9999,1
1748426499012,BGGN 271,136,967970,Zou; Yimin,9998,0,9999,1
1748426500038,BGGN 272,A00,943373,Lo; Stanley M.,14,0,15,1
1748426501065,BGGN 275,A00,943374,Pogliano; Joseph,0,0,0,0
1748426502094,BGGN 276,A00,943378,Pogliano; Joseph,0,0,0,0
1748426503121,BGJC 204,A00,943407,Lu; Li-Fan & Chang; John Tzu-yu,9998,0,9999,1
1748426504155,BGJC 215,A00,943417,Tour; Ella,9,0,10,1
1748426505246,BGRD 200,001,965406,Akbari; Omar Sultan,9999,0,9999,0
1748426505246,BGRD 200,002,965407,Allen; Eric,9999,0,9999,0
1748426505246,BGRD 200,003,965408,Allen; Nicola J,9998,0,9999,1
1748426505246,BGRD 200,004,965427,Alperin; Mariann,9999,0,9999,0
1748426505246,BGRD 200,005,965428,Amaro; Rommie E,9998,0,9999,1
1748426505246,BGRD 200,006,965429,Antal; Corina Elena,9998,0,9999,1
1748426505246,BGRD 200,007,965731,Asahina; Kenta,9999,0,9999,0
1748426505246,BGRD 200,008,965732,Augustine; Vineet,9999,0,9999,0
1748426505246,BGRD 200,009,965733,Ayres; Janelle Samantha,9998,0,9999,1
1748426505246,BGRD 200,010,965734,Banghart; Matthew Ryan,9999,0,9999,0
1748426505246,BGRD 200,011,965735,Barton; Andrew David,9999,0,9999,0
1748426505246,BGRD 200,012,965736,Bayless; Daniel Wilson,9999,0,9999,0
1748426505246,BGRD 200,013,965737,Benna; Marcus K,9999,0,9999,0
1748426505246,BGRD 200,014,965738,Bennett; Eric J,9999,0,9999,0
1748426505246,BGRD 200,015,965739,Bier; Ethan,9999,0,9999,0
1748426505246,BGRD 200,016,965740,Bloodgood; Brenda Laurie,9999,0,9999,0
1748426505246,BGRD 200,017,965741,Boss; Gerard R.,9999,0,9999,0
1748426505246,BGRD 200,018,966029,Bouvet; Michael,9999,0,9999,0
1748426505246,BGRD 200,019,966054,Breen; Ellen C.,9999,0,9999,0
1748426505246,BGRD 200,020,966072,Bui; Jack D,9999,0,9999,0
1748426505246,BGRD 200,021,966073,Burnett; Lindsey,9998,0,9999,1
1748426505246,BGRD 200,022,966080,Caffrey; Conor,9999,0,9999,0
1748426505246,BGRD 200,023,966082,Callaway; Edward M,9999,0,9999,0
1748426505246,BGRD 200,024,966087,Castle; Michael James,9999,0,9999,0
1748426505246,BGRD 200,025,966089,Chaim; Isaac,9999,0,9999,0
1748426505246,BGRD 200,026,966092,Chang; John Tzu-yu,9999,0,9999,0
1748426505246,BGRD 200,027,966094,Chen; Xu,9999,0,9999,0
1748426505246,BGRD 200,028,966095,Cheng; Christine Shiang-Ling,9999,0,9999,0
1748426505246,BGRD 200,029,966099,Cheresh; David A.,9999,0,9999,0
1748426505246,BGRD 200,030,966103,Cherqui; Stephanie,9999,0,9999,0
1748426505246,BGRD 200,031,966104,Chu; Hiutung,9999,0,9999,0
1748426505246,BGRD 200,032,966107,Church; Kellie Breen,9999,0,9999,0
1748426505246,BGRD 200,033,966108,Cleland; Elsa Eleanor,9997,0,9999,2
1748426505246,BGRD 200,034,966111,Cohen; Shiran,9999,0,9999,0
1748426505246,BGRD 200,035,966112,Cooper; Kimberly Lynn,9999,0,9999,0
1748426505246,BGRD 200,036,966114,Coufal; Nicole Gabriele,9999,0,9999,0
1748426505246,BGRD 200,037,966115,Croker; Ben Adam,9999,0,9999,0
1748426505246,BGRD 200,038,966116,Crotty Alexander; Laura E,9999,0,9999,0
1748426505246,BGRD 200,039,966117,Daugherty; Matthew Dorton,9997,0,9999,2
1748426505246,BGRD 200,040,966118,De Silva; Shermin,9998,0,9999,1
1748426505246,BGRD 200,041,966119,Desai; Arshad,9999,0,9999,0
1748426505246,BGRD 200,042,966120,Dhar; Debanjan,9999,0,9999,0
1748426505246,BGRD 200,043,966121,Dickinson; Alexandra Jazz,9999,0,9999,0
1748426505246,BGRD 200,044,966123,Dixon; Jesse,9999,0,9999,0
1748426505246,BGRD 200,045,966125,Doherty; Taylor Alan,9998,0,9999,1
1748426505246,BGRD 200,046,966128,Dore; Kim Bohemie,9999,0,9999,0
1748426505246,BGRD 200,047,966129,Dorrestein; Pieter,9999,0,9999,0
1748426505246,BGRD 200,048,966130,Dulawa; Stephanie Carole,9999,0,9999,0
1748426505246,BGRD 200,049,966131,Ecker; Joseph R,9999,0,9999,0
1748426505246,BGRD 200,050,966174,Engle; Dannielle D,9998,0,9999,1
1748426505246,BGRD 200,051,966179,Ernst; Andreas,9999,0,9999,0
1748426505246,BGRD 200,052,966182,Esko; Jeffrey D.,9999,0,9999,0
1748426505246,BGRD 200,053,966183,Fang; Xi,9999,0,9999,0
1748426505246,BGRD 200,054,966184,Farley; Emma Kristen,9998,0,9999,1
1748426505246,BGRD 200,055,966187,Ferguson; Cole John,9999,0,9999,0
1748426505246,BGRD 200,056,966190,Fisch; Kathleen Marie,9999,0,9999,0
1748426505246,BGRD 200,057,966193,Gage; Fred H,9999,0,9999,0
1748426505246,BGRD 200,058,966194,George; Monique Leana,9998,0,9999,1
1748426505246,BGRD 200,059,966196,George; Olivier,9999,0,9999,0
1748426505246,BGRD 200,060,966202,Ghosh; Pradipta,9998,0,9999,1
1748426505246,BGRD 200,061,966203,Glasgow; Stacey Marie,9999,0,9999,0
1748426505246,BGRD 200,062,966204,Glass; Christopher,9999,0,9999,0
1748426505246,BGRD 200,063,966226,Golden; James W,9999,0,9999,0
1748426505246,BGRD 200,064,966231,Goldrath; Ananda,9999,0,9999,0
1748426505246,BGRD 200,065,966232,Gonzalez Gamboa; Ivonne,9999,0,9999,0
1748426505246,BGRD 200,066,966233,Goren; Alon M,9999,0,9999,0
1748426505246,BGRD 200,067,966245,Guatelli; John C,9999,0,9999,0
1748426505246,BGRD 200,068,966247,Guma; Monica,9998,0,9999,1
1748426505246,BGRD 200,069,966253,Gustafsson; Asa Birgitta,9999,0,9999,0
1748426505246,BGRD 200,070,966255,Gutkind; Jorge Silvio,9998,0,9999,1
1748426505246,BGRD 200,071,966260,Hamdoun; Amr,9999,0,9999,0
1748426505246,BGRD 200,072,966262,Hampton; Randolph Y.,9998,0,9999,1
1748426505246,BGRD 200,073,966263,Hao; Nan,9999,0,9999,0
1748426505246,BGRD 200,074,966265,Hargreaves; Diana Clare,9997,0,9999,2
1748426505246,BGRD 200,075,966268,Hasty; Jeff M,9999,0,9999,0
1748426505246,BGRD 200,076,966270,Hollern; Daniel Patrick,9999,0,9999,0
1748426505246,BGRD 200,077,966271,Holway; David A.,9998,0,9999,1
1748426505246,BGRD 200,078,966272,Huffaker; Alisa,9999,0,9999,0
1748426505246,BGRD 200,079,966273,Hui; Enfu,9999,0,9999,0
1748426505246,BGRD 200,080,966275,Hwa; Terence T.,9999,0,9999,0
1748426505246,BGRD 200,081,966276,Jackrel; Sara,9998,0,9999,1
1748426505246,BGRD 200,082,966277,Jiang; Qingfei,9998,0,9999,1
1748426505246,BGRD 200,083,966281,Jin; Chunyu,9999,0,9999,0
1748426505246,BGRD 200,084,966283,Jin; Yishi,9999,0,9999,0
1748426505246,BGRD 200,085,966287,Joshi; Shweta,9999,0,9999,0
1748426505246,BGRD 200,086,966290,Ju; Won-Kyu,9998,0,9999,1
1748426505246,BGRD 200,087,966291,Jun; Suckjoon,9999,0,9999,0
1748426505246,BGRD 200,088,966292,Kadonaga; James T,9999,0,9999,0
1748426505246,BGRD 200,089,966293,Kaech; Susan Michelle,9999,0,9999,0
1748426505246,BGRD 200,090,966295,Kauffman; Alexander,9998,0,9999,1
1748426505246,BGRD 200,091,966301,Kendrick; Agnieszka Anasta,9999,0,9999,0
1748426505246,BGRD 200,092,966302,Kiger; Amy,9999,0,9999,0
1748426505246,BGRD 200,093,966314,Knight; Robin,9999,0,9999,0
1748426505246,BGRD 200,094,966315,Koloski; Miranda Jane,9998,0,9999,1
1748426505246,BGRD 200,095,966339,Komiyama; Takaki,9998,0,9999,1
1748426505246,BGRD 200,096,966351,Kosuri; Pallav,9999,0,9999,0
1748426505246,BGRD 200,097,966361,Kronenberg; Mitchell E.,9999,0,9999,0
1748426505246,BGRD 200,098,966374,Kryazhimskiy; Sergey A,9999,0,9999,0
1748426505246,BGRD 200,099,966377,Kufareva; Irina,9999,0,9999,0
1748426505246,BGRD 200,100,966380,Lee; Christopher Tingkuang,9999,0,9999,0
1748426505246,BGRD 200,101,966383,Lee; Kuo Fen,9999,0,9999,0
1748426505246,BGRD 200,102,966387,Lee; Yun Sok,9999,0,9999,0
1748426505246,BGRD 200,103,966397,Leutgeb; Jill K.,9999,0,9999,0
1748426505246,BGRD 200,104,966446,Leutgeb; Stefan,9998,0,9999,1
1748426505246,BGRD 200,105,966478,Lewis; Warren G.,9999,0,9999,0
1748426505246,BGRD 200,106,966490,Li; Willis Xiaowei,9998,0,9999,1
1748426505246,BGRD 200,107,966491,Lim; Byungkook,9998,0,9999,1
1748426505246,BGRD 200,108,966494,Lo; Stanley M.,9998,0,9999,1
1748426505246,BGRD 200,109,966499,Looger; Loren Lee,9998,0,9999,1
1748426505246,BGRD 200,110,966500,Lopez Ramirez; Miguel Alej,9999,0,9999,0
1748426505246,BGRD 200,111,966510,Lovett-Barron; Matthew Rod,9998,0,9999,1
1748426505246,BGRD 200,112,966513,Lu; Li-Fan,9998,0,9999,1
1748426505246,BGRD 200,113,966515,Lu; Pengzhe,9999,0,9999,0
1748426505246,BGRD 200,114,966522,Lykke-Andersen; Jens,9999,0,9999,0
1748426505246,BGRD 200,115,966526,Lyons; Deirdre Colleen,9999,0,9999,0
1748426505246,BGRD 200,116,966528,Lyumkis; Dmitry Evgenievich,9999,0,9999,0
1748426505246,BGRD 200,117,966531,Mandyam; Chitra,9999,0,9999,0
1748426505246,BGRD 200,118,966537,Manor; Uri,9999,0,9999,0
1748426505246,BGRD 200,119,966538,Mayfield; Stephen P.,9998,0,9999,1
1748426505246,BGRD 200,120,966539,McConville; Patrick James,9999,0,9999,0
1748426505246,BGRD 200,121,966546,Mertens; Jerome Stefan,9999,0,9999,0
1748426505246,BGRD 200,122,966586,Meyer; Justin Raymond,9999,0,9999,0
1748426505246,BGRD 200,123,966587,Morris; Gerald P,9999,0,9999,0
1748426505246,BGRD 200,124,966588,Mueller; Lena,9998,0,9999,1
1748426505246,BGRD 200,125,966590,Muroyama; Andrew David,9999,0,9999,0
1748426505246,BGRD 200,126,966591,Murre; Cornelis,9999,0,9999,0
1748426505246,BGRD 200,127,966593,Neal; Sonya E,9998,0,9999,1
1748426505246,BGRD 200,128,966594,Newton; Alexandra C.,9999,0,9999,0
1748426505246,BGRD 200,129,966596,Nieh; James Charles,9999,0,9999,0
1748426505246,BGRD 200,130,966597,Niwa; Maho,9999,0,9999,0
1748426505246,BGRD 200,131,966605,Nizet; Victor F.,9999,0,9999,0
1748426505246,BGRD 200,132,966606,Oegema; Karen,9999,0,9999,0
1748426505246,BGRD 200,133,966608,Panda; Satchidananda,9998,0,9999,1
1748426505246,BGRD 200,134,966610,Pantham; Priyadarshini,9999,0,9999,0
1748426505246,BGRD 200,135,966612,Parast; Mana,9999,0,9999,0
1748426505246,BGRD 200,136,966613,Pasquinelli; Amy,9999,0,9999,0
1748426505246,BGRD 200,137,966615,Pekkurnaz Banghart; Gulcin,9999,0,9999,0
1748426505246,BGRD 200,138,966639,Perry; Michael William,9998,0,9999,1
1748426505246,BGRD 200,139,966640,Pillus; Lorraine,9998,0,9999,1
1748426505246,BGRD 200,140,966654,Pogliano; Joseph,9999,0,9999,0
1748426505246,BGRD 200,141,966700,Pogliano; Kit J.,9999,0,9999,0
1748426505246,BGRD 200,142,966701,Pruneda-Paz; Jose L.,9999,0,9999,0
1748426505246,BGRD 200,143,966744,Raffatellu; Manuela,9999,0,9999,0
1748426505246,BGRD 200,144,966745,Ramanan; Deepshika,9998,0,9999,1
1748426505246,BGRD 200,145,966746,Rana; Tariq,9999,0,9999,0
1748426505246,BGRD 200,146,966747,Rao; Anjana,9999,0,9999,0
1748426505246,BGRD 200,147,966811,Raz; Eyal,9998,0,9999,1
1748426505246,BGRD 200,149,966817,Gaulton; Kyle J,9999,0,9999,0
1748426505246,BGRD 200,150,966824,Rennison; Diana,9999,0,9999,0
1748426505246,BGRD 200,151,966828,Reyes De Barboza; Nabora S,9999,0,9999,0
1748426505246,BGRD 200,152,966837,Rifkin; Scott,9998,0,9999,1
1748426505246,BGRD 200,153,966839,Risbrough; Victoria Blythe,9999,0,9999,0
1748426505246,BGRD 200,154,966846,Rivera; Fabian Chavez,9999,0,9999,0
1748426505246,BGRD 200,155,966851,Rohner; Patrick Thomas,9999,0,9999,0
1748426505246,BGRD 200,156,966859,Rose; Noah Hartmann,9999,0,9999,0
1748426505246,BGRD 200,157,966874,Rosenfeld; Michael G,9999,0,9999,0
1748426505246,BGRD 200,158,966882,Rouse; Gregory W.,9999,0,9999,0
1748426505246,BGRD 200,159,966885,Saier; Milton H.,9999,0,9999,0
1748426505246,BGRD 200,160,966923,Saltiel; Alan,9998,0,9999,1
1748426505246,BGRD 200,161,966926,Sanchez-Lopez; Elsa,9999,0,9999,0
1748426505246,BGRD 200,162,966927,Saphire; Erica Ollmann,9999,0,9999,0
1748426505246,BGRD 200,163,966931,Schenk; Simon,9999,0,9999,0
1748426505246,BGRD 200,164,966938,Schroeder; Julian I,9999,0,9999,0
1748426505246,BGRD 200,165,966966,Sebat; Lilia Mikhailovna,9999,0,9999,0
1748426505246,BGRD 200,166,966978,Sen; George L,9999,0,9999,0
1748426505246,BGRD 200,167,966981,Shah; Sameer B,9999,0,9999,0
1748426505246,BGRD 200,168,966982,Shaner; Nathan C.,9999,0,9999,0
1748426505246,BGRD 200,169,966983,Shao; Jianhua,9999,0,9999,0
1748426505246,BGRD 200,170,966984,Sharpee; Tatyana,9999,0,9999,0
1748426505246,BGRD 200,171,966985,Shaw; Reuben,9999,0,9999,0
1748426505246,BGRD 200,172,966986,Shurin; Jonathan,9997,0,9999,2
1748426505246,BGRD 200,173,966987,Sicklick; Jason Keith,9999,0,9999,0
1748426505246,BGRD 200,174,966988,Signer; Robert,9999,0,9999,0
1748426505246,BGRD 200,175,966989,Sigurdson; Christina,9999,0,9999,0
1748426505246,BGRD 200,176,966991,Simonson; Tatum Sasha Summ,9999,0,9999,0
1748426505246,BGRD 200,177,966992,Soncin; Francesca,9999,0,9999,0
1748426505246,BGRD 200,178,966993,Spitzer; Nicholas,9999,0,9999,0
1748426505246,BGRD 200,179,966994,Steinmetz; Nicole F,9999,0,9999,0
1748426505246,BGRD 200,180,966995,Su; Chih-Ying,9999,0,9999,0
1748426505246,BGRD 200,181,966996,Suel; Gurol Mehmet,9998,0,9999,1
1748426505246,BGRD 200,182,966997,Sun; Xin,9998,0,9999,1
1748426505246,BGRD 200,183,966998,Telese; Francesca,9998,0,9999,1
1748426505246,BGRD 200,184,966999,Towers; Christina Garlingt,9999,0,9999,0
1748426505246,BGRD 200,185,967000,Traver; David,9999,0,9999,0
1748426505246,BGRD 200,186,967001,Troemel; Emily Ruth,9998,0,9999,1
1748426505246,BGRD 200,187,967002,Tye; Kay M,9999,0,9999,0
1748426505246,BGRD 200,188,967003,Vijayanand; Pandurangan,9999,0,9999,0
1748426505246,BGRD 200,189,967004,Villa Rodriguez; Elizabeth,9999,0,9999,0
1748426505246,BGRD 200,190,967005,Wahlin; Karl Jonas,9997,0,9999,2
1748426505246,BGRD 200,191,967009,Wang; Shizhen,9999,0,9999,0
1748426505246,BGRD 200,192,967010,Wang; Jean Yin Jen,9999,0,9999,0
1748426505246,BGRD 200,193,967011,Webster; Nicholas J G,9999,0,9999,0
1748426505246,BGRD 200,194,967016,Weiskopf; Daniela,9998,0,9999,1
1748426505246,BGRD 200,195,967020,Welsbie; Derek,9999,0,9999,0
1748426505246,BGRD 200,196,967022,Wildonger; Jill Cathleen,9998,0,9999,1
1748426505246,BGRD 200,197,967027,Winzeler; Elizabeth A,9998,0,9999,1
1748426505246,BGRD 200,198,967029,Wodarz; Dominik Franz Xave,9999,0,9999,0
1748426505246,BGRD 200,199,967033,Yelon; Deborah,9998,0,9999,1
1748426505246,BGRD 200,200,967034,Yeo; Eugene Wei-Ming,9998,0,9999,1
1748426505246,BGRD 200,201,967040,Ying; Wei,9998,0,9999,1
1748426505246,BGRD 200,202,967052,Young; Jared W.,9999,0,9999,0
1748426505246,BGRD 200,203,967057,Zage; Peter,9999,0,9999,0
1748426505246,BGRD 200,204,967070,Zengler; Karsten B,9998,0,9999,1
1748426505246,BGRD 200,206,967081,Zhang; Jin,9999,0,9999,0
1748426505246,BGRD 200,207,967083,Zhao; Yunde,9999,0,9999,0
1748426505246,BGRD 200,208,967086,Zheng; Binhai,9999,0,9999,0
1748426505246,BGRD 200,209,967091,Zheng; Ye,9999,0,9999,0
1748426505246,BGRD 200,210,967093,Zhou; Huilin,9999,0,9999,0
1748426505246,BGRD 200,211,967095,Zou; Yimin,9998,0,9999,1
1748426505246,BGRD 200,212,967096,Zuniga; Elina I,9999,0,9999,0
1748426505246,BGRD 200,213,967978,Biering; Scott,9999,0,9999,0
1748426506274,BGSE 200,A00,943418,Tour; Ella & Petrie; Katherine Lynn,9999,0,9999,0
1748426507302,BGSE 205,A00,943419,Muroyama; Andrew David,46,0,50,4
1748426507302,BGSE 205,C00,943420,Russell; Alistair B,44,0,50,6
1748426507302,BGSE 205,D00,943421,Villa Rodriguez; Elizabeth,41,0,50,9
1748426507302,BGSE 205,E00,960271,Lim; Byungkook,45,0,50,5
1748426508337,BIBC 100,A01,959758,Flagg; Matthew Paul,0,0,38,38
1748426508337,BIBC 100,A02,959759,Flagg; Matthew Paul,0,0,38,38
1748426508337,BIBC 100,A03,959760,Flagg; Matthew Paul,0,0,38,38
1748426508337,BIBC 100,A04,959761,Flagg; Matthew Paul,0,0,36,36
1748426509379,BIBC 102,A01,959209,Pekkurnaz Banghart; Gulcin,0,0,34,34
1748426509379,BIBC 102,A02,959258,Pekkurnaz Banghart; Gulcin,0,0,34,34
1748426509379,BIBC 102,A03,959300,Pekkurnaz Banghart; Gulcin,0,0,35,35
1748426509379,BIBC 102,A04,959302,Pekkurnaz Banghart; Gulcin,0,0,34,34
1748426509379,BIBC 102,B01,959307,Pekkurnaz Banghart; Gulcin,0,0,34,34
1748426509379,BIBC 102,B02,959309,Pekkurnaz Banghart; Gulcin,0,0,34,34
1748426509379,BIBC 102,B03,959310,Pekkurnaz Banghart; Gulcin,0,0,33,33
1748426509379,BIBC 102,B04,959311,Pekkurnaz Banghart; Gulcin,0,0,34,34
1748426510416,BIBC 103,A01,942080,Grossman; Emily N,0,0,24,24
1748426510416,BIBC 103,A02,942081,Grossman; Emily N,0,0,24,24
1748426510416,BIBC 103,B01,942083,Grossman; Emily N,0,0,24,24
1748426510416,BIBC 103,B02,942129,Grossman; Emily N,0,0,24,24
1748426510416,BIBC 103,C01,942131,Burg; Michael,0,0,24,24
1748426510416,BIBC 103,C02,942152,Burg; Michael,0,0,24,24
1748426510416,BIBC 103,D01,942169,Burg; Michael,0,0,24,24
1748426510416,BIBC 103,D02,942170,Burg; Michael,0,0,24,24
1748426511446,BICD 100,A01,959831,Day; Christopher D,53,0,61,8
1748426511446,BICD 100,A02,959832,Day; Christopher D,49,0,61,12
1748426511446,BICD 100,A03,959833,Day; Christopher D,43,0,61,18
1748426511446,BICD 100,A04,959834,Day; Christopher D,57,0,61,4
1748426511446,BICD 100,B01,959749,McDonnell; Lisa Marie,0,0,61,61
1748426511446,BICD 100,B02,959750,McDonnell; Lisa Marie,0,0,61,61
1748426511446,BICD 100,B03,959751,McDonnell; Lisa Marie,0,0,61,61
1748426511446,BICD 100,B04,959752,McDonnell; Lisa Marie,37,0,61,24
1748426511446,BICD 100,C01,959835,Yelon; Deborah,0,0,61,61
1748426511446,BICD 100,C02,959836,Yelon; Deborah,54,0,61,7
1748426511446,BICD 100,C03,959837,Yelon; Deborah,61,0,61,0
1748426511446,BICD 100,C04,959838,Yelon; Deborah,57,0,61,4
1748426512477,BICD 110,A01,959312,Kiger; Amy,59,0,123,64
1748426512477,BICD 110,A02,959315,Kiger; Amy,94,0,122,28
1748426513504,BICD 130,A01,942207,Perry; Michael William,0,0,48,48
1748426513504,BICD 130,A02,942208,Perry; Michael William,37,0,48,11
1748426513504,BICD 130,A03,942209,Perry; Michael William,29,0,48,19
1748426513504,BICD 130,A04,942236,Perry; Michael William,19,0,48,29
1748426514537,BICD 140,A01,942372,Zuniga; Elina I,42,0,49,7
1748426514537,BICD 140,A02,942492,Zuniga; Elina I,45,0,49,4
1748426514537,BICD 140,A03,942493,Zuniga; Elina I,48,0,49,1
1748426514537,BICD 140,A04,942494,Zuniga; Elina I,46,0,49,3
1748426515564,BIEB 102,A01,942496,Butler; Shannon Rhey,182,0,248,66
1748426516594,BIEB 121,A00,942497,Holway; David A.,0,0,32,32
1748426516594,BIEB 121,B00,942498,Butler; Shannon Rhey,0,0,32,32
1748426517627,BIEB 141,A01,942500,Kryazhimskiy; Sergey A,23,0,40,17
1748426518659,BIEB 146,A01,942502,Petrie; Katherine Lynn,41,0,89,48
1748426518659,BIEB 146,A02,942503,Petrie; Katherine Lynn,0,0,88,88
1748426518659,BIEB 146,A03,942504,Petrie; Katherine Lynn,2,0,88,86
1748426518659,BIEB 146,A04,942505,Petrie; Katherine Lynn,21,0,89,68
1748426519686,BIEB 150,A01,942507,Rennison; Diana,28,0,41,13
1748426519686,BIEB 150,A02,942508,Rennison; Diana,32,0,41,9
1748426519686,BIEB 150,A03,942509,Rennison; Diana,36,0,41,5
1748426519686,BIEB 150,A04,942510,Rennison; Diana,6,0,40,34
1748426520715,BIEB 174,A01,942512,Cleland; Elsa Eleanor & Barton; Andrew David,9,0,41,32
1748426520715,BIEB 174,A02,942513,Cleland; Elsa Eleanor & Barton; Andrew David,37,0,41,4
1748426520715,BIEB 174,A03,942514,Cleland; Elsa Eleanor & Barton; Andrew David,35,0,41,6
1748426520715,BIEB 174,A04,942515,Cleland; Elsa Eleanor & Barton; Andrew David,30,0,40,10
1748426521760,BILD 1,A01,959729,Ochoa Mikrut; Stacy Daniel,50,0,60,10
1748426521760,BILD 1,A02,959730,Ochoa Mikrut; Stacy Daniel,47,0,59,12
1748426521760,BILD 1,A03,959731,Ochoa Mikrut; Stacy Daniel,48,0,59,11
1748426521760,BILD 1,A04,959732,Ochoa Mikrut; Stacy Daniel,50,0,59,9
1748426521760,BILD 1,B01,959733,Cooper; Andrew Michael,46,0,60,14
1748426521760,BILD 1,B02,959734,Cooper; Andrew Michael,58,0,59,1
1748426521760,BILD 1,B03,959735,Cooper; Andrew Michael,54,0,59,5
1748426521760,BILD 1,B04,959736,Cooper; Andrew Michael,50,0,59,9
1748426521760,BILD 1,C01,959737,Rusert; Jessica Marie,58,0,60,2
1748426521760,BILD 1,C02,959738,Rusert; Jessica Marie,59,0,59,0
1748426521760,BILD 1,C03,959739,Rusert; Jessica Marie,49,0,59,10
1748426521760,BILD 1,C04,959740,Rusert; Jessica Marie,55,0,59,4
1748426522791,BILD 2,A01,959013,Reyes Gonzalez; Catalina,28,0,57,29
1748426522791,BILD 2,A02,959016,Reyes Gonzalez; Catalina,51,0,57,6
1748426522791,BILD 2,A03,959017,Reyes Gonzalez; Catalina,46,0,56,10
1748426522791,BILD 2,A04,959018,Reyes Gonzalez; Catalina,51,0,55,4
1748426522791,BILD 2,B01,959078,Reyes Gonzalez; Catalina,42,0,57,15
1748426522791,BILD 2,B02,959095,Reyes Gonzalez; Catalina,50,0,57,7
1748426522791,BILD 2,B03,959165,Reyes Gonzalez; Catalina,55,0,56,1
1748426522791,BILD 2,B04,959169,Reyes Gonzalez; Catalina,54,0,55,1
1748426523833,BILD 3,A01,959741,Stockwell; Sarah R,56,0,60,4
1748426523833,BILD 3,A02,959742,Stockwell; Sarah R,57,0,59,2
1748426523833,BILD 3,A03,959743,Stockwell; Sarah R,59,0,59,0
1748426523833,BILD 3,A04,959744,Stockwell; Sarah R,55,0,59,4
1748426523833,BILD 3,B01,959745,Stockwell; Sarah R,55,0,60,5
1748426523833,BILD 3,B02,959746,Stockwell; Sarah R,59,0,59,0
1748426523833,BILD 3,B03,959747,Stockwell; Sarah R,56,0,59,3
1748426523833,BILD 3,B04,959748,Stockwell; Sarah R,58,0,59,1
1748426523833,BILD 3,C01,959823,Hammond; LaTisha Marie,47,0,60,13
1748426523833,BILD 3,C02,959824,Hammond; LaTisha Marie,48,0,59,11
1748426523833,BILD 3,C03,959825,Hammond; LaTisha Marie,56,0,59,3
1748426523833,BILD 3,C04,959826,Hammond; LaTisha Marie,58,0,59,1
1748426523833,BILD 3,D01,959827,Hammond; LaTisha Marie,43,0,60,17
1748426523833,BILD 3,D02,959828,Hammond; LaTisha Marie,49,0,59,10
1748426523833,BILD 3,D03,959829,Hammond; LaTisha Marie,52,0,59,7
1748426523833,BILD 3,D04,959830,Hammond; LaTisha Marie,56,0,59,3
1748426524888,BILD 4,A01,940749,Gonzalez Gamboa; Ivonne,0,0,0,0
1748426524888,BILD 4,A02,940750,Gonzalez Gamboa; Ivonne,0,0,0,0
1748426524888,BILD 4,A03,940909,Gonzalez Gamboa; Ivonne,0,0,0,0
1748426524888,BILD 4,A04,940922,Gonzalez Gamboa; Ivonne,0,0,0,0
1748426524888,BILD 4,A05,940925,Gonzalez Gamboa; Ivonne,0,0,0,0
1748426524888,BILD 4,A06,941008,Gonzalez Gamboa; Ivonne,0,0,0,0
1748426524888,BILD 4,A07,941009,Gonzalez Gamboa; Ivonne,0,0,0,0
1748426524888,BILD 4,A08,941114,Gonzalez Gamboa; Ivonne,0,0,0,0
1748426524888,BILD 4,B01,941116,Reuther; Keefe,0,0,0,0
1748426524888,BILD 4,B02,941119,Reuther; Keefe,0,0,0,0
1748426524888,BILD 4,B03,941120,Reuther; Keefe,0,0,0,0
1748426524888,BILD 4,B04,941143,Reuther; Keefe,0,0,0,0
1748426524888,BILD 4,B05,941182,Reuther; Keefe,0,0,0,0
1748426524888,BILD 4,B06,941183,Reuther; Keefe,0,0,0,0
1748426524888,BILD 4,B07,941184,Reuther; Keefe,0,0,0,0
1748426524888,BILD 4,B08,941202,Reuther; Keefe,0,0,0,0
1748426524888,BILD 4,C01,941209,Lo; Stanley M.,0,0,0,0
1748426524888,BILD 4,C02,941226,Lo; Stanley M.,0,0,0,0
1748426524888,BILD 4,C03,941228,Lo; Stanley M.,0,0,0,0
1748426524888,BILD 4,C04,941284,Lo; Stanley M.,0,0,0,0
1748426524888,BILD 4,C05,941394,Lo; Stanley M.,0,0,0,0
1748426524888,BILD 4,C06,941473,Lo; Stanley M.,0,0,0,0
1748426524888,BILD 4,C07,941905,Lo; Stanley M.,0,0,0,0
1748426524888,BILD 4,C08,941906,Lo; Stanley M.,0,0,0,0
1748426524888,BILD 4,D01,941908,Lo; Stanley M.,0,0,0,0
1748426524888,BILD 4,D02,941925,Lo; Stanley M.,0,0,0,0
1748426524888,BILD 4,D03,941926,Lo; Stanley M.,0,0,0,0
1748426524888,BILD 4,D04,941927,Lo; Stanley M.,0,0,0,0
1748426524888,BILD 4,D05,941928,Lo; Stanley M.,0,0,0,0
1748426524888,BILD 4,D06,941943,Lo; Stanley M.,0,0,0,0
1748426524888,BILD 4,D07,941944,Lo; Stanley M.,0,0,0,0
1748426524888,BILD 4,D08,941973,Lo; Stanley M.,0,0,0,0
1748426525914,BILD 5,A01,959177,Mueller; Liam O'Connor,0,0,0,0
1748426525914,BILD 5,A02,959178,Mueller; Liam O'Connor,0,0,0,0
1748426525914,BILD 5,A03,959179,Mueller; Liam O'Connor,0,0,0,0
1748426525914,BILD 5,A04,959181,Mueller; Liam O'Connor,0,0,0,0
1748426525914,BILD 5,B01,959183,Mueller; Liam O'Connor,0,0,0,0
1748426525914,BILD 5,B02,959184,Mueller; Liam O'Connor,0,0,0,0
1748426525914,BILD 5,B03,959188,Mueller; Liam O'Connor,0,0,0,0
1748426525914,BILD 5,B04,959189,Mueller; Liam O'Connor,0,0,0,0
1748426525914,BILD 5,C01,959190,Reuther; Keefe,0,0,0,0
1748426525914,BILD 5,C02,959191,Reuther; Keefe,0,0,0,0
1748426525914,BILD 5,C03,959196,Reuther; Keefe,0,0,0,0
1748426525914,BILD 5,C04,959199,Reuther; Keefe,0,0,0,0
1748426526943,BILD 10,A01,942020,Ochoa Mikrut; Stacy Daniel,40,0,40,0
1748426526943,BILD 10,A02,942033,Ochoa Mikrut; Stacy Daniel,35,0,39,4
1748426526943,BILD 10,A03,942045,Ochoa Mikrut; Stacy Daniel,32,0,39,7
1748426526943,BILD 10,A04,942046,Ochoa Mikrut; Stacy Daniel,30,0,39,9
1748426527970,BILD 87,A00,942047,Saier; Milton H.,20,0,20,0
1748426527970,BILD 87,B00,942060,Saier; Milton H.,20,0,20,0
1748426529000,BIMM 100,A01,959797,Lykke-Andersen; Jens,37,0,50,13
1748426529000,BIMM 100,A02,959798,Lykke-Andersen; Jens,5,0,50,45
1748426529000,BIMM 100,A03,959799,Lykke-Andersen; Jens,0,0,50,50
1748426529000,BIMM 100,A04,959800,Lykke-Andersen; Jens,3,0,50,47
1748426529000,BIMM 100,B01,959807,Pruneda-Paz; Jose L.,1,0,50,49
1748426529000,BIMM 100,B02,959808,Pruneda-Paz; Jose L.,0,0,50,50
1748426529000,BIMM 100,B03,959809,Pruneda-Paz; Jose L.,7,0,50,43
1748426529000,BIMM 100,B04,959810,Pruneda-Paz; Jose L.,37,0,50,13
1748426529000,BIMM 100,C01,959762,Pasquinelli; Amy,0,0,54,54
1748426529000,BIMM 100,C02,959763,Pasquinelli; Amy,20,0,54,34
1748426529000,BIMM 100,C03,959764,Pasquinelli; Amy,32,0,54,22
1748426529000,BIMM 100,C04,959765,Pasquinelli; Amy,47,0,54,7
1748426530084,BIMM 101,A01,942520,Meaders; Clara Leigh,0,0,24,24
1748426530084,BIMM 101,A02,942521,Meaders; Clara Leigh,0,0,24,24
1748426530084,BIMM 101,B01,942523,Meaders; Clara Leigh,0,0,24,24
1748426530084,BIMM 101,B02,942524,Meaders; Clara Leigh,0,0,24,24
1748426530084,BIMM 101,C01,942690,McDonnell; Lisa Marie,0,0,24,24
1748426530084,BIMM 101,C02,942755,McDonnell; Lisa Marie,0,0,24,24
1748426530084,BIMM 101,D01,942757,Day; Christopher D,0,0,24,24
1748426530084,BIMM 101,D02,942758,Day; Christopher D,12,0,24,12
1748426530084,BIMM 101,E01,942760,Cooper; Andrew Michael,0,0,24,24
1748426530084,BIMM 101,E02,942761,Cooper; Andrew Michael,0,0,24,24
1748426530084,BIMM 101,F01,942763,Rusert; Jessica Marie,14,0,24,10
1748426530084,BIMM 101,F02,942764,Rusert; Jessica Marie,19,0,24,5
1748426531112,BIMM 120,A01,942766,Saier; Milton H.,40,0,48,8
1748426531112,BIMM 120,A02,942767,Saier; Milton H.,40,0,48,8
1748426531112,BIMM 120,A03,942768,Saier; Milton H.,15,0,48,33
1748426531112,BIMM 120,A04,942769,Saier; Milton H.,0,0,48,48
1748426532148,BIMM 121,A01,942771,Gustafson-Brown; Cindy,0,0,24,24
1748426532148,BIMM 121,A02,942772,Gustafson-Brown; Cindy,0,0,24,24
1748426532148,BIMM 121,B01,942774,Gustafson-Brown; Cindy,0,0,24,24
1748426532148,BIMM 121,B02,942775,Gustafson-Brown; Cindy,5,0,24,19
1748426532148,BIMM 121,C01,942777,Pirino; Giorgia,0,0,24,24
1748426532148,BIMM 121,C02,942778,Pirino; Giorgia,0,0,24,24
1748426532148,BIMM 121,D01,942780,Pirino; Giorgia,0,0,24,24
1748426532148,BIMM 121,D02,942781,Pirino; Giorgia,0,0,24,24
1748426533177,BIMM 122,A01,942783,Russell; Alistair B,19,0,44,25
1748426533177,BIMM 122,A02,942784,Russell; Alistair B,29,0,44,15
1748426533177,BIMM 122,A03,942785,Russell; Alistair B,35,0,44,9
1748426533177,BIMM 122,A04,942786,Russell; Alistair B,30,0,44,14
1748426534204,BIMM 128,A01,942788,Hao; Nan,0,0,30,30
1748426534204,BIMM 128,A02,942789,Hao; Nan,0,0,31,31
1748426534204,BIMM 128,A03,942790,Hao; Nan,0,0,31,31
1748426534204,BIMM 128,A04,942791,Hao; Nan,0,0,31,31
1748426535234,BIMM 143,A01,942793,Grant; Barry J,13,0,40,27
1748426535234,BIMM 143,B01,942795,Bozinovic; Goran,21,0,40,19
1748426536261,BIMM 143R,A01,942797,Bozinovic; Goran,0,0,40,40
1748426537289,BIMM 194,A00,942798,Golden; Susan S.,5,0,32,27
1748426537289,BIMM 194,B00,942799,Golden; James W,21,0,32,11
1748426537289,BIMM 194,C00,942800,Karlseder; Jan & Saghatelian; Alan,0,0,32,32
1748426538320,BIOM 200A,A00,911746,Gordts; Philip,30,0,30,0
1748426539350,BIOM 200B,A00,911747,Gordts; Philip,35,0,35,0
1748426540379,BIOM 201,A00,911749,Daneman; Richard,35,0,35,0
1748426541410,BIOM 202,A01,911753,Corbett; Kevin Daniel,35,0,35,0
1748426542437,BIOM 203A,A00,911755,Corbett; Kevin Daniel,35,0,35,0
1748426543462,BIOM 218,A00,911756,Gagneux; Pascal,11,0,12,1
1748426544494,BIOM 219,A00,911757,Ross; Camille,20,0,20,0
1748426545524,BIOM 242,A00,911758,Hamilton; Bruce Alan,19,0,20,1
1748426546550,BIOM 293,A00,911759,Gustafsson; Asa Birgitta,35,0,35,0
1748426547581,BIOM 295,A00,911760,Joiner; William J.,0,0,0,0
1748426548611,BIOM 296,A00,911761,Yaksh; Tony L.,35,0,35,0
1748426549652,BIPN 100,A01,959801,Leutgeb; Stefan,0,0,36,36
1748426549652,BIPN 100,A02,959802,Leutgeb; Stefan,0,0,36,36
1748426549652,BIPN 100,A03,959803,Leutgeb; Stefan,3,0,36,33
1748426549652,BIPN 100,A04,959804,Leutgeb; Stefan,0,0,36,36
1748426549652,BIPN 100,B01,959766,Cooke; James Edward,33,0,41,8
1748426549652,BIPN 100,B02,959767,Cooke; James Edward,39,0,41,2
1748426549652,BIPN 100,B03,959768,Cooke; James Edward,37,0,40,3
1748426549652,BIPN 100,B04,959769,Cooke; James Edward,37,0,40,3
1748426549652,BIPN 100,C01,959770,Cooke; James Edward,35,0,41,6
1748426549652,BIPN 100,C02,959771,Cooke; James Edward,40,0,41,1
1748426549652,BIPN 100,C03,959772,Cooke; James Edward,37,0,40,3
1748426549652,BIPN 100,C04,959773,Cooke; James Edward,38,0,40,2
1748426549652,BIPN 100,D01,959811,Yang; Mingyu,0,0,41,41
1748426549652,BIPN 100,D02,959812,Yang; Mingyu,0,0,41,41
1748426549652,BIPN 100,D03,959813,Yang; Mingyu,0,0,40,40
1748426549652,BIPN 100,D04,959814,Yang; Mingyu,0,0,40,40
1748426550679,BIPN 103,A01,942981,Yang; Mingyu,0,0,48,48
1748426551714,BIPN 105,A01,942983,Armour; Jon Christopher,0,0,21,21
1748426551714,BIPN 105,A02,942984,Armour; Jon Christopher,0,0,21,21
1748426551714,BIPN 105,B01,942989,Armour; Jon Christopher,0,0,21,21
1748426551714,BIPN 105,B02,942990,Armour; Jon Christopher,0,0,21,21
1748426552743,BIPN 118,A01,960886,Banghart; Matthew Ryan,23,0,30,7
1748426552743,BIPN 118,A02,960889,Banghart; Matthew Ryan,24,0,30,6
1748426552743,BIPN 118,A03,960891,Banghart; Matthew Ryan,23,0,30,7
1748426552743,BIPN 118,A04,960892,Banghart; Matthew Ryan,27,0,30,3
1748426553780,BIPN 140,A01,942992,Owens; Melinda Tsao-Ying,8,0,32,24
1748426553780,BIPN 140,A02,942994,Owens; Melinda Tsao-Ying,0,0,32,32
1748426553780,BIPN 140,A03,942995,Owens; Melinda Tsao-Ying,1,0,32,31
1748426553780,BIPN 140,A04,942996,Owens; Melinda Tsao-Ying,9,0,30,21
1748426553780,BIPN 140,B01,942998,Owens; Melinda Tsao-Ying,4,0,32,28
1748426553780,BIPN 140,B02,942999,Owens; Melinda Tsao-Ying,3,0,32,29
1748426553780,BIPN 140,B03,943000,Owens; Melinda Tsao-Ying,18,0,32,14
1748426553780,BIPN 140,B04,943001,Owens; Melinda Tsao-Ying,23,0,30,7
1748426554816,BIPN 145,A01,943083,Maita; Isabella Vincenza,0,0,42,42
1748426554816,BIPN 145,B01,943085,Marino; Marc J,13,0,42,29
1748426554816,BIPN 145,C01,943108,Marino; Marc J,0,0,42,42
1748426555843,BIPN 148,A01,943119,Leutgeb; Jill K.,15,0,39,24
1748426555843,BIPN 148,A02,943120,Leutgeb; Jill K.,16,0,39,23
1748426555843,BIPN 148,A03,943121,Leutgeb; Jill K.,33,0,39,6
1748426555843,BIPN 148,A04,943201,Leutgeb; Jill K.,27,0,39,12
1748426556877,BIPN 189,A00,943247,Gentner; Tim,0,0,25,25
1748426557910,BISP 182,A00,943255,Pogliano; Joseph,9999,0,9999,0
1748426558936,BISP 194,A00,943261,Wertheim; Joel Okrent,0,0,32,32
1748426559969,BNFO 281,A00,961454,Gaasterland; Theresa,13,0,40,27
1748426560995,BNFO 283,A00,961457,Benner; Christopher William,69,0,100,31
1748426562022,BNFO 294,A01,961499,Ross; Camille,39,0,50,11
1748426563060,CAT 1,A01,915666,Bronstein; Phoebe Malan,13,0,16,3
1748426563060,CAT 1,A02,915673,Bronstein; Phoebe Malan,15,0,16,1
1748426563060,CAT 1,A03,915727,Bronstein; Phoebe Malan,16,0,16,0
1748426563060,CAT 1,A04,915728,Bronstein; Phoebe Malan,16,0,16,0
1748426563060,CAT 1,A05,915729,Bronstein; Phoebe Malan,16,0,16,0
1748426563060,CAT 1,A06,915730,Bronstein; Phoebe Malan,13,0,16,3
1748426563060,CAT 1,A07,915731,Bronstein; Phoebe Malan,16,0,16,0
1748426563060,CAT 1,A08,915732,Bronstein; Phoebe Malan,16,0,16,0
1748426563060,CAT 1,A09,915733,Bronstein; Phoebe Malan,14,0,16,2
1748426563060,CAT 1,A10,915734,Bronstein; Phoebe Malan,16,0,16,0
1748426563060,CAT 1,A11,915751,Bronstein; Phoebe Malan,16,0,16,0
1748426563060,CAT 1,A12,915752,Bronstein; Phoebe Malan,15,0,16,1
1748426563060,CAT 1,A13,915753,Bronstein; Phoebe Malan,15,0,16,1
1748426563060,CAT 1,A14,915754,Bronstein; Phoebe Malan,16,0,16,0
1748426563060,CAT 1,A15,915755,Bronstein; Phoebe Malan,16,0,16,0
1748426563060,CAT 1,A16,915756,Bronstein; Phoebe Malan,16,0,16,0
1748426563060,CAT 1,B01,915763,Bronstein; Phoebe Malan,15,0,16,1
1748426563060,CAT 1,B02,915764,Bronstein; Phoebe Malan,15,0,16,1
1748426563060,CAT 1,B03,915765,Bronstein; Phoebe Malan,14,0,16,2
1748426563060,CAT 1,B04,915766,Bronstein; Phoebe Malan,16,0,16,0
1748426563060,CAT 1,B05,915767,Bronstein; Phoebe Malan,12,0,16,4
1748426563060,CAT 1,B06,915768,Bronstein; Phoebe Malan,16,0,16,0
1748426563060,CAT 1,B07,915769,Bronstein; Phoebe Malan,16,0,16,0
1748426563060,CAT 1,B08,915770,Bronstein; Phoebe Malan,16,0,16,0
1748426563060,CAT 1,B09,915771,Bronstein; Phoebe Malan,16,0,16,0
1748426563060,CAT 1,B10,915772,Bronstein; Phoebe Malan,16,0,16,0
1748426563060,CAT 1,B11,915773,Bronstein; Phoebe Malan,16,0,16,0
1748426563060,CAT 1,B12,915774,Bronstein; Phoebe Malan,15,0,16,1
1748426563060,CAT 1,B13,915775,Bronstein; Phoebe Malan,16,0,16,0
1748426563060,CAT 1,B14,915776,Bronstein; Phoebe Malan,15,0,16,1
1748426563060,CAT 1,B15,915777,Bronstein; Phoebe Malan,14,0,16,2
1748426563060,CAT 1,B16,915778,Bronstein; Phoebe Malan,16,0,16,0
1748426563060,CAT 1,C01,915780,Algaze; Guillermo,11,0,16,5
1748426563060,CAT 1,C02,915781,Algaze; Guillermo,16,0,16,0
1748426563060,CAT 1,C03,915782,Algaze; Guillermo,15,0,16,1
1748426563060,CAT 1,C04,915783,Algaze; Guillermo,16,0,16,0
1748426563060,CAT 1,C05,915784,Algaze; Guillermo,16,0,16,0
1748426563060,CAT 1,C06,915785,Algaze; Guillermo,16,0,16,0
1748426563060,CAT 1,C07,915786,Algaze; Guillermo,16,0,16,0
1748426563060,CAT 1,C08,915787,Algaze; Guillermo,15,0,16,1
1748426563060,CAT 1,C09,915788,Algaze; Guillermo,16,0,16,0
1748426563060,CAT 1,C10,915790,Algaze; Guillermo,16,0,16,0
1748426563060,CAT 1,C11,915791,Algaze; Guillermo,16,0,16,0
1748426563060,CAT 1,C12,915792,Algaze; Guillermo,16,0,16,0
1748426563060,CAT 1,C13,915793,Algaze; Guillermo,16,0,16,0
1748426563060,CAT 1,C14,915794,Algaze; Guillermo,16,0,16,0
1748426563060,CAT 1,D01,915796,Marchisotto; Jennifer Anne,16,0,16,0
1748426563060,CAT 1,D02,915797,Marchisotto; Jennifer Anne,15,0,16,1
1748426563060,CAT 1,D03,915798,Marchisotto; Jennifer Anne,16,0,16,0
1748426563060,CAT 1,D04,915799,Marchisotto; Jennifer Anne,12,0,16,4
1748426563060,CAT 1,D05,915800,Marchisotto; Jennifer Anne,16,0,16,0
1748426563060,CAT 1,D06,915801,Marchisotto; Jennifer Anne,16,0,16,0
1748426563060,CAT 1,D07,915802,Marchisotto; Jennifer Anne,15,0,16,1
1748426563060,CAT 1,D08,915803,Marchisotto; Jennifer Anne,16,0,16,0
1748426563060,CAT 1,D09,915804,Marchisotto; Jennifer Anne,16,0,16,0
1748426563060,CAT 1,D10,915805,Marchisotto; Jennifer Anne,16,0,16,0
1748426563060,CAT 1,D11,915806,Marchisotto; Jennifer Anne,15,0,16,1
1748426563060,CAT 1,D12,915807,Marchisotto; Jennifer Anne,16,0,16,0
1748426563060,CAT 1,D13,915808,Marchisotto; Jennifer Anne,15,0,16,1
1748426563060,CAT 1,D14,915809,Marchisotto; Jennifer Anne,15,0,16,1
1748426564092,CAT 88,A00,969796,Popko; Elizabeth Ashley,0,0,0,0
1748426565121,CAT 90,A00,915812,Geibel; William,7,0,15,8
1748426566155,CAT 124,A01,915814,Rose; Becca Rae,0,0,20,20
1748426566155,CAT 124,B01,961453,Geibel; William,14,0,20,6
1748426567185,CAT 125,001,915815,Delaville; Romain,18,0,20,2
1748426567185,CAT 125,003,915817,Bigham; David Joseph,12,0,20,8
1748426567185,CAT 125,004,915818,Bigham; David Joseph,3,0,20,17
1748426567185,CAT 125,005,915819,Marchisotto; Jennifer Anne,11,0,20,9
1748426567185,CAT 125,006,915820,Marchisotto; Jennifer Anne,0,0,20,20
1748426567185,CAT 125,007,915821,Morales; Celeste Georgianna,12,0,20,8
1748426567185,CAT 125,008,915822,Morales; Celeste Georgianna,15,0,20,5
1748426567185,CAT 125,009,915823,Morales; Celeste Georgianna,18,0,20,2
1748426567185,CAT 125,010,915824,Irwin; Matthew Joseph,18,0,20,2
1748426567185,CAT 125,011,915825,Irwin; Matthew Joseph,15,0,20,5
1748426567185,CAT 125,012,915826,Irwin; Matthew Joseph,15,0,20,5
1748426567185,CAT 125,013,915827,Vanderschuit; Maya Alysia,16,0,20,4
1748426567185,CAT 125,014,915828,Vanderschuit; Maya Alysia,18,0,20,2
1748426567185,CAT 125,015,915829,Vanderschuit; Maya Alysia,15,0,20,5
1748426567185,CAT 125,016,915830,Rose; Becca Rae,5,0,20,15
1748426567185,CAT 125,017,915831,Rose; Becca Rae,4,0,20,16
1748426567185,CAT 125,018,915832,Hyland; Tina Mae,13,0,20,7
1748426567185,CAT 125,019,915833,Hyland; Tina Mae,17,0,20,3
1748426568217,CAT 125R,A00,915834,Hyland; Tina Mae,0,0,20,20
1748426568217,CAT 125R,B00,915835,Hyland; Tina Mae,0,0,20,20
1748426568217,CAT 125R,C00,915836,Hyland; Tina Mae,0,0,20,20
1748426568217,CAT 125R,D00,915837,Tosun; Adriana,0,0,20,20
1748426568217,CAT 125R,E00,915838,Smith; Lauryn Alissa,0,0,20,20
1748426568217,CAT 125R,F00,915839,Smith; Lauryn Alissa,0,0,20,20
1748426568217,CAT 125R,G00,915840,Smith; Lauryn Alissa,0,0,20,20
1748426569251,CAT 200,A00,915841,Popko; Elizabeth Ashley,17,0,20,3
1748426570278,CCE 1,A00,915063,Bigley; Michele Heather,30,0,40,10
1748426570278,CCE 1,B00,915064,Bigley; Michele Heather,36,0,40,4
1748426571313,CCE 2,001,915067,Santos; Vabianna Daria,0,0,20,20
1748426571313,CCE 2,002,915068,Santos; Vabianna Daria,0,0,20,20
1748426571313,CCE 2,003,915069,Santos; Vabianna Daria,18,0,20,2
1748426571313,CCE 2,004,915070,Staff,17,0,20,3
1748426571313,CCE 2,005,915071,Staff,15,0,20,5
1748426571313,CCE 2,006,915072,Staff,8,0,20,12
1748426571313,CCE 2,007,915073,Staff,10,0,20,10
1748426571313,CCE 2,008,915074,Staff,0,0,20,20
1748426571313,CCE 2,009,915090,Staff,5,0,20,15
1748426571313,CCE 2,010,915104,Merryman; Ashley,0,0,20,20
1748426571313,CCE 2,011,915114,Merryman; Ashley,0,0,20,20
1748426571313,CCE 2,012,915136,Merryman; Ashley,0,0,20,20
1748426571313,CCE 2,013,915176,Staff,13,0,20,7
1748426571313,CCE 2,014,915177,Staff,20,0,20,0
1748426571313,CCE 2,015,915178,Staff,17,0,20,3
1748426571313,CCE 2,016,915179,Staff,15,0,20,5
1748426572351,CCE 3,001,915194,Labat Ii; Michael Luis,13,0,20,7
1748426572351,CCE 3,002,915195,Labat Ii; Michael Luis,17,0,20,3
1748426572351,CCE 3,003,915196,Labat Ii; Michael Luis,17,0,20,3
1748426572351,CCE 3,004,915197,Lee; Kassandra,16,0,20,4
1748426572351,CCE 3,005,915198,Lee; Kassandra,6,0,20,14
1748426572351,CCE 3,006,915199,Lee; Kassandra,10,0,20,10
1748426572351,CCE 3,007,915200,Garcia; Kathryn Mary,0,0,20,20
1748426572351,CCE 3,008,915201,Garcia; Kathryn Mary,2,0,20,18
1748426573395,CCE 120,A01,915203,Quijada; David,26,0,30,4
1748426573395,CCE 120,B01,915205,Quijada; David,17,0,30,13
1748426573395,CCE 120,C01,915207,Williams; Danielle,21,0,30,9
1748426573395,CCE 120,D01,915275,Crawford; James,26,0,30,4
1748426573395,CCE 120,E01,915323,Kenley; Nicole,0,0,30,30
1748426573395,CCE 120,F01,915325,Kenley; Nicole,5,0,30,25
1748426574429,CENG 4,A01,913054,Li; Yanran,35,0,36,1
1748426574429,CENG 4,A02,913055,Li; Yanran,36,0,36,0
1748426574429,CENG 4,A03,913058,Li; Yanran,36,0,36,0
1748426574429,CENG 4,A04,913060,Li; Yanran,36,0,36,0
1748426575462,CENG 15,A01,913087,Lubarda; Vlado,69,0,70,1
1748426576490,CENG 100,A00,913088,Powell; Alyssa,108,0,120,12
1748426577521,CENG 101A,A00,913089,Opatkiewicz; Justin Paul,107,0,146,39
1748426578553,CENG 110,A01,913091,Powell; Alyssa,15,0,24,9
1748426579583,CENG 120,A00,913092,Opatkiewicz; Justin Paul,96,0,146,50
1748426580610,CENG 122,A00,913093,Li; Wan-Lu,120,0,140,20
1748426581637,CENG 170,A01,913196,Drews; Aaron,7,0,25,18
1748426581637,CENG 170,A02,913202,Drews; Aaron,4,0,25,21
1748426581637,CENG 170,A03,913204,Drews; Aaron,5,0,30,25
1748426582663,CENG 175,A00,913205,Steinmetz; Nicole F,14,0,35,21
1748426583696,CENG 205,A00,913207,Jahed Motlagh; Zeinab,54,0,70,16
1748426584732,CENG 210A,A00,913209,Shah; Nisarg,50,0,50,0
1748426585758,CENG 211,A00,913211,Sirbuly; Donald,23,0,25,2
1748426586789,CENG 213,A00,913213,Fenning; David,25,0,25,0
1748426587820,CENG 221A,A00,913214,Liu; Ping,38,0,50,12
1748426588847,CENG 252,A00,913215,Chen; Zheng,42,0,50,8
1748426589875,CGS 2A,A01,915347,Martin Sandino; Amanda Maria Yoland,11,0,15,4
1748426589875,CGS 2A,A02,915348,Martin Sandino; Amanda Maria Yoland,12,0,15,3
1748426589875,CGS 2A,A03,915375,Martin Sandino; Amanda Maria Yoland,11,0,15,4
1748426589875,CGS 2A,A04,915376,Martin Sandino; Amanda Maria Yoland,15,0,15,0
1748426590902,CGS 100A,A00,915379,Perez; Roy,16,0,31,15
1748426591930,CGS 109,A00,915458,Cuong; Marisol,36,0,40,4
1748426592958,CGS 110,A00,915463,Cuong; Marisol,27,0,30,3
1748426593985,CGS 113,A00,915465,Martin Sandino; Amanda Maria Yoland,8,0,16,8
1748426595019,CGS 134,A00,915498,Chatti; Deepti,17,0,32,15
1748426596046,CGS 150,A00,915508,Taylor-Garcia; Daphne,13,0,16,3
1748426597073,CGS 187,A00,915515,Martin Sandino; Amanda Maria Yoland,13,0,16,3
1748426598099,CGS 190,A00,915516,Taylor-Garcia; Daphne,7,0,7,0
1748426599130,CGS 208,A00,915517,Kang; Byung Chu,1,0,1,0
1748426600175,CHEM 4,A01,958051,Brydges; Stacey,39,0,40,1
1748426600175,CHEM 4,A02,958052,Brydges; Stacey,38,0,40,2
1748426600175,CHEM 4,A03,958053,Brydges; Stacey,37,0,40,3
1748426600175,CHEM 4,A04,958054,Brydges; Stacey,39,0,40,1
1748426600175,CHEM 4,A05,958055,Brydges; Stacey,40,0,40,0
1748426600175,CHEM 4,A06,958056,Brydges; Stacey,38,0,40,2
1748426600175,CHEM 4,A07,958057,Brydges; Stacey,40,0,40,0
1748426600175,CHEM 4,A08,958058,Brydges; Stacey,40,0,40,0
1748426600175,CHEM 4,B01,958059,Brydges; Stacey,40,0,40,0
1748426600175,CHEM 4,B02,958060,Brydges; Stacey,40,0,40,0
1748426600175,CHEM 4,B03,958061,Brydges; Stacey,40,0,40,0
1748426600175,CHEM 4,B04,958062,Brydges; Stacey,36,0,40,4
1748426600175,CHEM 4,B05,958063,Brydges; Stacey,38,0,40,2
1748426600175,CHEM 4,B06,958064,Brydges; Stacey,39,0,40,1
1748426600175,CHEM 4,B07,958065,Brydges; Stacey,40,0,40,0
1748426600175,CHEM 4,B08,958066,Brydges; Stacey,40,0,40,0
1748426601219,CHEM 6A,A01,958094,Stallings; Dontarie M,5,0,8,3
1748426601219,CHEM 6A,A02,958095,Stallings; Dontarie M,4,0,8,4
1748426601219,CHEM 6A,A03,958096,Stallings; Dontarie M,7,0,8,1
1748426601219,CHEM 6A,A04,958097,Stallings; Dontarie M,8,0,8,0
1748426601219,CHEM 6A,A05,958098,Stallings; Dontarie M,8,0,8,0
1748426601219,CHEM 6A,A06,958099,Stallings; Dontarie M,8,0,8,0
1748426601219,CHEM 6A,A07,958100,Stallings; Dontarie M,8,0,8,0
1748426601219,CHEM 6A,A08,958101,Stallings; Dontarie M,8,0,8,0
1748426601219,CHEM 6A,A09,958102,Stallings; Dontarie M,0,0,0,0
1748426601219,CHEM 6A,B01,958136,Stallings; Dontarie M,0,0,8,8
1748426601219,CHEM 6A,B02,958137,Stallings; Dontarie M,5,0,8,3
1748426601219,CHEM 6A,B03,958138,Stallings; Dontarie M,8,0,8,0
1748426601219,CHEM 6A,B04,958139,Stallings; Dontarie M,7,0,8,1
1748426601219,CHEM 6A,B05,958140,Stallings; Dontarie M,0,0,8,8
1748426601219,CHEM 6A,B06,958141,Stallings; Dontarie M,3,0,8,5
1748426601219,CHEM 6A,B07,958143,Stallings; Dontarie M,2,0,8,6
1748426601219,CHEM 6A,B08,958144,Stallings; Dontarie M,8,0,8,0
1748426601219,CHEM 6A,B09,958145,Stallings; Dontarie M,0,0,0,0
1748426601219,CHEM 6A,C01,958146,Schurmeier; Kimberly,6,0,8,2
1748426601219,CHEM 6A,C02,958147,Schurmeier; Kimberly,7,0,8,1
1748426601219,CHEM 6A,C03,958148,Schurmeier; Kimberly,8,0,8,0
1748426601219,CHEM 6A,C04,958149,Schurmeier; Kimberly,8,0,8,0
1748426601219,CHEM 6A,C05,958150,Schurmeier; Kimberly,8,0,8,0
1748426601219,CHEM 6A,C06,958151,Schurmeier; Kimberly,6,0,8,2
1748426601219,CHEM 6A,C07,958152,Schurmeier; Kimberly,8,0,8,0
1748426601219,CHEM 6A,C08,958153,Schurmeier; Kimberly,7,0,8,1
1748426601219,CHEM 6A,C09,958154,Schurmeier; Kimberly,0,0,0,0
1748426601219,CHEM 6A,D01,958155,Schurmeier; Kimberly,3,0,8,5
1748426601219,CHEM 6A,D02,958156,Schurmeier; Kimberly,3,0,8,5
1748426601219,CHEM 6A,D03,958157,Schurmeier; Kimberly,4,0,8,4
1748426601219,CHEM 6A,D04,958158,Schurmeier; Kimberly,6,0,8,2
1748426601219,CHEM 6A,D05,958159,Schurmeier; Kimberly,7,0,8,1
1748426601219,CHEM 6A,D06,958160,Schurmeier; Kimberly,7,0,8,1
1748426601219,CHEM 6A,D07,958161,Schurmeier; Kimberly,8,0,8,0
1748426601219,CHEM 6A,D08,958162,Schurmeier; Kimberly,8,0,8,0
1748426601219,CHEM 6A,D09,958195,Schurmeier; Kimberly,0,0,0,0
1748426601219,CHEM 6A,E01,958203,Zid; Brian M,0,0,8,8
1748426601219,CHEM 6A,E02,958206,Zid; Brian M,6,0,8,2
1748426601219,CHEM 6A,E03,958207,Zid; Brian M,7,0,8,1
1748426601219,CHEM 6A,E04,958350,Zid; Brian M,8,0,8,0
1748426601219,CHEM 6A,E05,958361,Zid; Brian M,7,0,8,1
1748426601219,CHEM 6A,E06,958373,Zid; Brian M,2,0,8,6
1748426601219,CHEM 6A,E07,958394,Zid; Brian M,7,0,8,1
1748426601219,CHEM 6A,E08,958395,Zid; Brian M,1,0,8,7
1748426601219,CHEM 6A,E09,958396,Zid; Brian M,0,0,0,0
1748426601219,CHEM 6A,F01,958397,Ortony; Julia Helen,8,0,8,0
1748426601219,CHEM 6A,F02,958407,Ortony; Julia Helen,0,0,8,8
1748426601219,CHEM 6A,F03,958409,Ortony; Julia Helen,2,0,8,6
1748426601219,CHEM 6A,F04,958417,Ortony; Julia Helen,6,0,8,2
1748426601219,CHEM 6A,F05,958422,Ortony; Julia Helen,8,0,8,0
1748426601219,CHEM 6A,F06,958425,Ortony; Julia Helen,8,0,8,0
1748426601219,CHEM 6A,F07,958428,Ortony; Julia Helen,7,0,8,1
1748426601219,CHEM 6A,F08,958442,Ortony; Julia Helen,8,0,8,0
1748426601219,CHEM 6A,F09,958488,Ortony; Julia Helen,0,0,0,0
1748426601219,CHEM 6A,G01,958489,Ortony; Julia Helen,7,0,8,1
1748426601219,CHEM 6A,G02,958490,Ortony; Julia Helen,8,0,8,0
1748426601219,CHEM 6A,G03,958491,Ortony; Julia Helen,3,0,8,5
1748426601219,CHEM 6A,G04,958499,Ortony; Julia Helen,2,0,8,6
1748426601219,CHEM 6A,G05,958500,Ortony; Julia Helen,4,0,8,4
1748426601219,CHEM 6A,G06,958501,Ortony; Julia Helen,8,0,8,0
1748426601219,CHEM 6A,G07,958502,Ortony; Julia Helen,8,0,8,0
1748426601219,CHEM 6A,G08,958636,Ortony; Julia Helen,8,0,8,0
1748426601219,CHEM 6A,G09,958637,Ortony; Julia Helen,0,0,0,0
1748426602260,CHEM 6B,A01,958638,Bussey; Thomas J,15,0,22,7
1748426602260,CHEM 6B,A02,958641,Bussey; Thomas J,0,0,22,22
1748426602260,CHEM 6B,A03,958646,Bussey; Thomas J,0,0,22,22
1748426602260,CHEM 6B,A04,958648,Bussey; Thomas J,11,0,22,11
1748426602260,CHEM 6B,A05,958650,Bussey; Thomas J,7,0,22,15
1748426602260,CHEM 6B,A06,958652,Bussey; Thomas J,18,0,22,4
1748426602260,CHEM 6B,A07,958653,Bussey; Thomas J,20,0,22,2
1748426602260,CHEM 6B,A08,958654,Bussey; Thomas J,19,0,22,3
1748426602260,CHEM 6B,A09,958710,Bussey; Thomas J,21,0,22,1
1748426602260,CHEM 6B,A10,958713,Bussey; Thomas J,21,0,22,1
1748426603289,CHEM 6C,A01,958743,Yuen Zhou; Joel,22,0,38,16
1748426603289,CHEM 6C,A02,958744,Yuen Zhou; Joel,20,0,38,18
1748426603289,CHEM 6C,A03,958745,Yuen Zhou; Joel,28,0,38,10
1748426603289,CHEM 6C,A04,958746,Yuen Zhou; Joel,30,0,38,8
1748426603289,CHEM 6C,A05,958747,Yuen Zhou; Joel,36,0,38,2
1748426603289,CHEM 6C,A06,958748,Yuen Zhou; Joel,23,0,38,15
1748426603289,CHEM 6C,A07,958749,Yuen Zhou; Joel,23,0,38,15
1748426603289,CHEM 6C,A08,958750,Yuen Zhou; Joel,12,0,38,26
1748426603289,CHEM 6C,A09,958751,Yuen Zhou; Joel,28,0,38,10
1748426604321,CHEM 7L,A01,912668,Leigh; Brian,0,0,24,24
1748426604321,CHEM 7L,A02,912669,Leigh; Brian,0,0,24,24
1748426604321,CHEM 7L,A03,912670,Leigh; Brian,0,0,24,24
1748426604321,CHEM 7L,A04,912671,Leigh; Brian,0,0,24,24
1748426604321,CHEM 7L,A05,912672,Leigh; Brian,0,0,24,24
1748426604321,CHEM 7L,A06,912673,Leigh; Brian,0,0,20,20
1748426604321,CHEM 7L,A07,912674,Leigh; Brian,0,0,24,24
1748426604321,CHEM 7L,A08,912675,Leigh; Brian,0,0,24,24
1748426604321,CHEM 7L,A09,912676,Leigh; Brian,0,0,24,24
1748426604321,CHEM 7L,A10,912677,Leigh; Brian,0,0,24,24
1748426604321,CHEM 7L,B01,912680,Leigh; Brian,0,0,24,24
1748426604321,CHEM 7L,B02,912681,Leigh; Brian,0,0,24,24
1748426604321,CHEM 7L,B03,912682,Leigh; Brian,0,0,24,24
1748426604321,CHEM 7L,B04,912683,Leigh; Brian,0,0,24,24
1748426604321,CHEM 7L,B05,912684,Leigh; Brian,0,0,24,24
1748426604321,CHEM 7L,B06,912685,Leigh; Brian,0,0,24,24
1748426604321,CHEM 7L,B07,912686,Leigh; Brian,0,0,24,24
1748426604321,CHEM 7L,B08,912687,Leigh; Brian,0,0,24,24
1748426604321,CHEM 7L,B09,912688,Leigh; Brian,0,0,24,24
1748426604321,CHEM 7L,B10,912689,Leigh; Brian,0,0,24,24
1748426605355,CHEM 40A,A01,958809,Bertrand; Guy,0,0,34,34
1748426605355,CHEM 40A,A02,958811,Bertrand; Guy,0,0,29,29
1748426605355,CHEM 40A,A03,958812,Bertrand; Guy,0,0,34,34
1748426605355,CHEM 40A,A04,958813,Bertrand; Guy,0,0,34,34
1748426605355,CHEM 40A,A05,958814,Bertrand; Guy,0,0,34,34
1748426605355,CHEM 40A,A06,958816,Bertrand; Guy,0,0,34,34
1748426605355,CHEM 40A,A07,958822,Bertrand; Guy,0,0,34,34
1748426605355,CHEM 40A,A08,958824,Bertrand; Guy,0,0,34,34
1748426605355,CHEM 40A,B01,958825,Bertrand; Guy,0,0,34,34
1748426605355,CHEM 40A,B02,958826,Bertrand; Guy,0,0,34,34
1748426605355,CHEM 40A,B03,958828,Bertrand; Guy,0,0,34,34
1748426605355,CHEM 40A,B04,958829,Bertrand; Guy,0,0,34,34
1748426605355,CHEM 40A,B05,958898,Bertrand; Guy,0,0,34,34
1748426605355,CHEM 40A,B06,958899,Bertrand; Guy,0,0,34,34
1748426605355,CHEM 40A,B07,958900,Bertrand; Guy,0,0,34,34
1748426605355,CHEM 40A,B08,958901,Bertrand; Guy,0,0,34,34
1748426605355,CHEM 40A,C01,958086,Yang; Jerry,29,0,34,5
1748426605355,CHEM 40A,C02,958087,Yang; Jerry,32,0,34,2
1748426605355,CHEM 40A,C03,958088,Yang; Jerry,31,0,34,3
1748426605355,CHEM 40A,C04,958089,Yang; Jerry,34,0,34,0
1748426605355,CHEM 40A,C05,958090,Yang; Jerry,34,0,34,0
1748426605355,CHEM 40A,C06,958091,Yang; Jerry,27,0,34,7
1748426605355,CHEM 40A,C07,958092,Yang; Jerry,29,0,34,5
1748426605355,CHEM 40A,C08,958093,Yang; Jerry,27,0,34,7
1748426605355,CHEM 40A,D01,958113,Albizati; Kim F.,0,0,34,34
1748426605355,CHEM 40A,D02,958114,Albizati; Kim F.,0,0,34,34
1748426605355,CHEM 40A,D03,958115,Albizati; Kim F.,0,0,34,34
1748426605355,CHEM 40A,D04,958116,Albizati; Kim F.,0,0,34,34
1748426605355,CHEM 40A,D05,958117,Albizati; Kim F.,0,0,34,34
1748426605355,CHEM 40A,D06,958118,Albizati; Kim F.,0,0,34,34
1748426605355,CHEM 40A,D07,958119,Albizati; Kim F.,0,0,34,34
1748426605355,CHEM 40A,D08,958120,Albizati; Kim F.,0,0,34,34
1748426606383,CHEM 40B,A01,958752,Molinski; Tadeusz,0,0,31,31
1748426606383,CHEM 40B,A02,958754,Molinski; Tadeusz,0,0,32,32
1748426606383,CHEM 40B,A03,958755,Molinski; Tadeusz,0,0,32,32
1748426606383,CHEM 40B,A04,958756,Molinski; Tadeusz,0,0,32,32
1748426606383,CHEM 40B,A05,958757,Molinski; Tadeusz,0,0,32,32
1748426606383,CHEM 40B,A06,958758,Molinski; Tadeusz,0,0,32,32
1748426606383,CHEM 40B,A07,958759,Molinski; Tadeusz,0,0,32,32
1748426606383,CHEM 40B,A08,958760,Molinski; Tadeusz,2,0,32,30
1748426606383,CHEM 40B,A09,958761,Molinski; Tadeusz,32,0,32,0
1748426607417,CHEM 41A,A01,958071,Klosterman; Jeremy K,0,0,22,22
1748426607417,CHEM 41A,A02,958072,Klosterman; Jeremy K,1,0,36,35
1748426607417,CHEM 41A,A03,958073,Klosterman; Jeremy K,16,0,36,20
1748426607417,CHEM 41A,A04,958074,Klosterman; Jeremy K,32,0,36,4
1748426607417,CHEM 41A,A05,958075,Klosterman; Jeremy K,0,0,0,0
1748426607417,CHEM 41A,A06,958076,Klosterman; Jeremy K,24,0,36,12
1748426607417,CHEM 41A,A07,958077,Klosterman; Jeremy K,3,0,36,33
1748426607417,CHEM 41A,A08,958078,Klosterman; Jeremy K,0,0,36,36
1748426607417,CHEM 41A,A09,958079,Klosterman; Jeremy K,36,0,36,0
1748426608449,CHEM 41C,A01,958105,Tor; Yitzhak,0,0,38,38
1748426608449,CHEM 41C,A02,958106,Tor; Yitzhak,0,0,40,40
1748426609479,CHEM 43A,A01,912711,Lam; Tin Yiu,0,0,24,24
1748426609479,CHEM 43A,A02,912712,Lam; Tin Yiu,0,0,24,24
1748426609479,CHEM 43A,A03,912713,Lam; Tin Yiu,0,0,24,24
1748426609479,CHEM 43A,A04,912714,Lam; Tin Yiu,0,0,24,24
1748426609479,CHEM 43A,A05,912715,Lam; Tin Yiu,0,0,24,24
1748426609479,CHEM 43A,A06,912716,Lam; Tin Yiu,0,0,24,24
1748426609479,CHEM 43A,A07,912717,Lam; Tin Yiu,0,0,24,24
1748426609479,CHEM 43A,A08,912718,Lam; Tin Yiu,0,0,24,24
1748426609479,CHEM 43A,A09,912719,Lam; Tin Yiu,0,0,24,24
1748426609479,CHEM 43A,A10,912720,Lam; Tin Yiu,0,0,24,24
1748426609479,CHEM 43A,B01,912722,Lam; Tin Yiu,0,0,24,24
1748426609479,CHEM 43A,B02,912723,Lam; Tin Yiu,0,0,24,24
1748426609479,CHEM 43A,B03,912724,Lam; Tin Yiu,0,0,19,19
1748426609479,CHEM 43A,B04,912725,Lam; Tin Yiu,0,0,24,24
1748426609479,CHEM 43A,B05,912726,Lam; Tin Yiu,0,0,24,24
1748426609479,CHEM 43A,B06,912727,Lam; Tin Yiu,0,0,24,24
1748426609479,CHEM 43A,B07,912728,Lam; Tin Yiu,0,0,24,24
1748426609479,CHEM 43A,B08,912729,Lam; Tin Yiu,0,0,24,24
1748426609479,CHEM 43A,B09,912730,Lam; Tin Yiu,0,0,24,24
1748426609479,CHEM 43A,B10,912731,Lam; Tin Yiu,0,0,24,24
1748426610510,CHEM 96,A00,960251,Bussey; Thomas J,15,0,20,5
1748426611549,CHEM 100A,A01,912734,Leigh; Brian,0,0,24,24
1748426611549,CHEM 100A,A02,912735,Leigh; Brian,0,0,24,24
1748426611549,CHEM 100A,A03,912736,Leigh; Brian,0,0,24,24
1748426611549,CHEM 100A,A04,912737,Leigh; Brian,0,0,24,24
1748426611549,CHEM 100A,A05,912738,Leigh; Brian,0,0,24,24
1748426611549,CHEM 100A,A06,912739,Leigh; Brian,0,0,24,24
1748426612577,CHEM 108,A01,912741,Ghosh; Gourisankar,0,0,24,24
1748426612577,CHEM 108,A02,912742,Ghosh; Gourisankar,0,0,24,24
1748426612577,CHEM 108,A03,912743,Ghosh; Gourisankar,13,0,24,11
1748426612577,CHEM 108,A04,912744,Ghosh; Gourisankar,23,0,24,1
1748426613612,CHEM 109,A01,912746,Muller; Ulrich K.,0,0,24,24
1748426613612,CHEM 109,A02,912747,Muller; Ulrich K.,0,0,24,24
1748426613612,CHEM 109,A03,912748,Muller; Ulrich K.,0,0,24,24
1748426613612,CHEM 109,A04,912749,Muller; Ulrich K.,15,0,24,9
1748426614649,CHEM 114A,A01,958067,Toor; Navtej,23,0,30,7
1748426614649,CHEM 114A,A02,958068,Toor; Navtej,18,0,30,12
1748426614649,CHEM 114A,A03,958069,Toor; Navtej,15,0,30,15
1748426614649,CHEM 114A,A04,958070,Toor; Navtej,0,0,30,30
1748426614649,CHEM 114A,B01,958080,Guseman; Alex,0,0,30,30
1748426614649,CHEM 114A,B02,958081,Guseman; Alex,0,0,30,30
1748426614649,CHEM 114A,B03,958082,Guseman; Alex,20,0,30,10
1748426614649,CHEM 114A,B04,958083,Guseman; Alex,24,0,30,6
1748426615676,CHEM 114D,A00,912752,Ghosh; Gourisankar,11,0,20,9
1748426616704,CHEM 116,A01,958121,Godula; Kamil,35,0,50,15
1748426616704,CHEM 116,A02,958122,Godula; Kamil,28,0,50,22
1748426617736,CHEM 117,A00,912754,Jones; Lisa Michelle,89,0,100,11
1748426618768,CHEM 126A,A01,958126,Schoeneberg; Johannes,14,0,35,21
1748426618768,CHEM 126A,A02,958127,Schoeneberg; Johannes,4,0,35,31
1748426618768,CHEM 126A,A03,958128,Schoeneberg; Johannes,0,0,35,35
1748426618768,CHEM 126A,A04,958129,Schoeneberg; Johannes,1,0,35,34
1748426618768,CHEM 126A,A05,958130,Schoeneberg; Johannes,34,0,35,1
1748426618768,CHEM 126A,A06,958131,Schoeneberg; Johannes,25,0,35,10
1748426619796,CHEM 130,A01,958084,Sinha; Amitabha,6,0,35,29
1748426619796,CHEM 130,A02,958085,Sinha; Amitabha,21,0,35,14
1748426620827,CHEM 142,A00,912758,Godula; Kamil,112,0,135,23
1748426621859,CHEM 143C,A01,912760,Klosterman; Jeremy K,8,0,24,16
1748426621859,CHEM 143C,A02,912761,Klosterman; Jeremy K,11,0,24,13
1748426622886,CHEM 152,A00,912762,Schmidt; Valerie A,18,0,30,12
1748426623914,CHEM 163,A00,912763,Jones; Lisa Michelle,1,0,10,9
1748426624948,CHEM 171,A01,958103,Slade; Jonathan,30,0,40,10
1748426624948,CHEM 171,A02,958104,Slade; Jonathan,36,0,40,4
1748426625978,CHEM 204,A00,912765,Ghosh; Partho,29,0,30,1
1748426627005,CHEM 209,A00,912766,Toor; Navtej,36,0,40,4
1748426628036,CHEM 213A,A00,912767,Guseman; Alex,46,0,50,4
1748426629068,CHEM 214,A00,912768,Ghosh; Gourisankar,18,0,20,2
1748426630100,CHEM 216,A00,912769,Godula; Kamil,28,0,30,2
1748426631125,CHEM 219A,A00,912770,Zid; Brian M,43,0,45,2
1748426632152,CHEM 222,A00,912771,Graeve; Olivia A,4,0,5,1
1748426633183,CHEM 224,A00,912772,Rinehart; Jeffrey Dennis,19,0,20,1
1748426634266,CHEM 227,A00,912773,Schimpf; Alina M,28,0,30,2
1748426636326,CHEM 231,A00,912775,Yong; Haiwang,20,0,20,0
1748426637354,CHEM 232A,A00,963071,Yuen Zhou; Joel,15,0,15,0
1748426638380,CHEM 234,A00,912776,Pun; Andrew Brian,39,0,40,1
1748426639410,CHEM 242,A00,912777,Godula; Kamil,22,0,25,3
1748426640437,CHEM 252,A00,912778,Schmidt; Valerie A,27,0,30,3
1748426641469,CHEM 263,A00,912779,Jones; Lisa Michelle,28,0,30,2
1748426642497,CHEM 291,A00,912780,Staff,20,0,20,0
1748426643527,CHEM 294,A00,912781,Staff,49,0,50,1
1748426644556,CHIN 10AD,A01,913381,Liu; Mingming,10,0,12,2
1748426644556,CHIN 10AD,A02,913382,Liu; Mingming,10,0,12,2
1748426645583,CHIN 10AM,A01,913384,Chen; Pei-Chia,9,0,12,3
1748426645583,CHIN 10AM,A02,913385,Chen; Pei-Chia,10,0,12,2
1748426646618,CHIN 10AN,A01,913387,Xu; Li,10,0,10,0
1748426646618,CHIN 10AN,A02,913388,Xu; Li,10,0,10,0
1748426646618,CHIN 10AN,B01,913390,Xu; Li,9,0,10,1
1748426646618,CHIN 10AN,B02,913391,Xu; Li,8,0,10,2
1748426646618,CHIN 10AN,C01,913393,Xu; Li,12,0,12,0
1748426646618,CHIN 10AN,C02,913394,Xu; Li,11,0,12,1
1748426647649,CHIN 20AD,A01,913396,Liu; Mingming,12,0,14,2
1748426647649,CHIN 20AD,A02,913397,Liu; Mingming,13,0,14,1
1748426648682,CHIN 20AM,A01,913399,Wang; Xiao,11,0,12,1
1748426648682,CHIN 20AM,A02,913400,Wang; Xiao,9,0,12,3
1748426648682,CHIN 20AM,B01,913402,Wang; Xiao,12,0,12,0
1748426648682,CHIN 20AM,B02,913403,Wang; Xiao,12,0,12,0
1748426649716,CHIN 20AN,A01,913405,Anderson; Qin-Hong,8,0,12,4
1748426649716,CHIN 20AN,A02,913406,Anderson; Qin-Hong,7,0,12,5
1748426649716,CHIN 20AN,B01,913408,Anderson; Qin-Hong,6,0,12,6
1748426649716,CHIN 20AN,B02,913409,Anderson; Qin-Hong,9,0,12,3
1748426649716,CHIN 20AN,C01,913411,Anderson; Qin-Hong,11,0,12,1
1748426650750,CHIN 100AM,A00,913412,Wang; Xiao,12,0,15,3
1748426651780,CHIN 100AN,A00,913413,Chen; Pei-Chia,8,0,15,7
1748426652808,CHIN 185A,A00,913414,Liu; Mingming,15,0,15,0
1748426653837,CLIN 294A,A00,914822,Weingarten; Amanda Gooding,10,0,10,0
1748426654875,CLIN 296,A00,914825,Moore; David Joseph,100,0,100,0
1748426654875,CLIN 296,B00,914826,Brookman; Lauren Irene,5,0,5,0
1748426655904,CLIN 297,A00,914827,Wall; Tamara Lynn,100,0,100,0
1748426656935,CLRE 254,A00,914830,Vaida; Florin,9997,0,9999,2
1748426657962,CLRE 255,A01,914832,Cuomo; Raphael Eduardo,9997,0,9999,2
1748426658988,CLRE 256,A01,914835,Morris; Sheldon,9996,0,9999,3
1748426660020,CLRE 257,A00,914836,Mehta; Ravindra L.,9997,0,9999,2
1748426661048,CLRE 258,A00,914839,Mehta; Ravindra L.,9997,0,9999,2
1748426662074,CLRE 260,A00,914840,Cuomo; Raphael Eduardo,9999,0,9999,0
1748426663101,CLRE 295A,A00,914845,Cuomo; Raphael Eduardo,9999,0,9999,0
1748426664130,CLRE 297,001,914847,Cuomo; Raphael Eduardo,9999,0,9999,0
1748426665158,CLX 87,A00,913379,Castro; Robert Jess,20,0,20,0
1748426666190,COGR 200A,A00,914800,Dewaard; Andrew Michael,5,0,5,0
1748426667216,COGR 200C,A00,914801,Irani; Lilly C,5,0,5,0
1748426668248,COGR 225A,A00,914803,McKenzie; Kerry V.,10,0,10,0
1748426669276,COGR 225C,A00,914804,McKenzie; Kerry V.,9,0,10,1
1748426670306,COGR 275,A00,914805,Jack; Caroline Sarah,9,0,10,1
1748426670306,COGR 275,B00,914807,Zilberg; Elana,9,0,10,1
1748426670306,COGR 275,C00,914809,Goldfarb; Brian,7,0,10,3
1748426671334,COGS 1,A01,913420,Beatty-Martinez; Anne,47,0,56,9
1748426671334,COGS 1,A02,913421,Beatty-Martinez; Anne,39,0,56,17
1748426671334,COGS 1,A03,913422,Beatty-Martinez; Anne,51,0,55,4
1748426671334,COGS 1,A04,913423,Beatty-Martinez; Anne,46,0,50,4
1748426671334,COGS 1,A05,913424,Beatty-Martinez; Anne,41,0,50,9
1748426671334,COGS 1,A06,913425,Beatty-Martinez; Anne,44,0,50,6
1748426671334,COGS 1,A07,913426,Beatty-Martinez; Anne,48,0,50,2
1748426671334,COGS 1,A08,913427,Beatty-Martinez; Anne,45,0,50,5
1748426672361,COGS 2,A01,913429,Boyle; Mary E. T.,49,0,50,1
1748426672361,COGS 2,A02,913430,Boyle; Mary E. T.,47,0,50,3
1748426672361,COGS 2,A03,913431,Boyle; Mary E. T.,46,0,50,4
1748426672361,COGS 2,A04,913432,Boyle; Mary E. T.,49,0,50,1
1748426672361,COGS 2,A05,913433,Boyle; Mary E. T.,47,0,50,3
1748426673388,COGS 3,A01,913435,Boyle; Mary E. T.,48,0,60,12
1748426673388,COGS 3,A02,913436,Boyle; Mary E. T.,52,0,60,8
1748426674415,COGS 9,A01,913439,Khosla; Meenakshi,48,0,50,2
1748426674415,COGS 9,A02,913440,Khosla; Meenakshi,49,0,50,1
1748426674415,COGS 9,A03,913441,Khosla; Meenakshi,48,0,50,2
1748426674415,COGS 9,A04,913442,Khosla; Meenakshi,46,0,50,4
1748426674415,COGS 9,A05,913443,Khosla; Meenakshi,44,0,50,6
1748426674415,COGS 9,A06,913444,Khosla; Meenakshi,46,0,50,4
1748426675447,COGS 10,A01,913446,Staff,41,0,50,9
1748426675447,COGS 10,A02,913447,Staff,46,0,50,4
1748426675447,COGS 10,A03,913448,Staff,47,0,50,3
1748426675447,COGS 10,A04,913449,Staff,47,0,50,3
1748426675447,COGS 10,A05,913450,Staff,50,0,50,0
1748426675447,COGS 10,A06,913451,Staff,45,0,50,5
1748426676475,COGS 11,A01,913453,Boroditsky; Lera,142,0,149,7
1748426677505,COGS 14A,A01,913455,Creel; Sarah,29,0,50,21
1748426677505,COGS 14A,A02,913456,Creel; Sarah,37,0,50,13
1748426677505,COGS 14A,A03,913457,Creel; Sarah,42,0,50,8
1748426677505,COGS 14A,A04,913458,Creel; Sarah,45,0,50,5
1748426677505,COGS 14A,A05,913459,Creel; Sarah,47,0,50,3
1748426677505,COGS 14A,A06,913460,Creel; Sarah,48,0,50,2
1748426677505,COGS 14A,A07,913461,Creel; Sarah,46,0,50,4
1748426678537,COGS 14B,A01,913463,Barrera; Steven James,32,0,50,18
1748426678537,COGS 14B,A02,913464,Barrera; Steven James,45,0,50,5
1748426678537,COGS 14B,A03,913465,Barrera; Steven James,40,0,50,10
1748426678537,COGS 14B,A04,913466,Barrera; Steven James,46,0,50,4
1748426678537,COGS 14B,A05,913467,Barrera; Steven James,40,0,50,10
1748426679568,COGS 15,A01,913469,Bergen; Benjamin,57,0,60,3
1748426679568,COGS 15,A02,913470,Bergen; Benjamin,57,0,60,3
1748426680596,COGS 17,A01,913472,Johnson; Christine M.,38,0,50,12
1748426680596,COGS 17,A02,913473,Johnson; Christine M.,47,0,50,3
1748426680596,COGS 17,A03,913474,Johnson; Christine M.,39,0,50,11
1748426680596,COGS 17,A04,913475,Johnson; Christine M.,42,0,50,8
1748426680596,COGS 17,A05,913476,Johnson; Christine M.,48,0,50,2
1748426680596,COGS 17,A06,913477,Johnson; Christine M.,48,0,50,2
1748426680596,COGS 17,A07,913478,Johnson; Christine M.,50,0,54,4
1748426680596,COGS 17,A08,913479,Johnson; Christine M.,43,0,56,13
1748426681630,COGS 18,A01,913481,Morgan; Eric,27,0,35,8
1748426681630,COGS 18,A02,913482,Morgan; Eric,30,0,35,5
1748426681630,COGS 18,A03,913483,Morgan; Eric,29,0,35,6
1748426681630,COGS 18,A04,913484,Morgan; Eric,32,0,35,3
1748426681630,COGS 18,A05,913485,Morgan; Eric,31,0,35,4
1748426681630,COGS 18,A06,913486,Morgan; Eric,31,0,35,4
1748426681630,COGS 18,A07,913487,Morgan; Eric,30,0,35,5
1748426681630,COGS 18,A08,913488,Morgan; Eric,31,0,35,4
1748426681630,COGS 18,A09,913520,Morgan; Eric,27,0,35,8
1748426681630,COGS 18,B01,968089,Morgan; Eric,34,0,35,1
1748426681630,COGS 18,B02,968090,Morgan; Eric,35,0,35,0
1748426681630,COGS 18,B03,968091,Morgan; Eric,35,0,35,0
1748426681630,COGS 18,B04,968092,Morgan; Eric,35,0,35,0
1748426681630,COGS 18,B05,968093,Morgan; Eric,35,0,35,0
1748426681630,COGS 18,B06,968094,Morgan; Eric,35,0,35,0
1748426681630,COGS 18,B07,968095,Morgan; Eric,35,0,35,0
1748426681630,COGS 18,B08,968096,Morgan; Eric,34,0,35,1
1748426681630,COGS 18,B09,968097,Morgan; Eric,34,0,35,1
1748426682658,COGS 100,A01,913580,Staff,58,0,60,2
1748426682658,COGS 100,A02,913581,Staff,55,0,60,5
1748426682658,COGS 100,A03,913621,Staff,55,0,60,5
1748426682658,COGS 100,A04,913622,Staff,55,0,60,5
1748426682658,COGS 100,A05,913663,Staff,54,0,60,6
1748426683690,COGS 101A,A01,913705,Barrera; Steven James,37,0,50,13
1748426683690,COGS 101A,A02,913709,Barrera; Steven James,35,0,50,15
1748426683690,COGS 101A,A03,913713,Barrera; Steven James,18,0,50,32
1748426683690,COGS 101A,A04,913715,Barrera; Steven James,25,0,50,25
1748426683690,COGS 101A,A05,913718,Barrera; Steven James,44,0,50,6
1748426683690,COGS 101A,A06,913721,Barrera; Steven James,36,0,50,14
1748426683690,COGS 101A,A07,913722,Barrera; Steven James,41,0,50,9
1748426684721,COGS 101B,A01,913725,Hoffman; Drew Ellen,26,0,50,24
1748426684721,COGS 101B,A02,913726,Hoffman; Drew Ellen,44,0,50,6
1748426684721,COGS 101B,A03,913727,Hoffman; Drew Ellen,47,0,50,3
1748426684721,COGS 101B,A04,913730,Hoffman; Drew Ellen,50,0,50,0
1748426685749,COGS 102A,A01,968009,Staff,41,0,48,7
1748426685749,COGS 102A,A02,968010,Staff,36,0,48,12
1748426685749,COGS 102A,A03,968011,Staff,47,0,50,3
1748426686777,COGS 107A,A01,913748,Rangel; Lara M,44,0,56,12
1748426686777,COGS 107A,A02,913750,Rangel; Lara M,43,0,54,11
1748426686777,COGS 107A,A03,913751,Rangel; Lara M,31,0,50,19
1748426686777,COGS 107A,A04,913754,Rangel; Lara M,20,0,50,30
1748426686777,COGS 107A,A05,913755,Rangel; Lara M,27,0,50,23
1748426686777,COGS 107A,A06,913756,Rangel; Lara M,0,0,50,50
1748426687804,COGS 107B,A01,968098,Staff,0,0,50,50
1748426687804,COGS 107B,A02,968099,Staff,6,0,50,44
1748426687804,COGS 107B,A03,968102,Staff,37,0,49,12
1748426688834,COGS 108,A01,913846,Fleischer; Jason G,0,0,56,56
1748426688834,COGS 108,A02,913847,Fleischer; Jason G,17,0,56,39
1748426688834,COGS 108,A03,913858,Fleischer; Jason G,20,0,50,30
1748426688834,COGS 108,A04,913899,Fleischer; Jason G,44,0,55,11
1748426688834,COGS 108,A05,913984,Fleischer; Jason G,29,0,50,21
1748426688834,COGS 108,A06,914035,Fleischer; Jason G,31,0,50,19
1748426688834,COGS 108,A07,914036,Fleischer; Jason G,36,0,50,14
1748426688834,COGS 108,A08,914037,Fleischer; Jason G,44,0,50,6
1748426688834,COGS 108,B01,914039,Fleischer; Jason G,38,0,50,12
1748426688834,COGS 108,B02,914040,Fleischer; Jason G,48,0,50,2
1748426688834,COGS 108,B03,914172,Fleischer; Jason G,32,0,50,18
1748426688834,COGS 108,B04,914182,Fleischer; Jason G,36,0,50,14
1748426688834,COGS 108,B05,914185,Fleischer; Jason G,28,0,50,22
1748426688834,COGS 108,B06,914188,Fleischer; Jason G,19,0,50,31
1748426688834,COGS 108,B07,914209,Fleischer; Jason G,39,0,54,15
1748426688834,COGS 108,B08,914210,Fleischer; Jason G,49,0,56,7
1748426689866,COGS 109,A01,968106,Mukamel; Eran A,30,0,48,18
1748426689866,COGS 109,A02,968107,Mukamel; Eran A,39,0,49,10
1748426689866,COGS 109,A03,968108,Mukamel; Eran A,47,0,49,2
1748426690893,COGS 111,A01,914261,Hoffman; Drew Ellen,34,0,50,16
1748426690893,COGS 111,A02,914262,Hoffman; Drew Ellen,49,0,50,1
1748426690893,COGS 111,A03,914263,Hoffman; Drew Ellen,46,0,50,4
1748426690893,COGS 111,A04,914264,Hoffman; Drew Ellen,28,0,50,22
1748426691921,COGS 115,A01,914266,Deak; Gedeon O.,35,0,70,35
1748426692951,COGS 116,A01,914268,Greene; Deanna Jacquelyn,49,0,70,21
1748426693979,COGS 118A,A01,914270,Tu; Zhuowen,30,0,50,20
1748426693979,COGS 118A,A02,914271,Tu; Zhuowen,31,0,50,19
1748426693979,COGS 118A,A03,914272,Tu; Zhuowen,7,0,50,43
1748426693979,COGS 118A,A04,914273,Tu; Zhuowen,6,0,50,44
1748426695007,COGS 118B,A01,969817,De Sa; Virginia,32,0,49,17
1748426695007,COGS 118B,A02,969818,De Sa; Virginia,34,0,49,15
1748426695007,COGS 118B,A03,969819,De Sa; Virginia,31,0,49,18
1748426695007,COGS 118B,A04,969822,De Sa; Virginia,43,0,49,6
1748426696034,COGS 125,A00,968043,Klemmer; Scott R,48,0,50,2
1748426697061,COGS 128,A01,914278,Staff,16,0,50,34
1748426697061,COGS 128,A02,914279,Staff,0,0,50,50
1748426698092,COGS 143,A01,914284,Johnson; Christine M.,16,0,40,24
1748426699118,COGS 150,A01,968112,Staff,36,0,50,14
1748426699118,COGS 150,A02,968113,Staff,44,0,49,5
1748426699118,COGS 150,A03,968114,Staff,43,0,48,5
1748426700145,COGS 151,A00,968044,Coulson; Seana M,48,0,50,2
1748426701173,COGS 160,A00,914286,Kirsh; David Joel,25,0,25,0
1748426702201,COGS 165,A01,914291,Kiyonaga; Anastasia,0,0,50,50
1748426703229,COGS 187A,A01,914293,Kirsh; David Joel,0,0,50,50
1748426703229,COGS 187A,A02,914294,Kirsh; David Joel,0,0,50,50
1748426703229,COGS 187A,A03,914295,Kirsh; David Joel,16,0,49,33
1748426704256,COGS 189,A00,914296,De Sa; Virginia,119,0,200,81
1748426705287,COGS 190A,A00,914297,Staff,9999,0,9999,0
1748426706317,COGS 194,A00,914298,Hill; Seth J,9999,0,9999,0
1748426707346,COGS 203,A00,914326,Zettersten; Martin,11,0,20,9
1748426708384,COGS 210A,001,914327,Kirsh; David Joel,9999,0,9999,0
1748426708384,COGS 210A,002,914328,Greene; Deanna Jacquelyn,9998,0,9999,1
1748426708384,COGS 210A,003,914329,Xia; Haijun,9998,0,9999,1
1748426708384,COGS 210A,004,914330,Nitz; Douglas A.,9999,0,9999,0
1748426708384,COGS 210A,005,914331,Hollan; James D.,9999,0,9999,0
1748426708384,COGS 210A,006,914332,De Sa; Virginia,9998,0,9999,1
1748426708384,COGS 210A,007,914333,Rossano; Federico,9999,0,9999,0
1748426708384,COGS 210A,008,914334,Kiyonaga; Anastasia,9999,0,9999,0
1748426708384,COGS 210A,009,914335,Coulson; Seana M,9998,0,9999,1
1748426709410,COGS 211A,A00,914336,Boroditsky; Lera,9995,0,9999,4
1748426710442,COGS 230,A00,914337,Munyaka; Imani N. S.,3,0,15,12
1748426711470,COGS 234,A00,970720,Xia; Haijun,4,0,20,16
1748426712503,COGS 260,A00,914340,Voytek; Bradley Thomas,9994,0,9999,5
1748426713533,COMM 10,A01,914366,Whitworth-Smith; Andrew C,6,0,10,4
1748426713533,COMM 10,A02,914367,Whitworth-Smith; Andrew C,7,0,10,3
1748426713533,COMM 10,A03,914368,Whitworth-Smith; Andrew C,9,0,10,1
1748426713533,COMM 10,A04,914369,Whitworth-Smith; Andrew C,6,0,10,4
1748426713533,COMM 10,A05,914370,Whitworth-Smith; Andrew C,10,0,10,0
1748426713533,COMM 10,A06,914371,Whitworth-Smith; Andrew C,9,0,10,1
1748426713533,COMM 10,A07,914372,Whitworth-Smith; Andrew C,9,0,10,1
1748426713533,COMM 10,A08,914373,Whitworth-Smith; Andrew C,7,0,10,3
1748426713533,COMM 10,A09,914374,Whitworth-Smith; Andrew C,9,0,10,1
1748426713533,COMM 10,A10,914375,Whitworth-Smith; Andrew C,10,0,10,0
1748426713533,COMM 10,A11,914376,Whitworth-Smith; Andrew C,6,0,10,4
1748426713533,COMM 10,A12,914377,Whitworth-Smith; Andrew C,10,0,10,0
1748426714560,COMM 20,A01,914385,Hill; Erin Truesdell,75,0,75,0
1748426715591,COMM 40,A00,914386,Jack; Caroline Sarah,61,0,75,14
1748426716619,COMM 50,A00,914387,Staff,21,0,25,4
1748426717648,COMM 80,A01,914389,Staff,77,0,80,3
1748426718674,COMM 100A,A01,914391,Harb; Anthony Joseph,1,0,10,9
1748426718674,COMM 100A,A02,914392,Harb; Anthony Joseph,0,0,10,10
1748426718674,COMM 100A,A03,914393,Harb; Anthony Joseph,0,0,10,10
1748426718674,COMM 100A,A04,914394,Harb; Anthony Joseph,0,0,10,10
1748426718674,COMM 100A,A05,914395,Harb; Anthony Joseph,0,0,10,10
1748426718674,COMM 100A,A06,914396,Harb; Anthony Joseph,0,0,10,10
1748426718674,COMM 100A,A07,914397,Harb; Anthony Joseph,1,0,10,9
1748426718674,COMM 100A,A08,914398,Harb; Anthony Joseph,6,0,10,4
1748426718674,COMM 100A,A09,914399,Harb; Anthony Joseph,7,0,10,3
1748426718674,COMM 100A,A10,914400,Harb; Anthony Joseph,7,0,10,3
1748426719702,COMM 101,A01,914404,Martinico; Daniel J,8,0,15,7
1748426719702,COMM 101,A02,914405,Martinico; Daniel J,2,0,15,13
1748426719702,COMM 101,A03,914406,Martinico; Daniel J,1,0,15,14
1748426719702,COMM 101,A04,914407,Martinico; Daniel J,13,0,15,2
1748426720728,COMM 101K,A00,914408,Staff,0,0,0,0
1748426721754,COMM 101M,A00,914409,Halm; Gavin Patrick,10,0,18,8
1748426722783,COMM 101N,A00,914410,Martinico; Daniel J,4,0,16,12
1748426723815,COMM 101T,A00,914411,Davis; Zeinabu I.,12,0,18,6
1748426724840,COMM 102C,A01,914417,Campion; Camille E,0,0,6,6
1748426724840,COMM 102C,A02,914423,Campion; Camille E,0,0,6,6
1748426724840,COMM 102C,A03,914432,Campion; Camille E,0,0,6,6
1748426725868,COMM 106,A00,914439,Kidman; Shawna F,54,0,70,16
1748426726895,COMM 106F,A00,914442,Hill; Erin Truesdell,23,0,42,19
1748426727926,COMM 106N,A00,914480,Hallin; Daniel C,46,0,70,24
1748426728953,COMM 108D,A00,914491,Goldfarb; Brian,45,0,46,1
1748426729987,COMM 113T,A00,914493,Dominguez Rubio; Fernando,43,0,46,3
1748426731014,COMM 114E,A00,914767,Pavon Aramburu; Maria Laur,41,0,44,3
1748426732041,COMM 114I,A00,914768,Rojo Solis; Juan Jose,39,0,44,5
1748426733072,COMM 115,A00,914769,Alac; Morana,35,0,46,11
1748426734098,COMM 119,A01,914771,Staff,50,0,50,0
1748426735129,COMM 120M,A00,914773,Abuelhiga; Soraya Jill,37,0,44,7
1748426736159,COMM 127,A00,914774,Abuelhiga; Soraya Jill,33,0,44,11
1748426737187,COMM 133,A00,914775,Dewey; Matthew D,35,0,44,9
1748426738286,COMM 134,A00,914777,Kidman; Shawna F,31,0,44,13
1748426739316,COMM 135,A00,914778,Davis; Zeinabu I.,43,0,46,3
1748426740342,COMM 142,A00,914779,McKenna; Denise,22,0,44,22
1748426741370,COMM 146,A00,914780,Halm; Gavin Patrick,34,0,44,10
1748426741370,COMM 146,B00,968068,Ybarra; Megan,41,0,44,3
1748426742408,COMM 148,A00,914785,Staff,0,0,0,0
1748426743435,COMM 164,A00,914786,Dominguez Rubio; Fernando,9,0,25,16
1748426744460,COMM 173,A00,914787,Alac; Morana,4,0,25,21
1748426745487,COMM 177,A00,914788,Rojo Solis; Juan Jose,2,0,25,23
1748426746519,COMM 185,A00,914792,Boateng; Boatema,21,0,25,4
1748426747552,COMM 190,B00,914793,Staff,0,0,23,23
1748426747552,COMM 190,C00,914794,Staff,10,0,23,13
1748426747552,COMM 190,D00,914795,Hassanpour; Anvar,4,0,23,19
1748426748577,COMM 194,A00,954115,Hill; Seth J,9999,0,9999,0
1748426749604,COMM 196A,A00,914796,Dewaard; Andrew Michael,0,0,0,1
1748426750635,CSE 3,A50,914849,Alvarado; Christine J.,49,0,50,1
1748426750635,CSE 3,A51,914850,Alvarado; Christine J.,49,0,50,1
1748426750635,CSE 3,A52,914852,Alvarado; Christine J.,46,0,46,0
1748426751662,CSE 6R,A01,914856,Soosai Raj; Adalbert Geral,238,0,250,12
1748426752698,CSE 8A,A50,914860,Soosai Raj; Adalbert Geral,2,0,3,1
1748426752698,CSE 8A,A51,914868,Soosai Raj; Adalbert Geral,0,0,3,3
1748426752698,CSE 8A,A52,914870,Soosai Raj; Adalbert Geral,1,0,3,2
1748426752698,CSE 8A,A53,914871,Soosai Raj; Adalbert Geral,1,0,3,2
1748426752698,CSE 8A,A54,914872,Soosai Raj; Adalbert Geral,2,0,3,1
1748426752698,CSE 8A,A55,914873,Soosai Raj; Adalbert Geral,2,0,3,1
1748426752698,CSE 8A,A56,914875,Soosai Raj; Adalbert Geral,3,0,3,0
1748426752698,CSE 8A,A57,914876,Soosai Raj; Adalbert Geral,1,0,3,2
1748426753724,CSE 11,A01,958990,Cao; Yingjun,0,0,50,50
1748426753724,CSE 11,B01,959775,Ochoa; Benjamin Lawrence,103,0,115,12
1748426754752,CSE 12,A01,958991,Cao; Yingjun,0,0,100,100
1748426755783,CSE 20,A01,959784,Jones; Miles E,0,0,25,25
1748426755783,CSE 20,A02,968053,Jones; Miles E,1,0,25,24
1748426756809,CSE 21,A01,959776,Jones; Miles E,0,0,30,30
1748426756809,CSE 21,A02,968059,Jones; Miles E,2,0,30,28
1748426757836,CSE 29,A50,914888,Politz; Joseph Gibbs,0,0,10,10
1748426757836,CSE 29,A51,914889,Politz; Joseph Gibbs,0,0,10,10
1748426757836,CSE 29,A52,914891,Politz; Joseph Gibbs,0,0,10,10
1748426757836,CSE 29,A53,914892,Politz; Joseph Gibbs,0,0,10,10
1748426757836,CSE 29,B50,914897,Shalev; Aaron D,0,0,10,10
1748426757836,CSE 29,B51,914898,Shalev; Aaron D,0,0,10,10
1748426757836,CSE 29,B52,914900,Shalev; Aaron D,0,0,10,10
1748426757836,CSE 29,B53,914901,Shalev; Aaron D,0,0,10,10
1748426758877,CSE 30,A01,959778,Eldon; John,0,0,15,15
1748426759906,CSE 87,A00,914904,Moshiri; Niema,20,0,20,0
1748426760934,CSE 89,A00,914906,Minnes Kemp; Mor Mia,100,0,100,0
1748426760934,CSE 89,B00,969276,Minnes Kemp; Mor Mia,100,0,100,0
1748426761962,CSE 95,A00,914907,Cao; Yingjun,100,0,100,0
1748426762991,CSE 100,A01,959787,Moshiri; Niema,0,0,75,75
1748426764018,CSE 100R,A01,914911,Moshiri; Niema,0,0,125,125
1748426765046,CSE 101,A01,958995,Impagliazzo; Russell,0,0,30,30
1748426765046,CSE 101,A02,958998,Impagliazzo; Russell,0,0,30,30
1748426765046,CSE 101,A03,959000,Impagliazzo; Russell,0,0,30,30
1748426765046,CSE 101,B01,959777,Liu; Qipeng,94,0,175,81
1748426766073,CSE 103,A01,959001,Freund; Yoav,69,0,96,27
1748426767105,CSE 105,A01,959785,Lovett; Shachar,0,0,45,45
1748426768132,CSE 107,A01,959002,Bellare; Mihir,81,0,96,15
1748426769163,CSE 110,A50,914923,Coblenz; Michael J,10,0,50,40
1748426769163,CSE 110,A51,914925,Coblenz; Michael J,18,0,50,32
1748426769163,CSE 110,A52,914926,Coblenz; Michael J,44,0,50,6
1748426769163,CSE 110,A53,914928,Coblenz; Michael J,33,0,50,17
1748426769163,CSE 110,A54,914930,Coblenz; Michael J,42,0,50,8
1748426769163,CSE 110,A55,914931,Coblenz; Michael J,36,0,45,9
1748426770192,CSE 118,A50,914934,Weibel; Nadir,16,0,25,9
1748426771219,CSE 120,A01,959780,Voelker; Geoffrey M.,130,0,295,165
1748426772245,CSE 127,A01,959795,Savage; Stefan,88,0,192,104
1748426773277,CSE 130,A01,959003,Polikarpova; Nadezhda,118,0,145,27
1748426774305,CSE 131,A01,914941,Politz; Joseph Gibbs,33,0,50,17
1748426775336,CSE 132A,A01,959790,Gupta; Amarnath,141,0,196,55
1748426776366,CSE 134B,A01,959005,Powell; Thomas Allan,115,0,146,31
1748426777396,CSE 140,A01,914947,Orailoglu; Alex,124,0,146,22
1748426778426,CSE 140L,A01,914949,Orailoglu; Alex,112,0,146,34
1748426779456,CSE 141,A01,959006,Pannuto; Patrick William,79,0,146,67
1748426780485,CSE 141L,A01,961134,Eldon; John,75,0,146,71
1748426781512,CSE 142,A01,959781,Swanson; Steven James,250,0,295,45
1748426782539,CSE 150A,A01,959774,Bonjour; Trevor,101,0,225,124
1748426783570,CSE 150B,A01,959791,Solares; Edwin A,187,0,196,9
1748426784598,CSE 151A,A01,959782,Dasgupta; Sanjoy,186,0,250,64
1748426784598,CSE 151A,B01,959783,Dasgupta; Sanjoy,226,0,250,24
1748426785629,CSE 152A,A01,959792,Su; Hao,0,0,0,0
1748426786656,CSE 158,A01,959793,McAuley; Julian John,100,0,196,96
1748426787683,CSE 158R,A01,914961,McAuley; Julian John,449,0,550,101
1748426787683,CSE 158R,B01,968064,McAuley; Julian John,100,0,100,0
1748426788714,CSE 167,A01,959796,Li; Tzumao,110,0,192,82
1748426789743,CSE 170,A01,914965,Vaccaro; Kristen Marie,13,0,20,7
1748426789743,CSE 170,A02,914967,Vaccaro; Kristen Marie,0,0,20,20
1748426789743,CSE 170,A03,914968,Vaccaro; Kristen Marie,17,0,20,3
1748426789743,CSE 170,A04,914969,Vaccaro; Kristen Marie,15,0,20,5
1748426789743,CSE 170,A05,914970,Vaccaro; Kristen Marie,17,0,20,3
1748426789743,CSE 170,A06,914971,Vaccaro; Kristen Marie,18,0,20,2
1748426789743,CSE 170,A07,914972,Vaccaro; Kristen Marie,16,0,19,3
1748426789743,CSE 170,A08,914973,Vaccaro; Kristen Marie,1,0,19,18
1748426789743,CSE 170,A09,914974,Vaccaro; Kristen Marie,8,0,19,11
1748426789743,CSE 170,A10,969577,Vaccaro; Kristen Marie,18,0,19,1
1748426790771,CSE 190,A00,914975,Vaccaro; Kristen Marie,146,0,146,0
1748426791800,CSE 191,A00,914976,Minnes Kemp; Mor Mia,9999,0,9999,0
1748426792827,CSE 193,A01,959007,Bonjour; Trevor,50,0,50,0
1748426793857,CSE 194,A01,959009,Munyaka; Imani N. S.,6,0,60,54
1748426794886,CSE 197,001,914980,Minnes Kemp; Mor Mia,9999,0,9999,0
1748426795917,CSE 202,A00,914981,Liu; Qipeng,0,0,0,0
1748426796943,CSE 206A,A00,914982,Micciancio; Daniele,0,0,0,0
1748426797969,CSE 207B,A00,914983,Heninger; Nadia A,0,0,0,0
1748426798999,CSE 209A,A00,914984,Impagliazzo; Russell,0,0,0,0
1748426800024,CSE 209B,A00,914985,Bellare; Mihir,0,0,0,0
1748426801051,CSE 210,A00,914986,Powell; Thomas Allan,0,0,0,0
1748426802077,CSE 216,A00,914987,Munyaka; Imani N. S.,0,0,0,0
1748426803103,CSE 221,A00,914988,Ousterhout; Amy,0,0,0,0
1748426804129,CSE 227,A00,914989,Fernandes; Earlence T,0,0,0,0
1748426805160,CSE 229A,A00,914990,Snoeren; Alex C.,0,0,0,0
1748426806191,CSE 229C,A00,914993,Fernandes; Earlence T,0,0,0,0
1748426807219,CSE 237C,A00,914994,Kastner; Ryan Charles,0,0,0,0
1748426808245,CSE 239B,A00,914996,D'Antoni; Loris,0,0,0,0
1748426809275,CSE 240A,A00,914997,Tullsen; Dean Michael,0,0,0,0
1748426810304,CSE 249E,A00,914998,Pannuto; Patrick William,0,0,0,0
1748426811334,CSE 250A,A00,914999,Bonjour; Trevor,0,0,0,0
1748426812365,CSE 252A,A00,915000,Ochoa; Benjamin Lawrence,0,0,0,0
1748426813391,CSE 258,A01,959794,McAuley; Julian John,0,0,0,0
1748426814420,CSE 258R,A01,915004,McAuley; Julian John,0,0,0,0
1748426815446,CSE 259,A00,915005,Prithviraj; Ammanabrolu,0,0,0,0
1748426816473,CSE 260,A01,959011,Chin; Bryan W.,0,0,0,0
1748426817505,CSE 270,A01,959012,Chern; Albert Ren-Haur,0,0,0,0
1748426818530,CSE 276A,A00,915009,Christensen; Henrik I,0,0,0,0
1748426819558,CSE 290,A00,915013,Bafna; Vineet,0,0,0,0
1748426819558,CSE 290,B00,915014,Nakashole; Ndapandula,0,0,0,0
1748426819558,CSE 290,C00,915015,Ramamoorthi; Ravi,0,0,0,0
1748426819558,CSE 290,D00,915017,Tullsen; Dean Michael,0,0,0,0
1748426819558,CSE 290,F00,915020,Vaccaro; Kristen Marie,0,0,0,0
1748426820600,CSE 291A,A00,915021,Yu; Qi,0,0,0,0
1748426820600,CSE 291A,B00,915022,Weibel; Nadir,0,0,0,0
1748426820600,CSE 291A,C00,915049,Munyaka; Imani N. S.,0,0,0,0
1748426820600,CSE 291A,D00,968730,Zhang; Yiying,0,0,0,0
1748426821627,CSE 291P,A00,915050,D'Antoni; Loris,0,0,0,0
1748426821627,CSE 291P,B00,915051,Ding; Yufei,0,0,0,0
1748426822655,CSE 291T,A00,915052,Grier; Daniel T,0,0,0,0
1748426822655,CSE 291T,B00,915053,Heninger; Nadia A,0,0,0,0
1748426823682,CSE 291Y,A00,915054,Fernandes; Earlence T,0,0,0,0
1748426824709,CSE 292,A00,968504,Ousterhout; Amy,0,0,0,0
1748426825796,CSE 293,001,968115,Bafna; Vineet,9999,0,9999,0
1748426825796,CSE 293,002,968116,Bellare; Mihir,9999,0,9999,0
1748426825796,CSE 293,003,968122,Berg-Kirkpatrick; Taylor D,9999,0,9999,0
1748426825796,CSE 293,004,968298,Chandraker; Manmohan Krishna,9999,0,9999,0
1748426825796,CSE 293,005,968317,Cheng; Chung Kuan,9999,0,9999,0
1748426825796,CSE 293,006,968334,Christensen; Henrik I,9999,0,9999,0
1748426825796,CSE 293,007,968339,Coblenz; Michael J,9999,0,9999,0
1748426825796,CSE 293,008,968345,Cottrell; Garrison W,9999,0,9999,0
1748426825796,CSE 293,009,968346,Deutsch; Alin Bernard,9999,0,9999,0
1748426825796,CSE 293,010,968357,Esmaeilzadeh; Hadi,9999,0,9999,0
1748426825796,CSE 293,011,968359,Freund; Yoav,9999,0,9999,0
1748426825796,CSE 293,012,968427,Griswold; William G.,9999,0,9999,0
1748426825796,CSE 293,013,968472,Gymrek; Melissa Ann,9999,0,9999,0
1748426825796,CSE 293,014,968473,Heninger; Nadia A,9999,0,9999,0
1748426825796,CSE 293,015,968480,Impagliazzo; Russell,9999,0,9999,0
1748426825796,CSE 293,016,968489,Jhala; Ranjit,9999,0,9999,0
1748426825796,CSE 293,017,968490,Kahng; Andrew Byun,9999,0,9999,0
1748426825796,CSE 293,018,968494,Kane; Daniel Mertz,9999,0,9999,0
1748426825796,CSE 293,019,968495,Kriegman; David J,9999,0,9999,0
1748426825796,CSE 293,020,968496,Kumar; Arun Kumar,9999,0,9999,0
1748426825796,CSE 293,021,968497,Lerner; Sorin,9999,0,9999,0
1748426825796,CSE 293,022,968498,Lovett; Shachar,9999,0,9999,0
1748426825796,CSE 293,023,968499,McAuley; Julian John,9999,0,9999,0
1748426825796,CSE 293,024,968501,Micciancio; Daniele,9999,0,9999,0
1748426825796,CSE 293,025,968502,Orailoglu; Alex,9999,0,9999,0
1748426825796,CSE 293,026,968503,Pannuto; Patrick William,9999,0,9999,0
1748426825796,CSE 293,027,968505,Paturi; Ramamohan,9999,0,9999,0
1748426825796,CSE 293,028,968506,Polikarpova; Nadezhda,9999,0,9999,0
1748426825796,CSE 293,029,968507,Politz; Joseph Gibbs,9999,0,9999,0
1748426825796,CSE 293,030,968508,Porter; George M,9999,0,9999,0
1748426825796,CSE 293,031,968509,Porter; Leonard Emerson,9999,0,9999,0
1748426825796,CSE 293,032,968510,Ramamoorthi; Ravi,9999,0,9999,0
1748426825796,CSE 293,033,968511,Riek; Laurel D,9999,0,9999,0
1748426825796,CSE 293,034,968512,Sahoo; Debashis,9999,0,9999,0
1748426825796,CSE 293,035,968513,Saul; Lawrence,9999,0,9999,0
1748426825796,CSE 293,036,968514,Savage; Stefan,9999,0,9999,0
1748426825796,CSE 293,037,968515,Schulze; Jurgen P.,9999,0,9999,0
1748426825796,CSE 293,038,968516,Snoeren; Alex C.,9999,0,9999,0
1748426825796,CSE 293,039,968517,Shang; Jingbo,9999,0,9999,0
1748426825796,CSE 293,040,968575,Stefan; Deian,9999,0,9999,0
1748426825796,CSE 293,041,968580,Su; Hao,9999,0,9999,0
1748426825796,CSE 293,042,968589,Swanson; Steven James,9999,0,9999,0
1748426825796,CSE 293,043,968639,Tullsen; Dean Michael,9999,0,9999,0
1748426825796,CSE 293,044,968674,Vaccaro; Kristen Marie,9999,0,9999,0
1748426825796,CSE 293,045,968681,Voelker; Geoffrey M.,9999,0,9999,0
1748426825796,CSE 293,046,968692,Zhao; Jishen,9999,0,9999,0
1748426825796,CSE 293,047,968694,Zhou; Yuan-Yuan,9999,0,9999,0
1748426825796,CSE 293,048,968702,Gao; Sicun,9999,0,9999,0
1748426825796,CSE 293,049,968703,Weibel; Nadir,9999,0,9999,0
1748426825796,CSE 293,050,968704,Gupta; Rajesh K.,9999,0,9999,0
1748426825796,CSE 293,051,968705,Soosai Raj; Adalbert Geral,9999,0,9999,0
1748426826822,CSE 294,A00,915055,Orailoglu; Alex,0,0,0,0
1748426827853,CSS 1,A01,958041,Staff,31,0,41,10
1748426827853,CSS 1,A02,958042,Staff,41,0,41,0
1748426827853,CSS 1,A03,958043,Staff,33,0,41,8
1748426827853,CSS 1,A04,958044,Staff,39,0,41,2
1748426828879,CSS 120,A01,915059,Staff,0,0,0,0
1748426829908,CSS 204,A01,915061,Long; Bria,0,0,0,0
1748426830935,CSS 209,A00,915062,Staff,14,0,40,26
1748426831968,DDPM 200,A00,919742,Ma; Joseph David,35,0,35,0
1748426832996,DDPM 201,A00,919743,Ma; Joseph David,35,0,35,0
1748426834029,DDPM 202,A00,919761,Reed; Chantal,35,0,35,0
1748426835055,DDPM 203,A00,963085,Momper; Jeremiah D,40,0,40,0
1748426836097,DOC 1,A01,916077,Staff,4,0,4,0
1748426836097,DOC 1,A02,916080,Staff,1,0,4,3
1748426836097,DOC 1,A03,916081,Staff,1,0,4,3
1748426836097,DOC 1,A04,916082,Staff,3,0,4,1
1748426836097,DOC 1,A05,916083,Staff,2,0,4,2
1748426836097,DOC 1,A06,916084,Staff,4,0,4,0
1748426836097,DOC 1,A07,916085,Staff,4,0,4,0
1748426836097,DOC 1,A08,916096,Staff,4,0,4,0
1748426836097,DOC 1,A09,916097,Staff,4,0,4,0
1748426836097,DOC 1,A10,916099,Staff,4,0,4,0
1748426836097,DOC 1,A11,916170,Staff,0,0,0,0
1748426836097,DOC 1,A12,916186,Staff,0,0,0,0
1748426836097,DOC 1,A13,916203,Staff,4,0,4,0
1748426836097,DOC 1,A14,916222,Staff,4,0,4,0
1748426836097,DOC 1,A15,916223,Staff,4,0,4,0
1748426836097,DOC 1,A16,916224,Staff,4,0,4,0
1748426836097,DOC 1,B01,916279,Staff,4,0,4,0
1748426836097,DOC 1,B02,916281,Staff,2,0,4,2
1748426836097,DOC 1,B03,916282,Staff,3,0,4,1
1748426836097,DOC 1,B04,916283,Staff,3,0,4,1
1748426836097,DOC 1,B05,916284,Staff,2,0,4,2
1748426836097,DOC 1,B06,916285,Staff,3,0,4,1
1748426836097,DOC 1,B07,916287,Staff,4,0,4,0
1748426836097,DOC 1,B08,916288,Staff,3,0,4,1
1748426836097,DOC 1,B09,916289,Staff,0,0,0,0
1748426836097,DOC 1,B10,916290,Staff,0,0,0,0
1748426836097,DOC 1,B11,916349,Staff,4,0,4,0
1748426836097,DOC 1,B12,916375,Staff,4,0,4,0
1748426836097,DOC 1,B13,916381,Staff,3,0,4,1
1748426836097,DOC 1,B14,916382,Staff,2,0,4,2
1748426836097,DOC 1,B15,916383,Staff,4,0,4,0
1748426836097,DOC 1,B16,916384,Staff,3,0,4,1
1748426836097,DOC 1,C01,916386,Staff,4,0,4,0
1748426836097,DOC 1,C02,916387,Staff,4,0,4,0
1748426836097,DOC 1,C03,916388,Staff,4,0,4,0
1748426836097,DOC 1,C04,916389,Staff,0,0,4,4
1748426836097,DOC 1,C05,916390,Staff,2,0,4,2
1748426836097,DOC 1,C06,916391,Staff,2,0,4,2
1748426836097,DOC 1,C07,916392,Staff,4,0,4,0
1748426836097,DOC 1,C08,916417,Staff,4,0,4,0
1748426836097,DOC 1,C09,916418,Staff,0,0,0,0
1748426836097,DOC 1,C10,916426,Staff,0,0,0,0
1748426836097,DOC 1,C11,916497,Staff,4,0,4,0
1748426836097,DOC 1,C12,916506,Staff,3,0,4,1
1748426836097,DOC 1,C13,916507,Staff,3,0,4,1
1748426836097,DOC 1,C14,916508,Staff,3,0,4,1
1748426836097,DOC 1,C15,916509,Staff,4,0,4,0
1748426836097,DOC 1,C16,916510,Staff,4,0,4,0
1748426836097,DOC 1,D01,916512,Staff,4,0,4,0
1748426836097,DOC 1,D02,916513,Staff,4,0,4,0
1748426836097,DOC 1,D03,916514,Staff,4,0,4,0
1748426836097,DOC 1,D04,916515,Staff,4,0,4,0
1748426836097,DOC 1,D05,916516,Staff,1,0,4,3
1748426836097,DOC 1,D06,916555,Staff,4,0,4,0
1748426836097,DOC 1,D07,916581,Staff,4,0,4,0
1748426836097,DOC 1,D08,916582,Staff,4,0,4,0
1748426836097,DOC 1,D09,916583,Staff,0,0,0,0
1748426836097,DOC 1,D10,916584,Staff,0,0,0,0
1748426836097,DOC 1,D11,916585,Staff,4,0,4,0
1748426836097,DOC 1,D12,916586,Staff,4,0,4,0
1748426836097,DOC 1,D13,916587,Staff,4,0,4,0
1748426836097,DOC 1,D14,916588,Staff,4,0,4,0
1748426836097,DOC 1,D15,916589,Staff,3,0,4,1
1748426836097,DOC 1,D16,916590,Staff,4,0,4,0
1748426837144,DOC 100D,A00,916591,Pass; Natalye,22,0,25,3
1748426837144,DOC 100D,B00,916838,Pass; Natalye,22,0,25,3
1748426838173,DSC 10,A01,915848,Tiefenbruck; Janine LoBue,0,0,0,0
1748426838173,DSC 10,B01,915851,Tiefenbruck; Janine LoBue,0,0,0,0
1748426838173,DSC 10,C01,915854,Tiefenbruck; Janine LoBue,0,0,0,0
1748426839200,DSC 20,A01,915857,Langlois; Marina,87,0,90,3
1748426840228,DSC 30,A01,915859,Liao; Soohyun Nam,175,0,180,5
1748426841255,DSC 40A,A01,915861,Mishne; Gal,167,0,180,13
1748426842339,DSC 40B,A01,915863,Langlois; Marina,126,0,149,23
1748426843369,DSC 80,A01,915865,Eldridge; Justin Matthew,117,0,145,28
1748426843369,DSC 80,B01,915867,Eldridge; Justin Matthew,140,0,145,5
1748426844395,DSC 95,A01,915869,Langlois; Marina,50,0,50,0
1748426845427,DSC 100,A01,915871,Shannon; Kyle Michael,97,0,150,53
1748426846455,DSC 102,A01,915890,Kolovos; Alexandros,128,0,150,22
1748426847489,DSC 106,A01,915892,Lau; Samuel Ethan,74,0,90,16
1748426847489,DSC 106,B01,915894,Lau; Samuel Ethan,53,0,90,37
1748426848516,DSC 140A,A01,915896,Ustun; Tevfik Berk,135,0,150,15
1748426849549,DSC 161,A00,968072,Roberts; Margaret Earling,24,0,25,1
1748426850595,DSC 180A,A01,915898,Bellur; Umesh,0,0,0,0
1748426850595,DSC 180A,A02,969828,Bellur; Umesh,0,0,0,0
1748426850595,DSC 180A,A03,969829,Bellur; Umesh,0,0,0,0
1748426850595,DSC 180A,A04,969830,Bellur; Umesh,0,0,0,0
1748426850595,DSC 180A,A05,969831,Bellur; Umesh,0,0,0,0
1748426850595,DSC 180A,A06,969833,Bellur; Umesh,0,0,0,0
1748426850595,DSC 180A,A07,969835,Bellur; Umesh,0,0,0,0
1748426850595,DSC 180A,A08,969836,Bellur; Umesh,0,0,0,0
1748426850595,DSC 180A,A09,969978,Bellur; Umesh,0,0,0,0
1748426850595,DSC 180A,A10,969985,Bellur; Umesh,0,0,0,0
1748426850595,DSC 180A,A11,969986,Bellur; Umesh,0,0,0,0
1748426850595,DSC 180A,A12,970002,Bellur; Umesh,0,0,0,0
1748426850595,DSC 180A,A13,970008,Bellur; Umesh,0,0,0,0
1748426850595,DSC 180A,A14,970011,Bellur; Umesh,0,0,0,0
1748426850595,DSC 180A,A15,970014,Bellur; Umesh,0,0,0,0
1748426850595,DSC 180A,A16,970019,Bellur; Umesh,0,0,0,0
1748426850595,DSC 180A,A17,970020,Bellur; Umesh,0,0,0,0
1748426850595,DSC 180A,B01,915901,Bellur; Umesh,0,0,0,0
1748426850595,DSC 180A,B02,915902,Bellur; Umesh,0,0,0,0
1748426850595,DSC 180A,B03,970021,Bellur; Umesh,0,0,0,0
1748426850595,DSC 180A,B04,970024,Bellur; Umesh,0,0,0,0
1748426850595,DSC 180A,B05,970025,Bellur; Umesh,0,0,0,0
1748426850595,DSC 180A,B06,970028,Bellur; Umesh,0,0,0,0
1748426850595,DSC 180A,B07,970030,Bellur; Umesh,0,0,0,0
1748426850595,DSC 180A,B08,970031,Bellur; Umesh,0,0,0,0
1748426850595,DSC 180A,B09,970034,Bellur; Umesh,0,0,0,0
1748426850595,DSC 180A,B10,970035,Bellur; Umesh,0,0,0,0
1748426850595,DSC 180A,B11,970042,Bellur; Umesh,0,0,0,0
1748426850595,DSC 180A,B12,970043,Bellur; Umesh,0,0,0,0
1748426850595,DSC 180A,B13,970047,Bellur; Umesh,0,0,0,0
1748426850595,DSC 180A,B14,970049,Bellur; Umesh,0,0,0,0
1748426850595,DSC 180A,B15,970050,Bellur; Umesh,0,0,0,0
1748426850595,DSC 180A,B16,970052,Bellur; Umesh,0,0,0,0
1748426850595,DSC 180A,B17,970057,Bellur; Umesh,0,0,0,0
1748426850595,DSC 180A,B18,970060,Bellur; Umesh,0,0,0,0
1748426850595,DSC 180A,B19,970063,Bellur; Umesh,0,0,0,0
1748426850595,DSC 180A,B20,970068,Bellur; Umesh,0,0,0,0
1748426850595,DSC 180A,B21,970070,Bellur; Umesh,0,0,0,0
1748426850595,DSC 180A,B22,970071,Bellur; Umesh,0,0,0,0
1748426850595,DSC 180A,B23,970075,Bellur; Umesh,0,0,0,0
1748426850595,DSC 180A,B24,970076,Bellur; Umesh,0,0,0,0
1748426850595,DSC 180A,B25,970083,Bellur; Umesh,0,0,0,0
1748426850595,DSC 180A,B26,970072,Bellur; Umesh,0,0,0,0
1748426851624,DSC 190,A01,915904,Schwartzman; Armin,176,0,200,24
1748426851624,DSC 190,C01,915908,Ma; Yian,48,0,60,12
1748426852650,DSC 197,001,971692,Eldridge; Justin Matthew,9999,0,9999,0
1748426853681,DSC 200,A00,915909,Watson-Parris; Duncan,0,0,100,100
1748426854708,DSC 204A,A00,915910,Zhang; Hao,65,0,90,25
1748426855738,DSC 207R,A01,915912,Soosai Raj; Adalbert Geral,99,0,100,1
1748426856764,DSC 209R,A01,915922,Lau; Samuel Ethan,34,0,75,41
1748426857796,DSC 210,A00,915979,Weng; Tsui-Wei (lily),0,0,100,100
1748426858828,DSC 212,A00,915984,Mazumdar; Arya,0,0,90,90
1748426859864,DSC 215R,A01,916032,Saab; Rayan,99,0,100,1
1748426861921,DSC 241,A00,916052,Aoi; Mikio C,81,0,90,9
1748426862948,DSC 256R,A01,916054,McAuley; Julian John,42,0,100,58
1748426863977,DSC 257R,A01,916057,Dasgupta; Sanjoy,50,0,75,25
1748426865007,DSC 261,A00,916058,Salimi; Babak,0,0,90,90
1748426866035,DSC 291,A00,916059,Rahman; Tauhidur,0,0,60,60
1748426866035,DSC 291,B00,916060,Wang; Yuxiang,0,0,60,60
1748426866035,DSC 291,C00,916061,Li; Aobo,0,0,40,40
1748426867061,DSC 293,A00,916062,Ustun; Tevfik Berk,9983,0,9999,16
1748426868103,DSC 294,001,970730,Danks; David J,9999,0,9999,0
1748426868103,DSC 294,002,970731,Hu; Zhiting,9999,0,9999,0
1748426868103,DSC 294,003,970732,Schwartzman; Armin,9999,0,9999,0
1748426868103,DSC 294,004,970739,Salimi; Babak,9999,0,9999,0
1748426868103,DSC 294,005,970742,Wang; Yuxiang,9999,0,9999,0
1748426868103,DSC 294,006,970749,Huang; Biwei,9999,0,9999,0
1748426868103,DSC 294,007,970751,Amariuta-Bartell; Tiffany,9999,0,9999,0
1748426868103,DSC 294,008,970754,Smarr; Benjamin,9999,0,9999,0
1748426868103,DSC 294,009,970755,Jin; Haojian,9999,0,9999,0
1748426868103,DSC 294,010,970758,Ma; Yian,9999,0,9999,0
1748426868103,DSC 294,011,970763,Warstadt; Alexander Scott,9999,0,9999,0
1748426868103,DSC 294,012,970764,Wang; Yusu,9999,0,9999,0
1748426868103,DSC 294,013,970766,Lau; Samuel Ethan,9999,0,9999,0
1748426868103,DSC 294,014,970771,Politis; Dimitris,9999,0,9999,0
1748426869129,DSE 200,A00,915842,Staff,30,0,30,0
1748426870157,DSE 203,A00,915844,Staff,20,0,20,0
1748426871185,DSE 220,A00,915845,Staff,20,0,20,0
1748426872212,DSE 290,A00,915846,Staff,30,0,30,0
1748426873238,DSGN 1,A01,913417,Meyer; Michael Wayne,0,0,50,50
1748426873238,DSGN 1,A02,913418,Meyer; Michael Wayne,15,0,50,35
1748426875297,DSGN 118,A01,914325,Xia; Haijun,0,0,50,50
1748426876324,DSGN 201,A00,970721,Eikey; Elizabeth Victoria,10,0,20,10
1748426877356,ECE 5,A01,917741,Morris; Karcher William,0,0,0,0
1748426877356,ECE 5,A02,917742,Morris; Karcher William,0,0,0,0
1748426877356,ECE 5,A03,917775,Morris; Karcher William,0,0,0,0
1748426877356,ECE 5,A04,917804,Morris; Karcher William,0,0,0,0
1748426877356,ECE 5,A05,917811,Morris; Karcher William,0,0,0,0
1748426877356,ECE 5,A06,917816,Morris; Karcher William,0,0,0,0
1748426878382,ECE 15,A01,917850,Schurgers; Curt,0,0,0,0
1748426878382,ECE 15,A02,917851,Schurgers; Curt,0,0,0,0
1748426879419,ECE 17,A01,917878,Sahay; Rajeev,61,0,65,4
1748426880448,ECE 18,A01,917886,Sahay; Rajeev,42,0,50,8
1748426881477,ECE 25,A50,917898,Liu; Zhaowei,0,0,0,0
1748426881477,ECE 25,A51,917900,Liu; Zhaowei,0,0,0,0
1748426881477,ECE 25,A52,917904,Liu; Zhaowei,0,0,0,0
1748426881477,ECE 25,A53,969573,Liu; Zhaowei,0,0,0,0
1748426882505,ECE 30,A50,917909,Mir Arabbaygi; Siavash,11,0,30,19
1748426882505,ECE 30,A51,917910,Mir Arabbaygi; Siavash,21,0,30,9
1748426882505,ECE 30,A52,917912,Mir Arabbaygi; Siavash,29,0,30,1
1748426883548,ECE 35,A50,917993,Schurgers; Curt,0,0,0,0
1748426883548,ECE 35,A51,917994,Schurgers; Curt,0,0,0,0
1748426883548,ECE 35,A52,918000,Schurgers; Curt,0,0,0,0
1748426883548,ECE 35,A53,918001,Schurgers; Curt,0,0,0,0
1748426883548,ECE 35,A54,918072,Schurgers; Curt,0,0,0,0
1748426883548,ECE 35,A55,918078,Schurgers; Curt,0,0,0,0
1748426883548,ECE 35,B50,918131,Schurgers; Curt,0,0,0,0
1748426883548,ECE 35,B51,918135,Schurgers; Curt,0,0,0,0
1748426883548,ECE 35,B52,918146,Schurgers; Curt,0,0,0,0
1748426883548,ECE 35,B53,918147,Schurgers; Curt,0,0,0,0
1748426883548,ECE 35,B54,918148,Schurgers; Curt,0,0,0,0
1748426883548,ECE 35,B55,918149,Schurgers; Curt,0,0,0,0
1748426884575,ECE 45,A01,918151,Zeger; Kenneth A.,94,0,120,26
1748426885605,ECE 65,A50,918356,Baghdadchi; Saharnaz,1,0,30,29
1748426885605,ECE 65,A51,918470,Baghdadchi; Saharnaz,17,0,30,13
1748426885605,ECE 65,A52,918477,Baghdadchi; Saharnaz,25,0,30,5
1748426886639,ECE 100,A01,918485,Baghdadchi; Saharnaz,0,0,30,30
1748426886639,ECE 100,A02,918486,Baghdadchi; Saharnaz,1,0,30,29
1748426886639,ECE 100,A03,918488,Baghdadchi; Saharnaz,0,0,30,30
1748426886639,ECE 100,A04,918490,Baghdadchi; Saharnaz,22,0,30,8
1748426887687,ECE 101,A01,918495,Zheng; Yang,21,0,75,54
1748426887687,ECE 101,A02,918497,Zheng; Yang,51,0,75,24
1748426888715,ECE 102,A00,918499,Hsueh; Tzu-Chien,52,0,100,48
1748426889756,ECE 103,A01,918621,Ng; Tse Nga,45,0,60,15
1748426890790,ECE 107,A01,918642,Fullerton; Eric E,31,0,70,39
1748426891818,ECE 108,A01,918661,Turakhia; Yatish Girish,6,0,70,64
1748426892853,ECE 109,A01,918758,Poveda Fonseca; Jorge,122,0,149,27
1748426893881,ECE 111,A01,918766,Koushanfar; Farinaz,46,0,75,29
1748426894917,ECE 121A,A50,918857,Esmaili; Gholamreza,11,0,24,13
1748426894917,ECE 121A,A51,918888,Esmaili; Gholamreza,15,0,24,9
1748426894917,ECE 121A,A52,918889,Esmaili; Gholamreza,2,0,24,22
1748426895944,ECE 128A,A00,918911,Esmaili; Gholamreza,53,0,75,22
1748426896976,ECE 135A,A01,918931,Kuzum; Duygu,24,0,40,16
1748426898003,ECE 143,A00,918936,Staff,0,0,0,3
1748426899033,ECE 148,A01,918940,Silberman; Jack,14,0,24,10
1748426900062,ECE 155,A01,919022,Gonzalez Prelcic; Nuria,20,0,25,5
1748426901089,ECE 158A,A01,919041,Javidi; Tara,58,0,70,12
1748426902122,ECE 161A,A01,919070,Meyer; Florian,65,0,80,15
1748426903151,ECE 164,A00,919098,Hall; Drew A.,100,0,146,46
1748426904185,ECE 166,A50,919250,Rebeiz; Gabriel,0,0,30,30
1748426904185,ECE 166,A51,919254,Rebeiz; Gabriel,23,0,30,7
1748426904185,ECE 166,A52,919262,Rebeiz; Gabriel,29,0,30,1
1748426904185,ECE 166,A53,919316,Rebeiz; Gabriel,28,0,30,2
1748426905213,ECE 171B,A01,919338,Shi; Yuanyuan,36,0,50,14
1748426906240,ECE 174,A01,919371,Wang; Jun-Kun,77,0,100,23
1748426907267,ECE 180,A00,968047,Fainman; Yeshaiahu,30,0,30,0
1748426908296,ECE 182,A01,962444,Fainman; Yeshaiahu,24,0,30,6
1748426909320,ECE 197,001,919379,Mercier; Patrick Philip,9999,0,9999,0
1748426910353,ECE 198,001,919418,Nguyen; Truong Quang,9999,0,9999,0
1748426911387,ECE 201,A00,919420,Lo; Yu-Hwa,0,0,0,0
1748426912414,ECE 203,A01,919506,Mercier; Patrick Philip,0,0,0,0
1748426913443,ECE 207A,A00,919507,Liu; Thomas Tao-Ming & McVeigh; Elliot R.,0,0,0,0
1748426914475,ECE 212AN,A00,919508,Nomura; Kenji,0,0,0,0
1748426915506,ECE 222A,A00,919524,Rebeiz; Gabriel,0,0,0,0
1748426916534,ECE 225A,A00,919525,Orlitsky; Alon,0,0,0,0
1748426917561,ECE 230A,A00,919526,Nomura; Kenji,0,0,0,0
1748426918590,ECE 238A,A00,919540,Luo; Jian,0,0,0,0
1748426919616,ECE 240A,A00,919541,Ndao; Abdoulaye,0,0,0,0
1748426920649,ECE 247A,A00,919553,Shi; Lingyan,0,0,0,0
1748426921676,ECE 247B,A00,919562,Aran; Kiana,0,0,0,0
1748426922708,ECE 250,A00,919563,Naghizadeh Ardabili; Parinaz,0,0,0,0
1748426923741,ECE 251C,A00,919583,Parhi; Rahul,0,0,0,0
1748426924768,ECE 253,A00,919597,Nguyen; Truong Quang,0,0,0,0
1748426925795,ECE 255A,A00,919638,Orlitsky; Alon,0,0,0,0
1748426926823,ECE 257A,A01,919640,Zhang; Xinyu,0,0,0,0
1748426927851,ECE 258A,A00,919653,Heath Jr.; Robert Wendell,0,0,0,0
1748426928878,ECE 260A,A01,919655,Eldon; John,0,0,0,0
1748426929908,ECE 264C,A00,919656,Galton; Ian A,0,0,0,0
1748426930936,ECE 265C,A00,919672,Staff,0,0,0,0
1748426931966,ECE 271A,A00,919673,Vasconcelos; Nuno,0,0,0,0
1748426932994,ECE 276C,A00,919674,Yip; Michael,0,0,0,0
1748426934023,ECE 283,A00,919675,Le; Hanh-Phuc,0,0,0,0
1748426934023,ECE 283,B00,919676,Hall; Drew A.,0,0,0,0
1748426935055,ECE 284,A00,919691,Kang; Mingu,0,0,0,0
1748426936081,ECE 285,A00,919718,Naghizadeh Ardabili; Parinaz,0,0,0,0
1748426937116,ECON 1,A01,917129,Famulari; Melissa,33,0,40,7
1748426937116,ECON 1,A02,917130,Famulari; Melissa,39,0,40,1
1748426937116,ECON 1,A03,917131,Famulari; Melissa,45,0,45,0
1748426937116,ECON 1,B01,917133,Famulari; Melissa,39,0,40,1
1748426937116,ECON 1,B02,917134,Famulari; Melissa,38,0,40,2
1748426937116,ECON 1,B03,917135,Famulari; Melissa,45,0,45,0
1748426937116,ECON 1,C01,917137,Levkoff; Steven B.,53,0,60,7
1748426937116,ECON 1,C02,917138,Levkoff; Steven B.,60,0,60,0
1748426937116,ECON 1,C03,917139,Levkoff; Steven B.,59,0,60,1
1748426937116,ECON 1,C04,917140,Levkoff; Steven B.,60,0,60,0
1748426937116,ECON 1,C05,917141,Levkoff; Steven B.,59,0,60,1
1748426937116,ECON 1,D01,917144,Levkoff; Steven B.,44,0,50,6
1748426937116,ECON 1,D02,917145,Levkoff; Steven B.,50,0,50,0
1748426937116,ECON 1,D03,917146,Levkoff; Steven B.,50,0,50,0
1748426937116,ECON 1,D04,917154,Levkoff; Steven B.,50,0,50,0
1748426938144,ECON 2,A01,917160,Crane; Meredith Helen,35,0,45,10
1748426938144,ECON 2,A02,917164,Crane; Meredith Helen,43,0,45,2
1748426939172,ECON 3,A01,917170,Ma; Alyson Chan,41,0,60,19
1748426940200,ECON 4,A01,917174,Brooks; Marcus Raymond,0,0,0,0
1748426941236,ECON 5,A01,917177,Staff,12,0,30,18
1748426941236,ECON 5,B01,917182,Staff,16,0,30,14
1748426941236,ECON 5,C01,917193,Dai; Yinlin,0,0,30,30
1748426942267,ECON 86,A00,917197,Muendler; Marc,95,0,100,5
1748426943303,ECON 100A,A01,917209,Newhouse; Herbert S,32,0,50,18
1748426943303,ECON 100A,A02,917212,Newhouse; Herbert S,34,0,50,16
1748426943303,ECON 100A,A03,917213,Newhouse; Herbert S,41,0,50,9
1748426943303,ECON 100A,B01,917216,Newhouse; Herbert S,0,0,50,50
1748426943303,ECON 100A,B02,917298,Newhouse; Herbert S,21,0,50,29
1748426943303,ECON 100A,B03,917301,Newhouse; Herbert S,44,0,50,6
1748426944332,ECON 100B,A01,917305,Crane; Meredith Helen,0,0,75,75
1748426944332,ECON 100B,B01,917309,Crane; Meredith Helen,0,0,75,75
1748426945362,ECON 100C,A01,917311,Staff,0,0,25,25
1748426946445,ECON 109,A01,917313,Shishkin; Denis,58,0,65,7
1748426946445,ECON 109,B01,917315,Shishkin; Denis,59,0,75,16
1748426947474,ECON 110A,A01,917336,Jaimovich; Nir,44,0,70,26
1748426947474,ECON 110A,B01,917339,Jaimovich; Nir,19,0,37,18
1748426947474,ECON 110A,B02,917341,Jaimovich; Nir,36,0,38,2
1748426948503,ECON 110B,A01,917388,Trottner; Fabian Gunter We,0,0,50,50
1748426948503,ECON 110B,A02,917389,Trottner; Fabian Gunter We,0,0,50,50
1748426948503,ECON 110B,A03,917390,Trottner; Fabian Gunter We,14,0,50,36
1748426948503,ECON 110B,B01,917396,Trottner; Fabian Gunter We,24,0,50,26
1748426949531,ECON 120A,A01,917401,Dai; Yinlin,21,0,50,29
1748426949531,ECON 120A,A02,917405,Dai; Yinlin,40,0,50,10
1748426949531,ECON 120A,B01,917408,Dai; Yinlin,0,0,40,40
1748426949531,ECON 120A,B02,917409,Dai; Yinlin,0,0,40,40
1748426949531,ECON 120A,B03,917410,Dai; Yinlin,30,0,40,10
1748426950568,ECON 120B,A01,917415,Candido; Maria Teresa,0,0,98,98
1748426950568,ECON 120B,A02,917418,Candido; Maria Teresa,78,0,98,20
1748426950568,ECON 120B,B01,917422,Candido; Maria Teresa,33,0,98,65
1748426950568,ECON 120B,B02,917423,Candido; Maria Teresa,75,0,98,23
1748426951599,ECON 120C,A01,917505,Candido; Maria Teresa,81,0,146,65
1748426952633,ECON 121,A00,917511,Vogl; Tom Saul,68,0,70,2
1748426952633,ECON 121,B00,917516,Vogl; Tom Saul,55,0,70,15
1748426953660,ECON 130,A00,917518,Staff,165,0,190,25
1748426954688,ECON 131,A00,917519,Jacobsen; Mark,56,0,120,64
1748426955719,ECON 139,A00,917520,Arnold; David Hall,21,0,50,29
1748426956748,ECON 152,A00,917523,Fadlon; Yizhak,87,0,90,3
1748426956748,ECON 152,B00,917524,Fadlon; Yizhak,88,0,90,2
1748426957778,ECON 181,A00,965256,Esfahani; Sara,88,0,100,12
1748426958810,ECON 186,A00,917525,Ross; Stephen Geoffrey,80,0,110,30
1748426959837,ECON 191B,A00,917527,Cullen; Julie,20,0,20,0
1748426960865,ECON 200A,A00,917529,Shishkin; Denis,20,0,20,0
1748426961897,ECON 204,A00,917531,Watson; Joel Christopher,25,0,25,0
1748426962925,ECON 205,A00,917532,Du; Songzi,20,0,20,0
1748426963952,ECON 210A,A00,917536,Alon; Titan Michael,20,0,20,0
1748426964979,ECON 220A,A00,917537,Elliott; Graham,20,0,20,0
1748426966011,ECON 220D,A00,917538,Hamilton; James D.,22,0,30,8
1748426967050,ECON 221,A00,960527,Zhu; Ying,20,0,20,0
1748426968080,ECON 232,A00,917539,Fadlon; Yizhak,18,0,20,2
1748426969108,ECON 242,A00,917540,Vogl; Tom Saul & Lee; Munseob,17,0,20,3
1748426970137,ECON 250A,A00,917544,Berman; Eli & Betts; Julian & Arnold; David Hall,21,0,25,4
1748426971167,ECON 262,A00,917546,Trevino; Isabel,20,0,20,0
1748426972194,ECON 268,A00,917547,Boomhower; Judson P,18,0,20,2
1748426973220,ECON 280,A00,917549,Arnold; David Hall,20,0,20,0
1748426974249,ECON 281,A00,917550,Jacobsen; Mark,20,0,20,0
1748426974249,ECON 281,B00,917553,Jaimovich; Nir,15,0,20,5
1748426975277,ECON 285,A00,917554,Bharadwaj; Prashant & Zhu; Ying,24,0,25,1
1748426976313,ECON 286,A00,917556,Ma; Xinwei,20,0,20,0
1748426976313,ECON 286,B00,917558,Eckert; Fabian Paul & Wu; Pak Yeung,20,0,20,0
1748426976313,ECON 286,C00,917559,Bharadwaj; Prashant,20,0,20,0
1748426976313,ECON 286,D00,969571,Cullen; Julie,20,0,20,0
1748426976313,ECON 286,E00,969572,Vespa; Emanuel Ignacio,19,0,20,1
1748426977340,ECON 296,A00,917565,Bharadwaj; Prashant & Zhu; Ying,24,0,25,1
1748426978373,EDS 31,A00,960270,Bussey; Thomas J,5,0,10,5
1748426979401,EDS 88,A00,960441,Bintliff; Amy S.V.,16,0,20,4
1748426980430,EDS 110R,A01,943452,Wishard Guerra; Alison G.,33,0,60,27
1748426980430,EDS 110R,B01,960792,Wishard Guerra; Alison G.,20,0,20,0
1748426981458,EDS 111,A00,969314,Cohen; Shana R,31,0,60,29
1748426982484,EDS 112,A00,969313,Chapman; Thandeka K,32,0,50,18
1748426983519,EDS 114,A01,943493,Eguchi; Emi,19,0,20,1
1748426983519,EDS 114,A02,943494,Eguchi; Emi,18,0,20,2
1748426984546,EDS 115,A00,943495,Jones; Gabrielle Anastasia,46,0,60,14
1748426985576,EDS 117,A01,943675,Jones; Makeba,17,0,37,20
1748426985576,EDS 117,A02,943682,Jones; Makeba,36,0,37,1
1748426985576,EDS 117,A03,943683,Jones; Makeba,33,0,38,5
1748426985576,EDS 117,A04,943691,Jones; Makeba,35,0,38,3
1748426985576,EDS 117,B01,943693,Jones; Gabrielle Anastasia,21,0,30,9
1748426985576,EDS 117,B02,943694,Jones; Gabrielle Anastasia,27,0,30,3
1748426985576,EDS 117,B03,943695,Jones; Gabrielle Anastasia,28,0,30,2
1748426985576,EDS 117,B04,943696,Jones; Gabrielle Anastasia,30,0,30,0
1748426986604,EDS 124AR,A00,943698,Simon; Elizabeth A,129,0,150,21
1748426986604,EDS 124AR,B00,943699,Simon; Elizabeth A,149,0,150,1
1748426986604,EDS 124AR,C00,961307,Simon; Elizabeth A,40,0,40,0
1748426987631,EDS 124BR,A00,943700,Eguchi; Emi,122,0,150,28
1748426987631,EDS 124BR,B00,961276,Eguchi; Emi,20,0,20,0
1748426988657,EDS 125,A00,943701,Jones; Gabrielle Anastasia,49,0,60,11
1748426989684,EDS 129A,A01,943703,Heinzman; Erica M.,48,0,50,2
1748426990711,EDS 130,A01,943705,Staff,6,0,20,14
1748426990711,EDS 130,A02,943706,Staff,18,0,20,2
1748426990711,EDS 130,A03,943707,Staff,20,0,20,0
1748426991740,EDS 131,A01,943709,Staff,8,0,20,12
1748426991740,EDS 131,A02,943710,Staff,17,0,20,3
1748426992767,EDS 133,A01,960443,Bintliff; Amy S.V.,20,0,25,5
1748426992767,EDS 133,A02,960447,Bintliff; Amy S.V.,15,0,15,0
1748426993795,EDS 139,A00,943725,Heinzman; Erica M.,40,0,50,10
1748426993795,EDS 139,B00,943726,Staff,29,0,50,21
1748426993795,EDS 139,C00,943788,Staff,34,0,50,16
1748426993795,EDS 139,E00,943802,Bintliff; Amy S.V.,42,0,50,8
1748426993795,EDS 139,F00,960448,Bintliff; Amy S.V.,40,0,40,0
1748426994824,EDS 149,A00,943814,Black; Alison Michelle,20,0,20,0
1748426995853,EDS 201,A00,943816,Fine; Sarah,44,0,45,1
1748426996879,EDS 203,A01,943818,Eguchi; Emi,44,0,45,1
1748426997906,EDS 205A,A00,943819,Staff,44,0,45,1
1748426998934,EDS 246,A01,943855,Cohen; Shana R,10,0,10,0
1748426999964,EDS 250,A00,943856,Chapman; Thandeka K,49,0,50,1
1748427000991,EDS 251,A00,943862,Wishard Guerra; Alison G.,10,0,10,0
1748427002027,EDS 257,A00,943863,Datnow; Amanda Lee,7,0,10,3
1748427003063,EDS 283,A00,943871,Daly; Alan J.,15,0,15,0
1748427004087,EDS 285,A00,943872,Daly; Alan J.,15,0,15,0
1748427005115,EDS 286,A00,943873,Daly; Alan J.,15,0,15,0
1748427006146,EDS 289D,A00,943874,Hofstetter; Carolyn,15,0,15,0
1748427007172,EDS 292,A00,943876,Hofstetter; Carolyn,15,0,15,0
1748427008205,EDS 296,001,970523,Aragon; Maria Jose,9999,0,9999,0
1748427008205,EDS 296,002,970539,Bintliff; Amy S.V.,9997,0,9999,2
1748427008205,EDS 296,003,970543,Chapman; Thandeka K,9999,0,9999,0
1748427008205,EDS 296,004,970544,Clarke; Sherice Nicole,9999,0,9999,0
1748427008205,EDS 296,005,970587,Cohen; Shana R,9998,0,9999,1
1748427008205,EDS 296,006,970606,Daly; Alan J.,9998,0,9999,1
1748427008205,EDS 296,007,970607,Datnow; Amanda Lee,9997,0,9999,2
1748427008205,EDS 296,008,970608,Eguchi; Emi,9999,0,9999,0
1748427008205,EDS 296,009,970609,Fine; Sarah,9999,0,9999,0
1748427008205,EDS 296,010,970614,Hofstetter; Carolyn,9998,0,9999,1
1748427008205,EDS 296,011,970615,Hopkins; Megan Beth,9998,0,9999,1
1748427008205,EDS 296,012,970616,Jones; Makeba,9999,0,9999,0
1748427008205,EDS 296,013,970631,Jones; Gabrielle Anastasia,9999,0,9999,0
1748427008205,EDS 296,014,970636,Mamas; Christoforos,9998,0,9999,1
1748427008205,EDS 296,015,970649,Phuong; Andrew,9999,0,9999,0
1748427008205,EDS 296,016,970670,Pollock; Mica,9999,0,9999,0
1748427008205,EDS 296,017,970671,Wishard Guerra; Alison G.,9998,0,9999,1
1748427009232,EDS 297,001,972987,Staff,1,0,1,0
1748427010259,ENG 5,A00,916064,Rodriguez; Ruben,70,0,70,0
1748427011286,ENG 10,A00,916066,Evdokimenko; Ekaterina,58,0,60,2
1748427012321,ENG 15,A00,916067,Evdokimenko; Ekaterina,24,0,30,6
1748427013350,ENG 100D,A00,916069,Ngo; Anh-Thu T.,23,0,50,27
1748427014386,ENG 100L,A00,916070,Kleissl; Jan,8,0,8,0
1748427014386,ENG 100L,B00,916071,Bratton; Maryann,8,0,8,0
1748427014386,ENG 100L,C00,916072,Goldberg; Charles G.,8,0,8,0
1748427014386,ENG 100L,D00,916073,de Oliveira; Mauricio,8,0,8,0
1748427014386,ENG 100L,E00,916074,Bratton; Maryann,8,0,8,0
1748427014386,ENG 100L,F00,916075,Boyle; Mary E. T.,8,0,8,0
1748427015418,ENVR 30,A01,959899,Amoa-Bosompem; Michael,17,0,30,13
1748427015418,ENVR 30,A02,959900,Amoa-Bosompem; Michael,27,0,30,3
1748427015418,ENVR 30,A03,959901,Amoa-Bosompem; Michael,26,0,30,4
1748427015418,ENVR 30,A04,959902,Amoa-Bosompem; Michael,28,0,30,2
1748427015418,ENVR 30,A05,959903,Amoa-Bosompem; Michael,29,0,30,1
1748427015418,ENVR 30,A06,959904,Amoa-Bosompem; Michael,30,0,30,0
1748427016452,ENVR 102,A00,960031,Laughing; Cheron,23,0,25,2
1748427017481,ERC 20,A00,921227,Evans; Ivan T,30,0,30,0
1748427017481,ERC 20,B00,921229,Evans; Ivan T,30,0,30,0
1748427018513,ERC 88,A00,961214,Peterson; Johanna L,19,0,20,1
1748427019541,ESYS 101,A01,921233,Taylor; Jennifer Rebecca,21,0,32,11
1748427019541,ESYS 101,A02,921234,Taylor; Jennifer Rebecca,14,0,32,18
1748427019541,ESYS 101,A03,921235,Taylor; Jennifer Rebecca,20,0,32,12
1748427019541,ESYS 101,A04,921241,Taylor; Jennifer Rebecca,26,0,32,6
1748427020567,ESYS 187A,A01,921248,Hetherington; Elizabeth Dorsey,30,0,40,10
1748427020567,ESYS 187A,B01,921250,Shipp; Lauren Elizabeth,27,0,40,13
1748427021616,ETHN 1,A01,919800,Wilson; Brenda K,13,0,15,2
1748427021616,ETHN 1,A02,919843,Wilson; Brenda K,14,0,15,1
1748427021616,ETHN 1,A03,920214,Wilson; Brenda K,15,0,15,0
1748427021616,ETHN 1,A04,920215,Wilson; Brenda K,14,0,15,1
1748427021616,ETHN 1,A05,920223,Wilson; Brenda K,15,0,15,0
1748427021616,ETHN 1,A06,920224,Wilson; Brenda K,15,0,15,0
1748427021616,ETHN 1,A07,920225,Wilson; Brenda K,15,0,15,0
1748427021616,ETHN 1,A08,920226,Wilson; Brenda K,12,0,15,3
1748427021616,ETHN 1,A09,920237,Wilson; Brenda K,15,0,15,0
1748427021616,ETHN 1,A10,920368,Wilson; Brenda K,15,0,15,0
1748427021616,ETHN 1,A11,920402,Wilson; Brenda K,15,0,15,0
1748427021616,ETHN 1,A12,920406,Wilson; Brenda K,15,0,15,0
1748427021616,ETHN 1,A13,920410,Wilson; Brenda K,14,0,15,1
1748427021616,ETHN 1,A14,920441,Wilson; Brenda K,14,0,15,1
1748427022649,ETHN 20R,A01,920461,Sasaki; Christen T,0,0,15,15
1748427022649,ETHN 20R,A02,920467,Sasaki; Christen T,0,0,15,15
1748427022649,ETHN 20R,A03,920468,Sasaki; Christen T,0,0,15,15
1748427022649,ETHN 20R,A04,920470,Sasaki; Christen T,0,0,15,15
1748427023681,ETHN 100A,A00,920489,Patel; Shaista,18,0,35,17
1748427024709,ETHN 101TV,A01,920518,Gallagher-Geurtsen; Tricia Meghan,21,0,25,4
1748427024709,ETHN 101TV,A02,920519,Gallagher-Geurtsen; Tricia Meghan,20,0,25,5
1748427024709,ETHN 101TV,A03,920522,Gallagher-Geurtsen; Tricia Meghan,24,0,25,1
1748427024709,ETHN 101TV,A04,920523,Gallagher-Geurtsen; Tricia Meghan,22,0,25,3
1748427025737,ETHN 110,A00,920528,Klann; Mary Cameron,27,0,35,8
1748427026768,ETHN 116,A00,920529,Cuong; Marisol,29,0,35,6
1748427027800,ETHN 120,A00,920542,Tran; Ly Thi Hai,31,0,35,4
1748427028833,ETHN 122A,A00,920559,Museus; Samuel David,30,0,35,5
1748427029866,ETHN 125R,A00,920694,Sasaki; Christen T,0,0,35,35
1748427030897,ETHN 130,A00,920703,Frank; Ross H.,28,0,30,2
1748427031930,ETHN 139,A00,920704,Ruiz; Ariana,18,0,20,2
1748427032957,ETHN 150,A00,920717,Taylor-Garcia; Daphne,16,0,16,0
1748427033985,ETHN 161,A00,920826,Browne; Errol Tsekani,33,0,35,2
1748427035015,ETHN 174,A00,963091,Staff,15,0,15,0
1748427036043,ETHN 186,A00,959881,Perez; Roy,25,0,30,5
1748427037071,ETHN 187,A00,920860,Martin Sandino; Amanda Maria Yoland,16,0,16,0
1748427038106,ETHN 189,A00,920861,Museus; Samuel David,18,0,20,2
1748427039139,ETHN 200A,A00,920862,Espiritu; Yen,7,0,10,3
1748427040166,ETHN 230,A00,920864,Perreira; Christopher Michael,8,0,10,2
1748427041197,ETIM 289,A00,921224,Patel; Shaista,10,0,10,0
1748427042225,EXPR 100,A00,964355,Staff,9999,0,9999,0
1748427043255,EXPR 105,A00,964356,Staff,9999,0,9999,0
1748427044284,EXPR 201,A00,964357,Staff,9999,0,9999,0
1748427045312,EXPR 205,A00,964358,Staff,9999,0,9999,0
1748427046339,FILM 71,A01,960804,Park; Joanne Moeun,0,0,11,11
1748427046339,FILM 71,B01,960877,Park; Joanne Moeun,3,0,11,8
1748427047373,FILM 72,A01,964349,Kroopf; Jackson Stanford,9,0,11,2
1748427047373,FILM 72,B01,964351,Kroopf; Jackson Stanford,9,0,11,2
1748427048400,FILM 73,A01,964345,Staff,0,0,0,0
1748427048400,FILM 73,B01,964347,Kroopf; Jackson Stanford,7,0,11,4
1748427049427,FMPH 291,A00,969582,Tsuyuki; Kiyomi,10,0,10,0
1748427050509,FPM 291,A00,922036,Rabin; Adrienn Borsika & Stadnick; Nicole & Aarons; Gregory A,12,0,12,0
1748427051547,GLBH 20,A00,921344,Elwardani; Nile Regina,137,0,146,9
1748427052575,GLBH 100,A00,921503,Jenkins; Janis A.,5,0,12,7
1748427052575,GLBH 100,B00,921504,Schonberg; Jeffrey,18,0,20,2
1748427053611,GLBH 111,A01,921733,Burgos; Jose L.,17,0,17,0
1748427053611,GLBH 111,B01,921862,Burgos; Jose L.,17,0,17,0
1748427054638,GLBH 114,A00,921864,Olivas Hernandez; Olga Lid,42,0,50,8
1748427055667,GLBH 116,A00,921865,Villarino; Margarita,41,0,45,4
1748427056699,GLBH 117,A00,921873,Villarino; Margarita,40,0,40,0
1748427057725,GLBH 118,A00,921884,Wilson; Brenda K,25,0,32,7
1748427058754,GLBH 119,A00,921956,Elwardani; Nile Regina,40,0,40,0
1748427059782,GLBH 148,A00,921961,Walkover; Lillian B,75,0,100,25
1748427060809,GLBH 181,A00,921962,Burgos; Jose L.,188,0,216,28
1748427061838,GLBH 200,A00,921963,Schonberg; Jeffrey,15,0,18,3
1748427062865,GLBH 201,A00,921982,Staff,16,0,18,2
1748427063891,GLBH 248,A00,921999,Kaiser; Bronwyn Nicole,16,0,18,2
1748427064920,GPEC 243,A00,946441,McCord; Gordon Carlos,96,0,100,4
1748427065949,GSS 20,A00,923030,Siapno; Jacqueline A,38,0,40,2
1748427065949,GSS 20,B00,923031,Siapno; Jacqueline A,36,0,40,4
1748427066979,HDS 1,A01,923033,Reese; Clarissa Jane,25,0,25,0
1748427066979,HDS 1,A02,923034,Reese; Clarissa Jane,20,0,25,5
1748427066979,HDS 1,A03,923035,Reese; Clarissa Jane,19,0,25,6
1748427066979,HDS 1,A04,923036,Reese; Clarissa Jane,22,0,25,3
1748427066979,HDS 1,A05,923037,Reese; Clarissa Jane,22,0,25,3
1748427066979,HDS 1,A06,923038,Reese; Clarissa Jane,23,0,25,2
1748427066979,HDS 1,A07,923039,Reese; Clarissa Jane,24,0,25,1
1748427068006,HDS 60,A01,923041,Staff,25,0,30,5
1748427068006,HDS 60,A02,923042,Staff,21,0,30,9
1748427069036,HDS 111,A00,923043,Staff,13,0,40,27
1748427070065,HDS 124,A00,923044,Staff,29,0,40,11
1748427071094,HDS 150,A00,923045,Staff,20,0,20,0
1748427072123,HDS 175,A00,923046,Staff,14,0,25,11
1748427073152,HDS 181,A01,923048,Staff,30,0,30,0
1748427074180,HDS 191,A01,923050,Reese; Clarissa Jane,25,0,25,0
1748427075210,HIEA 112,A00,922103,Matsumura; Wendy Y,92,0,115,23
1748427076244,HIEA 153,A00,922106,Henry; Todd A.,43,0,51,8
1748427077271,HIEU 108,A00,922108,Balberg; Mira,29,0,70,41
1748427078302,HIEU 114,A00,959889,Staff,59,0,70,11
1748427079337,HIEU 139,A00,922110,Strasser; Ulrike,40,0,51,11
1748427080363,HIEU 140,A00,922111,Radcliff; Pamela B.,58,0,65,7
1748427081394,HIEU 154,A00,922113,Hansen; Jan Eric,55,0,65,10
1748427082429,HIEU 158,A00,922116,Hertz; Deborah,61,0,70,9
1748427083457,HIEU 171,A00,922117,Hertz; Deborah,15,0,15,0
1748427084484,HIEU 271,A00,922189,Hertz; Deborah,0,0,0,0
1748427085515,HIGR 200,A00,922191,Matsumura; Wendy Y,10,0,10,0
1748427086548,HIGR 210,A00,922221,Muscolino; Micah S,8,0,10,2
1748427087577,HIGR 222,A00,963094,Biess; Frank Peter,10,0,10,0
1748427088609,HIGR 238,A00,922242,McKenzie; Kerry V.,9,0,10,1
1748427089636,HIGR 240,A00,922253,McKenzie; Kerry V.,10,0,10,0
1748427090663,HIGR 267A,A00,922256,Widener; Daniel,8,0,10,2
1748427092727,HILA 114,A00,922118,Cowan; Benjamin A,42,0,65,23
1748427093756,HILA 131,A00,922125,Vitz; Matthew,91,0,99,8
1748427094784,HILA 161,A00,922126,Cowan; Benjamin A,12,0,15,3
1748427095823,HILD 2A,A01,922043,Staff,31,0,32,1
1748427095823,HILD 2A,A02,922044,Staff,31,0,32,1
1748427095823,HILD 2A,A03,922046,Staff,28,0,32,4
1748427095823,HILD 2A,A04,922047,Staff,32,0,32,0
1748427095823,HILD 2A,A05,922051,Staff,30,0,32,2
1748427096851,HILD 7A,A01,922063,Widener; Daniel,31,0,32,1
1748427096851,HILD 7A,A02,922066,Widener; Daniel,31,0,32,1
1748427096851,HILD 7A,A03,922067,Widener; Daniel,32,0,32,0
1748427096851,HILD 7A,A04,922070,Widener; Daniel,28,0,32,4
1748427096851,HILD 7A,A05,922072,Widener; Daniel,32,0,32,0
1748427096851,HILD 7A,A06,922074,Widener; Daniel,32,0,32,0
1748427096851,HILD 7A,A07,922078,Widener; Daniel,29,0,32,3
1748427096851,HILD 7A,A08,922080,Widener; Daniel,32,0,32,0
1748427096851,HILD 7A,A09,922081,Widener; Daniel,32,0,32,0
1748427096851,HILD 7A,A10,922082,Widener; Daniel,32,0,32,0
1748427096851,HILD 7A,A11,922083,Widener; Daniel,32,0,32,0
1748427096851,HILD 7A,A12,922084,Widener; Daniel,32,0,32,0
1748427097879,HILD 10,A01,922089,Muscolino; Micah S,30,0,32,2
1748427097879,HILD 10,A02,922090,Muscolino; Micah S,28,0,32,4
1748427097879,HILD 10,A03,922092,Muscolino; Micah S,31,0,32,1
1748427097879,HILD 10,A04,922095,Muscolino; Micah S,30,0,32,2
1748427098913,HILD 14,A01,959886,Murillo; Dana V.,26,0,32,6
1748427098913,HILD 14,A02,959887,Murillo; Dana V.,32,0,32,0
1748427099942,HINE 144,A00,922132,Provence; Michael,40,0,45,5
1748427100968,HINE 186,A00,922133,Provence; Michael,15,0,15,0
1748427101999,HISA 110,A00,922136,De; Aniket,38,0,45,7
1748427103030,HISA 122,A00,959884,De; Aniket,12,0,15,3
1748427104059,HISC 107,A00,922137,Golan; Tal,41,0,45,4
1748427105089,HISC 131,A00,922148,Golan; Tal,45,0,51,6
1748427106116,HITO 87,A00,922097,Patterson; Patrick H.,0,0,0,0
1748427106116,HITO 87,B00,922098,Patterson; Patrick H.,0,0,0,0
1748427107155,HITO 100,A00,922150,Martinez-Matsuda; Veronica,0,0,17,17
1748427108191,HITO 193,A00,954127,Hill; Seth J,9999,0,9999,0
1748427109230,HITO 194,001,970059,Hertz; Deborah,1,0,1,0
1748427109230,HITO 194,002,970084,Daly; Heather Marie,1,0,1,0
1748427109230,HITO 194,003,970086,Plant; Rebecca Jo,1,0,1,0
1748427109230,HITO 194,004,970093,Henry; Todd A.,1,0,1,0
1748427109230,HITO 194,005,970094,Biess; Frank Peter,1,0,1,0
1748427109230,HITO 194,006,970095,Shafir; Nir,1,0,1,0
1748427109230,HITO 194,007,970099,Martinez-Matsuda; Veronica,1,0,1,0
1748427109230,HITO 194,008,970101,De; Aniket,1,0,1,0
1748427109230,HITO 194,009,970126,Kwak; Nancy,1,0,1,0
1748427109230,HITO 194,010,970128,Muscolino; Micah S,1,0,1,0
1748427109230,HITO 194,011,970129,Hendrickson; Gerald M.,1,0,1,0
1748427109230,HITO 194,012,970132,Balberg; Mira,1,0,1,0
1748427110261,HITO 196,A00,922151,Man; Simeon S,14,0,22,8
1748427111288,HIUS 105,A00,922152,Bermudez; Rosie Cano,22,0,35,13
1748427112320,HIUS 106,A00,922154,Bermudez; Rosie Cano,52,0,65,13
1748427113351,HIUS 144,A00,922156,Daly; Heather Marie,31,0,35,4
1748427114389,HIUS 158,A00,922163,Frank; Ross H.,12,0,20,8
1748427115421,HIUS 181,A00,922187,Daly; Heather Marie,8,0,15,7
1748427116450,HIUS 281,A00,922264,Daly; Heather Marie,0,0,0,0
1748427117488,HUM 1,A01,946360,Markman; Kristina,14,0,15,1
1748427117488,HUM 1,A02,946361,Markman; Kristina,12,0,15,3
1748427117488,HUM 1,A03,946362,Markman; Kristina,14,0,15,1
1748427117488,HUM 1,A04,946363,Markman; Kristina,11,0,15,4
1748427117488,HUM 1,A05,946364,Markman; Kristina,14,0,15,1
1748427117488,HUM 1,A06,946365,Markman; Kristina,14,0,15,1
1748427117488,HUM 1,A07,946366,Markman; Kristina,14,0,15,1
1748427117488,HUM 1,A08,946367,Markman; Kristina,12,0,15,3
1748427117488,HUM 1,A09,946368,Markman; Kristina,13,0,15,2
1748427117488,HUM 1,A10,946369,Markman; Kristina,11,0,15,4
1748427117488,HUM 1,A11,946370,Markman; Kristina,6,0,15,9
1748427117488,HUM 1,A12,946371,Markman; Kristina,15,0,15,0
1748427118527,HUM 3,A01,946373,West; Geoffrey Scott,20,0,28,8
1748427118527,HUM 3,A02,946374,West; Geoffrey Scott,14,0,28,14
1748427118527,HUM 3,A03,946375,West; Geoffrey Scott,13,0,28,15
1748427118527,HUM 3,A04,946376,West; Geoffrey Scott,9,0,28,19
1748427118527,HUM 3,A05,946377,West; Geoffrey Scott,8,0,28,20
1748427118527,HUM 3,A06,946378,West; Geoffrey Scott,22,0,28,6
1748427118527,HUM 3,A07,946379,West; Geoffrey Scott,23,0,28,5
1748427118527,HUM 3,A08,946380,West; Geoffrey Scott,15,0,28,13
1748427118527,HUM 3,A09,946381,West; Geoffrey Scott,0,0,0,0
1748427118527,HUM 3,A10,946382,West; Geoffrey Scott,0,0,0,0
1748427118527,HUM 3,C01,946393,Crum; Matthew Stephen,0,0,0,0
1748427118527,HUM 3,C02,946394,Crum; Matthew Stephen,0,0,0,0
1748427118527,HUM 3,C03,946395,Crum; Matthew Stephen,17,0,28,11
1748427118527,HUM 3,C04,946396,Crum; Matthew Stephen,25,0,28,3
1748427118527,HUM 3,C05,946397,Crum; Matthew Stephen,16,0,28,12
1748427118527,HUM 3,C06,946398,Crum; Matthew Stephen,20,0,28,8
1748427118527,HUM 3,C07,946399,Crum; Matthew Stephen,24,0,28,4
1748427118527,HUM 3,C08,946400,Crum; Matthew Stephen,26,0,28,2
1748427118527,HUM 3,C09,946401,Crum; Matthew Stephen,18,0,28,10
1748427118527,HUM 3,C10,946402,Crum; Matthew Stephen,22,0,28,6
1748427118527,HUM 3,D01,946404,Rodriguez; Bretton Sigfred,4,0,28,24
1748427118527,HUM 3,D02,946405,Rodriguez; Bretton Sigfred,16,0,28,12
1748427118527,HUM 3,D03,946406,Rodriguez; Bretton Sigfred,25,0,28,3
1748427118527,HUM 3,D04,946407,Rodriguez; Bretton Sigfred,12,0,28,16
1748427118527,HUM 3,D05,946408,Rodriguez; Bretton Sigfred,12,0,28,16
1748427118527,HUM 3,D06,946409,Rodriguez; Bretton Sigfred,19,0,28,9
1748427118527,HUM 3,D07,946410,Rodriguez; Bretton Sigfred,0,0,0,0
1748427118527,HUM 3,D08,946411,Rodriguez; Bretton Sigfred,0,0,0,0
1748427118527,HUM 3,D09,946412,Rodriguez; Bretton Sigfred,7,0,28,21
1748427118527,HUM 3,D10,946413,Rodriguez; Bretton Sigfred,20,0,28,8
1748427119555,HUM 88,A00,969578,Markman; Kristina,0,0,0,0
1748427120592,HUM 100,A00,946414,West; Geoffrey Scott,14,0,16,2
1748427120592,HUM 100,B00,946415,West; Geoffrey Scott,15,0,16,1
1748427120592,HUM 100,C00,946416,Zavodny; Tatiana Sophia,13,0,16,3
1748427120592,HUM 100,D00,946417,Zavodny; Tatiana Sophia,15,0,16,1
1748427120592,HUM 100,E00,946419,Zavodny; Tatiana Sophia,15,0,16,1
1748427120592,HUM 100,F00,946420,Crum; Matthew Stephen,0,0,0,0
1748427120592,HUM 100,G00,946421,Crum; Matthew Stephen,0,0,0,0
1748427120592,HUM 100,H00,946422,Crum; Matthew Stephen,16,0,16,0
1748427120592,HUM 100,I00,946424,Staff,0,0,0,0
1748427120592,HUM 100,J00,946425,Crum; Matthew Stephen,16,0,16,0
1748427120592,HUM 100,K00,946426,Staff,0,0,0,0
1748427121633,INTL 100,A01,960908,Feuer; Anna Stagg,9,0,20,11
1748427121633,INTL 100,A02,960964,Feuer; Anna Stagg,16,0,20,4
1748427121633,INTL 100,A03,961088,Feuer; Anna Stagg,15,0,20,5
1748427121633,INTL 100,A04,961091,Feuer; Anna Stagg,17,0,20,3
1748427121633,INTL 100,A05,961100,Feuer; Anna Stagg,16,0,20,4
1748427121633,INTL 100,A06,961130,Feuer; Anna Stagg,19,0,20,1
1748427122675,INTL 101,A01,923053,McIntosh; Justin,1,0,30,29
1748427122675,INTL 101,A02,923055,McIntosh; Justin,8,0,30,22
1748427122675,INTL 101,A03,923127,McIntosh; Justin,5,0,30,25
1748427122675,INTL 101,A04,923140,McIntosh; Justin,0,0,30,30
1748427122675,INTL 101,A05,923148,McIntosh; Justin,9,0,30,21
1748427122675,INTL 101,A06,923186,McIntosh; Justin,10,0,30,20
1748427123703,INTL 102,A01,923194,Prather; Lauren R,3,0,30,27
1748427123703,INTL 102,A02,923195,Prather; Lauren R,4,0,30,26
1748427123703,INTL 102,A03,923199,Prather; Lauren R,13,0,30,17
1748427123703,INTL 102,A04,923202,Prather; Lauren R,8,0,30,22
1748427124731,INTL 190,A00,923203,Segui; Alan S,0,0,0,5
1748427124731,INTL 190,B00,923205,Segui; Alan S,0,0,0,9
1748427124731,INTL 190,C00,923219,Lee; Munseob,0,0,0,5
1748427125758,INTL 190H,A00,923247,Feuer; Anna Stagg,0,0,0,1
1748427126797,JAPN 10A,A01,923258,Kamioka; Sachiko,22,0,23,1
1748427126797,JAPN 10A,B01,923261,Ross; Kayoko F,23,0,23,0
1748427126797,JAPN 10A,C01,923265,Sato; Kyoko,20,0,23,3
1748427126797,JAPN 10A,D01,923268,Inada; Minori,22,0,23,1
1748427126797,JAPN 10A,E01,923270,Tipton; Yuko,9,0,12,3
1748427126797,JAPN 10A,E02,923273,Tipton; Yuko,12,0,12,0
1748427126797,JAPN 10A,F01,923352,Ross; Kayoko F,11,0,12,1
1748427126797,JAPN 10A,F02,923355,Ross; Kayoko F,12,0,12,0
1748427126797,JAPN 10A,G01,923358,McKee; Mayumi Mochizuki,7,0,10,3
1748427126797,JAPN 10A,G02,923360,McKee; Mayumi Mochizuki,6,0,10,4
1748427126797,JAPN 10A,H01,923365,Sato; Kyoko,8,0,12,4
1748427126797,JAPN 10A,H02,923370,Sato; Kyoko,12,0,12,0
1748427126797,JAPN 10A,I01,923373,Inada; Minori,8,0,12,4
1748427126797,JAPN 10A,I02,923374,Inada; Minori,8,0,12,4
1748427126797,JAPN 10A,J01,923376,McKee; Mayumi Mochizuki,11,0,12,1
1748427126797,JAPN 10A,J02,923428,McKee; Mayumi Mochizuki,11,0,12,1
1748427126797,JAPN 10A,K01,923433,Tipton; Yuko,5,0,10,5
1748427126797,JAPN 10A,K02,923437,Tipton; Yuko,9,0,10,1
1748427126797,JAPN 10A,L01,923439,Sato; Kyoko,12,0,12,0
1748427126797,JAPN 10A,L02,923449,Sato; Kyoko,11,0,12,1
1748427126797,JAPN 10A,M01,923455,Kamioka; Sachiko,22,0,23,1
1748427126797,JAPN 10A,N01,923459,McKee; Mayumi Mochizuki,22,0,23,1
1748427127829,JAPN 10AR,A01,923462,Tipton; Yuko,17,0,20,3
1748427128873,JAPN 20A,A01,923470,Takeda; Izumi,21,0,23,2
1748427128873,JAPN 20A,B01,923473,Iwamoto; Naoki,9,0,12,3
1748427128873,JAPN 20A,B02,923475,Iwamoto; Naoki,6,0,12,6
1748427128873,JAPN 20A,C01,923519,Takeda; Izumi,0,0,12,12
1748427128873,JAPN 20A,C02,923520,Takeda; Izumi,4,0,12,8
1748427128873,JAPN 20A,D01,923623,Iwamoto; Naoki,11,0,12,1
1748427128873,JAPN 20A,D02,923625,Iwamoto; Naoki,11,0,12,1
1748427128873,JAPN 20A,E01,923627,Simpson; Junko Tokuda,12,0,20,8
1748427129905,JAPN 130A,A01,923630,Kamioka; Sachiko,14,0,15,1
1748427129905,JAPN 130A,B01,923634,Ross; Kayoko F,11,0,15,4
1748427130936,JAPN 135A,A00,923636,Iwamoto; Naoki,10,0,20,10
1748427131962,JAPN 137A,A00,923638,Simpson; Junko Tokuda,19,0,20,1
1748427132991,JAPN 140A,A00,923640,Takeda; Izumi,18,0,20,2
1748427134019,JWSP 1,A01,921258,Shuster; Alana,19,0,20,1
1748427135051,JWSP 104,A01,921340,Shuster; Alana,15,0,15,0
1748427136081,LATI 10,A01,923694,Kennemore; Amy Michelle,22,0,28,6
1748427136081,LATI 10,A02,923695,Kennemore; Amy Michelle,25,0,28,3
1748427136081,LATI 10,A03,923707,Kennemore; Amy Michelle,25,0,28,3
1748427136081,LATI 10,A04,923713,Kennemore; Amy Michelle,27,0,28,1
1748427136081,LATI 10,A05,923720,Kennemore; Amy Michelle,28,0,28,0
1748427136081,LATI 10,A06,923723,Kennemore; Amy Michelle,30,0,30,0
1748427136081,LATI 10,A07,923745,Kennemore; Amy Michelle,26,0,30,4
1748427137110,LATI 50,A01,923778,Kokinis; Troy Andreas,27,0,30,3
1748427137110,LATI 50,A02,923779,Kokinis; Troy Andreas,28,0,30,2
1748427137110,LATI 50,A03,923780,Kokinis; Troy Andreas,29,0,30,1
1748427137110,LATI 50,A04,923783,Kokinis; Troy Andreas,28,0,30,2
1748427137110,LATI 50,A05,923784,Kokinis; Troy Andreas,30,0,30,0
1748427138142,LATI 166,A00,923785,Kokinis; Troy Andreas,117,0,120,3
1748427139168,LATI 170,A00,923787,Kennemore; Amy Michelle,45,0,60,15
1748427140195,LATI 180,A00,923788,Kennemore; Amy Michelle,52,0,60,8
1748427141226,LATI 184,A00,923790,Jimenez Cano; Nayeli Guada,29,0,30,1
1748427142253,LATI 200,A00,923791,Martin-Cabrera; Luis,7,0,10,3
1748427143282,LIAB 1A,A00,923983,Saab; Dima,12,0,14,2
1748427143282,LIAB 1A,B00,923984,Saab; Dima,8,0,14,6
1748427144313,LIAB 1AX,A00,923992,El Cheddadi; Youniss,25,0,28,3
1748427145344,LIAB 1D,A00,923996,Saab; Dima,7,0,14,7
1748427146369,LIAB 1DX,A00,923998,El Cheddadi; Youniss,10,0,14,4
1748427147400,LIFR 1A,A00,923999,Van Moer; Vinciane G,14,0,14,0
1748427147400,LIFR 1A,B00,924001,Van Moer; Vinciane G,14,0,14,0
1748427147400,LIFR 1A,C00,924003,Van Moer; Vinciane G,13,0,14,1
1748427147400,LIFR 1A,D00,924039,Van Moer; Vinciane G,12,0,14,2
1748427147400,LIFR 1A,E00,924044,Van Moer; Vinciane G,12,0,14,2
1748427147400,LIFR 1A,F00,924100,Van Moer; Vinciane G,10,0,14,4
1748427148428,LIFR 1AX,A00,924134,Van Moer; Vinciane G,26,0,28,2
1748427148428,LIFR 1AX,B00,924138,Van Moer; Vinciane G,24,0,28,4
1748427148428,LIFR 1AX,C00,924196,Van Moer; Vinciane G,26,0,28,2
1748427149454,LIFR 1B,A00,924197,Van Moer; Vinciane G,11,0,14,3
1748427149454,LIFR 1B,B00,924199,Van Moer; Vinciane G,11,0,14,3
1748427150483,LIFR 1BX,A00,924215,Van Moer; Vinciane G,23,0,28,5
1748427151514,LIFR 1D,A00,924216,Van Moer; Vinciane G,11,0,14,3
1748427151514,LIFR 1D,B00,924217,Van Moer; Vinciane G,12,0,14,2
1748427151514,LIFR 1D,C00,924218,Van Moer; Vinciane G,3,0,14,11
1748427152545,LIFR 1DX,A00,924219,Van Moer; Vinciane G,14,0,21,7
1748427152545,LIFR 1DX,B00,924220,Van Moer; Vinciane G,13,0,21,8
1748427153575,LIFR 11,A00,924221,Goodall; Grant Todd,10,0,10,0
1748427154663,LIGM 1A,A00,924222,Fischer-Grunski; Eva K,11,0,14,3
1748427154663,LIGM 1A,B00,924223,Fischer-Grunski; Eva K,13,0,14,1
1748427154663,LIGM 1A,C00,924224,Fischer-Grunski; Eva K,11,0,14,3
1748427154663,LIGM 1A,D00,924227,Fischer-Grunski; Eva K,11,0,14,3
1748427155694,LIGM 1AX,A00,924228,Fischer-Grunski; Eva K,28,0,28,0
1748427155694,LIGM 1AX,B00,924229,Fischer-Grunski; Eva K,19,0,28,9
1748427156725,LIGM 1D,A00,924230,Fischer-Grunski; Eva K,0,0,0,0
1748427156725,LIGM 1D,B00,924231,Fischer-Grunski; Eva K,12,0,14,2
1748427157756,LIGM 1DX,A00,924232,Fischer-Grunski; Eva K,0,0,0,0
1748427158782,LIGM 11,A00,924233,Goodall; Grant Todd,10,0,10,0
1748427159813,LIGN 5,A00,923794,Goodall; Grant Todd,112,0,120,8
1748427160839,LIGN 7,A00,923796,Mayberry; Rachel,115,0,120,5
1748427161865,LIGN 8,A00,923797,McIntosh; Justin,231,0,245,14
1748427162895,LIGN 17,A00,923798,Staff,232,0,245,13
1748427163932,LIGN 101,A01,923929,Bakovic; Eric John,26,0,30,4
1748427163932,LIGN 101,A02,923930,Bakovic; Eric John,26,0,30,4
1748427163932,LIGN 101,A04,923935,Bakovic; Eric John,19,0,30,11
1748427163932,LIGN 101,A05,923940,Bakovic; Eric John,23,0,30,7
1748427164963,LIGN 108,A00,923942,Rose; Sharon,29,0,35,6
1748427165993,LIGN 110,A01,923944,Garellek; Marc,15,0,27,12
1748427165993,LIGN 110,A02,923947,Garellek; Marc,14,0,27,13
1748427165993,LIGN 110,A03,923948,Garellek; Marc,20,0,27,7
1748427165993,LIGN 110,A04,923949,Garellek; Marc,4,0,27,23
1748427167021,LIGN 152,A00,967971,Caballero; Gabriela Hernandez,17,0,30,13
1748427168048,LIGN 160,A00,963083,Dudley; Rachel,39,0,50,11
1748427169077,LIGN 167,A00,923951,Warstadt; Alexander Scott,0,0,90,90
1748427170107,LIGN 179,A00,923955,Kluender; Robert,0,0,35,35
1748427171134,LIGN 188R,A00,923956,Clem; Emily,40,0,40,0
1748427172161,LIGN 200,A00,973075,Staff,0,0,0,0
1748427173187,LIGN 210,A00,923962,Garellek; Marc,10,0,10,0
1748427174214,LIGN 221,A00,923964,Clem; Emily,9,0,10,1
1748427175241,LIGN 236,A00,923965,Clem; Emily,8,0,10,2
1748427176268,LIGN 293,A00,923971,Caballero; Gabriela Hernandez,0,0,0,0
1748427177311,LIGN 296,001,950061,Ackerman; Farrell,10,0,10,0
1748427177311,LIGN 296,002,950062,Bakovic; Eric John,10,0,10,0
1748427177311,LIGN 296,003,950063,Bergen; Leon,10,0,10,0
1748427177311,LIGN 296,004,950064,Caballero; Gabriela Hernandez,10,0,10,0
1748427177311,LIGN 296,005,950065,Caponigro; Ivano,10,0,10,0
1748427177311,LIGN 296,006,950066,Clem; Emily,10,0,10,0
1748427177311,LIGN 296,007,950067,Dudley; Rachel,10,0,10,0
1748427177311,LIGN 296,008,950068,Garellek; Marc,10,0,10,0
1748427177311,LIGN 296,009,950070,Goodall; Grant Todd,9,0,10,1
1748427177311,LIGN 296,010,950071,Kehler; Andrew Scott,10,0,10,0
1748427177311,LIGN 296,011,950072,Kluender; Robert,10,0,10,0
1748427177311,LIGN 296,012,950073,Rose; Sharon,10,0,10,0
1748427177311,LIGN 296,013,950074,Styler; William Francis,10,0,10,0
1748427177311,LIGN 296,014,950075,Caponigro; Ivano,10,0,10,0
1748427178343,LIHL 112F,A00,923972,Pagkalinawan; Leticia Cant,15,0,28,13
1748427179368,LIHL 114F,A00,923973,Nguyen; Hoan Thi,8,0,28,20
1748427180401,LIHL 117F,A00,923974,Sadegholvad; Elham,19,0,20,1
1748427181434,LIHL 118,A00,923975,Chen; Areana Yen,23,0,28,5
1748427182462,LIHL 124F,A00,923976,Nguyen; Hoan Thi,17,0,20,3
1748427183488,LIHL 132F,A00,923978,Pagkalinawan; Leticia Cant,18,0,20,2
1748427184518,LIHL 134F,A00,923980,Nguyen; Hoan Thi,19,0,20,1
1748427185545,LIHL 138,A00,923982,Chen; Areana Yen,28,0,28,0
1748427186573,LIIT 1A,A00,924234,Carnelos; Chiara,11,0,14,3
1748427186573,LIIT 1A,B00,924235,Carnelos; Chiara,11,0,14,3
1748427186573,LIIT 1A,C00,924236,Carnelos; Chiara,13,0,14,1
1748427186573,LIIT 1A,D00,924237,Carnelos; Chiara,12,0,14,2
1748427187607,LIIT 1AX,A00,924238,Carnelos; Chiara,28,0,28,0
1748427187607,LIIT 1AX,B00,924239,Carnelos; Chiara,24,0,28,4
1748427188641,LIPO 1A,A00,924241,Paladini; Denise,13,0,14,1
1748427188641,LIPO 1A,B00,924242,Paladini; Denise,14,0,14,0
1748427189674,LIPO 1AX,A00,924243,De Abreu; Cassia,13,0,14,1
1748427189674,LIPO 1AX,B00,924244,De Abreu; Cassia,14,0,14,0
1748427190704,LIPO 1D,A00,924245,Paladini; Denise,11,0,14,3
1748427191732,LIPO 1DX,A00,924248,De Abreu; Cassia,14,0,14,0
1748427192761,LISL 1A,A00,924249,Lott; Margaret S.,9,0,14,5
1748427192761,LISL 1A,B00,924250,Lott; Margaret S.,11,0,14,3
1748427192761,LISL 1A,C00,924252,Lott; Margaret S.,7,0,14,7
1748427192761,LISL 1A,D00,924253,Lott; Margaret S.,12,0,14,2
1748427192761,LISL 1A,E00,924254,Lott; Margaret S.,4,0,14,10
1748427192761,LISL 1A,F00,924255,Lott; Margaret S.,13,0,14,1
1748427193796,LISL 1AR,A00,924257,Lott; Margaret S.,11,0,15,4
1748427193796,LISL 1AR,B00,924258,Lott; Margaret S.,10,0,15,5
1748427193796,LISL 1AR,C00,924260,Lott; Margaret S.,9,0,15,6
1748427193796,LISL 1AR,D00,968060,Lott; Margaret S.,3,0,3,0
1748427193796,LISL 1AR,E00,968061,Lott; Margaret S.,3,0,3,0
1748427193796,LISL 1AR,F00,968062,Lott; Margaret S.,3,0,3,0
1748427194823,LISL 1AX,A00,924261,Lott; Margaret S.,28,0,28,0
1748427194823,LISL 1AX,B00,924262,Lott; Margaret S.,18,0,28,10
1748427194823,LISL 1AX,C00,924263,Lott; Margaret S.,21,0,28,7
1748427195854,LISL 1B,A00,924264,Lott; Margaret S.,13,0,14,1
1748427195854,LISL 1B,B00,924265,Lott; Margaret S.,6,0,14,8
1748427195854,LISL 1B,C00,924302,Lott; Margaret S.,9,0,14,5
1748427195854,LISL 1B,D00,924304,Lott; Margaret S.,7,0,14,7
1748427195854,LISL 1B,E00,924305,Lott; Margaret S.,10,0,14,4
1748427195854,LISL 1B,F00,964375,Lott; Margaret S.,12,0,14,2
1748427196888,LISL 1BX,A00,924307,Lott; Margaret S.,12,0,28,16
1748427196888,LISL 1BX,B00,924308,Lott; Margaret S.,20,0,28,8
1748427196888,LISL 1BX,C00,924314,Lott; Margaret S.,28,0,28,0
1748427197916,LISL 1D,A00,924316,Lott; Margaret S.,0,0,14,14
1748427197916,LISL 1D,B00,924317,Lott; Margaret S.,0,0,14,14
1748427197916,LISL 1D,C00,924319,Lott; Margaret S.,0,0,14,14
1748427197916,LISL 1D,D00,924321,Lott; Margaret S.,0,0,14,14
1748427198948,LISL 1DX,A00,924323,Lott; Margaret S.,0,0,28,28
1748427198948,LISL 1DX,B00,924365,Lott; Margaret S.,0,0,28,28
1748427199976,LISP 1A,A00,924370,Munoz Sanchez; Alicia,12,0,14,2
1748427199976,LISP 1A,B00,924372,Munoz Sanchez; Alicia,8,0,14,6
1748427199976,LISP 1A,C00,924401,Munoz Sanchez; Alicia,0,0,14,14
1748427199976,LISP 1A,D00,924406,Munoz Sanchez; Alicia,3,0,14,11
1748427199976,LISP 1A,E00,924471,Munoz Sanchez; Alicia,0,0,14,14
1748427199976,LISP 1A,F00,924472,Munoz Sanchez; Alicia,4,0,14,10
1748427199976,LISP 1A,G00,924473,Munoz Sanchez; Alicia,11,0,14,3
1748427199976,LISP 1A,H00,924474,Munoz Sanchez; Alicia,9,0,14,5
1748427201009,LISP 1AX,A00,924478,Munoz Sanchez; Alicia,16,0,28,12
1748427201009,LISP 1AX,B00,924479,Munoz Sanchez; Alicia,26,0,28,2
1748427201009,LISP 1AX,C00,924484,Munoz Sanchez; Alicia,12,0,28,16
1748427201009,LISP 1AX,D00,924491,Munoz Sanchez; Alicia,18,0,28,10
1748427202040,LISP 1B,A00,924492,Munoz Sanchez; Alicia,12,0,14,2
1748427202040,LISP 1B,B00,924493,Munoz Sanchez; Alicia,6,0,14,8
1748427202040,LISP 1B,C00,924498,Munoz Sanchez; Alicia,13,0,14,1
1748427202040,LISP 1B,D00,924501,Munoz Sanchez; Alicia,13,0,14,1
1748427202040,LISP 1B,E00,924505,Munoz Sanchez; Alicia,11,0,14,3
1748427202040,LISP 1B,F00,924506,Munoz Sanchez; Alicia,9,0,14,5
1748427202040,LISP 1B,G00,924507,Munoz Sanchez; Alicia,10,0,14,4
1748427202040,LISP 1B,H00,924549,Munoz Sanchez; Alicia,12,0,14,2
1748427202040,LISP 1B,I00,924566,Munoz Sanchez; Alicia,13,0,14,1
1748427202040,LISP 1B,J00,924572,Munoz Sanchez; Alicia,13,0,14,1
1748427202040,LISP 1B,K00,924576,Munoz Sanchez; Alicia,12,0,14,2
1748427202040,LISP 1B,L00,924577,Munoz Sanchez; Alicia,13,0,14,1
1748427203074,LISP 1BX,A00,924578,Munoz Sanchez; Alicia,26,0,28,2
1748427203074,LISP 1BX,B00,924618,Munoz Sanchez; Alicia,24,0,28,4
1748427203074,LISP 1BX,C00,924619,Munoz Sanchez; Alicia,20,0,28,8
1748427203074,LISP 1BX,D00,924629,Munoz Sanchez; Alicia,24,0,28,4
1748427203074,LISP 1BX,E00,924635,Munoz Sanchez; Alicia,24,0,28,4
1748427203074,LISP 1BX,F00,924640,Munoz Sanchez; Alicia,27,0,28,1
1748427204111,LISP 1D,A00,924641,Munoz Sanchez; Alicia,10,0,14,4
1748427204111,LISP 1D,B00,924649,Munoz Sanchez; Alicia,10,0,14,4
1748427204111,LISP 1D,C00,924654,Munoz Sanchez; Alicia,11,0,14,3
1748427204111,LISP 1D,D00,924660,Munoz Sanchez; Alicia,7,0,14,7
1748427204111,LISP 1D,E00,924671,Munoz Sanchez; Alicia,5,0,14,9
1748427204111,LISP 1D,F00,924722,Munoz Sanchez; Alicia,6,0,14,8
1748427204111,LISP 1D,G00,924724,Munoz Sanchez; Alicia,8,0,14,6
1748427204111,LISP 1D,H00,924726,Munoz Sanchez; Alicia,9,0,14,5
1748427204111,LISP 1D,I00,924728,Munoz Sanchez; Alicia,13,0,14,1
1748427204111,LISP 1D,J00,924732,Munoz Sanchez; Alicia,14,0,14,0
1748427204111,LISP 1D,K00,924739,Munoz Sanchez; Alicia,13,0,14,1
1748427204111,LISP 1D,L00,924745,Munoz Sanchez; Alicia,12,0,14,2
1748427205147,LISP 1DX,A00,924747,Munoz Sanchez; Alicia,23,0,28,5
1748427205147,LISP 1DX,B00,924818,Munoz Sanchez; Alicia,27,0,28,1
1748427205147,LISP 1DX,C00,924819,Munoz Sanchez; Alicia,16,0,28,12
1748427205147,LISP 1DX,D00,924820,Munoz Sanchez; Alicia,23,0,28,5
1748427205147,LISP 1DX,E00,924821,Munoz Sanchez; Alicia,16,0,28,12
1748427205147,LISP 1DX,F00,924822,Munoz Sanchez; Alicia,22,0,28,6
1748427206178,LISP 15,A00,924823,Munoz Sanchez; Alicia,17,0,20,3
1748427207208,LISP 18,A00,924824,Munoz Sanchez; Alicia,14,0,20,6
1748427208241,LTAF 120,A00,925431,Zhiri; Oumelbanine,37,0,40,3
1748427209271,LTAM 100,A00,925432,Villafuerte Vazquez; Nadia,33,0,40,7
1748427210301,LTCH 101,A00,964372,Liao; Ping H,35,0,40,5
1748427211329,LTCO 285,A00,925806,Glaser; Amelia,0,0,0,0
1748427212355,LTCS 10,A00,924830,Bessett; Ryan Matthew,39,0,40,1
1748427213383,LTCS 87,A00,969580,Nguyen; Hoang Tan,20,0,20,0
1748427213383,LTCS 87,B00,969581,Nguyen; Hoang Tan,20,0,20,0
1748427214411,LTCS 130,A00,925434,Kim; Joo Ok,36,0,40,4
1748427215437,LTCS 150,A00,925435,Mendoza; Andrea,36,0,40,4
1748427216465,LTCS 250,A00,925807,Sanchez Cruz; Jorge,9,0,15,6
1748427217492,LTEA 120A,A00,925438,Fiss; Geraldine Anna,16,0,40,24
1748427218521,LTEA 120B,A00,925439,Liao; Ping H,211,0,225,14
1748427219555,LTEA 132,A00,925441,Mendoza; Andrea,66,0,75,9
1748427220585,LTEA 143,A00,925443,Lee; Jin-Kyung,72,0,75,3
1748427221612,LTEA 145,A00,925444,Lee; Jin-Kyung,39,0,40,1
1748427222646,LTEN 21,A01,924832,Vitkus; Daniel J.,23,0,28,5
1748427222646,LTEN 21,A02,924833,Vitkus; Daniel J.,28,0,28,0
1748427223681,LTEN 28,A01,924835,Suzuki; Erin M.,26,0,28,2
1748427223681,LTEN 28,A02,924836,Suzuki; Erin M.,25,0,28,3
1748427223681,LTEN 28,A03,924837,Suzuki; Erin M.,25,0,28,3
1748427223681,LTEN 28,A04,924838,Suzuki; Erin M.,28,0,28,0
1748427223681,LTEN 28,A05,924839,Suzuki; Erin M.,28,0,28,0
1748427223681,LTEN 28,A06,924840,Suzuki; Erin M.,28,0,28,0
1748427223681,LTEN 28,A07,924841,Suzuki; Erin M.,28,0,28,0
1748427223681,LTEN 28,A08,924842,Suzuki; Erin M.,28,0,28,0
1748427224709,LTEN 113,A00,925449,Vitkus; Daniel J.,31,0,40,9
1748427225741,LTEN 152,A00,925450,Staff,13,0,40,27
1748427226773,LTEN 169,A00,925451,Ruiz; Ariana,34,0,40,6
1748427227803,LTEN 180,A00,925452,Ruiz; Ariana,9,0,20,11
1748427228833,LTEN 181,A00,925453,Suzuki; Erin M.,27,0,40,13
1748427229860,LTEN 185,A00,963086,Staff,23,0,25,2
1748427230887,LTEN 189,A00,925458,Vijay; Ameeth Varma,35,0,40,5
1748427231917,LTEN 271,A00,925808,Garofalo; Devin,13,0,15,2
1748427232944,LTEU 140,A00,925459,De Marchi Gherini; Adriana,33,0,40,7
1748427233976,LTEU 154,A00,925461,Morse; Ainsley,25,0,30,5
1748427235005,LTFR 2A,A01,924916,Ploye; Catherine,20,0,25,5
1748427236034,LTFR 2B,A01,924920,Ploye; Catherine,25,0,25,0
1748427237061,LTFR 104,A00,925462,Ploye; Catherine,25,0,25,0
1748427238104,LTGK 1,A00,924923,Murray; Kourtney Kristine,34,0,40,6
1748427239136,LTGK 104,A00,925465,Myerston Santana; Jacobo,29,0,30,1
1748427240163,LTGM 2A,A01,924926,Fischer-Grunski; Eva K,19,0,25,6
1748427241196,LTIT 2A,A01,925054,De Marchi Gherini; Adriana,19,0,25,6
1748427242227,LTKO 1A,A01,925085,Cho; Hye Jin,25,0,28,3
1748427242227,LTKO 1A,B01,925182,Cho; Hye Jin,25,0,28,3
1748427242227,LTKO 1A,C01,925210,Cho; Hye Jin,23,0,28,5
1748427242227,LTKO 1A,D01,925229,Staff,27,0,28,1
1748427242227,LTKO 1A,E01,925246,Staff,25,0,28,3
1748427242227,LTKO 1A,F01,925248,Yim; Nancy,26,0,28,2
1748427242227,LTKO 1A,G01,925323,Yim; Nancy,26,0,28,2
1748427242227,LTKO 1A,H01,925331,Yim; Nancy,25,0,28,3
1748427243261,LTKO 2A,A01,925333,Jung; Ji Yun,14,0,28,14
1748427243261,LTKO 2A,B01,925335,Jung; Ji Yun,24,0,28,4
1748427243261,LTKO 2A,C01,925338,Lee; Jeyseon,26,0,28,2
1748427244293,LTKO 130F,A00,925468,Lee; Jeyseon,22,0,25,3
1748427245319,LTLA 1,A00,925339,Murray; Kourtney Kristine,0,0,20,20
1748427246349,LTLA 100,A00,925470,Murray; Kourtney Kristine,39,0,40,1
1748427247377,LTRU 1A,A01,925342,Wells; Patricia Rebecca,22,0,28,6
1748427248402,LTRU 2A,A01,925345,Wells; Patricia Rebecca,19,0,20,1
1748427249433,LTRU 104B,A01,925473,Wells; Patricia Rebecca,20,0,20,0
1748427250460,LTRU 150,A00,925474,Morse; Ainsley,10,0,10,0
1748427251492,LTSP 2A,A01,925347,Staff,22,0,28,6
1748427251492,LTSP 2A,B01,925349,Staff,24,0,28,4
1748427252519,LTSP 2B,A01,925351,Staff,17,0,28,11
1748427253548,LTSP 2C,A01,925353,Mastromartino; Alexandra L,22,0,28,6
1748427254577,LTSP 2F,A00,925354,Mastromartino; Alexandra L,25,0,25,0
1748427255605,LTSP 3F,A00,925355,Dominguez; Noelia,24,0,25,1
1748427255605,LTSP 3F,B00,925356,Dominguez; Noelia,22,0,25,3
1748427256632,LTSP 87,A00,925357,Bessett; Ryan Matthew,20,0,20,0
1748427257660,LTSP 100A,A00,925595,Dominguez; Noelia,21,0,25,4
1748427258747,LTSP 100F,A00,925621,Bessett; Ryan Matthew,25,0,25,0
1748427258747,LTSP 100F,B00,925623,Bessett; Ryan Matthew,25,0,25,0
1748427258747,LTSP 100F,C00,925626,Martin-Cabrera; Luis,25,0,25,0
1748427259776,LTSP 116,A00,925629,Villafuerte Vazquez; Nadia,35,0,40,5
1748427260806,LTSP 172,A00,925637,Chacon; Gloria Elizabeth,36,0,40,4
1748427261833,LTSP 174,A00,925639,Chacon; Gloria Elizabeth,34,0,40,6
1748427262866,LTTH 210A,A00,925809,Fiss; Geraldine Anna,6,0,15,9
1748427263892,LTWL 10,A00,925358,Garofalo; Devin,40,0,40,0
1748427264923,LTWL 19A,A00,925360,Myerston Santana; Jacobo,39,0,40,1
1748427265952,LTWL 101,A00,925661,Kelting; Edward William,32,0,40,8
1748427266979,LTWL 165,A00,925748,Kim; Joo Ok,40,0,40,0
1748427268005,LTWL 167,A00,964371,Glaser; Amelia,40,0,40,0
1748427269036,LTWL 183,A00,925755,Cohen; Alain J. J.,34,0,40,6
1748427270062,LTWL 194,A00,925757,Vijay; Ameeth Varma,38,0,40,2
1748427271095,LTWR 8A,A01,925362,Springer; Anna Joy,28,0,28,0
1748427271095,LTWR 8A,A02,925363,Springer; Anna Joy,23,0,28,5
1748427271095,LTWR 8A,A03,925364,Springer; Anna Joy,23,0,28,5
1748427271095,LTWR 8A,A04,925365,Springer; Anna Joy,18,0,28,10
1748427272122,LTWR 8B,A01,925368,Lopez; Casandra,18,0,28,10
1748427272122,LTWR 8B,A02,925370,Lopez; Casandra,19,0,28,9
1748427272122,LTWR 8B,A03,925371,Lopez; Casandra,28,0,28,0
1748427272122,LTWR 8B,A04,925372,Lopez; Casandra,26,0,28,2
1748427273149,LTWR 100C,A00,925759,Staff,16,0,30,14
1748427274178,LTWR 100W,A00,925760,Forbes; Camille,0,0,15,15
1748427275208,LTWR 102W,A00,925761,Lopez; Casandra,6,0,15,9
1748427276235,LTWR 104AW,A00,925762,Hoang; Lily Kim,5,0,15,10
1748427277263,LTWR 106C,A00,925764,Ali; Mohammad Kazim,22,0,30,8
1748427278289,LTWR 113C,A00,925765,Wilkinson; Marco,28,0,30,2
1748427279322,LTWR 115C,A00,925766,Ali; Mohammad Kazim,23,0,30,7
1748427280349,LTWR 124C,A00,925801,Morse; Ainsley,29,0,30,1
1748427281376,LTWR 126C,A00,925802,Forbes; Camille,28,0,30,2
1748427282412,LTWR 148,A00,925804,Wilkinson; Marco,27,0,30,3
1748427283441,LTWR 194,A00,925805,Carroll; Amy Sara,30,0,40,10
1748427284473,LTWR 215,A00,925934,Hoang; Lily Kim,13,0,20,7
1748427285498,LTWR 220,A00,925935,Springer; Anna Joy,10,0,15,5
1748427286531,MAE 2,A01,931344,Anderson; Mark Ronald,0,0,1,1
1748427286531,MAE 2,A02,931345,Anderson; Mark Ronald,0,0,1,1
1748427286531,MAE 2,A03,931347,Anderson; Mark Ronald,0,0,1,1
1748427286531,MAE 2,B01,960499,Sadeghizadeh; Zahra,0,0,1,1
1748427286531,MAE 2,B02,960500,Sadeghizadeh; Zahra,0,0,1,1
1748427286531,MAE 2,B03,960501,Sadeghizadeh; Zahra,0,0,1,1
1748427287559,MAE 3,A01,931355,Delson; Nathan Joseph,8,0,11,3
1748427287559,MAE 3,A02,931356,Delson; Nathan Joseph,10,0,11,1
1748427287559,MAE 3,A03,931357,Delson; Nathan Joseph,10,0,11,1
1748427287559,MAE 3,A04,931358,Delson; Nathan Joseph,11,0,11,0
1748427287559,MAE 3,B01,931360,Qi; Huihui,0,0,11,11
1748427287559,MAE 3,B02,931361,Qi; Huihui,5,0,11,6
1748427287559,MAE 3,B03,931362,Qi; Huihui,9,0,11,2
1748427287559,MAE 3,B04,931364,Qi; Huihui,10,0,11,1
1748427288589,MAE 8,A01,931368,Pham; Hieu Tan,90,0,100,10
1748427289615,MAE 11,A00,931369,Nomura; Keiko K.,83,0,180,97
1748427290642,MAE 20,A00,931371,Graeve; Olivia A,79,0,100,21
1748427291676,MAE 21,A01,931373,Cai; Shengqiang,1,0,10,9
1748427291676,MAE 21,A02,931375,Cai; Shengqiang,7,0,10,3
1748427291676,MAE 21,A03,931376,Cai; Shengqiang,1,0,10,9
1748427291676,MAE 21,A04,931377,Cai; Shengqiang,5,0,10,5
1748427291676,MAE 21,A05,931378,Cai; Shengqiang,10,0,10,0
1748427291676,MAE 21,A06,931381,Cai; Shengqiang,10,0,10,0
1748427291676,MAE 21,A07,931382,Cai; Shengqiang,8,0,10,2
1748427291676,MAE 21,A08,931384,Cai; Shengqiang,7,0,10,3
1748427291676,MAE 21,A09,931385,Cai; Shengqiang,8,0,10,2
1748427291676,MAE 21,A10,931386,Cai; Shengqiang,9,0,10,1
1748427292707,MAE 30A,A00,931387,Lubarda; Marko,29,0,70,41
1748427293734,MAE 40,A00,931388,Cortes; Jorge,83,0,146,63
1748427294785,MAE 101A,A00,931389,Sarkar; Sutanu,94,0,150,56
1748427295816,MAE 101C,A00,931390,Seshadri; Kalyanasundaram,175,0,200,25
1748427296845,MAE 104,A00,931391,Pham; Hieu Tan,146,0,160,14
1748427297872,MAE 105,A00,931392,Bandaru; Prabhakar,135,0,180,45
1748427298902,MAE 107,A00,931393,Chen; Renkun,0,0,90,90
1748427298902,MAE 107,B00,931394,McEneaney; William Michael,45,0,90,45
1748427299930,MAE 108,A00,931395,Hao; Xuanting,91,0,120,29
1748427300962,MAE 113,A00,931396,Seshadri; Kalyanasundaram,92,0,130,38
1748427301995,MAE 114,A00,931399,Krasheninnikov; Sergei,37,0,40,3
1748427303023,MAE 120,A00,931400,Krasheninnikov; Sergei,36,0,50,14
1748427304056,MAE 122,A00,931402,Pawlak; Geno Ronald,43,0,70,27
1748427305085,MAE 131A,A00,931403,Lubarda; Marko,46,0,70,24
1748427306111,MAE 142,A00,931404,Anderson; Mark Ronald,21,0,60,39
1748427307137,MAE 143A,A00,931406,Diagne; Mamadou Lamine,98,0,125,27
1748427308167,MAE 148,A01,931409,Silberman; Jack,11,0,30,19
1748427309196,MAE 150,A00,931411,Friend; James Robert,139,0,192,53
1748427310223,MAE 153,A00,931413,Ghazinejad; Maziar,2,0,45,43
1748427311248,MAE 156A,A01,931416,Delson; Nathan Joseph,2,0,12,10
1748427311248,MAE 156A,A02,931417,Delson; Nathan Joseph,9,0,12,3
1748427311248,MAE 156A,A03,931418,Delson; Nathan Joseph,12,0,12,0
1748427311248,MAE 156A,A04,931419,Delson; Nathan Joseph,10,0,12,2
1748427311248,MAE 156A,A05,931420,Delson; Nathan Joseph,2,0,12,10
1748427311248,MAE 156A,A06,931421,Delson; Nathan Joseph,12,0,12,0
1748427312275,MAE 165,A00,931422,Scholtes Acevedo; Claire,19,0,30,11
1748427313303,MAE 170,A01,931424,Evdokimenko; Ekaterina,9,0,30,21
1748427313303,MAE 170,A02,931427,Evdokimenko; Ekaterina,14,0,30,16
1748427313303,MAE 170,A03,931428,Evdokimenko; Ekaterina,0,0,30,30
1748427313303,MAE 170,A04,931429,Evdokimenko; Ekaterina,14,0,30,16
1748427313303,MAE 170,A05,931430,Evdokimenko; Ekaterina,27,0,30,3
1748427313303,MAE 170,A06,931434,Evdokimenko; Ekaterina,23,0,30,7
1748427314330,MAE 180,A00,931436,Sadeghizadeh; Zahra,109,0,140,31
1748427315362,MAE 181,A00,931437,Bahadori; Mohammad Yousef,53,0,80,27
1748427316389,MAE 190,A00,971317,Marinoni; Alessandro & Krasheninnikov; Sergei,19,0,20,1
1748427317418,MAE 191,A01,931442,Qi; Huihui,19,0,20,1
1748427318443,MAE 201,A00,931445,Pawlak; Geno Ronald,36,0,90,54
1748427319468,MAE 202,A00,931452,Poulikakos; Lisa Voula,42,0,90,48
1748427320497,MAE 203,A00,931455,Frazier; Michael,26,0,90,64
1748427321526,MAE 205,A00,931456,Staff,9989,0,9999,10
1748427322551,MAE 208,A00,931457,Marinoni; Alessandro,52,0,150,98
1748427323580,MAE 210A,A00,931458,Saintillan; David,37,0,60,23
1748427324610,MAE 217A,A00,931459,Arefiev; Alexey,13,0,20,7
1748427325635,MAE 221A,A00,931460,Chen; Renkun,26,0,40,14
1748427326666,MAE 232A,A00,931464,Chen; Jiun-Shyan,3,0,35,32
1748427327691,MAE 233A,A00,931466,Luan; Haiwen,29,0,40,11
1748427328770,MAE 235,A00,954132,Krysl; Petr,0,0,0,0
1748427329853,MAE 249,A00,931472,Tolley; Michael Thomas,8,0,50,42
1748427330882,MAE 251,A00,931477,Graeve; Olivia A,12,0,15,3
1748427331912,MAE 257,A00,931478,Cai; Shengqiang,0,0,10,10
1748427332944,MAE 265A,A00,931480,Bandaru; Prabhakar,10,0,15,5
1748427333972,MAE 271A,A00,931481,Luo; Jian,9,0,10,1
1748427334998,MAE 280A,A00,931482,Kramer; Boris,61,0,110,49
1748427336023,MAE 283A,A00,931484,de Callafon; Raymond A,12,0,50,38
1748427337048,MAE 285,A00,931486,Friend; James Robert,30,0,30,0
1748427338078,MAE 287,A00,931488,Diagne; Mamadou Lamine,17,0,30,13
1748427339103,MAE 290A,A00,931490,Lindsey; Stephanie,42,0,70,28
1748427340135,MAE 294A,A00,931491,Becker; Janet Maria,14,0,20,6
1748427341160,MATH 2,A01,929271,Quarfoot; David James,22,0,25,3
1748427341160,MATH 2,B01,929278,Staff,21,0,25,4
1748427342189,MATH 3B,A01,929284,Hammock; Frances H,1,0,2,1
1748427342189,MATH 3B,A02,929312,Hammock; Frances H,1,0,2,1
1748427342189,MATH 3B,A03,967979,Hammock; Frances H,2,0,2,0
1748427342189,MATH 3B,A04,967980,Hammock; Frances H,1,0,2,1
1748427342189,MATH 3B,A05,967983,Hammock; Frances H,1,0,2,1
1748427342189,MATH 3B,A06,967984,Hammock; Frances H,2,0,2,0
1748427342189,MATH 3B,D01,929666,Staff,0,0,2,2
1748427342189,MATH 3B,D02,929667,Staff,0,0,2,2
1748427342189,MATH 3B,D03,929668,Staff,0,0,2,2
1748427342189,MATH 3B,D04,967987,Staff,0,0,2,2
1748427343214,MATH 3C,A01,929670,Staff,0,0,2,2
1748427343214,MATH 3C,A02,929671,Staff,0,0,2,2
1748427343214,MATH 3C,A03,929672,Staff,2,0,2,0
1748427343214,MATH 3C,A04,929673,Staff,2,0,2,0
1748427343214,MATH 3C,A05,967985,Staff,0,0,2,2
1748427343214,MATH 3C,A06,967986,Staff,1,0,2,1
1748427343214,MATH 3C,B01,929675,Staff,0,0,0,2
1748427343214,MATH 3C,B02,929676,Staff,0,0,2,2
1748427343214,MATH 3C,B03,929677,Staff,0,0,2,2
1748427343214,MATH 3C,B04,929679,Staff,0,0,2,2
1748427343214,MATH 3C,B05,967988,Staff,0,0,2,2
1748427343214,MATH 3C,B06,967989,Staff,0,0,2,2
1748427344239,MATH 4C,B01,929698,Anzaldo; Leesa B,0,0,0,2
1748427344239,MATH 4C,B02,929699,Anzaldo; Leesa B,4,0,4,0
1748427344239,MATH 4C,B03,929700,Anzaldo; Leesa B,3,0,4,1
1748427344239,MATH 4C,B04,929701,Anzaldo; Leesa B,4,0,4,0
1748427344239,MATH 4C,D01,929709,Staff,4,0,4,0
1748427344239,MATH 4C,D02,929710,Staff,3,0,4,1
1748427344239,MATH 4C,D03,967990,Staff,4,0,4,0
1748427344239,MATH 4C,D04,967991,Staff,4,0,4,0
1748427345274,MATH 10A,A01,929713,Staff,8,0,12,4
1748427345274,MATH 10A,A02,929715,Staff,12,0,12,0
1748427345274,MATH 10A,A03,929717,Staff,5,0,5,0
1748427345274,MATH 10A,A04,929718,Staff,5,0,5,0
1748427345274,MATH 10A,A05,929719,Staff,5,0,5,0
1748427345274,MATH 10A,A06,929720,Staff,4,0,5,1
1748427345274,MATH 10A,B01,929723,Eggers; John Dietrich,0,0,0,4
1748427345274,MATH 10A,B02,929724,Eggers; John Dietrich,0,0,4,4
1748427345274,MATH 10A,B03,929726,Eggers; John Dietrich,0,0,4,4
1748427345274,MATH 10A,B04,929727,Eggers; John Dietrich,0,0,4,4
1748427345274,MATH 10A,B05,929728,Eggers; John Dietrich,0,0,4,4
1748427345274,MATH 10A,B06,929729,Eggers; John Dietrich,1,0,4,3
1748427345274,MATH 10A,C01,929732,Staff,0,0,0,3
1748427345274,MATH 10A,C02,929734,Staff,0,0,4,4
1748427345274,MATH 10A,C03,929735,Staff,0,0,4,4
1748427345274,MATH 10A,C04,929736,Staff,0,0,4,4
1748427345274,MATH 10A,C05,929737,Staff,0,0,4,4
1748427345274,MATH 10A,C06,929739,Staff,0,0,4,4
1748427345274,MATH 10A,D01,929742,Staff,0,0,4,4
1748427345274,MATH 10A,D02,929743,Staff,0,0,4,4
1748427345274,MATH 10A,D03,929744,Staff,4,0,4,0
1748427345274,MATH 10A,D04,929746,Staff,4,0,4,0
1748427345274,MATH 10A,D05,929747,Staff,3,0,4,1
1748427345274,MATH 10A,D06,929748,Staff,4,0,4,0
1748427345274,MATH 10A,D07,968012,Staff,0,0,4,4
1748427345274,MATH 10A,D08,968013,Staff,3,0,4,1
1748427345274,MATH 10A,D09,968015,Staff,4,0,4,0
1748427345274,MATH 10A,D10,968017,Staff,2,0,4,2
1748427346310,MATH 10B,A01,929759,Bowers; Adam R.,0,0,10,10
1748427346310,MATH 10B,A02,929760,Bowers; Adam R.,0,0,10,10
1748427346310,MATH 10B,A03,929761,Bowers; Adam R.,0,0,10,10
1748427346310,MATH 10B,A04,929762,Bowers; Adam R.,0,0,10,10
1748427346310,MATH 10B,A05,929763,Bowers; Adam R.,0,0,10,10
1748427346310,MATH 10B,A06,929764,Bowers; Adam R.,0,0,10,10
1748427346310,MATH 10B,B01,929767,Staff,0,0,10,10
1748427346310,MATH 10B,B02,929770,Staff,7,0,10,3
1748427346310,MATH 10B,B03,929771,Staff,10,0,10,0
1748427346310,MATH 10B,B04,929772,Staff,9,0,10,1
1748427346310,MATH 10B,B05,929774,Staff,1,0,10,9
1748427346310,MATH 10B,B06,929775,Staff,10,0,10,0
1748427346310,MATH 10B,C01,929778,Huang; Lei,0,0,8,8
1748427346310,MATH 10B,C02,929779,Huang; Lei,0,0,10,10
1748427346310,MATH 10B,C03,929780,Huang; Lei,2,0,10,8
1748427346310,MATH 10B,C04,929781,Huang; Lei,8,0,10,2
1748427346310,MATH 10B,C05,929784,Huang; Lei,0,0,10,10
1748427346310,MATH 10B,C06,929785,Huang; Lei,2,0,10,8
1748427347357,MATH 10C,A01,929788,Staff,0,0,15,15
1748427347357,MATH 10C,A02,929789,Staff,0,0,15,15
1748427347357,MATH 10C,A03,929790,Staff,12,0,15,3
1748427347357,MATH 10C,A04,929791,Staff,13,0,15,2
1748427347357,MATH 10C,A05,929792,Staff,0,0,15,15
1748427347357,MATH 10C,A06,929793,Staff,0,0,15,15
1748427347357,MATH 10C,A07,929795,Staff,2,0,15,13
1748427347357,MATH 10C,A08,929796,Staff,15,0,15,0
1748427347357,MATH 10C,B01,929798,Staff,15,0,15,0
1748427347357,MATH 10C,B02,929799,Staff,0,0,15,15
1748427347357,MATH 10C,B03,929800,Staff,11,0,15,4
1748427347357,MATH 10C,B04,929802,Staff,14,0,15,1
1748427347357,MATH 10C,B05,929803,Staff,14,0,15,1
1748427347357,MATH 10C,B06,929805,Staff,15,0,15,0
1748427348385,MATH 11,A01,929807,Rava; Denise,0,0,25,25
1748427348385,MATH 11,A02,929808,Rava; Denise,0,0,25,25
1748427348385,MATH 11,A03,929809,Rava; Denise,0,0,25,25
1748427348385,MATH 11,A04,929811,Rava; Denise,0,0,25,25
1748427348385,MATH 11,B01,929816,Rava; Denise,0,0,25,25
1748427348385,MATH 11,B02,929817,Rava; Denise,0,0,25,25
1748427348385,MATH 11,B03,929818,Rava; Denise,0,0,25,25
1748427348385,MATH 11,B04,929819,Rava; Denise,0,0,25,25
1748427349419,MATH 18,C01,929841,Peca-Medlin; John Michael,4,0,10,6
1748427349419,MATH 18,C02,929843,Peca-Medlin; John Michael,7,0,10,3
1748427349419,MATH 18,C03,929844,Peca-Medlin; John Michael,3,0,10,7
1748427349419,MATH 18,C04,929845,Peca-Medlin; John Michael,0,0,10,10
1748427349419,MATH 18,C05,929846,Peca-Medlin; John Michael,2,0,10,8
1748427349419,MATH 18,C06,929848,Peca-Medlin; John Michael,0,0,10,10
1748427349419,MATH 18,D01,929852,Anzaldo; Leesa B,0,0,10,10
1748427349419,MATH 18,D02,929855,Anzaldo; Leesa B,0,0,10,10
1748427349419,MATH 18,D03,929856,Anzaldo; Leesa B,0,0,9,9
1748427349419,MATH 18,D04,929857,Anzaldo; Leesa B,0,0,10,10
1748427349419,MATH 18,D05,929858,Anzaldo; Leesa B,0,0,10,10
1748427349419,MATH 18,D06,929859,Anzaldo; Leesa B,0,0,10,10
1748427349419,MATH 18,E01,929862,Ganesan; Priyanga,0,0,10,10
1748427349419,MATH 18,E02,929863,Ganesan; Priyanga,0,0,10,10
1748427349419,MATH 18,E03,929865,Ganesan; Priyanga,0,0,10,10
1748427349419,MATH 18,E04,929866,Ganesan; Priyanga,8,0,10,2
1748427349419,MATH 18,E05,929867,Ganesan; Priyanga,10,0,10,0
1748427349419,MATH 18,E06,929869,Ganesan; Priyanga,10,0,10,0
1748427349419,MATH 18,F01,929872,Ganesan; Priyanga,12,0,20,8
1748427349419,MATH 18,F02,929873,Ganesan; Priyanga,17,0,20,3
1748427349419,MATH 18,F03,929874,Ganesan; Priyanga,19,0,20,1
1748427349419,MATH 18,F04,929875,Ganesan; Priyanga,19,0,20,1
1748427349419,MATH 18,F05,968018,Ganesan; Priyanga,12,0,12,0
1748427349419,MATH 18,F06,968019,Ganesan; Priyanga,11,0,12,1
1748427349419,MATH 18,F07,968020,Ganesan; Priyanga,10,0,12,2
1748427349419,MATH 18,F08,968022,Ganesan; Priyanga,11,0,12,1
1748427350446,MATH 20A,A01,929880,Bowers; Adam R.,23,0,25,2
1748427350446,MATH 20A,A02,929881,Bowers; Adam R.,24,0,25,1
1748427350446,MATH 20A,A03,929883,Bowers; Adam R.,1,0,5,4
1748427350446,MATH 20A,A04,929884,Bowers; Adam R.,4,0,5,1
1748427350446,MATH 20A,B01,929886,Staff,0,0,0,0
1748427350446,MATH 20A,B02,929887,Staff,3,0,5,2
1748427350446,MATH 20A,B03,929888,Staff,5,0,5,0
1748427350446,MATH 20A,B04,929889,Staff,5,0,5,0
1748427350446,MATH 20A,B05,929890,Staff,5,0,5,0
1748427350446,MATH 20A,B06,929891,Staff,5,0,5,0
1748427350446,MATH 20A,B07,967992,Staff,5,0,5,0
1748427350446,MATH 20A,B08,967993,Staff,5,0,5,0
1748427350446,MATH 20A,B09,967994,Staff,5,0,5,0
1748427350446,MATH 20A,B10,967995,Staff,5,0,5,0
1748427351496,MATH 20B,A01,929910,Staff,14,0,15,1
1748427351496,MATH 20B,A02,929911,Staff,15,0,15,0
1748427351496,MATH 20B,A03,929982,Staff,15,0,15,0
1748427351496,MATH 20B,A04,929983,Staff,15,0,15,0
1748427351496,MATH 20B,A05,929984,Staff,15,0,15,0
1748427351496,MATH 20B,A06,929985,Staff,15,0,15,0
1748427351496,MATH 20B,C01,930160,Staff,24,0,25,1
1748427351496,MATH 20B,C02,930186,Staff,25,0,25,0
1748427351496,MATH 20B,C03,930198,Staff,15,0,15,0
1748427351496,MATH 20B,C04,968000,Staff,15,0,15,0
1748427351496,MATH 20B,D01,930241,Chou; Raymond Oliver,13,0,25,12
1748427351496,MATH 20B,D02,930242,Chou; Raymond Oliver,23,0,25,2
1748427351496,MATH 20B,D03,930244,Chou; Raymond Oliver,0,0,15,15
1748427351496,MATH 20B,D04,968002,Chou; Raymond Oliver,0,0,13,13
1748427351496,MATH 20B,E01,930428,Wesley; William J,32,0,35,3
1748427351496,MATH 20B,E02,930529,Wesley; William J,35,0,35,0
1748427351496,MATH 20B,E03,968023,Wesley; William J,15,0,15,0
1748427351496,MATH 20B,E04,968024,Wesley; William J,15,0,15,0
1748427351496,MATH 20B,E05,968025,Wesley; William J,15,0,15,0
1748427351496,MATH 20B,E06,968026,Wesley; William J,15,0,15,0
1748427352524,MATH 20C,A01,930548,Staff,18,0,20,2
1748427352524,MATH 20C,A02,930554,Staff,19,0,20,1
1748427352524,MATH 20C,A03,930584,Staff,19,0,20,1
1748427352524,MATH 20C,A04,930606,Staff,20,0,20,0
1748427352524,MATH 20C,A05,930610,Staff,19,0,20,1
1748427352524,MATH 20C,A06,930641,Staff,20,0,20,0
1748427352524,MATH 20C,A07,968027,Staff,20,0,20,0
1748427352524,MATH 20C,A08,968028,Staff,20,0,20,0
1748427352524,MATH 20C,A09,968029,Staff,19,0,20,1
1748427352524,MATH 20C,A10,968031,Staff,20,0,20,0
1748427352524,MATH 20C,C01,930911,Staff,6,0,20,14
1748427352524,MATH 20C,C02,930940,Staff,16,0,20,4
1748427352524,MATH 20C,C03,930946,Staff,18,0,20,2
1748427352524,MATH 20C,C04,930959,Staff,20,0,20,0
1748427352524,MATH 20C,C05,930966,Staff,19,0,20,1
1748427352524,MATH 20C,C06,930974,Staff,16,0,20,4
1748427352524,MATH 20C,D01,931266,Hammock; Frances H,10,0,20,10
1748427352524,MATH 20C,D02,931267,Hammock; Frances H,14,0,17,3
1748427352524,MATH 20C,D03,931268,Hammock; Frances H,17,0,20,3
1748427352524,MATH 20C,D04,931269,Hammock; Frances H,19,0,20,1
1748427352524,MATH 20C,D05,931270,Hammock; Frances H,20,0,20,0
1748427352524,MATH 20C,D06,931271,Hammock; Frances H,18,0,20,2
1748427352524,MATH 20C,E01,931273,Staff,11,0,20,9
1748427352524,MATH 20C,E02,931274,Staff,19,0,20,1
1748427352524,MATH 20C,E03,931275,Staff,17,0,20,3
1748427352524,MATH 20C,E04,931276,Staff,19,0,20,1
1748427352524,MATH 20C,E05,931278,Staff,20,0,20,0
1748427352524,MATH 20C,E06,931279,Staff,20,0,20,0
1748427352524,MATH 20C,F01,931281,Staff,20,0,25,5
1748427352524,MATH 20C,F02,931282,Staff,22,0,25,3
1748427352524,MATH 20C,F03,931283,Staff,23,0,25,2
1748427352524,MATH 20C,F04,931285,Staff,24,0,25,1
1748427353552,MATH 20D,B01,931293,Upadrashta; Pranav Kumar,0,0,24,25
1748427353552,MATH 20D,B02,931294,Upadrashta; Pranav Kumar,0,0,30,30
1748427353552,MATH 20D,B03,931297,Upadrashta; Pranav Kumar,0,0,30,30
1748427353552,MATH 20D,B04,931298,Upadrashta; Pranav Kumar,8,0,30,22
1748427353552,MATH 20D,B05,931299,Upadrashta; Pranav Kumar,1,0,30,29
1748427353552,MATH 20D,B06,931300,Upadrashta; Pranav Kumar,25,0,30,5
1748427353552,MATH 20D,C01,931305,Upadrashta; Pranav Kumar,15,0,40,25
1748427353552,MATH 20D,C02,931306,Upadrashta; Pranav Kumar,38,0,40,2
1748427353552,MATH 20D,C03,931307,Upadrashta; Pranav Kumar,12,0,30,18
1748427353552,MATH 20D,C04,931308,Upadrashta; Pranav Kumar,26,0,30,4
1748427354578,MATH 20E,A01,931313,Staff,0,0,27,27
1748427354578,MATH 20E,A02,931315,Staff,19,0,27,8
1748427354578,MATH 20E,A03,931316,Staff,27,0,27,0
1748427354578,MATH 20E,A04,931317,Staff,27,0,27,0
1748427354578,MATH 20E,A05,968032,Staff,9,0,27,18
1748427354578,MATH 20E,A06,968033,Staff,24,0,27,3
1748427354578,MATH 20E,A07,968034,Staff,27,0,27,0
1748427354578,MATH 20E,A08,968035,Staff,26,0,27,1
1748427354578,MATH 20E,C01,931327,Staff,0,0,23,23
1748427354578,MATH 20E,C02,931329,Staff,0,0,27,27
1748427354578,MATH 20E,C03,931331,Staff,0,0,27,27
1748427354578,MATH 20E,C04,931332,Staff,0,0,27,27
1748427354578,MATH 20E,C05,931333,Staff,0,0,27,27
1748427354578,MATH 20E,C06,931334,Staff,7,0,27,20
1748427355603,MATH 31AH,A01,931337,Nandi; Achinta Kumar,5,0,5,0
1748427355603,MATH 31AH,A02,931340,Nandi; Achinta Kumar,5,0,5,0
1748427356632,MATH 87,A00,970775,Harel; Guershon,0,0,0,0
1748427356632,MATH 87,B00,970803,Meyer; David A.,0,0,0,0
1748427357659,MATH 88,A00,967999,Seward; Brandon M.,30,0,35,5
1748427358700,MATH 96,A00,931341,Kane; Daniel Mertz,0,0,0,0
1748427359729,MATH 100A,A01,927335,De Vleming; Kristin Elizab,21,0,30,9
1748427359729,MATH 100A,A02,927337,De Vleming; Kristin Elizab,24,0,30,6
1748427359729,MATH 100A,B01,927341,De Vleming; Kristin Elizab,2,0,30,28
1748427359729,MATH 100A,B02,927342,De Vleming; Kristin Elizab,8,0,30,22
1748427360759,MATH 102,B01,927348,Harel; Guershon,2,0,30,28
1748427360759,MATH 102,B02,927349,Harel; Guershon,22,0,30,8
1748427361785,MATH 103A,B01,927370,Staff,16,0,30,14
1748427361785,MATH 103A,B02,927378,Staff,29,0,30,1
1748427361785,MATH 103A,B03,969574,Staff,27,0,30,3
1748427361785,MATH 103A,C01,927381,Staff,13,0,30,17
1748427361785,MATH 103A,C02,927385,Staff,24,0,30,6
1748427361785,MATH 103A,D01,927388,Suk; Andrew Hoon,0,0,30,30
1748427361785,MATH 103A,D02,927389,Suk; Andrew Hoon,0,0,30,30
1748427362871,MATH 105,A01,927391,Ganapathy; Karthik,26,0,35,9
1748427362871,MATH 105,A02,927454,Ganapathy; Karthik,29,0,35,6
1748427363909,MATH 109,B01,927493,Xiao; Ming,0,0,5,5
1748427363909,MATH 109,B02,927494,Xiao; Ming,0,0,5,5
1748427363909,MATH 109,C01,927500,Xiao; Ming,0,0,5,5
1748427363909,MATH 109,C02,927501,Xiao; Ming,0,0,5,5
1748427363909,MATH 109,D01,927516,Buzaglo; Lucas,0,0,5,5
1748427363909,MATH 109,D02,927517,Buzaglo; Lucas,0,0,5,5
1748427363909,MATH 109,E01,927519,Buzaglo; Lucas,0,0,5,5
1748427363909,MATH 109,E02,927552,Buzaglo; Lucas,0,0,5,5
1748427364938,MATH 111A,A01,927559,Meyer; David A.,0,0,35,35
1748427365963,MATH 120A,A01,927572,Eggers; John Dietrich,13,0,30,17
1748427365963,MATH 120A,A02,927574,Eggers; John Dietrich,29,0,30,1
1748427366990,MATH 140A,A01,927580,Spolaor; Luca,0,0,30,30
1748427366990,MATH 140A,A02,927582,Spolaor; Luca,6,0,30,24
1748427366990,MATH 140A,B01,927588,Ioana; Adrian,0,0,30,30
1748427366990,MATH 140A,B02,927599,Ioana; Adrian,0,0,30,30
1748427368024,MATH 142A,B01,927620,Bejenaru; Ioan,0,0,30,30
1748427368024,MATH 142A,B02,927750,Bejenaru; Ioan,13,0,30,17
1748427368024,MATH 142A,C01,927789,Staff,25,0,30,5
1748427368024,MATH 142A,C02,927815,Staff,30,0,30,0
1748427368024,MATH 142A,C03,969575,Staff,25,0,30,5
1748427368024,MATH 142A,D01,927829,Staff,15,0,30,15
1748427368024,MATH 142A,D02,927832,Staff,30,0,30,0
1748427369053,MATH 153,A01,927862,Harel; Guershon,26,0,35,9
1748427370083,MATH 154,A01,928077,Kane; Daniel Mertz,27,0,35,8
1748427370083,MATH 154,A02,928083,Kane; Daniel Mertz,35,0,35,0
1748427370083,MATH 154,A03,928085,Kane; Daniel Mertz,0,0,35,35
1748427370083,MATH 154,A04,928086,Kane; Daniel Mertz,20,0,35,15
1748427371112,MATH 170A,A01,928146,Tian; Xiaochuan,0,0,30,30
1748427371112,MATH 170A,A02,928225,Tian; Xiaochuan,1,0,30,29
1748427371112,MATH 170A,A03,928231,Tian; Xiaochuan,26,0,30,4
1748427371112,MATH 170A,A04,928237,Tian; Xiaochuan,30,0,30,0
1748427371112,MATH 170A,B01,928244,Huang; Lei,23,0,30,7
1748427371112,MATH 170A,B02,928273,Huang; Lei,30,0,30,0
1748427371112,MATH 170A,B03,928274,Huang; Lei,18,0,30,12
1748427371112,MATH 170A,B04,928276,Huang; Lei,28,0,30,2
1748427372148,MATH 173A,A01,928278,Ding; Lijun,0,0,30,30
1748427372148,MATH 173A,A02,928319,Ding; Lijun,0,0,30,30
1748427372148,MATH 173A,A03,928322,Ding; Lijun,0,0,30,30
1748427372148,MATH 173A,A04,928377,Ding; Lijun,0,0,30,30
1748427372148,MATH 173A,B01,928383,Cloninger; Alexander,0,0,30,30
1748427372148,MATH 173A,B02,928384,Cloninger; Alexander,0,0,30,30
1748427372148,MATH 173A,B03,928385,Cloninger; Alexander,0,0,30,30
1748427372148,MATH 173A,B04,928386,Cloninger; Alexander,0,0,30,30
1748427373175,MATH 174,A01,928397,Cheng; Li-Tien,15,0,28,13
1748427373175,MATH 174,A02,928402,Cheng; Li-Tien,23,0,28,5
1748427374202,MATH 180A,A01,928408,Staff,0,0,25,25
1748427374202,MATH 180A,A02,928409,Staff,18,0,25,7
1748427374202,MATH 180A,A03,928416,Staff,23,0,25,2
1748427374202,MATH 180A,A04,928417,Staff,21,0,25,4
1748427374202,MATH 180A,B01,928428,Peca-Medlin; John Michael,0,0,25,25
1748427374202,MATH 180A,B02,928435,Peca-Medlin; John Michael,11,0,25,14
1748427374202,MATH 180A,B03,928436,Peca-Medlin; John Michael,20,0,25,5
1748427374202,MATH 180A,B04,928453,Peca-Medlin; John Michael,21,0,25,4
1748427374202,MATH 180A,C01,928466,Dixit; Rishabh,20,0,25,5
1748427374202,MATH 180A,C02,928467,Dixit; Rishabh,25,0,25,0
1748427374202,MATH 180A,C03,928506,Dixit; Rishabh,22,0,25,3
1748427374202,MATH 180A,C04,928511,Dixit; Rishabh,25,0,25,0
1748427375231,MATH 180C,A01,928520,Schweinsberg; Jason,0,0,35,35
1748427375231,MATH 180C,A02,928527,Schweinsberg; Jason,0,0,35,35
1748427376256,MATH 181B,A01,928538,Lou; Zhipeng,3,0,30,27
1748427376256,MATH 181B,A02,928539,Lou; Zhipeng,21,0,30,9
1748427376256,MATH 181B,A03,928543,Lou; Zhipeng,27,0,30,3
1748427377281,MATH 183,A01,928545,Quarfoot; David James,0,0,22,22
1748427377281,MATH 183,A02,928560,Quarfoot; David James,0,0,22,22
1748427377281,MATH 183,A03,928565,Quarfoot; David James,0,0,22,22
1748427377281,MATH 183,A04,928566,Quarfoot; David James,0,0,22,22
1748427377281,MATH 183,A05,928567,Quarfoot; David James,0,0,22,22
1748427377281,MATH 183,A06,928568,Quarfoot; David James,0,0,22,22
1748427378307,MATH 184,A01,928587,Chou; Raymond Oliver,13,0,35,22
1748427378307,MATH 184,A02,928592,Chou; Raymond Oliver,29,0,35,6
1748427378307,MATH 184,A03,928593,Chou; Raymond Oliver,32,0,35,3
1748427378307,MATH 184,A04,928594,Chou; Raymond Oliver,35,0,35,0
1748427379332,MATH 187A,A01,928609,Ganapathy; Karthik,0,0,25,25
1748427379332,MATH 187A,A02,928614,Ganapathy; Karthik,0,0,25,25
1748427379332,MATH 187A,A03,928615,Ganapathy; Karthik,0,0,25,25
1748427379332,MATH 187A,A04,928616,Ganapathy; Karthik,7,0,25,18
1748427379332,MATH 187A,A05,928617,Ganapathy; Karthik,0,0,25,25
1748427379332,MATH 187A,A06,928618,Ganapathy; Karthik,12,0,25,13
1748427380363,MATH 190A,A01,928685,Roberts; Justin Deritter,15,0,35,20
1748427381394,MATH 197,001,973284,Kedlaya; Kiran S.,9999,0,9999,0
1748427382537,MATH 200A,A00,928693,Salehi Golsefidy; Alireza,20,0,20,0
1748427383565,MATH 201A,A00,928694,Wenzl; Hans G,20,0,20,0
1748427384594,MATH 202A,A00,928732,Novak; Jonathan I,15,0,20,5
1748427385631,MATH 203A,A00,928743,Izadi; Elham,20,0,20,0
1748427386657,MATH 204A,A00,928764,Sorensen; Claus M,19,0,20,1
1748427387684,MATH 208,A00,928765,Staff,10,0,10,0
1748427388709,MATH 209,A00,928766,Staff,10,0,10,0
1748427389753,MATH 210A,A00,928808,Miller; Pearson,19,0,20,1
1748427390777,MATH 211A,A00,928809,Staff,10,0,10,0
1748427391815,MATH 211B,A00,928811,Staff,10,0,10,0
1748427392839,MATH 216A,A00,928812,Webber; Robert Jacobs,12,0,20,8
1748427393863,MATH 218,A00,928828,Staff,9,0,10,1
1748427394905,MATH 220A,A00,928829,Ebenfelt; Peter F,15,0,20,5
1748427395959,MATH 240A,A00,928830,Spolaor; Luca,17,0,20,3
1748427396988,MATH 241A,A00,928831,Zlatos; Andrej,14,0,20,6
1748427398012,MATH 242,A00,928903,Bejenaru; Ioan,16,0,20,4
1748427399043,MATH 243,A00,928911,Staff,10,0,10,0
1748427400071,MATH 248,A00,928919,Staff,10,0,10,0
1748427401097,MATH 251A,A00,928970,Sam; Steven V,18,0,20,2
1748427402122,MATH 258,A00,928973,Staff,10,0,10,0
1748427403152,MATH 259A,A00,929052,Staff,18,0,20,2
1748427404178,MATH 261A,A00,929059,Warnke; Lutz Peter,10,0,20,10
1748427405203,MATH 269,A00,929060,Staff,10,0,10,0
1748427406233,MATH 270A,A00,929061,Dumitriu; Ioana,8,0,20,12
1748427407266,MATH 273A,A00,929063,Leok; Melvin,17,0,20,3
1748427408296,MATH 274,A01,929069,Cheng; Li-Tien,5,0,5,0
1748427408296,MATH 274,A02,929071,Cheng; Li-Tien,5,0,5,0
1748427409324,MATH 277A,A00,929073,Grier; Daniel T,18,0,20,2
1748427409324,MATH 277A,B00,929080,Nie; Jiawang,20,0,20,0
1748427410353,MATH 278A,A00,929092,Staff,10,0,10,0
1748427411382,MATH 278B,A00,929105,Staff,10,0,10,0
1748427412408,MATH 278C,A00,929113,Staff,10,0,10,0
1748427413436,MATH 280A,A00,929117,Ang; Jie Jun,7,0,20,13
1748427414462,MATH 281A,A00,929120,Lou; Zhipeng,9,0,20,11
1748427415492,MATH 282A,A00,929138,Zhang; Danna,4,0,20,16
1748427416525,MATH 283,A00,929153,Tesler; Glenn,0,0,0,17
1748427417558,MATH 287A,A00,967998,Politis; Dimitris,9,0,15,6
1748427418586,MATH 288,A00,929158,Staff,9,0,10,1
1748427419619,MATH 290A,A00,929180,McKernan; James,18,0,20,2
1748427420644,MATH 292,A00,929185,Staff,10,0,10,0
1748427421669,MATH 295,A00,929189,Staff,15,0,15,0
1748427422698,MATH 297,001,929218,Gamst; Anthony Collins,0,0,0,0
1748427423725,MATS 200,A00,927075,Graeve; Olivia A,9983,0,9999,16
1748427424753,MATS 201A,A00,927076,Luo; Jian,36,0,50,14
1748427425779,MATS 202,A00,927102,Staff,37,0,50,13
1748427426810,MATS 227,A00,927103,Graeve; Olivia A,36,0,50,14
1748427427842,MATS 251A,A00,927139,Bandaru; Prabhakar,40,0,50,10
1748427428872,MATS 257,A00,927140,Cai; Shengqiang,8,0,20,12
1748427429898,MATS 295,A00,927151,Graeve; Olivia A,9999,0,9999,0
1748427429898,MATS 295,B00,927152,Kummel; Andrew C,9999,0,9999,0
1748427430952,MCWP 40,001,945345,Guillen; Melinda,3,0,3,0
1748427430952,MCWP 40,002,945347,Guillen; Melinda,0,0,3,3
1748427430952,MCWP 40,003,945348,Guillen; Melinda,0,0,3,3
1748427430952,MCWP 40,004,945379,Wastal; Carrie King,3,0,3,0
1748427430952,MCWP 40,005,945382,Wastal; Carrie King,2,0,3,1
1748427430952,MCWP 40,006,945383,Compas; Sean Matthew,0,0,3,3
1748427430952,MCWP 40,007,945387,Bartulis; Jason Michael,3,0,3,0
1748427430952,MCWP 40,008,945388,Wastal; Carrie King,2,0,3,1
1748427430952,MCWP 40,009,945391,Wastal; Carrie King,3,0,3,0
1748427430952,MCWP 40,011,945394,Bartulis; Jason Michael,3,0,3,0
1748427430952,MCWP 40,012,945395,Carter; Jennifer A,3,0,3,0
1748427430952,MCWP 40,013,945396,Carter; Jennifer A,2,0,3,1
1748427430952,MCWP 40,014,945429,Carter; Jennifer A,2,0,3,1
1748427430952,MCWP 40,015,945432,Smith; Haydee Marie,3,0,3,0
1748427430952,MCWP 40,016,945433,Smith; Haydee Marie,3,0,3,0
1748427430952,MCWP 40,017,945435,Smith; Haydee Marie,3,0,3,0
1748427430952,MCWP 40,018,945436,Pham; Vincent Minhduc,3,0,3,0
1748427430952,MCWP 40,019,945453,Pham; Vincent Minhduc,3,0,3,0
1748427430952,MCWP 40,020,945459,Pham; Vincent Minhduc,3,0,3,0
1748427430952,MCWP 40,023,945469,Montejo; Carolina,3,0,3,0
1748427430952,MCWP 40,024,945472,Montejo; Carolina,3,0,3,0
1748427430952,MCWP 40,026,945708,Compas; Sean Matthew,3,0,3,0
1748427430952,MCWP 40,027,945710,Duru; Nur,2,0,3,1
1748427430952,MCWP 40,028,945714,Duru; Nur,1,0,3,2
1748427430952,MCWP 40,029,945715,Duru; Nur,2,0,3,1
1748427430952,MCWP 40,030,945718,Compas; Sean Matthew,0,0,3,3
1748427431983,MCWP 40R,A00,945742,Miller; Elizabeth Deen,0,0,0,1
1748427431983,MCWP 40R,B00,945743,Miller; Elizabeth Deen,0,0,0,0
1748427431983,MCWP 40R,C00,945744,Miller; Elizabeth Deen,0,0,0,1
1748427433008,MCWP 50,001,945745,Wastal; Carrie King,2,0,15,13
1748427433008,MCWP 50,002,945746,Carter; Andrea L,18,0,20,2
1748427433008,MCWP 50,003,945788,Carter; Andrea L,11,0,20,9
1748427433008,MCWP 50,004,945887,Carter; Andrea L,7,0,20,13
1748427434051,MCWP 125,001,945901,Nies; Laurie Elizabeth,3,0,3,0
1748427434051,MCWP 125,002,945902,Nies; Laurie Elizabeth,3,0,3,0
1748427434051,MCWP 125,003,945904,Redela; Pamela Morgan,3,0,3,0
1748427434051,MCWP 125,004,945930,Redela; Pamela Morgan,3,0,3,0
1748427434051,MCWP 125,005,945931,Redela; Pamela Morgan,3,0,3,0
1748427434051,MCWP 125,006,945932,Silva; Kelly B,3,0,3,0
1748427434051,MCWP 125,007,945933,Silva; Kelly B,3,0,3,0
1748427434051,MCWP 125,009,945935,Krone; Jarret,3,0,3,0
1748427434051,MCWP 125,010,945940,Krone; Jarret,3,0,3,0
1748427434051,MCWP 125,011,945941,Krone; Jarret,3,0,3,0
1748427434051,MCWP 125,012,945942,Morshed; Michael James,3,0,3,0
1748427434051,MCWP 125,013,945943,Morshed; Michael James,3,0,3,0
1748427434051,MCWP 125,014,945944,Morshed; Michael James,3,0,3,0
1748427435078,MGT 3,A00,945992,Wagner; Timothy Ryan,96,0,98,2
1748427436105,MGT 4,A01,945994,Brooks; Marcus Raymond,80,0,90,10
1748427437136,MGT 5,A00,945995,Molloie Jr.; William H,134,0,150,16
1748427438163,MGT 12,A00,945996,Lindenberger; Wade Douglas,63,0,98,35
1748427438163,MGT 12,B00,945997,Pecore; Joseph P.,58,0,98,40
1748427439197,MGT 16,A00,945998,Buchanan; Harold G,96,0,98,2
1748427439197,MGT 16,B00,946005,Buchanan; Harold G,90,0,98,8
1748427439197,MGT 16,C00,946006,Campbell; Robert Harold,92,0,98,6
1748427439197,MGT 16,D00,946007,Campbell; Robert Harold,93,0,98,5
1748427439197,MGT 16,E00,946022,Lindenberger; Wade Douglas,42,0,98,56
1748427440235,MGT 18,A00,946040,McKay; Michael J,95,0,98,3
1748427440235,MGT 18,B00,946041,McKay; Michael J,96,0,98,2
1748427440235,MGT 18,C00,946044,McKay; Michael J,96,0,98,2
1748427440235,MGT 18,D00,946047,Chamberlain; Travis Dean,98,0,98,0
1748427440235,MGT 18,E00,946051,Chamberlain; Travis Dean,96,0,98,2
1748427440235,MGT 18,F00,960148,Chamberlain; Travis Dean,0,0,0,2
1748427441261,MGT 45,A00,946055,Pecore; Joseph P.,80,0,150,70
1748427441261,MGT 45,B00,946057,Pecore; Joseph P.,118,0,150,32
1748427442287,MGT 52,A00,946059,Staff,77,0,98,21
1748427443314,MGT 71,A00,946060,Goodarzi; Shadi,0,0,98,98
1748427443314,MGT 71,B00,946061,Erat; Sanjiv,0,0,98,98
1748427443314,MGT 71,D00,960149,Staff,0,0,98,98
1748427444345,MGT 100,A00,946069,Yavorsky; Daniel Ryan,0,0,98,98
1748427445372,MGT 103,A00,946081,Ehrich; Kristine R,96,0,98,2
1748427445372,MGT 103,C00,946083,Ehrich; Kristine R,75,0,98,23
1748427445372,MGT 103,D00,946084,Ehrich; Kristine R,57,0,98,41
1748427445372,MGT 103,E00,946138,Bates; Kenneth Walter,82,0,98,16
1748427446398,MGT 105,A00,946139,Bates; Kenneth Walter,0,0,98,98
1748427447429,MGT 108R,A00,946141,Amir; On,888,0,999,111
1748427448457,MGT 109,A00,946142,Staff,13,0,98,85
1748427449482,MGT 112,A00,960205,Zimmermann; Carsten,30,0,98,68
1748427450513,MGT 119,A00,946144,Schurr; Amos Shlomo,96,0,98,2
1748427450513,MGT 119,B00,946153,Staff,97,0,98,1
1748427451538,MGT 121A,A00,946154,Wang; Helen Shan,89,0,98,9
1748427451538,MGT 121A,B00,946188,Wang; Helen Shan,96,0,98,2
1748427452564,MGT 127R,A00,946197,Zhu; Kevin Xiaoguo,70,0,98,28
1748427453589,MGT 131A,A00,946227,Brooks; Marcus Raymond,91,0,98,7
1748427454615,MGT 132,A00,946230,Blakley; Bruce,76,0,98,22
1748427455644,MGT 135,A00,946234,Anderson; John Charles,1,0,40,39
1748427456671,MGT 137,A00,960206,Lindenberger; Wade Douglas,0,0,98,98
1748427457698,MGT 151R,A00,946235,Staff,64,0,98,34
1748427458723,MGT 153,A00,946242,Perols; Johan Lars,0,0,90,90
1748427458723,MGT 153,B00,946244,Perols; Johan Lars,0,0,90,90
1748427459754,MGT 158,A00,946247,Bliss; Barbara Ann,85,0,98,13
1748427460785,MGT 160,A00,946265,Johnson; Erik Barry,30,0,90,60
1748427460785,MGT 160,B00,946266,Johnson; Erik Barry,58,0,90,32
1748427461816,MGT 162,A00,946267,Demill; Burritt,85,0,98,13
1748427461816,MGT 162,B00,946269,Demill; Burritt,67,0,98,31
1748427462844,MGT 162R,A00,946270,Gneezy; Uri,0,0,150,150
1748427463870,MGT 164,A00,946271,McKay; Mary A,88,0,98,10
1748427463870,MGT 164,B00,946272,McKay; Mary A,80,0,98,18
1748427463870,MGT 164,C00,946273,McKay; Mary A,88,0,98,10
1748427463870,MGT 164,D00,946274,Meyer; Alison Bloomfield,0,0,98,98
1748427464898,MGT 166,A00,946276,Moran; Cathleen L.,40,0,60,20
1748427464898,MGT 166,B00,946277,Moran; Cathleen L.,84,0,98,14
1748427464898,MGT 166,C00,946278,Moran; Cathleen L.,94,0,98,4
1748427465930,MGT 167,A00,946279,Jacob; Jo Dee C,88,0,98,10
1748427465930,MGT 167,B00,946280,Klaas; Jeffrey David,97,0,98,1
1748427468041,MGT 172,A00,946282,Hedges; Kathleen & Royal; Rebecca,92,0,98,6
1748427468041,MGT 172,B00,946283,Hedges; Kathleen,73,0,98,25
1748427468041,MGT 172,C00,946284,Zimmermann; Carsten,0,0,0,3
1748427469066,MGT 172R,A00,946285,Erat; Sanjiv,134,0,150,16
1748427470095,MGT 173,A00,946286,Hayes; Sherry Lorine,66,0,98,32
1748427471121,MGT 175,A00,946287,Gopal; Christopher S.,81,0,90,9
1748427472147,MGT 180,A00,946288,Bliss; Barbara Ann,96,0,150,54
1748427472147,MGT 180,B00,946289,Buti; Krisztina,140,0,150,10
1748427472147,MGT 180,C00,960207,Buti; Krisztina,142,0,150,8
1748427473177,MGT 181,A00,946290,Buchanan; Harold G,17,0,120,103
1748427474206,MGT 183,A00,960208,Staff,53,0,98,45
1748427475236,MGT 185,A00,946291,Dunn; Louis Jean,69,0,98,29
1748427476261,MGT 187,A00,946292,Dunn; Louis Jean,43,0,98,55
1748427477287,MGT 189,A00,946293,Staff,88,0,98,10
1748427478314,MGT 228,A00,946294,Sadoff; Sally,16,0,20,4
1748427479340,MGT 286,A00,946295,Staff,20,0,20,0
1748427480391,MGT 296,001,969295,Gneezy; Ayelet,2,0,3,1
1748427480391,MGT 296,002,969296,Amir; On,3,0,3,0
1748427480391,MGT 296,003,969297,Amir; On & Karmarkar; Uma R,2,0,3,1
1748427480391,MGT 296,004,969298,Liu; Jun,3,0,3,0
1748427480391,MGT 296,005,969300,Hansen; Karsten T.,2,0,3,1
1748427480391,MGT 296,006,969301,Erat; Sanjiv,2,0,3,1
1748427480391,MGT 296,007,969302,Avenancio-Leon; Carlos,3,0,3,0
1748427480391,MGT 296,008,969303,Engelberg; Joseph Edward,3,0,3,0
1748427480391,MGT 296,009,969304,Zhang; Zhe,3,0,3,0
1748427480391,MGT 296,010,969305,Oveis; Christopher S,3,0,3,0
1748427480391,MGT 296,011,969306,Zhu; Kevin Xiaoguo & Gneezy; Ayelet,3,0,3,0
1748427480391,MGT 296,012,969307,Luo; Danqi,3,0,3,0
1748427480391,MGT 296,013,969309,Oveis; Christopher S & Campbell; Elizabeth L,3,0,3,0
1748427480391,MGT 296,014,969310,Serra Garcia; Marta & Gneezy; Uri,3,0,3,0
1748427480391,MGT 296,015,969311,Rai; Tage S,3,0,3,0
1748427481431,MMW 11,A01,925937,Herbst; Matthew,4,0,4,0
1748427481431,MMW 11,A02,925938,Herbst; Matthew,3,0,4,1
1748427481431,MMW 11,A03,925939,Herbst; Matthew,4,0,4,0
1748427481431,MMW 11,A04,925940,Herbst; Matthew,4,0,4,0
1748427481431,MMW 11,A05,925941,Herbst; Matthew,0,0,0,0
1748427481431,MMW 11,A06,925942,Herbst; Matthew,0,0,0,0
1748427481431,MMW 11,A07,925975,Herbst; Matthew,3,0,4,1
1748427481431,MMW 11,A08,926004,Herbst; Matthew,3,0,4,1
1748427481431,MMW 11,A09,926021,Herbst; Matthew,3,0,4,1
1748427481431,MMW 11,A10,926064,Herbst; Matthew,4,0,4,0
1748427481431,MMW 11,A11,926067,Herbst; Matthew,4,0,4,0
1748427481431,MMW 11,A12,926072,Herbst; Matthew,4,0,4,0
1748427481431,MMW 11,B01,926211,Chang; Edmond Yi-Teh,3,0,4,1
1748427481431,MMW 11,B02,926212,Chang; Edmond Yi-Teh,4,0,4,0
1748427481431,MMW 11,B03,926213,Chang; Edmond Yi-Teh,4,0,4,0
1748427481431,MMW 11,B04,926214,Chang; Edmond Yi-Teh,4,0,4,0
1748427481431,MMW 11,B05,926215,Chang; Edmond Yi-Teh,4,0,4,0
1748427481431,MMW 11,B06,926216,Chang; Edmond Yi-Teh,4,0,4,0
1748427481431,MMW 11,B07,926217,Chang; Edmond Yi-Teh,4,0,4,0
1748427481431,MMW 11,B08,926218,Chang; Edmond Yi-Teh,3,0,4,1
1748427481431,MMW 11,B09,926219,Chang; Edmond Yi-Teh,4,0,4,0
1748427481431,MMW 11,B10,926220,Chang; Edmond Yi-Teh,4,0,4,0
1748427481431,MMW 11,B11,926221,Chang; Edmond Yi-Teh,0,0,0,0
1748427481431,MMW 11,B12,926233,Chang; Edmond Yi-Teh,0,0,0,0
1748427481431,MMW 11,C01,926237,Chang; Edmond Yi-Teh,4,0,4,0
1748427481431,MMW 11,C02,926238,Chang; Edmond Yi-Teh,4,0,4,0
1748427481431,MMW 11,C03,926239,Chang; Edmond Yi-Teh,3,0,4,1
1748427481431,MMW 11,C04,926240,Chang; Edmond Yi-Teh,4,0,4,0
1748427481431,MMW 11,C05,926241,Chang; Edmond Yi-Teh,4,0,4,0
1748427481431,MMW 11,C06,926242,Chang; Edmond Yi-Teh,4,0,4,0
1748427481431,MMW 11,C07,926243,Chang; Edmond Yi-Teh,4,0,4,0
1748427481431,MMW 11,C08,926244,Chang; Edmond Yi-Teh,4,0,4,0
1748427481431,MMW 11,C09,926245,Chang; Edmond Yi-Teh,0,0,0,0
1748427481431,MMW 11,C10,926301,Chang; Edmond Yi-Teh,0,0,0,0
1748427481431,MMW 11,C11,926303,Chang; Edmond Yi-Teh,4,0,4,0
1748427481431,MMW 11,C12,926305,Chang; Edmond Yi-Teh,4,0,4,0
1748427482460,MMW 14,A01,926309,Carreras; Maria Victoria,0,0,0,0
1748427482460,MMW 14,A02,926470,Carreras; Maria Victoria,0,0,0,0
1748427482460,MMW 14,A03,926472,Carreras; Maria Victoria,0,0,28,28
1748427482460,MMW 14,A04,926474,Carreras; Maria Victoria,0,0,28,28
1748427482460,MMW 14,A05,926475,Carreras; Maria Victoria,0,0,28,28
1748427482460,MMW 14,A06,926476,Carreras; Maria Victoria,0,0,28,28
1748427482460,MMW 14,A07,926477,Carreras; Maria Victoria,0,0,28,28
1748427482460,MMW 14,A08,926513,Carreras; Maria Victoria,0,0,28,28
1748427482460,MMW 14,A09,926514,Carreras; Maria Victoria,0,0,0,0
1748427482460,MMW 14,A10,926515,Carreras; Maria Victoria,0,0,0,0
1748427483490,MMW 121,A01,926517,Adamiak; Patrick John,0,0,0,0
1748427483490,MMW 121,A02,926548,Adamiak; Patrick John,0,0,0,0
1748427483490,MMW 121,A03,926549,Adamiak; Patrick John,0,0,4,4
1748427483490,MMW 121,A04,926550,Adamiak; Patrick John,2,0,4,2
1748427483490,MMW 121,A05,926551,Adamiak; Patrick John,0,0,4,4
1748427483490,MMW 121,A06,926552,Adamiak; Patrick John,3,0,4,1
1748427483490,MMW 121,A07,926585,Adamiak; Patrick John,3,0,4,1
1748427483490,MMW 121,A08,926590,Adamiak; Patrick John,3,0,4,1
1748427483490,MMW 121,A09,926641,Adamiak; Patrick John,0,0,0,0
1748427483490,MMW 121,A10,926658,Adamiak; Patrick John,0,0,0,0
1748427483490,MMW 121,B01,926680,Adamiak; Patrick John,0,0,4,4
1748427483490,MMW 121,B02,926691,Adamiak; Patrick John,0,0,4,4
1748427483490,MMW 121,B03,926710,Adamiak; Patrick John,2,0,4,2
1748427483490,MMW 121,B04,926714,Adamiak; Patrick John,4,0,4,0
1748427483490,MMW 121,B05,926750,Adamiak; Patrick John,0,0,4,4
1748427483490,MMW 121,B06,926765,Adamiak; Patrick John,4,0,4,0
1748427483490,MMW 121,B07,926769,Adamiak; Patrick John,3,0,4,1
1748427483490,MMW 121,B08,926953,Adamiak; Patrick John,3,0,4,1
1748427483490,MMW 121,B09,926954,Adamiak; Patrick John,0,0,0,0
1748427483490,MMW 121,B10,926955,Adamiak; Patrick John,0,0,0,0
1748427484516,MSED 295,A00,927153,Staff,5,0,5,0
1748427485545,MSED 296A,A00,927181,Rabin; Jeffrey Mark,13,0,15,2
1748427486573,MUS 1A,A01,931495,Staff,24,0,25,1
1748427486573,MUS 1A,A02,931499,Staff,21,0,25,4
1748427486573,MUS 1A,A03,931502,Staff,21,0,25,4
1748427486573,MUS 1A,A04,931503,Staff,25,0,25,0
1748427486573,MUS 1A,A05,931504,Staff,19,0,25,6
1748427486573,MUS 1A,A06,931505,Staff,22,0,25,3
1748427486573,MUS 1A,B01,931507,Staff,25,0,25,0
1748427486573,MUS 1A,B02,931530,Staff,22,0,25,3
1748427486573,MUS 1A,B03,931534,Staff,23,0,25,2
1748427486573,MUS 1A,B04,931536,Staff,24,0,25,1
1748427486573,MUS 1A,B05,931539,Staff,17,0,25,8
1748427486573,MUS 1A,B06,931541,Staff,13,0,25,12
1748427487603,MUS 2A,A01,931544,Carlson; Erik,40,0,40,0
1748427488629,MUS 2AK,A00,931545,Ohnishi; Takae,15,0,15,0
1748427488629,MUS 2AK,B00,931546,Ohnishi; Takae,15,0,15,0
1748427489662,MUS 4,A01,931551,Staff,24,0,25,1
1748427489662,MUS 4,A02,931552,Staff,25,0,25,0
1748427489662,MUS 4,A03,931553,Staff,24,0,25,1
1748427489662,MUS 4,A04,931554,Staff,25,0,25,0
1748427489662,MUS 4,A05,931558,Staff,24,0,25,1
1748427489662,MUS 4,A06,931561,Staff,25,0,25,0
1748427489662,MUS 4,A07,931562,Staff,25,0,25,0
1748427489662,MUS 4,A08,931563,Staff,25,0,25,0
1748427489662,MUS 4,A09,931564,Staff,25,0,25,0
1748427489662,MUS 4,A10,931566,Staff,25,0,25,0
1748427490695,MUS 6,A01,931573,Freitas Caetano; Marcelo,27,0,30,3
1748427490695,MUS 6,A02,931574,Freitas Caetano; Marcelo,28,0,30,2
1748427490695,MUS 6,A03,931677,Freitas Caetano; Marcelo,28,0,30,2
1748427490695,MUS 6,A04,931696,Freitas Caetano; Marcelo,30,0,30,0
1748427491731,MUS 8,A01,931732,Smythe; Cory Benjamin,12,0,25,13
1748427491731,MUS 8,A02,931737,Smythe; Cory Benjamin,17,0,25,8
1748427491731,MUS 8,A03,931761,Smythe; Cory Benjamin,25,0,25,0
1748427491731,MUS 8,A04,931920,Smythe; Cory Benjamin,23,0,25,2
1748427491731,MUS 8,A05,931925,Smythe; Cory Benjamin,21,0,25,4
1748427491731,MUS 8,A06,931943,Smythe; Cory Benjamin,19,0,25,6
1748427491731,MUS 8,A07,931948,Smythe; Cory Benjamin,22,0,25,3
1748427491731,MUS 8,A08,931955,Smythe; Cory Benjamin,18,0,25,7
1748427491731,MUS 8,A09,931964,Smythe; Cory Benjamin,25,0,25,0
1748427491731,MUS 8,A10,931974,Smythe; Cory Benjamin,24,0,25,1
1748427492760,MUS 13,A01,961328,Guy; Nancy,28,0,30,2
1748427492760,MUS 13,A02,961333,Guy; Nancy,30,0,30,0
1748427492760,MUS 13,A03,961343,Guy; Nancy,28,0,30,2
1748427492760,MUS 13,A04,961351,Guy; Nancy,30,0,30,0
1748427493789,MUS 14,A01,932176,McCormack; Timothy Matthew,29,0,30,1
1748427493789,MUS 14,A02,932183,McCormack; Timothy Matthew,29,0,30,1
1748427493789,MUS 14,A03,932186,McCormack; Timothy Matthew,30,0,30,0
1748427493789,MUS 14,A04,932190,McCormack; Timothy Matthew,29,0,30,1
1748427494819,MUS 15,A01,932270,Lou; Michelle Siulai,28,0,30,2
1748427494819,MUS 15,A02,932315,Lou; Michelle Siulai,29,0,30,1
1748427494819,MUS 15,A03,932316,Lou; Michelle Siulai,28,0,30,2
1748427494819,MUS 15,A04,932323,Lou; Michelle Siulai,30,0,30,0
1748427494819,MUS 15,A05,932325,Lou; Michelle Siulai,27,0,30,3
1748427494819,MUS 15,A06,932326,Lou; Michelle Siulai,27,0,30,3
1748427494819,MUS 15,A07,932327,Lou; Michelle Siulai,30,0,30,0
1748427494819,MUS 15,A08,932328,Lou; Michelle Siulai,28,0,30,2
1748427494819,MUS 15,A09,932366,Lou; Michelle Siulai,29,0,30,1
1748427494819,MUS 15,A10,932380,Lou; Michelle Siulai,25,0,30,5
1748427495849,MUS 17,A01,932416,Staff,0,0,0,0
1748427495849,MUS 17,A02,932423,Staff,0,0,0,0
1748427495849,MUS 17,A03,932437,Staff,0,0,0,0
1748427495849,MUS 17,A04,932447,Staff,0,0,0,0
1748427495849,MUS 17,A05,932460,Staff,0,0,0,0
1748427495849,MUS 17,A06,932466,Staff,0,0,0,0
1748427495849,MUS 17,A07,932475,Staff,0,0,0,0
1748427495849,MUS 17,A08,932479,Staff,0,0,0,0
1748427495849,MUS 17,A09,932480,Staff,0,0,0,0
1748427495849,MUS 17,A10,932481,Staff,0,0,0,0
1748427495849,MUS 17,A11,932487,Staff,0,0,0,9
1748427495849,MUS 17,A12,932490,Staff,0,0,0,1
1748427496881,MUS 19R,A01,932494,Britt; King James,7,0,25,18
1748427496881,MUS 19R,A02,932500,Britt; King James,20,0,25,5
1748427496881,MUS 19R,A03,932503,Britt; King James,24,0,25,1
1748427496881,MUS 19R,A04,932504,Britt; King James,23,0,25,2
1748427496881,MUS 19R,A05,932512,Britt; King James,25,0,25,0
1748427496881,MUS 19R,A06,932513,Britt; King James,17,0,25,8
1748427496881,MUS 19R,A07,932517,Britt; King James,22,0,25,3
1748427496881,MUS 19R,A08,932522,Britt; King James,20,0,25,5
1748427496881,MUS 19R,A09,960795,Britt; King James,25,0,25,0
1748427496881,MUS 19R,A10,960796,Britt; King James,15,0,25,10
1748427496881,MUS 19R,B01,960808,Britt; King James,5,0,5,0
1748427496881,MUS 19R,B02,960810,Britt; King James,4,0,5,1
1748427496881,MUS 19R,B03,960812,Britt; King James,5,0,5,0
1748427496881,MUS 19R,B04,960815,Britt; King James,5,0,5,0
1748427496881,MUS 19R,B05,960861,Britt; King James,5,0,5,0
1748427496881,MUS 19R,B06,960863,Britt; King James,5,0,5,0
1748427496881,MUS 19R,B07,960866,Britt; King James,5,0,5,0
1748427496881,MUS 19R,B08,960870,Britt; King James,5,0,5,0
1748427496881,MUS 19R,B09,960871,Britt; King James,5,0,5,0
1748427496881,MUS 19R,B10,960872,Britt; King James,5,0,5,0
1748427497923,MUS 32,001,931432,Dresser; Mark Stuart,5,0,5,0
1748427497923,MUS 32,002,931433,Smythe; Cory Benjamin,5,0,5,0
1748427497923,MUS 32,003,931438,Kenyatta; Kamau,5,0,5,0
1748427497923,MUS 32,004,931441,Curtis; Charles Rector,5,0,5,0
1748427497923,MUS 32,005,931443,Staff,5,0,5,0
1748427497923,MUS 32,006,931447,Terrazas Perez; Wilfrido D,5,0,5,0
1748427497923,MUS 32,007,931448,Ohnishi; Takae,5,0,5,0
1748427497923,MUS 32,008,931453,Burr; Anthony I,5,0,5,0
1748427497923,MUS 32,009,931454,Carlson; Erik,5,0,5,0
1748427498951,MUS 32V,A00,932529,Staff,5,0,5,0
1748427498951,MUS 32V,B00,932532,Staff,5,0,5,0
1748427499978,MUS 32VM,A00,932533,Staff,15,0,15,0
1748427501003,MUS 33A,A00,932538,Liang; Lei,16,0,17,1
1748427502030,MUS 43,A00,932540,Staff,79,0,96,17
1748427503059,MUS 95C,A00,932544,Staff,30,0,40,10
1748427504093,MUS 95D,A00,932547,Staff,30,0,30,0
1748427505124,MUS 95E,A00,932548,Staff,45,0,45,0
1748427506155,MUS 95F,A00,932549,Staff,40,0,40,0
1748427507186,MUS 95G,A00,932550,Anderson; Kenneth,374,0,395,21
1748427507186,MUS 95G,B00,932553,Anderson; Kenneth,381,0,395,14
1748427508212,MUS 95JC,A00,932555,Kenyatta; Kamau,25,0,25,0
1748427509238,MUS 95L,A00,932556,Staff,65,0,65,0
1748427510272,MUS 95P,A00,932564,Nourai; Keyavash,17,0,20,3
1748427510272,MUS 95P,B00,932565,Nourai; Keyavash,18,0,20,2
1748427511304,MUS 95W,A00,932567,Seshadri; Kartik,26,0,30,4
1748427511304,MUS 95W,B00,932570,Seshadri; Kartik,30,0,30,0
1748427512329,MUS 101A,A01,932575,Burr; Anthony I,31,0,35,4
1748427513357,MUS 107,A00,932578,Terrazas Perez; Wilfrido D,14,0,15,1
1748427514385,MUS 111,A00,932580,Liang; Lei,135,0,140,5
1748427515415,MUS 113,A00,932584,Curtis; Charles Rector,48,0,50,2
1748427516445,MUS 115,A00,932585,Narucki; Susan M,32,0,40,8
1748427517478,MUS 120A,A01,932593,Leslie Santana; Myrta,27,0,30,3
1748427518506,MUS 130,A00,932600,Ohnishi; Takae,35,0,35,0
1748427519534,MUS 132,001,931462,Dresser; Mark Stuart,5,0,5,0
1748427519534,MUS 132,002,931463,Smythe; Cory Benjamin,5,0,5,0
1748427519534,MUS 132,003,931465,Kenyatta; Kamau,5,0,5,0
1748427519534,MUS 132,004,931467,Curtis; Charles Rector,5,0,5,0
1748427519534,MUS 132,005,931468,Staff,5,0,5,0
1748427519534,MUS 132,006,931470,Terrazas Perez; Wilfrido D,5,0,5,0
1748427519534,MUS 132,007,931471,Ohnishi; Takae,5,0,5,0
1748427519534,MUS 132,008,931473,Burr; Anthony I,5,0,5,0
1748427519534,MUS 132,009,931474,Carlson; Erik,5,0,5,0
1748427520562,MUS 132R,A00,961401,Narucki; Susan M,5,0,5,0
1748427521588,MUS 132V,A00,961362,Narucki; Susan M,10,0,10,0
1748427521588,MUS 132V,B00,961397,Staff,10,0,10,0
1748427522619,MUS 134,A00,932601,Staff,30,0,30,0
1748427523646,MUS 137A,A00,932604,Kenyatta; Kamau,31,0,35,4
1748427524675,MUS 143,A00,932617,Staff,10,0,30,20
1748427525702,MUS 170,A01,932620,Freitas Caetano; Marcelo,45,0,50,5
1748427525702,MUS 170,A02,932623,Freitas Caetano; Marcelo,41,0,50,9
1748427526729,MUS 173A,A00,932625,Britt; King James,27,0,65,38
1748427527760,MUS 174A,A00,932649,Erbe; Tom,0,0,25,25
1748427528794,MUS 175,A00,932810,Smyth; Tamara R.,29,0,30,1
1748427529821,MUS 176,A00,932811,Yadegari; Shahrokh D,29,0,30,1
1748427530847,MUS 201A,A00,932812,Carlson; Erik,14,0,15,1
1748427531876,MUS 201C,A00,932818,Schick; Steven,15,0,15,0
1748427532903,MUS 203A,A00,932821,Lou; Michelle Siulai,15,0,15,0
1748427533932,MUS 203D,A00,932825,Davis; Anthony Curtis,10,0,10,0
1748427533932,MUS 203D,B00,932827,Liang; Lei,10,0,10,0
1748427533932,MUS 203D,C00,932828,Lou; Michelle Siulai,9,0,10,1
1748427533932,MUS 203D,D00,932830,Obermueller; Karola,9,0,10,1
1748427533932,MUS 203D,E00,932831,Steiger; Rand,10,0,10,0
1748427533932,MUS 203D,F00,961402,McCormack; Timothy Matthew,10,0,10,0
1748427534958,MUS 204,A00,932832,Obermueller; Karola,29,0,30,1
1748427535987,MUS 205,A00,932833,Guy; Nancy,15,0,15,0
1748427537015,MUS 206,B00,961403,Obermueller; Karola,14,0,15,1
1748427537015,MUS 206,C00,932839,Davis; Anthony Curtis,14,0,15,1
1748427538049,MUS 215A,A00,932985,Cimini; Amy Marie,15,0,15,0
1748427539078,MUS 228,A00,933096,Schick; Steven,13,0,15,2
1748427540104,MUS 229,A00,933148,McCormack; Timothy Matthew,14,0,15,1
1748427541133,MUS 232,001,931483,Dresser; Mark Stuart,5,0,5,0
1748427541133,MUS 232,002,931485,Kenyatta; Kamau,5,0,5,0
1748427541133,MUS 232,003,931487,Narucki; Susan M,4,0,5,1
1748427541133,MUS 232,004,931489,Schick; Steven,5,0,5,0
1748427541133,MUS 232,005,964353,Terrazas Perez; Wilfrido D,3,0,3,0
1748427542164,MUS 234,A00,933176,Erbe; Tom,20,0,20,0
1748427543191,MUS 270D,A00,969315,Smyth; Tamara R.,0,0,0,0
1748427544235,MUS 291,A00,933192,Curtis; Charles Rector,15,0,15,0
1748427545269,NANO 4,A01,912573,Vazquez Mena; Oscar,21,0,24,3
1748427545269,NANO 4,B01,912575,Vazquez Mena; Oscar,24,0,24,0
1748427545269,NANO 4,C01,912577,Vazquez Mena; Oscar,21,0,24,3
1748427545269,NANO 4,D01,912579,Vazquez Mena; Oscar,23,0,24,1
1748427546297,NANO 11,A00,912580,Fenning; David,143,0,146,3
1748427547325,NANO 15,A01,912583,Lubarda; Vlado,26,0,30,4
1748427548354,NANO 20L,A00,912584,Sirbuly; Donald,0,0,30,30
1748427548354,NANO 20L,B00,912585,Sirbuly; Donald,20,0,30,10
1748427549387,NANO 102,A00,912586,Tao; Andrea Rae,99,0,115,16
1748427550415,NANO 103,A00,912587,Jahed Motlagh; Zeinab,49,0,50,1
1748427551441,NANO 111,A00,912588,Vecchio; Kenneth S,51,0,60,9
1748427552469,NANO 119,A00,912589,Jokerst; Jesse Vincent,6,0,28,22
1748427552469,NANO 119,B00,912590,Jokerst; Jesse Vincent,26,0,28,2
1748427553494,NANO 148,A00,912591,Luo; Jian,55,0,70,15
1748427554520,NANO 150,A00,912592,Lubarda; Vlado,48,0,50,2
1748427555549,NANO 159,A00,912593,Wang; Joseph,44,0,50,6
1748427556577,NANO 175,A00,912594,Steinmetz; Nicole F,13,0,35,22
1748427557605,NANO 200,A00,912595,Jahed Motlagh; Zeinab,110,0,120,10
1748427558633,NANO 201,A00,912596,Sirbuly; Donald,49,0,60,11
1748427559660,NANO 202,A00,912597,Pascal; Tod A,60,0,60,0
1748427560689,NANO 203,A00,912598,Fenning; David,95,0,100,5
1748427561721,NANO 227,A00,912599,Graeve; Olivia A,14,0,15,1
1748427562750,NANO 247A,A00,912600,Shi; Lingyan,9,0,15,6
1748427563777,NANO 247B,A00,912601,Aran; Kiana,11,0,15,4
1748427564805,NANO 257,A00,912602,Cai; Shengqiang,32,0,35,3
1748427565832,NANO 265,A00,912603,Luo; Jian,9,0,10,1
1748427566859,NEU 276,A00,969333,Staff,0,0,0,0
1748427566859,NEU 276,A01,969334,Staff,0,0,0,0
1748427567889,NEUG 200A,A01,969326,Bloodgood; Brenda Laurie,0,0,0,0
1748427567889,NEUG 200A,A02,969327,Bloodgood; Brenda Laurie,0,0,0,0
1748427568921,NEUG 221,A00,969330,Dore; Kim Bohemie,6,0,6,0
1748427568921,NEUG 221,B00,969331,Bloodgood; Brenda Laurie,0,0,0,0
1748427569948,NEUG 265,A00,969329,Yaksh; Tony L.,10,0,10,0
1748427571042,NEUG 296,A00,969336,Bloodgood; Brenda Laurie,12,0,12,0
1748427572076,PH 40,A00,922279,Trinidad; Dennis Ryan,136,0,150,14
1748427572076,PH 40,B00,922283,Trinidad; Dennis Ryan,148,0,150,2
1748427573104,PH 50,A00,922284,Glockner; Susan Mariscal,160,0,175,15
1748427574132,PH 90,A00,964352,Larsen; Britta Ann,0,0,0,0
1748427575162,PH 91,A00,922286,Harrell; Maralee Mae,48,0,50,2
1748427576188,PH 101,A00,922287,Brouwer; Kimberly,0,0,50,50
1748427577221,PH 102,A01,922307,Rana; Brinda Kanti,0,0,25,25
1748427577221,PH 102,A02,922310,Rana; Brinda Kanti,0,0,25,25
1748427578252,PH 110,A00,922333,Zoumas-Morse; Christine E.,0,0,50,50
1748427579285,PH 120,A00,922392,McMenamin; Sara B,0,0,50,50
1748427580313,PH 120R,A00,922393,McMenamin; Sara B,0,0,50,50
1748427581344,PH 130,A00,922441,Kayser; Georgia Lyn,0,0,60,60
1748427582375,PH 157,A00,922444,Campbell; Chadwick Karl,29,0,50,21
1748427583400,PH 161,A00,922445,Zoumas-Morse; Christine E.,0,0,50,50
1748427584431,PH 193,A00,922468,Zoumas-Morse; Christine E.,0,0,0,0
1748427585460,PH 231,A00,970937,Hurst; Samantha,12,0,12,0
1748427586494,PH 258,A00,960659,Bazzi; Angela Robertson,15,0,15,0
1748427587522,PH 259,A00,960660,Bandoli; Gretchen,10,0,10,0
1748427588549,PH 275,A00,922474,Groessl; Erik Joseph,10,0,10,0
1748427589578,PH 280,A00,960661,Strong; David R & Skaathun; Britt Paige,10,0,10,0
1748427590612,PHAR 219,A00,954131,Ross; Camille,0,0,0,0
1748427591643,PHAR 236,A00,934403,Chen; Shu-Juan,10,0,10,0
1748427592670,PHAR 295,A00,934404,Joiner; William J.,14,0,15,1
1748427593699,PHB 221,A00,922708,Zou; Jingjing,22,0,39,17
1748427594727,PHB 224,A00,922793,Jain; Sonia,9,0,30,21
1748427595754,PHB 227,A00,922796,Liu; Lin,14,0,37,23
1748427596783,PHB 241,A00,970723,Vaida; Florin,9998,0,9999,1
1748427597817,PHB 243A,A01,922822,Tu; Xin,20,0,45,25
1748427598843,PHB 244A,A00,922870,Zhang; Xinlian,20,0,35,15
1748427599874,PHB 280,A00,922875,Messer; Karen Sue,69,0,70,1
1748427600901,PHB 281,A00,923029,Staff,62,0,65,3
1748427601931,PHIL 1,A00,934405,Sher; Gila,38,0,40,2
1748427602960,PHIL 10,A01,934409,Rudolph; Rachel Etta,34,0,39,5
1748427602960,PHIL 10,A02,934410,Rudolph; Rachel Etta,32,0,40,8
1748427602960,PHIL 10,A03,934414,Rudolph; Rachel Etta,31,0,40,9
1748427602960,PHIL 10,A04,934415,Rudolph; Rachel Etta,39,0,40,1
1748427602960,PHIL 10,A05,934416,Rudolph; Rachel Etta,35,0,40,5
1748427602960,PHIL 10,A06,934417,Rudolph; Rachel Etta,39,0,40,1
1748427603993,PHIL 12,A01,934419,Harrell; Maralee Mae,0,0,0,0
1748427603993,PHIL 12,A02,934422,Harrell; Maralee Mae,0,0,0,0
1748427603993,PHIL 12,A03,934423,Harrell; Maralee Mae,30,0,35,5
1748427603993,PHIL 12,A04,934425,Harrell; Maralee Mae,32,0,35,3
1748427605025,PHIL 13,A01,934427,Lamey; Andy M.,32,0,34,2
1748427605025,PHIL 13,A02,934429,Lamey; Andy M.,31,0,34,3
1748427605025,PHIL 13,A03,934430,Lamey; Andy M.,31,0,34,3
1748427605025,PHIL 13,A04,934432,Lamey; Andy M.,34,0,34,0
1748427606053,PHIL 25,A00,934434,Chen; Keming,65,0,70,5
1748427607085,PHIL 27,A01,934442,Brandt; Reuven A,0,0,33,33
1748427607085,PHIL 27,A02,934443,Brandt; Reuven A,7,0,33,26
1748427607085,PHIL 27,A03,934444,Brandt; Reuven A,10,0,33,23
1748427607085,PHIL 27,A04,934448,Brandt; Reuven A,0,0,33,33
1748427607085,PHIL 27,A05,934450,Brandt; Reuven A,19,0,33,14
1748427607085,PHIL 27,A06,934452,Brandt; Reuven A,0,0,33,33
1748427607085,PHIL 27,A07,934499,Brandt; Reuven A,0,0,33,33
1748427607085,PHIL 27,A08,934500,Brandt; Reuven A,5,0,33,28
1748427608113,PHIL 28,A01,934502,Brink; David O.,26,0,33,7
1748427608113,PHIL 28,A02,934506,Brink; David O.,26,0,33,7
1748427608113,PHIL 28,A03,934507,Brink; David O.,27,0,33,6
1748427608113,PHIL 28,A04,934512,Brink; David O.,8,0,33,25
1748427608113,PHIL 28,A05,934517,Brink; David O.,20,0,33,13
1748427608113,PHIL 28,A06,934518,Brink; David O.,0,0,33,33
1748427608113,PHIL 28,A07,934519,Brink; David O.,16,0,33,17
1748427608113,PHIL 28,A08,934520,Brink; David O.,27,0,33,6
1748427609140,PHIL 35,A00,934521,Vargas; Manuel Rogelio,138,0,140,2
1748427610166,PHIL 50,A00,934524,Nelkin; Dana Kay,124,0,140,16
1748427611194,PHIL 65,A00,934526,Rudolph; Rachel Etta,37,0,40,3
1748427612220,PHIL 110,A00,934529,Shields; Christopher John,38,0,42,4
1748427613249,PHIL 115,A00,934530,Nelkin; Dana Kay,15,0,20,5
1748427614278,PHIL 120,A00,934533,Kocurek; Alexander William,45,0,60,15
1748427615303,PHIL 125,A00,934534,Carr; Jennifer Rose,38,0,40,2
1748427616330,PHIL 138,A00,934535,Brink; David O.,29,0,40,11
1748427617362,PHIL 143,A00,934579,Cohen; Jonathan David,40,0,40,0
1748427618388,PHIL 148,A00,934580,Callender; Craig Adam,126,0,140,14
1748427619416,PHIL 149,A00,934581,Fulkerson; Matthew Todd,37,0,70,33
1748427620444,PHIL 158,A00,934593,Chen; Keming,20,0,40,20
1748427621475,PHIL 166,A00,934675,Lamey; Andy M.,27,0,40,13
1748427622503,PHIL 180,A00,934688,Hardimon; Michael O.,32,0,40,8
1748427623529,PHIL 200,A00,934719,Kovaka; Karenc,20,0,20,0
1748427624559,PHIL 201A,A00,934736,Shields; Christopher John,18,0,20,2
1748427625589,PHIL 209A,A00,934772,McKenzie; Kerry V.,10,0,10,0
1748427626617,PHIL 209C,A00,934787,McKenzie; Kerry V.,10,0,10,0
1748427627643,PHIL 222,A00,934789,Kocurek; Alexander William & Carr; Jennifer Rose,19,0,20,1
1748427628675,PHIL 260,A00,934791,Bazargan-Forward; Saba,18,0,20,2
1748427629702,PHIL 271,A00,934793,Vargas; Manuel Rogelio & Nelkin; Dana Kay & Fulkerson; Matthew Todd,9999,0,9999,0
1748427630733,PHIL 275,A00,934819,Watkins; Eric,9998,0,9999,1
1748427631759,PHIL 277,A00,934820,Tolley; Clinton,9997,0,9999,2
1748427632784,PHIL 278,A00,934821,Cohen; Jonathan David & Fulkerson; Matthew Todd,9999,0,9999,0
1748427633810,PHIL 280,A00,934827,Kovaka; Karenc,9999,0,9999,0
1748427634838,PHIL 281,A00,934828,Tolley; Clinton,9999,0,9999,0
1748427635871,PHIL 282,A00,934869,Bazargan-Forward; Saba,9999,0,9999,0
1748427636897,PHIL 283,A00,934870,Vargas; Manuel Rogelio & Tolley; Clinton,9999,0,9999,0
1748427637924,PHIL 286,A00,934871,Callender; Craig Adam & Chen; Keming,9999,0,9999,0
1748427638953,PHIL 287,A00,934872,Shields; Christopher John,9999,0,9999,0
1748427640008,PHIL 290,001,963258,Bazargan-Forward; Saba,9999,0,9999,0
1748427640008,PHIL 290,002,963281,Brandt; Reuven A,9999,0,9999,0
1748427640008,PHIL 290,003,963724,Brink; David O.,9999,0,9999,0
1748427640008,PHIL 290,004,963726,Callender; Craig Adam,9999,0,9999,0
1748427640008,PHIL 290,005,963740,Carr; Jennifer Rose,9999,0,9999,0
1748427640008,PHIL 290,006,963878,Cartwright; Nancy D.,9999,0,9999,0
1748427640008,PHIL 290,007,963888,Chen; Keming,9999,0,9999,0
1748427640008,PHIL 290,008,963889,Cohen; Jonathan David,9999,0,9999,0
1748427640008,PHIL 290,009,964028,Danks; David J,9999,0,9999,0
1748427640008,PHIL 290,010,964036,Fulkerson; Matthew Todd,9999,0,9999,0
1748427640008,PHIL 290,011,964044,Hardimon; Michael O.,9999,0,9999,0
1748427640008,PHIL 290,012,964084,Harrell; Maralee Mae,9999,0,9999,0
1748427640008,PHIL 290,013,964086,Johnson; Monte,9999,0,9999,0
1748427640008,PHIL 290,014,964093,Kocurek; Alexander William,9999,0,9999,0
1748427640008,PHIL 290,015,964101,Kovaka; Karenc,9999,0,9999,0
1748427640008,PHIL 290,016,964107,Lamey; Andy M.,9999,0,9999,0
1748427640008,PHIL 290,017,964113,Marechal; Patricia,9999,0,9999,0
1748427640008,PHIL 290,018,964125,McKenzie; Kerry V.,9999,0,9999,0
1748427640008,PHIL 290,019,964131,Nelkin; Dana Kay,9999,0,9999,0
1748427640008,PHIL 290,020,964132,Rickless; Samuel Charles,9999,0,9999,0
1748427640008,PHIL 290,021,964133,Rudolph; Rachel Etta,9999,0,9999,0
1748427640008,PHIL 290,022,964141,Sher; Gila,9999,0,9999,0
1748427640008,PHIL 290,023,964142,Shields; Christopher John,9999,0,9999,0
1748427640008,PHIL 290,024,964181,Tolley; Clinton,9999,0,9999,0
1748427640008,PHIL 290,025,964182,Vargas; Manuel Rogelio,9999,0,9999,0
1748427640008,PHIL 290,026,964232,Watkins; Eric,9999,0,9999,0
1748427640008,PHIL 290,027,964233,Yuan; Yuan,9999,0,9999,0
1748427641036,PHIL 295,001,964259,Bazargan-Forward; Saba,9999,0,9999,0
1748427641036,PHIL 295,002,964262,Brandt; Reuven A,9999,0,9999,0
1748427641036,PHIL 295,003,964263,Brink; David O.,9999,0,9999,0
1748427641036,PHIL 295,004,964264,Callender; Craig Adam,9999,0,9999,0
1748427641036,PHIL 295,005,964265,Carr; Jennifer Rose,9999,0,9999,0
1748427641036,PHIL 295,006,964266,Cartwright; Nancy D.,9999,0,9999,0
1748427641036,PHIL 295,007,964267,Chen; Keming,9999,0,9999,0
1748427641036,PHIL 295,008,964268,Cohen; Jonathan David,9999,0,9999,0
1748427641036,PHIL 295,009,964269,Danks; David J,9999,0,9999,0
1748427641036,PHIL 295,010,964270,Fulkerson; Matthew Todd,9999,0,9999,0
1748427641036,PHIL 295,011,964271,Hardimon; Michael O.,9999,0,9999,0
1748427641036,PHIL 295,012,964272,Harrell; Maralee Mae,9999,0,9999,0
1748427641036,PHIL 295,013,964273,Johnson; Monte,9999,0,9999,0
1748427641036,PHIL 295,014,964274,Kocurek; Alexander William,9999,0,9999,0
1748427641036,PHIL 295,015,964275,Kovaka; Karenc,9999,0,9999,0
1748427641036,PHIL 295,016,964276,Lamey; Andy M.,9999,0,9999,0
1748427641036,PHIL 295,017,964277,Marechal; Patricia,9999,0,9999,0
1748427641036,PHIL 295,018,964278,McKenzie; Kerry V.,9999,0,9999,0
1748427641036,PHIL 295,019,964279,Nelkin; Dana Kay,9999,0,9999,0
1748427641036,PHIL 295,020,964280,Rickless; Samuel Charles,9999,0,9999,0
1748427641036,PHIL 295,021,964281,Rudolph; Rachel Etta,9999,0,9999,0
1748427641036,PHIL 295,022,964282,Sher; Gila,9999,0,9999,0
1748427641036,PHIL 295,023,964283,Shields; Christopher John,9999,0,9999,0
1748427641036,PHIL 295,024,964284,Tolley; Clinton,9999,0,9999,0
1748427641036,PHIL 295,025,964285,Vargas; Manuel Rogelio,9999,0,9999,0
1748427641036,PHIL 295,026,964286,Watkins; Eric,9999,0,9999,0
1748427641036,PHIL 295,027,964287,Yuan; Yuan,9999,0,9999,0
1748427642067,PHYS 1A,A00,935435,Groisman; Alexander,434,0,589,155
1748427642067,PHYS 1A,B00,935437,Groisman; Alexander,456,0,600,144
1748427643110,PHYS 1AL,001,935439,Bal; Gurleen K & Frano Pereira; Alex M,18,0,30,12
1748427643110,PHYS 1AL,002,935440,Bal; Gurleen K & Frano Pereira; Alex M,25,0,30,5
1748427643110,PHYS 1AL,003,935443,Bal; Gurleen K & Frano Pereira; Alex M,0,0,30,30
1748427643110,PHYS 1AL,004,935445,Bal; Gurleen K & Frano Pereira; Alex M,0,0,30,30
1748427643110,PHYS 1AL,005,935448,Bal; Gurleen K & Frano Pereira; Alex M,0,0,30,30
1748427643110,PHYS 1AL,006,935449,Bal; Gurleen K & Frano Pereira; Alex M,0,0,30,30
1748427643110,PHYS 1AL,007,935451,Bal; Gurleen K & Frano Pereira; Alex M,0,0,30,30
1748427643110,PHYS 1AL,008,935452,Bal; Gurleen K & Frano Pereira; Alex M,1,0,30,29
1748427643110,PHYS 1AL,009,935454,Bal; Gurleen K & Frano Pereira; Alex M,9,0,30,21
1748427643110,PHYS 1AL,010,935589,Bal; Gurleen K & Frano Pereira; Alex M,17,0,30,13
1748427643110,PHYS 1AL,011,935590,Bal; Gurleen K & Frano Pereira; Alex M,15,0,19,4
1748427643110,PHYS 1AL,012,935591,Bal; Gurleen K & Frano Pereira; Alex M,29,0,30,1
1748427643110,PHYS 1AL,013,935652,Bal; Gurleen K & Frano Pereira; Alex M,0,0,30,30
1748427643110,PHYS 1AL,014,935675,Bal; Gurleen K & Frano Pereira; Alex M,0,0,30,30
1748427643110,PHYS 1AL,015,935680,Bal; Gurleen K & Frano Pereira; Alex M,0,0,30,30
1748427643110,PHYS 1AL,016,935703,Bal; Gurleen K & Frano Pereira; Alex M,0,0,30,30
1748427643110,PHYS 1AL,017,935704,Bal; Gurleen K & Frano Pereira; Alex M,9,0,30,21
1748427643110,PHYS 1AL,018,935729,Bal; Gurleen K & Frano Pereira; Alex M,12,0,30,18
1748427643110,PHYS 1AL,019,935825,Bal; Gurleen K & Frano Pereira; Alex M,23,0,30,7
1748427643110,PHYS 1AL,020,935826,Bal; Gurleen K & Frano Pereira; Alex M,27,0,30,3
1748427643110,PHYS 1AL,021,935946,Bal; Gurleen K & Frano Pereira; Alex M,28,0,30,2
1748427643110,PHYS 1AL,022,935947,Bal; Gurleen K & Frano Pereira; Alex M,30,0,30,0
1748427643110,PHYS 1AL,023,936029,Bal; Gurleen K & Frano Pereira; Alex M,4,0,30,26
1748427643110,PHYS 1AL,024,936031,Bal; Gurleen K & Frano Pereira; Alex M,12,0,30,18
1748427643110,PHYS 1AL,025,936033,Bal; Gurleen K & Frano Pereira; Alex M,19,0,30,11
1748427643110,PHYS 1AL,026,936034,Bal; Gurleen K & Frano Pereira; Alex M,19,0,30,11
1748427643110,PHYS 1AL,027,936036,Bal; Gurleen K & Frano Pereira; Alex M,6,0,30,24
1748427643110,PHYS 1AL,028,936038,Bal; Gurleen K & Frano Pereira; Alex M,22,0,30,8
1748427643110,PHYS 1AL,029,936044,Bal; Gurleen K & Frano Pereira; Alex M,20,0,30,10
1748427643110,PHYS 1AL,030,936045,Bal; Gurleen K & Frano Pereira; Alex M,27,0,30,3
1748427643110,PHYS 1AL,031,936054,Bal; Gurleen K & Frano Pereira; Alex M,28,0,30,2
1748427643110,PHYS 1AL,032,936056,Bal; Gurleen K & Frano Pereira; Alex M,28,0,30,2
1748427643110,PHYS 1AL,033,936057,Bal; Gurleen K & Frano Pereira; Alex M,0,0,30,30
1748427643110,PHYS 1AL,034,936059,Bal; Gurleen K & Frano Pereira; Alex M,1,0,30,29
1748427643110,PHYS 1AL,035,936060,Bal; Gurleen K & Frano Pereira; Alex M,11,0,30,19
1748427643110,PHYS 1AL,036,936063,Bal; Gurleen K & Frano Pereira; Alex M,21,0,30,9
1748427643110,PHYS 1AL,037,960551,Bal; Gurleen K & Frano Pereira; Alex M,25,0,30,5
1748427643110,PHYS 1AL,038,960592,Bal; Gurleen K & Frano Pereira; Alex M,28,0,30,2
1748427643110,PHYS 1AL,039,960618,Bal; Gurleen K & Frano Pereira; Alex M,29,0,30,1
1748427643110,PHYS 1AL,040,960644,Bal; Gurleen K & Frano Pereira; Alex M,30,0,30,0
1748427644145,PHYS 1B,A00,936064,Staff,216,0,360,144
1748427645182,PHYS 1BL,001,936066,Bal; Gurleen K & Frano Pereira; Alex M,1,0,29,28
1748427645182,PHYS 1BL,002,936067,Bal; Gurleen K & Frano Pereira; Alex M,0,0,30,30
1748427645182,PHYS 1BL,003,936068,Bal; Gurleen K & Frano Pereira; Alex M,5,0,30,25
1748427645182,PHYS 1BL,004,936072,Bal; Gurleen K & Frano Pereira; Alex M,0,0,30,30
1748427645182,PHYS 1BL,005,936074,Bal; Gurleen K & Frano Pereira; Alex M,0,0,30,30
1748427645182,PHYS 1BL,006,936075,Bal; Gurleen K & Frano Pereira; Alex M,0,0,30,30
1748427645182,PHYS 1BL,007,936116,Bal; Gurleen K & Frano Pereira; Alex M,7,0,30,23
1748427645182,PHYS 1BL,008,936125,Bal; Gurleen K & Frano Pereira; Alex M,14,0,30,16
1748427645182,PHYS 1BL,009,936128,Bal; Gurleen K & Frano Pereira; Alex M,12,0,30,18
1748427645182,PHYS 1BL,010,936145,Bal; Gurleen K & Frano Pereira; Alex M,14,0,30,16
1748427645182,PHYS 1BL,011,936146,Bal; Gurleen K & Frano Pereira; Alex M,0,0,30,30
1748427645182,PHYS 1BL,012,936147,Bal; Gurleen K & Frano Pereira; Alex M,6,0,30,24
1748427646211,PHYS 1C,A00,936148,Tsai; Philbert S,220,0,360,140
1748427647237,PHYS 1CL,001,936149,Bal; Gurleen K & Frano Pereira; Alex M,0,0,30,30
1748427647237,PHYS 1CL,002,936150,Bal; Gurleen K & Frano Pereira; Alex M,0,0,30,30
1748427647237,PHYS 1CL,003,936152,Bal; Gurleen K & Frano Pereira; Alex M,0,0,30,30
1748427647237,PHYS 1CL,004,936153,Bal; Gurleen K & Frano Pereira; Alex M,0,0,30,30
1748427647237,PHYS 1CL,005,936154,Bal; Gurleen K & Frano Pereira; Alex M,0,0,30,30
1748427647237,PHYS 1CL,006,936156,Bal; Gurleen K & Frano Pereira; Alex M,0,0,24,24
1748427647237,PHYS 1CL,007,936157,Bal; Gurleen K & Frano Pereira; Alex M,22,0,30,8
1748427647237,PHYS 1CL,008,936158,Bal; Gurleen K & Frano Pereira; Alex M,0,0,30,30
1748427647237,PHYS 1CL,009,936159,Bal; Gurleen K & Frano Pereira; Alex M,0,0,30,30
1748427647237,PHYS 1CL,010,936160,Bal; Gurleen K & Frano Pereira; Alex M,0,0,30,30
1748427647237,PHYS 1CL,011,936161,Bal; Gurleen K & Frano Pereira; Alex M,0,0,30,30
1748427647237,PHYS 1CL,012,936162,Bal; Gurleen K & Frano Pereira; Alex M,0,0,30,30
1748427648264,PHYS 2A,A01,936165,Shotwell; Brian,30,0,30,0
1748427648264,PHYS 2A,A02,936167,Shotwell; Brian,28,0,30,2
1748427648264,PHYS 2A,A03,936168,Shotwell; Brian,25,0,30,5
1748427648264,PHYS 2A,A04,936169,Shotwell; Brian,30,0,30,0
1748427648264,PHYS 2A,A05,936170,Shotwell; Brian,16,0,25,9
1748427648264,PHYS 2A,A06,936171,Shotwell; Brian,26,0,30,4
1748427648264,PHYS 2A,A07,936172,Shotwell; Brian,18,0,30,12
1748427648264,PHYS 2A,A08,936174,Shotwell; Brian,24,0,30,6
1748427648264,PHYS 2A,A09,936175,Shotwell; Brian,25,0,30,5
1748427648264,PHYS 2A,A10,936176,Shotwell; Brian,25,0,30,5
1748427648264,PHYS 2A,A11,936177,Shotwell; Brian,21,0,30,9
1748427648264,PHYS 2A,A12,936179,Shotwell; Brian,25,0,30,5
1748427649297,PHYS 2B,A01,936182,Barreiro Guerrero; Julio,13,0,30,17
1748427649297,PHYS 2B,A02,936183,Barreiro Guerrero; Julio,20,0,30,10
1748427649297,PHYS 2B,A03,936184,Barreiro Guerrero; Julio,20,0,30,10
1748427649297,PHYS 2B,A04,936185,Barreiro Guerrero; Julio,26,0,29,3
1748427649297,PHYS 2B,A05,936187,Barreiro Guerrero; Julio,27,0,30,3
1748427649297,PHYS 2B,A06,936217,Barreiro Guerrero; Julio,26,0,30,4
1748427649297,PHYS 2B,A07,936219,Barreiro Guerrero; Julio,23,0,30,7
1748427649297,PHYS 2B,A08,936220,Barreiro Guerrero; Julio,26,0,30,4
1748427649297,PHYS 2B,A09,936221,Barreiro Guerrero; Julio,29,0,30,1
1748427649297,PHYS 2B,A10,936224,Barreiro Guerrero; Julio,29,0,30,1
1748427649297,PHYS 2B,A11,936229,Barreiro Guerrero; Julio,28,0,30,2
1748427649297,PHYS 2B,A12,936231,Barreiro Guerrero; Julio,27,0,30,3
1748427650332,PHYS 2C,A01,936235,Tan; Tzer Han,23,0,30,7
1748427650332,PHYS 2C,A02,936236,Tan; Tzer Han,27,0,30,3
1748427650332,PHYS 2C,A03,936237,Tan; Tzer Han,22,0,30,8
1748427650332,PHYS 2C,A04,936246,Tan; Tzer Han,17,0,30,13
1748427650332,PHYS 2C,A05,936292,Tan; Tzer Han,16,0,28,12
1748427650332,PHYS 2C,A06,936300,Tan; Tzer Han,19,0,30,11
1748427650332,PHYS 2C,A07,936301,Tan; Tzer Han,8,0,30,22
1748427650332,PHYS 2C,A08,936302,Tan; Tzer Han,20,0,30,10
1748427650332,PHYS 2C,A09,936303,Tan; Tzer Han,26,0,30,4
1748427650332,PHYS 2C,A10,936304,Tan; Tzer Han,26,0,30,4
1748427650332,PHYS 2C,A11,936305,Tan; Tzer Han,12,0,30,18
1748427650332,PHYS 2C,A12,936332,Tan; Tzer Han,27,0,30,3
1748427650332,PHYS 2C,B01,936337,Tan; Tzer Han,0,0,30,30
1748427650332,PHYS 2C,B02,936470,Tan; Tzer Han,1,0,30,29
1748427650332,PHYS 2C,B03,936503,Tan; Tzer Han,21,0,30,9
1748427650332,PHYS 2C,B04,936533,Tan; Tzer Han,22,0,30,8
1748427650332,PHYS 2C,B05,936534,Tan; Tzer Han,20,0,30,10
1748427650332,PHYS 2C,B06,936535,Tan; Tzer Han,23,0,30,7
1748427650332,PHYS 2C,B07,936536,Tan; Tzer Han,25,0,30,5
1748427650332,PHYS 2C,B08,936537,Tan; Tzer Han,22,0,30,8
1748427650332,PHYS 2C,B09,936539,Tan; Tzer Han,26,0,30,4
1748427650332,PHYS 2C,B10,936540,Tan; Tzer Han,27,0,30,3
1748427650332,PHYS 2C,B11,936544,Tan; Tzer Han,28,0,30,2
1748427650332,PHYS 2C,B12,936548,Tan; Tzer Han,28,0,30,2
1748427651359,PHYS 2CL,A01,936555,Ni; Kaixuan,0,0,28,28
1748427651359,PHYS 2CL,A02,936556,Ni; Kaixuan,0,0,28,28
1748427651359,PHYS 2CL,A03,936557,Ni; Kaixuan,0,0,28,28
1748427651359,PHYS 2CL,A04,936559,Ni; Kaixuan,0,0,28,28
1748427651359,PHYS 2CL,A05,936566,Ni; Kaixuan,0,0,28,28
1748427651359,PHYS 2CL,A06,936582,Ni; Kaixuan,0,0,28,28
1748427651359,PHYS 2CL,A07,936583,Ni; Kaixuan,0,0,28,28
1748427652400,PHYS 2D,A01,936615,Sharma; Vivek A.,0,0,27,27
1748427653428,PHYS 2DL,A01,936627,Butov; Leonid,14,0,17,3
1748427653428,PHYS 2DL,A02,936628,Butov; Leonid,0,0,17,17
1748427653428,PHYS 2DL,A03,936629,Butov; Leonid,3,0,15,12
1748427653428,PHYS 2DL,A04,936630,Butov; Leonid,10,0,17,7
1748427653428,PHYS 2DL,A05,936631,Butov; Leonid,17,0,17,0
1748427653428,PHYS 2DL,A06,936632,Butov; Leonid,7,0,17,10
1748427653428,PHYS 2DL,A07,936633,Butov; Leonid,8,0,18,10
1748427654456,PHYS 4C,A01,936635,Chivukula; Raja S,22,0,43,21
1748427654456,PHYS 4C,A02,936636,Chivukula; Raja S,33,0,45,12
1748427654456,PHYS 4C,A03,936637,Chivukula; Raja S,38,0,45,7
1748427654456,PHYS 4C,A04,936638,Chivukula; Raja S,44,0,45,1
1748427655488,PHYS 12,A01,936640,Branson; James G,187,0,192,5
1748427656519,PHYS 87,A00,936641,Grinstein; Benjamin,20,0,20,0
1748427657547,PHYS 100A,A01,936643,Green; Daniel Richard,111,0,146,35
1748427658574,PHYS 110A,A01,936645,Dudko; Olga,107,0,146,39
1748427659601,PHYS 116,A00,936646,Diamond; Patrick H & Vergassola; Massimo,12,0,15,3
1748427660633,PHYS 130B,A01,936648,Keating; Brian,56,0,60,4
1748427661666,PHYS 133,A00,936649,Allen; Monica T,20,0,32,12
1748427662692,PHYS 136,A00,936650,Grinstein; Benjamin,42,0,50,8
1748427663719,PHYS 139,A00,936651,Hirsch; Jorge Eduardo,13,0,15,2
1748427663719,PHYS 139,B00,936663,Duarte; Javier Mauricio,0,0,0,10
1748427664750,PHYS 140A,A01,936723,Parker; Daniel E,54,0,60,6
1748427665783,PHYS 161,A01,936727,Fuller; George Michael,53,0,60,7
1748427666809,PHYS 175,A00,936728,Koslover; Elena F,11,0,15,4
1748427667840,PHYS 191,A00,936730,Yang; Liang,68,0,75,7
1748427668868,PHYS 200A,A01,936733,Di Ventra; Massimiliano,20,0,30,10
1748427669896,PHYS 201,A01,936736,Vergassola; Massimo,23,0,30,7
1748427670927,PHYS 210B,A00,936737,McGreevy; John A.,29,0,30,1
1748427671955,PHYS 211A,A00,936740,Butov; Leonid,28,0,30,2
1748427672982,PHYS 212A,A01,936873,Fogler; Michael M.,38,0,50,12
1748427674007,PHYS 215A,A00,936878,Shotwell; Brian,30,0,30,0
1748427675087,PHYS 216,A00,936879,Diamond; Patrick H & Vergassola; Massimo,15,0,15,0
1748427676114,PHYS 219,A00,936903,Allen; Monica T,5,0,5,0
1748427677145,PHYS 220,A01,936910,Arovas; Daniel P,30,0,30,0
1748427678172,PHYS 225A,A00,936911,Flauger; Raphael M,28,0,30,2
1748427679199,PHYS 239,A00,937172,Hirsch; Jorge Eduardo,14,0,15,1
1748427679199,PHYS 239,B00,937176,Duarte; Javier Mauricio,15,0,15,0
1748427679199,PHYS 239,C00,959883,Intriligator; Kenneth Arthur,30,0,30,0
1748427680225,PHYS 250,A00,937178,Hirsch; Jorge Eduardo,14,0,15,1
1748427681252,PHYS 251,A00,937182,Grinstein; Benjamin,15,0,15,0
1748427682281,PHYS 252,A00,937183,Diamond; Patrick H,15,0,15,0
1748427683306,PHYS 253,A00,937184,Fuller; George Michael,15,0,15,0
1748427684334,PHYS 254,A00,937185,Serra; Mattia,15,0,15,0
1748427685364,PHYS 255,A00,937186,Hwa; Terence T.,14,0,15,1
1748427686391,PHYS 260,A00,937187,Shpyrko; Oleg,49,0,50,1
1748427687416,PHYS 275,A00,937190,Koslover; Elena F,15,0,15,0
1748427688448,PHYS 279,A01,946429,Silva; Gabriel,0,0,0,0
1748427689477,PHYS 282,A00,937194,Hwa; Terence T.,20,0,20,0
1748427690504,POLI 5D,A01,937210,Staff,4,0,5,1
1748427690504,POLI 5D,B01,937219,Staff,5,0,5,0
1748427690504,POLI 5D,C01,937225,Dai; Yinlin,0,0,5,5
1748427691533,POLI 10D,A01,937228,Noble; Benjamin S,20,0,28,8
1748427691533,POLI 10D,A02,937229,Noble; Benjamin S,24,0,28,4
1748427691533,POLI 10D,A03,937230,Noble; Benjamin S,24,0,27,3
1748427691533,POLI 10D,A04,937231,Noble; Benjamin S,25,0,27,2
1748427691533,POLI 10D,A05,937238,Noble; Benjamin S,27,0,28,1
1748427691533,POLI 10D,A06,937243,Noble; Benjamin S,26,0,28,2
1748427692564,POLI 11D,A01,937360,Desposato; Scott,20,0,29,9
1748427692564,POLI 11D,A02,937430,Desposato; Scott,22,0,29,7
1748427692564,POLI 11D,A03,937445,Desposato; Scott,25,0,29,4
1748427692564,POLI 11D,A04,937446,Desposato; Scott,29,0,29,0
1748427692564,POLI 11D,A05,937447,Desposato; Scott,27,0,29,2
1748427692564,POLI 11D,A06,937463,Desposato; Scott,27,0,29,2
1748427693595,POLI 12D,A01,937472,Roeder; Philip G,16,0,20,4
1748427693595,POLI 12D,A02,937475,Roeder; Philip G,18,0,20,2
1748427693595,POLI 12D,A03,937485,Roeder; Philip G,17,0,19,2
1748427693595,POLI 12D,A04,937490,Roeder; Philip G,17,0,20,3
1748427693595,POLI 12D,A05,937500,Roeder; Philip G,19,0,20,1
1748427693595,POLI 12D,A06,937507,Roeder; Philip G,20,0,20,0
1748427694623,POLI 30D,A01,937510,Desposato; Scott,0,0,23,23
1748427694623,POLI 30D,A02,937530,Desposato; Scott,0,0,23,23
1748427694623,POLI 30D,A03,937531,Desposato; Scott,11,0,23,12
1748427694623,POLI 30D,A04,937532,Desposato; Scott,18,0,23,5
1748427694623,POLI 30D,A05,937591,Desposato; Scott,5,0,23,18
1748427694623,POLI 30D,A06,937592,Desposato; Scott,19,0,23,4
1748427695651,POLI 100H,A00,937593,Stout; Christopher Timothy,114,0,183,69
1748427696678,POLI 100I,A00,937594,Gause; LaGina,47,0,56,9
1748427697705,POLI 100V,A00,937596,Gause; LaGina,56,0,68,12
1748427698736,POLI 101A,A00,937597,Stout; Christopher Timothy,84,0,115,31
1748427699763,POLI 104A,A00,937598,Smith; Glenn Chatmas,207,0,290,83
1748427700791,POLI 104N,A00,937599,Stephens; Mattheus E,168,0,245,77
1748427701818,POLI 110A,A00,937600,Wiens; David,61,0,70,9
1748427702849,POLI 118,A00,937601,Wiens; David,69,0,94,25
1748427703876,POLI 122D,A00,937602,Strom; Kaare,15,0,70,55
1748427704902,POLI 125B,A00,937603,Naoi; Megumi,128,0,158,30
1748427705929,POLI 125D,A00,937604,Nichter; Simeon C,103,0,158,55
1748427706959,POLI 126,A00,937607,Nichter; Simeon C,43,0,120,77
1748427707989,POLI 133A,A00,937608,Naoi; Megumi,202,0,216,14
1748427709020,POLI 134D,A00,937609,Saiegh; Sebastian,62,0,75,13
1748427710048,POLI 143A,A00,937610,Slantchev; Branislav,147,0,158,11
1748427711076,POLI 145C,A00,937611,Fisk; David Lee,152,0,190,38
1748427712103,POLI 154,A00,937612,Fisk; David Lee,28,0,90,62
1748427713130,POLI 163,A00,937613,Saiegh; Sebastian,103,0,120,17
1748427714159,POLI 176,A00,968071,Roberts; Margaret Earling,23,0,45,22
1748427715190,POLI 191A,A00,937617,Stout; Christopher Timothy & Saiegh; Sebastian,25,0,25,0
1748427716221,POLI 194,A00,954111,Hill; Seth J,9999,0,9999,0
1748427717247,POLI 204A,A00,937618,Schneider; Christina,20,0,25,5
1748427718274,POLI 204B,A00,937619,Desposato; Scott,7,0,12,5
1748427719299,POLI 220B,A00,937621,Strom; Kaare,20,0,25,5
1748427720331,POLI 225,A00,937622,Thomas; Jakana,18,0,25,7
1748427721359,POLI 251,A00,937623,Noble; Benjamin S,24,0,25,1
1748427722386,POLI 252,A00,937624,Hajnal; Zoltan Lloyd,24,0,25,1
1748427724445,POLI 270,A00,973288,Roberts; Margaret Earling,24,0,25,1
1748427725471,POLI 279,A00,937626,Staff,8,0,12,4
1748427726501,POLI 280,A00,937628,Hafner-Burton; Emilie,21,0,25,4
1748427727527,POLI 281,A00,937629,Stout; Christopher Timothy,13,0,15,2
1748427728553,POLI 282,A00,937630,Roeder; Philip G,20,0,25,5
1748427729581,POLI 283,A00,937631,Slantchev; Branislav,18,0,25,7
1748427730612,POLI 285,A00,937632,Wiens; David,12,0,12,0
1748427731639,PSYC 1,A00,937633,Hurwitz; Ethan Scott,175,0,200,25
1748427732667,PSYC 2,A00,937634,Rose; Fred E.,133,0,150,17
1748427733695,PSYC 3R,A00,937693,Pilegard; Celeste Cristine,195,0,200,5
1748427734722,PSYC 6,A00,937694,McCullough; Michael E,142,0,150,8
1748427735758,PSYC 60,A01,957947,Lowe; Angela Beth,10,0,25,15
1748427735758,PSYC 60,A02,957948,Lowe; Angela Beth,17,0,25,8
1748427735758,PSYC 60,A03,957949,Lowe; Angela Beth,18,0,25,7
1748427735758,PSYC 60,A04,957950,Lowe; Angela Beth,24,0,25,1
1748427735758,PSYC 60,A05,957951,Lowe; Angela Beth,22,0,25,3
1748427735758,PSYC 60,A06,957952,Lowe; Angela Beth,22,0,25,3
1748427735758,PSYC 60,A07,957953,Lowe; Angela Beth,24,0,25,1
1748427735758,PSYC 60,B01,957954,Rickard; Timothy C.,24,0,25,1
1748427735758,PSYC 60,B02,957955,Rickard; Timothy C.,24,0,25,1
1748427735758,PSYC 60,B03,957956,Rickard; Timothy C.,25,0,25,0
1748427735758,PSYC 60,B04,957957,Rickard; Timothy C.,25,0,25,0
1748427735758,PSYC 60,B05,957958,Rickard; Timothy C.,24,0,25,1
1748427735758,PSYC 60,B06,957959,Rickard; Timothy C.,22,0,25,3
1748427735758,PSYC 60,B07,957960,Rickard; Timothy C.,22,0,25,3
1748427736784,PSYC 70,A01,957961,Pilegard; Celeste Cristine,6,0,25,19
1748427736784,PSYC 70,A02,957962,Pilegard; Celeste Cristine,19,0,25,6
1748427736784,PSYC 70,A03,957963,Pilegard; Celeste Cristine,19,0,25,6
1748427736784,PSYC 70,A04,957964,Pilegard; Celeste Cristine,21,0,25,4
1748427736784,PSYC 70,A05,957965,Pilegard; Celeste Cristine,24,0,25,1
1748427736784,PSYC 70,A06,957966,Pilegard; Celeste Cristine,23,0,25,2
1748427737812,PSYC 71,A01,937700,Geller; Emma Harlan,0,0,30,30
1748427737812,PSYC 71,A02,937701,Geller; Emma Harlan,0,0,30,30
1748427737812,PSYC 71,B01,937704,Steiner; Eric Tomas,0,0,25,25
1748427737812,PSYC 71,B02,937705,Steiner; Eric Tomas,0,0,25,25
1748427738844,PSYC 88,A00,937706,Dobkins; Karen R.,49,0,65,16
1748427739874,PSYC 100,A00,937707,Dickenson; Janna Alene,0,0,175,175
1748427740901,PSYC 101,A00,937709,Heyman; Gail D.,0,0,170,170
1748427741930,PSYC 104,A00,937711,Staff,0,0,175,175
1748427742955,PSYC 105,A00,937712,Geller; Emma Harlan,17,0,170,153
1748427743983,PSYC 106,A00,937713,Gremel; Christina M,89,0,170,81
1748427745010,PSYC 108,A00,937714,Adrian; Julia Anna,145,0,170,25
1748427746037,PSYC 114,A01,937720,Winkielman; Piotr,0,0,50,50
1748427747069,PSYC 122,A00,937724,Moranton; Nirelia Melbina-,241,0,250,9
1748427748095,PSYC 124,A00,937726,Chapman; Eddie Nathaniel,276,0,348,72
1748427749125,PSYC 137,A00,937727,Jolly; Eshin,249,0,295,46
1748427750151,PSYC 145,A00,937732,Lau; Aubrey,277,0,295,18
1748427751177,PSYC 154,A00,937734,Lacefield; Katharine I,18,0,300,282
1748427752204,PSYC 155,A00,937735,Dickenson; Janna Alene,139,0,295,156
1748427753229,PSYC 167,A00,937750,Walker; Caren Michelle,0,0,25,25
1748427754260,PSYC 169,A00,937751,Staff,212,0,250,38
1748427755289,PSYC 171,A00,937752,Mukku; Dhananjaya,149,0,216,67
1748427756320,PSYC 174,A00,937784,Staff,141,0,146,5
1748427757350,PSYC 178,A00,937788,Glaser; Dale,100,0,146,46
1748427758380,PSYC 181,A00,937814,Anagnostaras; Stephan,140,0,300,160
1748427759408,PSYC 184,A00,937816,Staff,267,0,295,28
1748427760436,PSYC 189,A00,937868,Gentner; Tim,14,0,55,41
1748427761462,PSYC 193,A00,937897,Chapman; Eddie Nathaniel,27,0,35,8
1748427761462,PSYC 193,B00,937917,Gorman; Michael R.,35,0,35,0
1748427761462,PSYC 193,C00,937918,Powell; Lindsey Jane,22,0,24,2
1748427762489,PSYC 193L,A01,937930,Brown; Sandra A,64,0,65,1
1748427762489,PSYC 193L,B01,937939,Lacefield; Katharine I,194,0,216,22
1748427763515,PSYC 194A,A01,937949,Heyman; Gail D.,35,0,35,0
1748427764546,PSYC 201A,A01,937954,Long; Bria,8,0,15,7
1748427765579,PSYC 205,A00,937976,Harris; Christine Renee,12,0,20,8
1748427766607,PSYC 217,A00,937977,Barner; David A.,16,0,20,4
1748427767635,PSYC 221,A00,937979,Dobkins; Karen R.,16,0,20,4
1748427768661,PSYC 224,A00,938013,Mukku; Dhananjaya,28,0,30,2
1748427769687,PSYC 242,A00,938016,Powell; Lindsey Jane,26,0,30,4
1748427770714,PSYC 244,A00,938017,Ferreira; Victor,15,0,20,5
1748427771741,PSYC 269,A00,938024,Schachner; Adena,19,0,20,1
1748427772769,PSYC 270A,A00,938028,Dobkins; Karen R.,13,0,20,7
1748427773799,PSYC 272,A00,938029,Lin; Chujun,14,0,20,6
1748427773799,PSYC 272,B00,938039,Wixted; John T,18,0,20,2
1748427774828,PSYC 274,A00,938042,McCullough; Michael E,26,0,30,4
1748427775855,PSYC 275,A00,938043,Brady; Timothy Francis,28,0,30,2
1748427776884,PSYC 280,A00,938055,Serences; John Thomas,70,0,80,10
1748427777920,PSYC 296,001,952632,Anagnostaras; Stephan,9999,0,9999,0
1748427777920,PSYC 296,002,952633,Aron; Adam,9999,0,9999,0
1748427777920,PSYC 296,003,952634,Mukku; Dhananjaya,9999,0,9999,0
1748427777920,PSYC 296,004,952635,Barner; David A.,9999,0,9999,0
1748427777920,PSYC 296,005,952636,Schachner; Adena,9999,0,9999,0
1748427777920,PSYC 296,006,952637,Brady; Timothy Francis,9999,0,9999,0
1748427777920,PSYC 296,007,952639,Brashier; Nadia Marie,9999,0,9999,0
1748427777920,PSYC 296,008,952640,Brown; Sandra A,9999,0,9999,0
1748427777920,PSYC 296,009,952641,Carver; Leslie J.,9998,0,9999,1
1748427777920,PSYC 296,010,952642,Chapman; Eddie Nathaniel,9999,0,9999,0
1748427777920,PSYC 296,011,952643,Dickenson; Janna Alene,9999,0,9999,0
1748427777920,PSYC 296,012,952644,Dobkins; Karen R.,9997,0,9999,2
1748427777920,PSYC 296,013,952646,Ferreira; Victor,9999,0,9999,0
1748427777920,PSYC 296,014,952647,Geller; Emma Harlan,9999,0,9999,0
1748427777920,PSYC 296,015,952648,Gentner; Tim,9999,0,9999,0
1748427777920,PSYC 296,016,952650,Gorman; Michael R.,9999,0,9999,0
1748427777920,PSYC 296,017,952651,Gremel; Christina M,9999,0,9999,0
1748427777920,PSYC 296,018,952652,Harris; Christine Renee,9999,0,9999,0
1748427777920,PSYC 296,019,952654,Heyman; Gail D.,9999,0,9999,0
1748427777920,PSYC 296,020,952655,Lin; Chujun,9999,0,9999,0
1748427777920,PSYC 296,021,952659,Long; Bria,9999,0,9999,0
1748427777920,PSYC 296,022,952660,McCullough; Michael E,9999,0,9999,0
1748427777920,PSYC 296,023,952661,Mc Kenzie; Craig R.M.,9999,0,9999,0
1748427777920,PSYC 296,024,952663,Miller; Cory T.,9998,0,9999,1
1748427777920,PSYC 296,025,952664,Oesch; Nicholas W,9999,0,9999,0
1748427777920,PSYC 296,026,952665,Pilegard; Celeste Cristine,9999,0,9999,0
1748427777920,PSYC 296,027,952666,Powell; Lindsey Jane,9999,0,9999,0
1748427777920,PSYC 296,028,952667,Rickard; Timothy C.,9999,0,9999,0
1748427777920,PSYC 296,029,952668,Serences; John Thomas,9999,0,9999,0
1748427777920,PSYC 296,030,952669,Walker; Caren Michelle,9998,0,9999,1
1748427777920,PSYC 296,031,952670,Winkielman; Piotr,9999,0,9999,0
1748427777920,PSYC 296,032,952671,Wixted; John T,9998,0,9999,1
1748427777920,PSYC 296,033,952673,Jolly; Eshin,9998,0,9999,1
1748427779002,REV 20,A00,946356,Yu; Paul K L,30,0,30,0
1748427779002,REV 20,B00,946357,Yu; Paul K L,30,0,30,0
1748427780031,REV 87,B00,969668,Rodriguez; Bretton Sigfred,20,0,20,0
1748427781063,SE 1,A01,938060,Van Den Einde; Yael Dahlia,0,0,9,9
1748427781063,SE 1,A02,938076,Van Den Einde; Yael Dahlia,0,0,8,8
1748427781063,SE 1,A03,938077,Van Den Einde; Yael Dahlia,0,0,8,8
1748427781063,SE 1,B01,938097,Van Den Einde; Yael Dahlia,0,0,9,9
1748427781063,SE 1,B02,938098,Van Den Einde; Yael Dahlia,0,0,8,8
1748427781063,SE 1,B03,938109,Van Den Einde; Yael Dahlia,0,0,8,8
1748427782112,SE 101A,A01,938120,Morrison; Machel Leigh,165,0,250,85
1748427783139,SE 101C,A01,938148,Zhu; Qiang,178,0,250,72
1748427784166,SE 105,A01,938153,Qiao; Yu,78,0,120,42
1748427785195,SE 125,A01,938218,Conte; Joel P,166,0,210,44
1748427786222,SE 130A,A00,938219,Loh; Kenneth J. H.,69,0,165,96
1748427787249,SE 131B,A01,938221,Krysl; Petr,119,0,210,91
1748427788278,SE 142,A01,938223,Kim; Hyonny,20,0,27,7
1748427788278,SE 142,A02,938236,Kim; Hyonny,23,0,27,4
1748427788278,SE 142,A03,938237,Kim; Hyonny,19,0,27,8
1748427788278,SE 142,A04,938238,Kim; Hyonny,19,0,22,3
1748427789315,SE 163,A01,938240,Lanza Di Scalea; Francesco,17,0,19,2
1748427789315,SE 163,A02,938241,Lanza Di Scalea; Francesco,16,0,19,3
1748427789315,SE 163,A03,938254,Lanza Di Scalea; Francesco,16,0,17,1
1748427790347,SE 180,A00,938255,Elgamal; Ahmed,142,0,170,28
1748427791377,SE 181,A01,938280,McCartney; John Scott,1,0,24,23
1748427791377,SE 181,A02,938281,McCartney; John Scott,6,0,24,18
1748427791377,SE 181,A03,938296,McCartney; John Scott,0,0,24,24
1748427791377,SE 181,A04,938297,McCartney; John Scott,0,0,24,24
1748427791377,SE 181,A05,938299,McCartney; John Scott,20,0,24,4
1748427791377,SE 181,A06,938320,McCartney; John Scott,22,0,24,2
1748427791377,SE 181,A07,938324,McCartney; John Scott,9,0,24,15
1748427792410,SE 201A,A00,938329,Mosqueda; Gilberto,35,0,65,30
1748427793443,SE 203A,A00,938331,Tsampras; Georgios,32,0,65,33
1748427794471,SE 212,A00,938332,Uang; Chia-Ming,28,0,68,40
1748427795497,SE 220,A00,965249,Mosqueda; Gilberto,28,0,36,8
1748427796522,SE 223,A00,969767,Staff,19,0,25,6
1748427797555,SE 233,A00,938555,Krysl; Petr,19,0,50,31
1748427798580,SE 241,A00,938333,Elgamal; Ahmed,0,0,20,20
1748427799608,SE 244,A00,938334,Elgamal; Ahmed,39,0,40,1
1748427800639,SE 248,A00,938363,McCartney; John Scott,20,0,30,10
1748427801667,SE 253A,A01,938448,Kim; Hyonny,2,0,5,3
1748427801667,SE 253A,A02,938451,Kim; Hyonny,3,0,5,2
1748427801667,SE 253A,A03,938452,Kim; Hyonny,3,0,5,2
1748427801667,SE 253A,A04,938453,Kim; Hyonny,2,0,2,0
1748427802694,SE 263,A01,938460,Lanza Di Scalea; Francesco,15,0,17,2
1748427802694,SE 263,A02,938461,Lanza Di Scalea; Francesco,11,0,17,6
1748427802694,SE 263,A03,938462,Lanza Di Scalea; Francesco,10,0,16,6
1748427803724,SE 271,A00,938464,Asaro; Robert J,25,0,32,7
1748427804757,SE 276A,A00,938465,Chen; Jiun-Shyan,18,0,35,17
1748427805789,SE 285,A00,938466,Kim; Hyunsun Alicia,18,0,20,2
1748427806816,SE 286,A00,938523,Kim; Hyunsun Alicia,13,0,20,7
1748427807846,SE 290,A00,938524,Lanza Di Scalea; Francesco,41,0,100,59
1748427808882,SE 296,001,953990,Asaro; Robert J,9999,0,9999,0
1748427808882,SE 296,002,953992,Chen; Jiun-Shyan,9999,0,9999,0
1748427808882,SE 296,003,953998,Conte; Joel P,9999,0,9999,0
1748427808882,SE 296,004,953999,Elgamal; Ahmed,9999,0,9999,0
1748427808882,SE 296,005,954001,Hutchinson; Tara,9999,0,9999,0
1748427808882,SE 296,006,954003,Jandaghi Semnani; Shabnam,9999,0,9999,0
1748427808882,SE 296,007,954004,Kim; Hyonny,9999,0,9999,0
1748427808882,SE 296,008,954005,Kim; Hyunsun Alicia,9999,0,9999,0
1748427808882,SE 296,009,954007,Kosmatka; John B,9999,0,9999,0
1748427808882,SE 296,010,954009,Krysl; Petr,9999,0,9999,0
1748427808882,SE 296,011,954011,Kuester; Falko,9999,0,9999,0
1748427808882,SE 296,012,954014,Lanza Di Scalea; Francesco,9999,0,9999,0
1748427808882,SE 296,013,954015,Loh; Kenneth J. H.,9999,0,9999,0
1748427808882,SE 296,014,954021,McCartney; John Scott,9999,0,9999,0
1748427808882,SE 296,015,954023,Morrison; Machel Leigh,9999,0,9999,0
1748427808882,SE 296,016,954024,Mosqueda; Gilberto,9999,0,9999,0
1748427808882,SE 296,017,954028,Qiao; Yu,9999,0,9999,0
1748427808882,SE 296,018,954030,Shing; P. Benson,9999,0,9999,0
1748427808882,SE 296,019,954031,Todd; Michael,9998,0,9999,1
1748427808882,SE 296,020,954033,Tomac; Ingrid,9999,0,9999,0
1748427808882,SE 296,021,954037,Tsampras; Georgios,9999,0,9999,0
1748427808882,SE 296,022,954040,Uang; Chia-Ming,9999,0,9999,0
1748427808882,SE 296,023,954043,Van Den Einde; Yael Dahlia,9999,0,9999,0
1748427808882,SE 296,024,954044,Zhu; Qiang,9999,0,9999,0
1748427808882,SE 296,025,954046,Tehrani; Mehran,9999,0,9999,0
1748427808882,SE 296,026,954047,Palermo; Alessandro,9999,0,9999,0
1748427808882,SE 296,027,954049,Chadha; Mayank,9999,0,9999,0
1748427809911,SIO 3,A01,938657,Hetherington; Elizabeth Dorsey,33,0,37,4
1748427809911,SIO 3,A02,938665,Hetherington; Elizabeth Dorsey,36,0,37,1
1748427810941,SIO 15,A00,938667,Laske; Gabi,292,0,348,56
1748427811970,SIO 20R,A01,938679,Russell; Lynn M.,144,0,200,56
1748427813013,SIO 25,A01,938684,Hildebrand; John A,33,0,40,7
1748427813013,SIO 25,A02,938685,Hildebrand; John A,39,0,40,1
1748427813013,SIO 25,A03,938963,Hildebrand; John A,40,0,40,0
1748427813013,SIO 25,A04,939110,Hildebrand; John A,40,0,40,0
1748427813013,SIO 25,A05,939116,Hildebrand; John A,40,0,40,0
1748427813013,SIO 25,A06,939149,Hildebrand; John A,40,0,40,0
1748427813013,SIO 25,A07,939158,Hildebrand; John A,40,0,40,0
1748427813013,SIO 25,A08,939173,Hildebrand; John A,40,0,40,0
1748427813013,SIO 25,A09,939180,Hildebrand; John A,40,0,40,0
1748427813013,SIO 25,A10,939228,Hildebrand; John A,40,0,40,0
1748427814041,SIO 30,A01,939230,Aluwihare; Lihini & Gille; Sarah T,33,0,37,4
1748427814041,SIO 30,A02,939231,Aluwihare; Lihini & Baumann-Pickering ; Simone,37,0,37,0
1748427814041,SIO 30,A03,939232,Aluwihare; Lihini & Gille; Sarah T,34,0,37,3
1748427814041,SIO 30,A04,939233,Aluwihare; Lihini & Gille; Sarah T,31,0,37,6
1748427814041,SIO 30,A05,939234,Aluwihare; Lihini & Gille; Sarah T,38,0,38,0
1748427814041,SIO 30,A06,939235,Aluwihare; Lihini & Gille; Sarah T,37,0,38,1
1748427814041,SIO 30,A07,939236,Aluwihare; Lihini & Gille; Sarah T,36,0,38,2
1748427814041,SIO 30,A08,939237,Aluwihare; Lihini & Gille; Sarah T,36,0,38,2
1748427815070,SIO 50,A01,939239,Cook; Geoffrey W,8,0,20,12
1748427815070,SIO 50,A02,939240,Cook; Geoffrey W,11,0,20,9
1748427816100,SIO 87,A00,939242,Norris; Joel Roland,20,0,20,0
1748427816100,SIO 87,B00,939306,Cook; Geoffrey W,20,0,20,0
1748427816100,SIO 87,C00,939327,Cook; Geoffrey W,20,0,20,0
1748427817131,SIO 100,A00,939328,Odlum; Margaret Larkin,0,0,30,30
1748427818160,SIO 101,A01,939330,Aluwihare; Lihini & Decima; Moira R.,0,0,35,35
1748427818160,SIO 101,A02,939331,Aluwihare; Lihini & Decima; Moira R.,12,0,35,23
1748427819189,SIO 103,A01,939371,Parnell-Turner; Ross Ernes,6,0,20,14
1748427820216,SIO 105,A00,939372,Driscoll; Neal W.,8,0,20,12
1748427821245,SIO 117,A01,939375,Keeling; Ralph F.,14,0,25,11
1748427822273,SIO 122,A01,939377,Lyons; Deirdre Colleen,6,0,30,24
1748427823300,SIO 124,A00,961131,Lukowski; April Lynn,34,0,65,31
1748427824340,SIO 132,A01,939379,Kacev; David & Hechinger; Ryan F.,9,0,34,25
1748427824340,SIO 132,A02,939380,Kacev; David & Hechinger; Ryan F.,28,0,34,6
1748427824340,SIO 132,A03,939381,Kacev; David & Hechinger; Ryan F.,19,0,34,15
1748427824340,SIO 132,A04,939480,Kacev; David & Hechinger; Ryan F.,26,0,34,8
1748427824340,SIO 132,A05,939481,Kacev; David & Hechinger; Ryan F.,18,0,34,16
1748427824340,SIO 132,A06,939482,Kacev; David & Hechinger; Ryan F.,25,0,34,9
1748427825379,SIO 136,A01,939562,Kacev; David & Shipp; Lauren Elizabeth,6,0,34,28
1748427825379,SIO 136,A02,939563,Kacev; David & Shipp; Lauren Elizabeth,24,0,34,10
1748427826405,SIO 147,A01,939566,Betancur Rodriguez; Ricard,0,0,30,30
1748427827437,SIO 166,A00,939567,Jimenez Cano; Nayeli Guada,13,0,30,17
1748427828466,SIO 167,A01,939569,Dunseth; Zachary Clark,9,0,10,1
1748427829492,SIO 170,A00,939571,Cook; Geoffrey W,39,0,45,6
1748427830524,SIO 171,A01,939573,Rudnick; Daniel Lars,44,0,50,6
1748427831557,SIO 177,A00,939574,Becker; Janet Maria,19,0,20,1
1748427832585,SIO 179,A01,939611,Martz; Todd R.,2,0,15,13
1748427833614,SIO 189,A00,939616,Staff,0,0,0,0
1748427834645,SIO 194,A00,954130,Hill; Seth J,9999,0,9999,0
1748427835678,SIOB 218,A01,960525,Staff,13,0,20,7
1748427836705,SIOB 262,A00,939617,Lukowski; April Lynn,15,0,20,5
1748427837733,SIOB 273,A00,939618,Leichter; James J.,9,0,15,6
1748427838764,SIOB 274,A01,939679,Leichter; James J.,15,0,20,5
1748427839791,SIOB 276,A01,939703,Sugihara; George,19,0,20,1
1748427840822,SIOB 279,A00,939717,Barton; Andrew David,19,0,25,6
1748427841849,SIOB 280,A00,939722,Allen; Andrew Ellis & Baumann-Pickering ; Simone,54,0,70,16
1748427842876,SIOB 296,A00,939790,Lyons; Deirdre Colleen,0,0,0,0
1748427843903,SIOB 297,A00,939795,Allen; Eric,57,0,65,8
1748427844930,SIOC 200A,A00,939821,Lin; Ying-Tsong,16,0,20,4
1748427845959,SIOC 203A,A00,939827,Becker; Janet Maria,18,0,20,2
1748427846986,SIOC 207A,A01,939909,Meyer; Florian,12,0,20,8
1748427848012,SIOC 208,A00,939913,Merrifield; Mark A,11,0,20,9
1748427849039,SIOC 210,A00,939917,Purkey; Sarah Michelle G.,25,0,35,10
1748427849039,SIOC 210,B00,939973,Purkey; Sarah Michelle G.,31,0,35,4
1748427850067,SIOC 217A,A00,940015,Evan; Amato Tomas,18,0,25,7
1748427851094,SIOC 221A,A00,940020,Alford; Matthew Hudson,16,0,20,4
1748427852122,SIOG 200C,A00,940290,Fan; Wenyuan,23,0,25,2
1748427853148,SIOG 223A,A00,940333,Constable; Catherine G,22,0,25,3
1748427854177,SIOG 225,A00,940334,Fialko; Yuri A.,19,0,20,1
1748427855206,SIOG 228,A00,940338,Diaz; Julia Michelle,15,0,40,25
1748427856234,SIOG 238,A00,940339,May; David Alexander,20,0,20,0
1748427857264,SIOG 239,A00,940340,Fan; Wenyuan,20,0,20,0
1748427857264,SIOG 239,B00,940342,Sandwell; David T,19,0,20,1
1748427858294,SIOG 240,A00,940409,Parnell-Turner; Ross Ernes,34,0,40,6
1748427859321,SIOG 249,A00,940442,Norris; Richard D.,25,0,25,0
1748427860347,SIOG 267,A01,940444,Martz; Todd R.,15,0,15,0
1748427861372,SIOG 288,A01,940446,Diaz; Julia Michelle,22,0,25,3
1748427862408,SOCE 194,A00,954128,Hill; Seth J,9999,0,9999,0
1748427863441,SOCG 200,A00,935260,Rona-Tas; Akos,2,0,12,10
1748427864476,SOCG 201,A00,935264,Shafir; Gershon,0,0,12,12
1748427865502,SOCG 203,A00,935265,Gong; Neil M,0,0,10,10
1748427866529,SOCG 207,A00,935267,Navon; Daniel,0,0,10,10
1748427867555,SOCG 208A,A00,935269,Blair-Loy; Mary,2,0,12,10
1748427868581,SOCG 226,A00,935302,Skrentny; John David,0,0,10,10
1748427869608,SOCG 227,A00,935303,Jules-Rosette; Bennetta W.,7,0,10,3
1748427870639,SOCG 244,A00,935305,Ribas Norris; Janet Vanesa,0,0,10,10
1748427871670,SOCG 252,A00,935307,Turner; Christena L.,2,0,10,8
1748427872697,SOCG 253,A00,935313,Evans; John Hyde,7,0,10,3
1748427873724,SOCG 255A,A00,934873,McKenzie; Kerry V.,10,0,10,0
1748427874751,SOCG 255C,A00,934874,McKenzie; Kerry V.,9,0,10,1
1748427875782,SOCG 271,A00,935434,Estefan; Michel,4,0,10,6
1748427876813,SOCI 1,A01,934878,Skrentny; John David,20,0,22,2
1748427876813,SOCI 1,A02,934879,Skrentny; John David,21,0,22,1
1748427876813,SOCI 1,A03,934880,Skrentny; John David,22,0,23,1
1748427876813,SOCI 1,A04,934881,Skrentny; John David,12,0,23,11
1748427876813,SOCI 1,A05,934883,Skrentny; John David,23,0,23,0
1748427876813,SOCI 1,A06,934884,Skrentny; John David,23,0,23,0
1748427876813,SOCI 1,A07,934885,Skrentny; John David,22,0,23,1
1748427876813,SOCI 1,A08,934886,Skrentny; John David,22,0,23,1
1748427876813,SOCI 1,A09,934887,Skrentny; John David,22,0,23,1
1748427877841,SOCI 30,A01,934889,Ruiz; Jonathan Joseph,18,0,20,2
1748427877841,SOCI 30,A02,934890,Ruiz; Jonathan Joseph,15,0,20,5
1748427878874,SOCI 60,A01,934892,Ribas Norris; Janet Vanesa,6,0,17,11
1748427878874,SOCI 60,A02,934896,Ribas Norris; Janet Vanesa,17,0,17,0
1748427878874,SOCI 60,A03,934965,Ribas Norris; Janet Vanesa,12,0,17,5
1748427878874,SOCI 60,A04,934974,Ribas Norris; Janet Vanesa,17,0,17,0
1748427879900,SOCI 70,A01,934984,Payne; Christine Anna,4,0,15,11
1748427879900,SOCI 70,A02,934988,Payne; Christine Anna,14,0,15,1
1748427879900,SOCI 70,A03,935006,Payne; Christine Anna,11,0,15,4
1748427879900,SOCI 70,A04,935047,Payne; Christine Anna,15,0,15,0
1748427880930,SOCI 88,A00,935058,Estefan; Michel,0,0,20,20
1748427881962,SOCI 100,A01,935065,Estefan; Michel,6,0,15,9
1748427881962,SOCI 100,A02,935068,Estefan; Michel,4,0,15,11
1748427881962,SOCI 100,A03,935069,Estefan; Michel,5,0,15,10
1748427881962,SOCI 100,A04,935071,Estefan; Michel,0,0,15,15
1748427883058,SOCI 103M,A00,935073,Kilpatrick; Kevin,22,0,30,8
1748427884088,SOCI 104,A00,935077,Arnal; Maud Marie Leonie,18,0,30,12
1748427885114,SOCI 104Q,A00,935079,Rogers; Julia,20,0,30,10
1748427886142,SOCI 105,A01,935083,Jules-Rosette; Bennetta W.,20,0,25,5
1748427887168,SOCI 109,A00,935084,Kilpatrick; Kevin,25,0,30,5
1748427888197,SOCI 112,A00,935085,Pitt; Richard Norris,61,0,65,4
1748427889222,SOCI 113,A00,935086,Rogers; Julia,68,0,75,7
1748427890249,SOCI 117,A01,935151,Jones; Makeba,0,0,13,13
1748427890249,SOCI 117,A02,935153,Jones; Makeba,4,0,13,9
1748427890249,SOCI 117,A03,935155,Jones; Makeba,11,0,12,1
1748427890249,SOCI 117,A04,935156,Jones; Makeba,10,0,12,2
1748427890249,SOCI 117,B01,935158,Jones; Gabrielle Anastasia,7,0,15,8
1748427890249,SOCI 117,B02,935159,Jones; Gabrielle Anastasia,15,0,15,0
1748427890249,SOCI 117,B03,935161,Jones; Gabrielle Anastasia,15,0,15,0
1748427890249,SOCI 117,B04,935162,Jones; Gabrielle Anastasia,15,0,15,0
1748427891276,SOCI 122,A00,935166,Lewis; Kevin Michael,101,0,120,19
1748427892313,SOCI 129,A00,935167,Pitt; Richard Norris,50,0,65,15
1748427893338,SOCI 135,A00,935170,Payne; Christine Anna,112,0,120,8
1748427894363,SOCI 136F,A00,935171,Gong; Neil M,52,0,56,4
1748427895387,SOCI 137,A00,935173,Crofts; Christine,53,0,100,47
1748427896412,SOCI 138,A00,935174,Navon; Daniel,111,0,135,24
1748427897443,SOCI 140,A00,935175,Ng; Kwai,47,0,65,18
1748427898467,SOCI 140K,A00,935176,Ng; Kwai,39,0,56,17
1748427899494,SOCI 142,A00,935177,Crofts; Christine,24,0,75,51
1748427900519,SOCI 143V,A00,935222,Lewis; Kevin Michael,99,0,140,41
1748427901550,SOCI 148,A00,935227,Shafir; Gershon,115,0,120,5
1748427902577,SOCI 148E,A00,935231,Calderon-Zaks; Michael Aar,44,0,56,12
1748427903609,SOCI 150,A00,935232,Victoria Torres; Pablo,14,0,50,36
1748427904638,SOCI 153,A00,935233,Ruiz; Jonathan Joseph,46,0,50,4
1748427905664,SOCI 166,A00,935243,Lampland; Martha,34,0,35,1
1748427906692,SOCI 170,A00,935247,Lampland; Martha,29,0,30,1
1748427907721,SOCI 172,A00,935249,Rona-Tas; Akos,40,0,45,5
1748427908746,SOCI 173,A00,935252,Arnal; Maud Marie Leonie,67,0,75,8
1748427909771,SOCI 180,A00,935253,Calderon-Zaks; Michael Aar,46,0,56,10
1748427910801,SOCI 184,A00,935254,Victoria Torres; Pablo,21,0,56,35
1748427911827,SOCI 196A,A00,935256,Turner; Christena L.,20,0,20,0
1748427912853,SPPS 200B,A00,959322,Luli; Alex J,99,0,99,0
1748427913879,SPPS 201,A00,959324,Mnatzaganian; Christina L,99,0,99,0
1748427914905,SPPS 202A,A00,959400,Tsunoda; Shirley M.,99,0,99,0
1748427915935,SPPS 204,A01,959405,Jones; John,99,0,99,0
1748427917005,SPPS 206,A00,959406,Bounthavong; Mark,80,0,80,0
1748427918031,SPPS 212A,A01,959408,Feist; Ashley,81,0,99,18
1748427919055,SPPS 213A,A00,959409,Namba; Jennifer Mariko,82,0,99,17
1748427920080,SPPS 219,A00,959410,Ma; Joseph David,81,0,99,18
1748427921111,SPPS 221,A01,959412,Siegel; Dionicio R.,80,0,80,0
1748427922140,SPPS 231,A00,959413,Penny; William F.,79,0,99,20
1748427923165,SPPS 232,A00,959415,Simonson; Tatum Sasha Summ,79,0,99,20
1748427924191,SPPS 233,A00,959417,Eckmann; Lars,79,0,99,20
1748427925220,SPPS 247,A00,959419,Brandl; Katharina,79,0,99,20
1748427926244,SPPS 251,A00,959420,Chen; Timothy,99,0,99,0
1748427927308,SPPS 264A,A00,959421,Tsunoda; Shirley M.,99,0,99,0
1748427929363,SPPS 267,A01,959426,Tsunoda; Shirley M.,25,0,25,0
1748427930393,SPPS 269,A00,959427,Atayee; Rabia Samady,29,0,30,1
1748427931424,SPPS 270A,A00,959430,Fricovsky; Eduardo Santiago,99,0,99,0
1748427932449,SPPS 271,A00,959432,Tsunoda; Shirley M.,99,0,99,0
1748427933507,SPPS 278,A00,959433,Fricovsky; Eduardo Santiago,98,0,99,1
1748427934532,SPPS 279,A00,959434,Painter; Nathan A.,99,0,99,0
1748427935581,SYN 2,001,946469,Girard; Gabrielle,3,0,20,17
1748427935581,SYN 2,002,946470,Girard; Gabrielle,0,0,20,20
1748427935581,SYN 2,003,946471,Rock; Martin,0,0,20,20
1748427935581,SYN 2,004,946472,Rock; Martin,0,0,20,20
1748427935581,SYN 2,005,946473,Iatarola; Briana Marie,0,0,20,20
1748427935581,SYN 2,006,946474,Tawater; Hanna Jean,0,0,20,20
1748427935581,SYN 2,007,946475,Browne; Emily,6,0,20,14
1748427935581,SYN 2,008,946476,Browne; Emily,0,0,20,20
1748427935581,SYN 2,009,946477,Staff,0,0,20,20
1748427935581,SYN 2,010,946478,Staff,8,0,20,12
1748427935581,SYN 2,012,946480,Deavenport; James Cary,0,0,20,20
1748427935581,SYN 2,013,946481,Deavenport; James Cary,0,0,20,20
1748427935581,SYN 2,014,946482,Staff,0,0,20,20
1748427935581,SYN 2,015,946483,Staff,0,0,20,20
1748427935581,SYN 2,016,946484,Staff,0,0,20,20
1748427935581,SYN 2,017,946485,Staff,5,0,20,15
1748427935581,SYN 2,019,946487,Atkinson; Arthur Laird,0,0,20,20
1748427935581,SYN 2,020,946488,Staff,0,0,20,20
1748427935581,SYN 2,021,946489,Staff,0,0,20,20
1748427935581,SYN 2,030,946498,Iatarola; Briana Marie,0,0,20,20
1748427935581,SYN 2,036,946587,Bishop; Graham,0,0,20,20
1748427936626,SYN 2R,001,946588,Bishop; Graham,0,0,20,20
1748427937838,SYN 100,A01,946594,Rock; Martin,0,0,15,15
1748427937838,SYN 100,A02,946595,Rock; Martin,0,0,15,15
1748427937838,SYN 100,B01,946598,Browne; Emily,0,0,15,15
1748427937838,SYN 100,B02,946600,Browne; Emily,0,0,15,15
1748427937838,SYN 100,C01,946606,Tawater; Hanna Jean,0,0,15,15
1748427937838,SYN 100,C02,946607,Tawater; Hanna Jean,0,0,15,15
1748427937838,SYN 100,D01,946610,Tawater; Hanna Jean,0,0,15,15
1748427937838,SYN 100,D02,946613,Tawater; Hanna Jean,0,0,15,15
1748427937838,SYN 100,E01,946617,Vega; Adrian,0,0,24,24
1748427937838,SYN 100,G01,946714,Iatarola; Briana Marie,0,0,15,15
1748427937838,SYN 100,G02,946721,Iatarola; Briana Marie,0,0,15,15
1748427937838,SYN 100,I01,946735,Gormally; Brenna,0,0,15,15
1748427937838,SYN 100,I02,946736,Gormally; Brenna,0,0,15,15
1748427937838,SYN 100,J01,946738,Hom; Kirstyn Courtney,0,0,15,15
1748427937838,SYN 100,J02,946739,Hom; Kirstyn Courtney,0,0,15,15
1748427937838,SYN 100,K01,946741,Hom; Kirstyn Courtney,0,0,15,15
1748427937838,SYN 100,K02,946742,Hom; Kirstyn Courtney,0,0,15,15
1748427937838,SYN 100,L01,946745,Difruscio; Mark,0,0,15,15
1748427937838,SYN 100,L02,946746,Difruscio; Mark,0,0,15,15
1748427937838,SYN 100,M01,946748,Difruscio; Mark,0,0,15,15
1748427937838,SYN 100,M02,946749,Difruscio; Mark,0,0,15,15
1748427937838,SYN 100,P01,946759,Atkinson; Arthur Laird,0,0,15,15
1748427937838,SYN 100,P02,946760,Atkinson; Arthur Laird,0,0,15,15
1748427937838,SYN 100,Q01,946763,Bishop; Graham,0,0,15,15
1748427937838,SYN 100,Q02,946764,Bishop; Graham,0,0,15,15
1748427937838,SYN 100,R01,946766,Deavenport; James Cary,0,0,15,15
1748427937838,SYN 100,R02,946767,Deavenport; James Cary,0,0,15,15
1748427938864,SYN 150,001,946771,Gladstein; Jill M,19,0,20,1
1748427938864,SYN 150,002,946772,Lagapa; Jason,17,0,20,3
1748427938864,SYN 150,003,946773,Fish; Gwendolyn Anne,19,0,20,1
1748427938864,SYN 150,004,946774,Fish; Gwendolyn Anne,20,0,20,0
1748427938864,SYN 150,006,946782,Lagapa; Jason,18,0,20,2
1748427938864,SYN 150,007,946783,Lagapa; Jason,19,0,20,1
1748427938864,SYN 150,008,946784,Fish; Gwendolyn Anne,19,0,20,1
1748427939889,SYN 150R,001,946786,Vega; Adrian,19,0,20,1
1748427940921,TDAC 1,A00,946788,Walsh; Kim C.,0,0,12,12
1748427940921,TDAC 1,B00,946789,Walsh; Kim C.,0,0,12,12
1748427940921,TDAC 1,C00,946790,Walsh; Kim C.,0,0,12,12
1748427940921,TDAC 1,D00,946791,Walsh; Kim C.,0,0,12,12
1748427940921,TDAC 1,E00,946792,Walsh; Kim C.,0,0,12,12
1748427940921,TDAC 1,F00,946793,Walsh; Kim C.,0,0,12,12
1748427941948,TDAC 101,A00,946887,Harting; Carla Kelso,3,0,12,9
1748427941948,TDAC 101,B00,946970,Salovey; Todd,9,0,12,3
1748427941948,TDAC 101,C00,946977,Walsh; Kim C.,10,0,12,2
1748427942973,TDAC 102,A00,946979,Celik; Aysan Karagasli,7,0,15,8
1748427943999,TDAC 104,A00,946994,Meyer; Ursula,14,0,15,1
1748427945027,TDAC 107,A00,946997,Stalling; Vanessa,0,0,0,0
1748427946063,TDAC 108,A00,947021,Basso; Beatrice,19,0,20,1
1748427946063,TDAC 108,B00,947025,Caban; Andrea Chudnow,12,0,20,8
1748427946063,TDAC 108,C00,968049,Buescher; Stephen W.,16,0,20,4
1748427947094,TDAC 115,A00,947050,Buescher; Stephen W.,14,0,20,6
1748427948127,TDAC 122,A00,947091,Stalling; Vanessa,30,0,30,0
1748427948127,TDAC 122,B00,947092,Perry; Lamar,30,0,30,0
1748427949155,TDAC 123,A00,947093,Castro; Robert Jess,30,0,30,0
1748427950182,TDDE 1,A01,946795,Guirguis; Mark C,10,0,11,1
1748427950182,TDDE 1,A02,946796,Guirguis; Mark C,10,0,11,1
1748427950182,TDDE 1,A03,946797,Guirguis; Mark C,7,0,11,4
1748427950182,TDDE 1,A04,946798,Guirguis; Mark C,8,0,11,3
1748427950182,TDDE 1,A05,946799,Guirguis; Mark C,11,0,11,0
1748427951213,TDDE 130,A00,947094,Guirguis; Mark C,20,0,20,0
1748427952243,TDDE 131,A00,947095,Guirguis; Mark C,17,0,20,3
1748427953267,TDDE 132,A00,947096,Guirguis; Mark C,20,0,20,0
1748427954294,TDDE 141,A00,947097,McElver; Robert Harrison,20,0,20,0
1748427955322,TDDM 1,A00,946800,Johnston; Holly,7,0,18,11
1748427956348,TDDM 100,A00,947098,Brown; Bernard Joseph,28,0,30,2
1748427957377,TDDR 101,A00,947099,Powell; Lora,4,0,20,16
1748427958405,TDDR 102,A00,947100,Powell; Lora,19,0,20,1
1748427959444,TDDR 111,A00,947101,Castro; Robert Jess,12,0,15,3
1748427960474,TDDR 190,A00,947102,Stalling; Vanessa,35,0,35,0
1748427961502,TDGE 1,A01,946802,Salovey; Todd,12,0,12,0
1748427961502,TDGE 1,A02,946803,Salovey; Todd,11,0,12,1
1748427961502,TDGE 1,A03,946804,Salovey; Todd,12,0,12,0
1748427961502,TDGE 1,A04,946806,Salovey; Todd,12,0,12,0
1748427961502,TDGE 1,A05,946807,Salovey; Todd,10,0,12,2
1748427961502,TDGE 1,A06,946808,Salovey; Todd,12,0,12,0
1748427962531,TDGE 10,A00,946810,Havis; Allan,208,0,225,17
1748427963557,TDGE 11,A00,946811,Fulton; Julia,205,0,245,40
1748427964590,TDGE 25,A00,946812,Harting; Carla Kelso,1,0,20,19
1748427964590,TDGE 25,B00,946813,Harting; Carla Kelso,5,0,20,15
1748427964590,TDGE 25,C00,946814,Harting; Carla Kelso,10,0,20,10
1748427964590,TDGE 25,D00,946815,Harting; Carla Kelso,12,0,20,8
1748427965617,TDGE 124,A00,947103,Fulton; Julia,190,0,245,55
1748427966649,TDGE 133,A00,947104,Brill; Robert L.,19,0,20,1
1748427967677,TDGR 201,A00,947268,Newcomb; James,8,0,8,0
1748427968706,TDGR 210A,A00,947269,Staff,8,0,8,0
1748427969733,TDGR 211A,A00,947270,Caban; Andrea Chudnow,8,0,8,0
1748427970760,TDGR 212,A00,947271,Meyer; Ursula,17,0,17,0
1748427970760,TDGR 212,B00,947272,Caban; Andrea Chudnow,17,0,17,0
1748427971786,TDGR 213A,A00,947273,Buescher; Stephen W.,8,0,8,0
1748427972821,TDGR 214A,A00,947274,Meyer; Ursula,8,0,8,0
1748427973850,TDGR 219,A00,947276,Stalling; Vanessa,3,0,5,2
1748427974880,TDGR 229,A00,947277,Meyer; Ursula,7,0,7,0
1748427975909,TDGR 231A,A00,947278,Meyer; Ursula,9,0,9,0
1748427976940,TDGR 233,A00,947279,Richard; Keiana Nikole,9,0,9,0
1748427977968,TDGR 235,A00,947280,Blair; Kyle Adam,9,0,9,0
1748427978993,TDGR 239,A00,947281,Staff,8,0,8,0
1748427978993,TDGR 239,B00,947282,Meyer; Ursula,9,0,9,0
1748427978993,TDGR 239,C00,947283,Staff,9,0,9,0
1748427980023,TDGR 240,A00,947284,Stalling; Vanessa,3,0,5,2
1748427981050,TDGR 244,A00,947285,Iizuka; Naomi Hisako,19,0,20,1
1748427982080,TDGR 245,A00,947287,Stalling; Vanessa,4,0,5,1
1748427983112,TDGR 250,A00,947289,Stein; Deborah Isobel,5,0,5,0
1748427984142,TDGR 251,A00,947296,Iizuka; Naomi Hisako,5,0,5,0
1748427984142,TDGR 251,B00,947355,Stein; Deborah Isobel,5,0,5,0
1748427985170,TDGR 274,A00,947358,Brill; Robert L.,19,0,20,1
1748427986197,TDGR 275,A00,947361,Staff,10,0,10,0
1748427987279,TDGR 276,A00,947362,Bokovikova; Alina V,10,0,10,0
1748427988311,TDGR 278,A00,947363,Petrovich; Victoria A.,12,0,12,0
1748427988311,TDGR 278,B00,947366,Staff,9,0,10,1
1748427989338,TDGR 279,A00,947367,Petrovich; Victoria A.,3,0,3,0
1748427989338,TDGR 279,B00,947368,Brill; Robert L.,2,0,3,1
1748427989338,TDGR 279,C00,947369,McElver; Robert Harrison,3,0,3,0
1748427989338,TDGR 279,D00,967973,Staff,0,0,0,0
1748427989338,TDGR 279,E00,967974,Bokovikova; Alina V,0,0,0,0
1748427990364,TDGR 282,A00,947370,McElver; Robert Harrison,10,0,10,0
1748427991390,TDGR 289,A00,947371,Power; Jade Yukana,10,0,10,0
1748427992429,TDGR 289C,A00,947373,Burelle; Julie Sara Veronique,10,0,10,0
1748427993456,TDGR 289D,A00,947374,Anderson; Mysia Anyse,5,0,5,0
1748427994484,TDGR 292,A00,947375,Yapp; Hentyle T,14,0,15,1
1748427995511,TDGR 295,A00,947376,Celik; Aysan Karagasli,8,0,8,0
1748427996542,TDGR 296,A00,947379,Powell; Lora,5,0,5,0
1748427997569,TDGR 297,001,947381,Meyer; Ursula,9,0,9,0
1748427998595,TDHT 10,A00,946817,Burelle; Julie Sara Veronique,23,0,25,2
1748427999626,TDHT 21,A02,946821,Power; Jade Yukana,11,0,15,4
1748427999626,TDHT 21,A03,946822,Power; Jade Yukana,8,0,15,7
1748428000657,TDHT 101,A00,947106,Perry; Lamar,19,0,25,6
1748428001687,TDHT 103,A00,947107,Yapp; Hentyle T,8,0,25,17
1748428002714,TDHT 115,A00,947108,Portes; Elizabeth Marie,16,0,25,9
1748428003741,TDMV 1,A00,946823,Arcidiacono; Kristin,18,0,30,12
1748428004772,TDMV 2,A00,946824,Wilson; Terry A.,24,0,30,6
1748428004772,TDMV 2,B00,946825,Brown; Bernard Joseph,23,0,30,7
1748428005800,TDMV 3,A00,946826,Mack; Kara Shanai',23,0,40,17
1748428006825,TDMV 11,A00,946827,Arcidiacono; Kristin,36,0,40,4
1748428006825,TDMV 11,B00,946828,Fyall; Daunte Edward,28,0,30,2
1748428007857,TDMV 20,A00,946830,Alvarez; Ana Maria,38,0,40,2
1748428007857,TDMV 20,B00,946831,Smith; Alison D,20,0,20,0
1748428008883,TDMV 110,A00,947109,Smith; Alison D,25,0,30,5
1748428009911,TDMV 120,A00,947110,Weinberg; Sadie,17,0,18,1
1748428009911,TDMV 120,B00,964374,Johnston; Holly,18,0,18,0
1748428010939,TDMV 123,A00,947111,Duran; Marcos Antonio,29,0,30,1
1748428011965,TDMV 138,A00,947113,Jun; Grace Shin Hae,4,0,40,36
1748428012991,TDMV 140,A00,947114,Corrales; Joseph Bernales,29,0,30,1
1748428012991,TDMV 140,B00,947138,Lima; Paulo Henrique,30,0,30,0
1748428012991,TDMV 140,C00,947139,Staff,25,0,30,5
1748428014018,TDMV 141,A00,947140,Caligagan; Tony,29,0,30,1
1748428015046,TDMV 142,A00,947225,Alvarez; Ana Maria,28,0,40,12
1748428015046,TDMV 142,B00,947226,Blanco; Juan Carlos,27,0,30,3
1748428016073,TDMV 143,A00,947227,Fyall; Daunte Edward,28,0,30,2
1748428017099,TDMV 144,A00,947261,Camaya; Michelle Ann,28,0,30,2
1748428017099,TDMV 144,B00,947262,Patnaik; Shibani,28,0,30,2
1748428018128,TDMV 146,A00,947263,Caligagan; Tony,30,0,30,0
1748428019156,TDPF 160,A00,947264,Mack; Kara Shanai',40,0,40,0
1748428020183,TDPR 6,A01,946869,Guirguis; Mark C,25,0,25,0
1748428020183,TDPR 6,A02,946870,Guirguis; Mark C,25,0,25,0
1748428021212,TDPR 102,A00,947265,Guirguis; Mark C,20,0,20,0
1748428022239,TDPR 104,A00,947266,Powell; Lora,15,0,15,0
1748428023271,TDPW 1,A00,946873,Stein; Deborah Isobel,6,0,10,4
1748428023271,TDPW 1,B00,946878,Stein; Deborah Isobel,10,0,10,0
1748428023271,TDPW 1,C00,946879,Stein; Deborah Isobel,10,0,10,0
1748428023271,TDPW 1,D00,946880,Stein; Deborah Isobel,7,0,10,3
1748428023271,TDPW 1,E00,946882,Stein; Deborah Isobel,7,0,10,3
1748428024297,TDPW 104,A00,947267,Loo; Eric James,13,0,20,7
1748428025321,TDTR 10,A00,946883,Wilson; Terry A.,14,0,20,6
1748428026348,TDTR 15,A00,946885,Smith; Alison D,30,0,30,0
1748428027377,TDTR 20,A00,946886,Duran; Marcos Antonio,25,0,30,5
1748428028404,USP 1,A01,943915,Garcia; Guadalupe,23,0,23,0
1748428028404,USP 1,A02,943916,Garcia; Guadalupe,19,0,23,4
1748428028404,USP 1,A03,943927,Garcia; Guadalupe,23,0,23,0
1748428028404,USP 1,A04,943933,Garcia; Guadalupe,22,0,23,1
1748428028404,USP 1,A05,943942,Garcia; Guadalupe,23,0,23,0
1748428028404,USP 1,A06,943951,Garcia; Guadalupe,22,0,23,1
1748428029435,USP 2,A01,943956,Pezzoli; Keith,15,0,23,8
1748428029435,USP 2,A02,943958,Pezzoli; Keith,20,0,22,2
1748428030460,USP 4,A00,943961,Schwaller; Nora Louise,2,0,18,16
1748428030460,USP 4,B00,943966,Schwaller; Nora Louise,12,0,18,6
1748428031486,USP 5,A01,943968,Boomhower; Matthew Charles,16,0,20,4
1748428031486,USP 5,A02,943969,Boomhower; Matthew Charles,16,0,20,4
1748428032517,USP 15,A01,943971,Anderson; William Raymond,18,0,20,2
1748428032517,USP 15,A02,944015,Anderson; William Raymond,19,0,20,1
1748428033548,USP 25,A00,944021,Shenkman; Michael Thomas,16,0,25,9
1748428034574,USP 50,A00,944025,Sun; Feiyang,3,0,30,27
1748428035603,USP 60,A01,944056,Wali; Behram,26,0,30,4
1748428036633,USP 105,A00,944057,Ruiz; Jonathan Joseph,9,0,15,6
1748428037660,USP 108,A00,944058,Pezzoli; Keith,10,0,21,11
1748428038687,USP 124,A00,944060,Devereux; Christina Schopp,16,0,35,19
1748428039715,USP 125,A00,944063,Lerner; Amy M,21,0,28,7
1748428040744,USP 136,A00,944064,Staff,27,0,35,8
1748428041769,USP 141A,A00,960658,Lewis; Leslie R,0,0,0,0
1748428042796,USP 143,A00,944065,Hinds; Juli Beth,200,0,250,50
1748428043824,USP 144,A00,944066,Chowdhury; Muhammed Zohir,94,0,100,6
1748428044851,USP 150,A00,944067,Devereux; Christina Schopp,68,0,75,7
1748428045878,USP 151,A00,944068,Clark; Christopher N,58,0,70,12
1748428046905,USP 152B,A00,944069,Moeder; Nathan L,14,0,25,11
1748428047934,USP 153,A00,944070,Shenkman; Michael Thomas,19,0,35,16
1748428048960,USP 161,A00,944071,Wartell; Julie Dara,27,0,35,8
1748428049990,USP 165C,A00,944072,Wali; Behram,25,0,30,5
1748428051019,USP 170,A00,944142,Entezam; Maryam,60,0,70,10
1748428052045,USP 171,A00,944153,Lerner; Amy M,24,0,65,41
1748428053072,USP 175,A00,944172,Peerson; Susan,0,0,25,25
1748428054102,USP 177A,A00,944173,Peerson; Susan,0,0,23,23
1748428056159,USP 185A,A01,944198,Boomhower; Matthew Charles,26,0,40,14
1748428056159,USP 185A,B01,944201,Sun; Feiyang,0,0,40,40
1748428057193,USP 186,A01,944255,Bussell; Mirle Rabinowitz,28,0,38,10
1748428057193,USP 186,A02,944262,Bussell; Mirle Rabinowitz,11,0,37,26
1748428058219,USP 189,A00,944269,Garcia; Guadalupe,35,0,35,0
1748428059250,USP 191A,A00,944270,McTague; Sarah,13,0,30,17
1748428060276,USP 193,A00,944271,Shilon; Mor,10,0,23,13
1748428061303,USP 194,A00,954112,Hill; Seth J,9999,0,9999,0
1748428062331,USP 265C,A00,944277,Wali; Behram,3,0,4,1
1748428063360,USP 271,A00,944280,Lerner; Amy M,5,0,5,0
1748428064393,VIS 1,A01,944283,Staff,4,0,12,8
1748428064393,VIS 1,A02,944284,Staff,0,0,12,12
1748428064393,VIS 1,A03,944286,Staff,0,0,12,12
1748428064393,VIS 1,A04,944288,Staff,0,0,12,12
1748428064393,VIS 1,A05,944290,Staff,0,0,12,12
1748428064393,VIS 1,A06,944292,Staff,1,0,12,11
1748428064393,VIS 1,A07,944293,Staff,9,0,12,3
1748428064393,VIS 1,A08,944300,Staff,0,0,12,12
1748428064393,VIS 1,A09,944302,Staff,12,0,12,0
1748428064393,VIS 1,A10,944303,Staff,0,0,12,12
1748428064393,VIS 1,A11,944307,Staff,0,0,12,12
1748428064393,VIS 1,A12,944309,Staff,0,0,12,12
1748428064393,VIS 1,A13,944310,Staff,0,0,12,12
1748428064393,VIS 1,A14,944312,Staff,0,0,12,12
1748428064393,VIS 1,A15,944316,Staff,6,0,12,6
1748428064393,VIS 1,A16,944319,Staff,0,0,12,12
1748428065422,VIS 20,A01,944323,Woods; Ann,14,0,16,2
1748428065422,VIS 20,A02,944325,Woods; Ann,15,0,16,1
1748428065422,VIS 20,A03,944326,Woods; Ann,14,0,16,2
1748428065422,VIS 20,A04,944328,Woods; Ann,14,0,16,2
1748428065422,VIS 20,A05,944330,Woods; Ann,16,0,16,0
1748428065422,VIS 20,A06,944334,Woods; Ann,16,0,16,0
1748428065422,VIS 20,A07,944336,Woods; Ann,14,0,16,2
1748428065422,VIS 20,A08,944337,Woods; Ann,16,0,16,0
1748428065422,VIS 20,A09,944338,Woods; Ann,15,0,16,1
1748428065422,VIS 20,A10,944339,Woods; Ann,16,0,16,0
1748428065422,VIS 20,A11,944340,Woods; Ann,15,0,16,1
1748428065422,VIS 20,A12,944342,Woods; Ann,15,0,16,1
1748428066453,VIS 23,A00,944343,Rose; Jordan M,0,0,5,5
1748428067480,VIS 30,A01,944346,Stone; Patricia,11,0,11,0
1748428067480,VIS 30,A02,944351,Stone; Patricia,0,0,11,11
1748428067480,VIS 30,A03,944353,Stone; Patricia,7,0,11,4
1748428067480,VIS 30,A04,944354,Stone; Patricia,9,0,11,2
1748428067480,VIS 30,A05,944356,Stone; Patricia,10,0,11,1
1748428067480,VIS 30,A06,944359,Stone; Patricia,6,0,11,5
1748428068508,VIS 41,A01,944391,D'Elena-Tweed; Jessica Erin,10,0,12,2
1748428068508,VIS 41,A02,944392,D'Elena-Tweed; Jessica Erin,11,0,12,1
1748428068508,VIS 41,A03,944393,D'Elena-Tweed; Jessica Erin,12,0,12,0
1748428068508,VIS 41,A04,944396,D'Elena-Tweed; Jessica Erin,9,0,12,3
1748428068508,VIS 41,A05,944397,D'Elena-Tweed; Jessica Erin,12,0,12,0
1748428068508,VIS 41,A06,944399,D'Elena-Tweed; Jessica Erin,8,0,12,4
1748428068508,VIS 41,A07,944405,D'Elena-Tweed; Jessica Erin,10,0,12,2
1748428068508,VIS 41,A08,944411,D'Elena-Tweed; Jessica Erin,10,0,12,2
1748428068508,VIS 41,A09,944412,D'Elena-Tweed; Jessica Erin,12,0,12,0
1748428068508,VIS 41,A10,944415,D'Elena-Tweed; Jessica Erin,10,0,12,2
1748428068508,VIS 41,A11,944428,D'Elena-Tweed; Jessica Erin,12,0,12,0
1748428068508,VIS 41,A12,944430,D'Elena-Tweed; Jessica Erin,11,0,12,1
1748428069536,VIS 42,A00,969576,Twomey; Robert Daniel,86,0,100,14
1748428070564,VIS 60,A01,944432,Sepuya; Paul Mpagi,10,0,12,2
1748428070564,VIS 60,A02,944434,Sepuya; Paul Mpagi,12,0,12,0
1748428070564,VIS 60,A03,944436,Sepuya; Paul Mpagi,12,0,12,0
1748428070564,VIS 60,A04,944438,Sepuya; Paul Mpagi,12,0,12,0
1748428071591,VIS 70N,A01,944456,Garnett; Mariah J,11,0,11,0
1748428071591,VIS 70N,A02,944461,Garnett; Mariah J,9,0,11,2
1748428071591,VIS 70N,A03,944462,Garnett; Mariah J,8,0,11,3
1748428071591,VIS 70N,A04,944500,Garnett; Mariah J,10,0,11,1
1748428071591,VIS 70N,A05,944501,Garnett; Mariah J,11,0,11,0
1748428071591,VIS 70N,A06,944502,Garnett; Mariah J,11,0,11,0
1748428071591,VIS 70N,A07,944503,Garnett; Mariah J,11,0,11,0
1748428071591,VIS 70N,A08,944507,Garnett; Mariah J,11,0,11,0
1748428072620,VIS 80,A01,944513,Adler; Amy,12,0,12,0
1748428072620,VIS 80,A02,944515,Adler; Amy,9,0,12,3
1748428072620,VIS 80,A03,944517,Adler; Amy,10,0,12,2
1748428072620,VIS 80,A04,944518,Adler; Amy,10,0,12,2
1748428072620,VIS 80,A05,944519,Adler; Amy,12,0,12,0
1748428072620,VIS 80,A06,944520,Adler; Amy,11,0,12,1
1748428072620,VIS 80,A07,944525,Adler; Amy,11,0,12,1
1748428072620,VIS 80,A08,944526,Adler; Amy,9,0,12,3
1748428073651,VIS 85A,A01,944694,Staff,18,0,18,0
1748428073651,VIS 85A,A02,944695,Staff,18,0,18,0
1748428073651,VIS 85A,A03,944696,Staff,17,0,18,1
1748428073651,VIS 85A,A04,944697,Staff,17,0,18,1
1748428073651,VIS 85A,A05,968082,Staff,17,0,18,1
1748428073651,VIS 85A,A06,968084,Staff,18,0,18,0
1748428073651,VIS 85A,A07,968085,Staff,17,0,18,1
1748428073651,VIS 85A,A08,968087,Staff,17,0,18,1
1748428074678,VIS 100,A00,944698,Cruz; Edwin Teddy,125,0,146,21
1748428075706,VIS 100A,A00,944699,D'Elena-Tweed; Jessica Erin,0,0,15,15
1748428076736,VIS 103D,A00,944767,Cartwright; Lisa,72,0,75,3
1748428077765,VIS 105A,A00,944769,Staff,8,0,30,22
1748428077765,VIS 105A,B00,944770,Staff,20,0,30,10
1748428078793,VIS 105B,A00,944773,Staff,16,0,30,14
1748428079820,VIS 105C,A00,944774,Ortiz-Torres; Ruben,1,0,15,14
1748428080848,VIS 106A,A00,944775,Staff,10,0,25,15
1748428081877,VIS 106B,A00,944776,Staff,0,0,25,25
1748428082907,VIS 107A,A00,944777,Staff,2,0,25,23
1748428083935,VIS 107C,A00,944780,Iglesias; Janelle Ann,11,0,15,4
1748428084961,VIS 108,A00,944781,Staff,0,0,15,15
1748428085987,VIS 110A,A00,944782,Staff,11,0,15,4
1748428087016,VIS 110G,A00,963093,Staff,14,0,15,1
1748428088047,VIS 113CN,A00,944783,Welchman; John C.,11,0,15,4
1748428089074,VIS 120A,A00,944784,Woods; Ann,118,0,146,28
1748428090102,VIS 121C,A00,944789,Tronzo; William,68,0,75,7
1748428091182,VIS 126F,A00,944793,Wardwell; Mariana Razo,74,0,75,1
1748428092209,VIS 128C,A00,944794,Staff,71,0,75,4
1748428093238,VIS 129A,A00,944799,Staff,7,0,15,8
1748428094265,VIS 132,A00,944800,Miller; Nicole L,6,0,15,9
1748428095292,VIS 133,A01,944806,Staff,32,0,34,2
1748428095292,VIS 133,A02,944809,Staff,34,0,34,0
1748428096318,VIS 133A,A00,944854,Staff,0,0,15,15
1748428097346,VIS 141A,A01,944856,Stalbaum; Brett,16,0,25,9
1748428097346,VIS 141A,A02,944858,Stalbaum; Brett,17,0,25,8
1748428097346,VIS 141A,A03,944859,Stalbaum; Brett,11,0,25,14
1748428097346,VIS 141A,A04,944861,Stalbaum; Brett,23,0,25,2
1748428098375,VIS 142,A01,944864,Stalbaum; Brett,11,0,15,4
1748428098375,VIS 142,A02,944865,Stalbaum; Brett,0,0,15,15
1748428098375,VIS 142,A03,944869,Stalbaum; Brett,11,0,15,4
1748428098375,VIS 142,A04,944873,Stalbaum; Brett,5,0,15,10
1748428098375,VIS 142,A05,944876,Stalbaum; Brett,15,0,15,0
1748428098375,VIS 142,A06,944878,Stalbaum; Brett,7,0,15,8
1748428099405,VIS 143,A00,969275,Akten; Mehmet,0,0,15,15
1748428100432,VIS 145B,A00,944879,Akten; Mehmet,0,0,15,15
1748428101458,VIS 146B,A00,944880,Twomey; Robert Daniel,14,0,15,1
1748428102485,VIS 147A,A01,944883,Staff,21,0,22,1
1748428102485,VIS 147A,A02,944923,Staff,12,0,22,10
1748428102485,VIS 147A,A03,944924,Staff,15,0,22,7
1748428102485,VIS 147A,A04,944925,Staff,17,0,22,5
1748428103508,VIS 147B,A00,944926,Staff,0,0,15,15
1748428103508,VIS 147B,B00,944927,Staff,1,0,15,14
1748428104540,VIS 149,A00,944928,Bratton; Benjamin H.,12,0,15,3
1748428104540,VIS 149,B00,944929,Crandall; Jordan,7,0,15,8
1748428105567,VIS 152D,A01,944931,Wardwell; Mariana Razo,19,0,24,5
1748428105567,VIS 152D,A02,945003,Wardwell; Mariana Razo,23,0,24,1
1748428105567,VIS 152D,A03,945007,Wardwell; Mariana Razo,24,0,24,0
1748428105567,VIS 152D,A04,945097,Wardwell; Mariana Razo,22,0,24,2
1748428106598,VIS 157,A01,945131,Cartwright; Lisa,23,0,24,1
1748428106598,VIS 157,A02,945167,Cartwright; Lisa,5,0,24,19
1748428107627,VIS 162,A00,945168,Bratton; Benjamin H.,6,0,15,9
1748428108655,VIS 163,A00,945169,Stone; Patricia,72,0,75,3
1748428109689,VIS 164,A00,945170,Sepuya; Paul Mpagi,19,0,22,3
1748428110716,VIS 165A,A00,945208,Staff,10,0,22,12
1748428111743,VIS 167,A00,945235,Staff,11,0,22,11
1748428112772,VIS 171,A00,945258,Staff,18,0,22,4
1748428113804,VIS 174,A00,945285,Cross; Brian R,0,0,22,22
1748428114830,VIS 175,A00,945286,Staff,18,0,22,4
1748428115861,VIS 179,A00,945287,Erdmann; Dean,20,0,22,2
1748428116890,VIS 180A,A00,945322,Cross; Brian R,9,0,22,13
1748428117918,VIS 180B,A00,945324,Gaines; Malik Julian,17,0,22,5
1748428118944,VIS 183B,A00,945329,Staff,4,0,22,18
1748428119973,VIS 203,A00,945331,Cruz; Edwin Teddy,4,0,15,11
1748428121003,VIS 204,A00,945333,Gaines; Malik Julian,11,0,15,4
1748428122031,VIS 205,A00,945334,Ortiz-Torres; Ruben,14,0,15,1
1748428123059,VIS 207,A00,971577,Staff,13,0,15,2
1748428124086,VIS 209,A00,945337,Welchman; John C.,10,0,15,5
1748428125113,VIS 243,A00,945340,Rose; Jordan M,8,0,15,7
1748428126139,VIS 255,A00,945342,Staff,9,0,15,6
1748428127171,VIS 295,001,971694,Miller; Nicole L,0,0,0,0
1748428127171,VIS 295,002,971695,Cruz; Edwin Teddy,0,0,0,0
1748428127171,VIS 295,003,971696,Segade; Alexandro Abraham,0,0,0,0
1748428127171,VIS 295,004,971697,Vangenderen; Monique Luise,0,0,0,0
1748428127171,VIS 295,005,971725,Sepuya; Paul Mpagi,0,0,0,0
1748428127171,VIS 295,006,971763,Sepuya; Paul Mpagi,0,0,0,0
1748428127171,VIS 295,007,971764,Mostajo; Lorena,0,0,0,0
1748428127171,VIS 295,008,971765,Akten; Mehmet,0,0,0,0
1748428128207,WCWP 10A,001,947782,Escobar; Jordan Christophe,20,0,20,0
1748428128207,WCWP 10A,002,947791,Escobar; Jordan Christophe,20,0,20,0
1748428128207,WCWP 10A,003,947792,Gagnon; Jeffrey C,0,0,0,0
1748428128207,WCWP 10A,004,947793,Escobar; Jordan Christophe,19,0,20,1
1748428128207,WCWP 10A,005,947794,Merryman; Walter,19,0,20,1
1748428128207,WCWP 10A,006,947840,Merryman; Walter,20,0,20,0
1748428128207,WCWP 10A,007,947841,Staff,0,0,0,0
1748428128207,WCWP 10A,008,947842,Staff,0,0,0,0
1748428128207,WCWP 10A,009,947843,Martiniuk; Jill,18,0,20,2
1748428128207,WCWP 10A,010,947844,Staff,0,0,0,0
1748428128207,WCWP 10A,011,947845,Martiniuk; Jill,19,0,20,1
1748428128207,WCWP 10A,012,947861,Martiniuk; Jill,20,0,20,0
1748428128207,WCWP 10A,013,947862,Staff,0,0,0,0
1748428128207,WCWP 10A,014,947863,Staff,0,0,0,0
1748428128207,WCWP 10A,015,947867,Staff,0,0,0,0
1748428128207,WCWP 10A,016,947868,Susi; Natalie,19,0,20,1
1748428128207,WCWP 10A,017,947869,Susi; Natalie,19,0,20,1
1748428128207,WCWP 10A,018,947870,Holloway Ii; Mathew,20,0,20,0
1748428128207,WCWP 10A,019,947912,Welji; Haleema Nazir,0,0,0,0
1748428128207,WCWP 10A,020,947941,Holloway Ii; Mathew,19,0,20,1
1748428128207,WCWP 10A,021,947954,Holloway Ii; Mathew,20,0,20,0
1748428128207,WCWP 10A,022,960902,Windham; Emily,19,0,20,1
1748428128207,WCWP 10A,023,960903,Windham; Emily,16,0,20,4
1748428128207,WCWP 10A,024,960904,Windham; Emily,18,0,20,2
1748428129243,WCWP 10B,001,948038,Dhir; Simrita,17,0,20,3
1748428129243,WCWP 10B,002,948042,Dhir; Simrita,13,0,20,7
1748428129243,WCWP 10B,003,948043,Uriarte; Emma,0,0,20,20
1748428129243,WCWP 10B,004,948044,Dhir; Simrita,12,0,20,8
1748428129243,WCWP 10B,005,948045,Uriarte; Emma,13,0,20,7
1748428129243,WCWP 10B,006,948046,Uriarte; Emma,13,0,20,7
1748428129243,WCWP 10B,007,948047,Staff,0,0,0,0
1748428129243,WCWP 10B,008,948075,Staff,0,0,0,0
1748428129243,WCWP 10B,009,948076,Ornelas; Tricia,15,0,20,5
1748428129243,WCWP 10B,010,948077,Staff,0,0,0,0
1748428129243,WCWP 10B,011,948096,Staff,0,0,0,0
1748428129243,WCWP 10B,012,948103,Staff,0,0,0,0
1748428129243,WCWP 10B,016,948169,Staff,0,0,0,0
1748428129243,WCWP 10B,017,948192,Ornelas; Tricia,12,0,20,8
1748428129243,WCWP 10B,018,948194,Ornelas; Tricia,14,0,20,6
1748428129243,WCWP 10B,019,948195,Staff,0,0,0,0
1748428130272,WCWP 100,A00,948196,McCleary; Keith Long,14,0,20,6
1748428130272,WCWP 100,B00,948198,McCleary; Keith Long,20,0,20,0
1748428130272,WCWP 100,C00,948199,McCleary; Keith Long,20,0,20,0
1748428130272,WCWP 100,D00,948200,Twohig; Niall Ivan,18,0,20,2
1748428130272,WCWP 100,E00,948201,Twohig; Niall Ivan,19,0,20,1
1748428130272,WCWP 100,F00,948202,Twohig; Niall Ivan,17,0,20,3
1748428130272,WCWP 100,G00,948203,Young; Mark T,18,0,20,2
1748428130272,WCWP 100,H00,948204,Young; Mark T,19,0,20,1
1748428130272,WCWP 100,I00,948205,Young; Mark T,19,0,20,1
1748428131299,WES 237C,A00,948206,Staff,15,0,15,0
1748428132327,WES 267,A00,948207,Staff,25,0,25,0
1748428133355,WES 268A,A01,948209,Staff,15,0,15,0
1748428135583,AAPI 87,A00,911745,Solomon; Amanda Lee Albaniel,20,0,20,0
1748428136616,AAS 10R,A01,912566,Butler; Elizabeth Annette,15,0,34,19
1748428136616,AAS 10R,A02,912567,Butler; Elizabeth Annette,20,0,34,14
1748428137641,AAS 170R,A00,912568,Butler; Elizabeth Annette,29,0,32,3
1748428138676,ANAR 104,A01,911408,Shtienberg; Gilad,11,0,20,9
1748428139702,ANAR 120,A00,911411,Staff,22,0,30,8
1748428140734,ANAR 166,A00,911412,Jimenez Cano; Nayeli Guada,21,0,30,9
1748428141766,ANAR 167,A01,911414,Dunseth; Zachary Clark,0,0,10,10
1748428142794,ANBI 100,A00,911416,Marchetto; Maria Carolina,36,0,40,4
1748428142794,ANBI 100,B00,961136,Staff,66,0,80,14
1748428143818,ANBI 112,A00,911417,Marchetto; Maria Carolina,0,0,20,20
1748428144849,ANBI 117,A01,961211,Fox; Patrick Keolu Ozer,33,0,40,7
1748428145875,ANBI 135,A01,911419,Non; Amy L,4,0,15,11
1748428146903,ANBI 141,A00,911420,Gagneux; Pascal,170,0,196,26
1748428147933,ANSC 108,A00,911460,Pedersen; David,38,0,40,2
1748428148964,ANSC 121,A00,911472,Sloane; Julia Kathryn,53,0,60,7
1748428149990,ANSC 124,A00,911473,Bialecki; Jon Anthony,32,0,40,8
1748428151018,ANSC 142,A00,911474,Stone; Annika Britt,31,0,40,9
1748428152047,ANSC 148,A00,911475,Walkover; Lillian B,46,0,46,0
1748428153072,ANSC 149,A00,911476,Varma; Saiba,56,0,60,4
1748428154098,ANSC 152,A00,961212,Staff,40,0,40,0
1748428155131,ANSC 190,A00,911479,Jassal; Aftab,41,0,50,9
1748428156158,ANTH 1,A00,910717,Jassal; Aftab,146,0,150,4
1748428157184,ANTH 2,A01,910719,Wilder; Linnea Lorene,31,0,36,5
1748428157184,ANTH 2,A02,910720,Wilder; Linnea Lorene,36,0,36,0
1748428157184,ANTH 2,A03,910722,Wilder; Linnea Lorene,32,0,36,4
1748428157184,ANTH 2,A04,910723,Wilder; Linnea Lorene,35,0,36,1
1748428157184,ANTH 2,A05,910724,Wilder; Linnea Lorene,35,0,36,1
1748428157184,ANTH 2,A06,910725,Wilder; Linnea Lorene,35,0,36,1
1748428157184,ANTH 2,A07,910726,Wilder; Linnea Lorene,33,0,34,1
1748428158215,ANTH 10,A00,910727,Stewart; Alexander B,148,0,175,27
1748428159246,ANTH 21,A01,910730,Stone; Annika Britt,35,0,36,1
1748428159246,ANTH 21,A02,910731,Stone; Annika Britt,34,0,36,2
1748428159246,ANTH 21,A03,910732,Stone; Annika Britt,34,0,36,2
1748428159246,ANTH 21,A04,910733,Stone; Annika Britt,30,0,36,6
1748428159246,ANTH 21,A05,910734,Stone; Annika Britt,35,0,36,1
1748428159246,ANTH 21,A06,910735,Stone; Annika Britt,30,0,36,6
1748428159246,ANTH 21,A07,910736,Stone; Annika Britt,24,0,34,10
1748428159246,ANTH 21,B01,910738,Kang; Byung Chu,36,0,36,0
1748428159246,ANTH 21,B02,910740,Kang; Byung Chu,36,0,36,0
1748428159246,ANTH 21,B03,910781,Kang; Byung Chu,34,0,36,2
1748428159246,ANTH 21,B04,910782,Kang; Byung Chu,34,0,36,2
1748428159246,ANTH 21,B05,910821,Kang; Byung Chu,36,0,36,0
1748428159246,ANTH 21,B06,910826,Kang; Byung Chu,34,0,36,2
1748428159246,ANTH 21,B07,910834,Kang; Byung Chu,34,0,34,0
1748428160272,ANTH 23,A01,910896,Stewart; Alexander B,25,0,25,0
1748428160272,ANTH 23,A02,910916,Stewart; Alexander B,25,0,25,0
1748428160272,ANTH 23,A03,910932,Stewart; Alexander B,25,0,25,0
1748428160272,ANTH 23,A04,910933,Stewart; Alexander B,24,0,25,1
1748428160272,ANTH 23,A05,910938,Stewart; Alexander B,25,0,25,0
1748428160272,ANTH 23,A06,911043,Stewart; Alexander B,25,0,25,0
1748428160272,ANTH 23,A07,911141,Stewart; Alexander B,24,0,25,1
1748428161306,ANTH 87,A00,911153,Jordan; David K.,20,0,20,0
1748428161306,ANTH 87,B00,911392,Jordan; David K.,20,0,20,0
1748428161306,ANTH 87,C00,911404,Varma; Saiba,20,0,20,0
1748428162337,ANTH 101,A01,911481,Staff,27,0,30,3
1748428162337,ANTH 101,A02,911482,Staff,15,0,30,15
1748428162337,ANTH 101,A03,911483,Staff,24,0,30,6
1748428162337,ANTH 101,A04,911484,Staff,17,0,30,13
1748428163364,ANTH 105,A00,911486,Staff,69,0,80,11
1748428164395,ANTH 108,A00,911487,Sloane; Julia Kathryn,31,0,35,4
1748428165422,ANTH 196A,A00,911488,Staff,14,0,15,1
1748428166448,ANTH 200,A00,911489,Non; Amy L,12,0,15,3
1748428167475,ANTH 203,A00,911490,Gagneux; Pascal,20,0,20,0
1748428168501,ANTH 208,A00,911491,Kang; Byung Chu,8,0,12,4
1748428169528,ANTH 268,A00,911492,McKenzie; Kerry V.,10,0,10,0
1748428170558,ANTH 273,A00,911493,McKenzie; Kerry V.,10,0,10,0
1748428171588,ANTH 281A,A00,911494,Pedersen; David,10,0,10,0
1748428172615,ANTH 285,A00,911495,Algaze; Guillermo,7,0,10,3
1748428173648,ASTR 1,A01,911506,Wright; Shelley Adams,282,0,300,18
1748428174674,ASTR 18,A01,911508,Arnold; Kam S,35,0,37,2
1748428175701,ASTR 20A,A01,911510,Theissen; Christopher Alexander,48,0,56,8
1748428176728,ASTR 65,A01,911512,Trumbo; Samantha Kathleen,49,0,50,1
1748428177761,ASTR 101,A01,911514,Burgasser; Adam Jonathan,25,0,32,7
1748428178793,ASTR 104,A01,911516,Lee; Eve Jihyun,29,0,32,3
1748428179821,ASTR 120,A01,911518,Tytler; David Robert,29,0,37,8
1748428180853,ASTR 124,A01,911520,Konopacky; Quinn Morgan,33,0,37,4
1748428181881,ASTR 150,A01,911522,Hosseinzadeh; Griffin Alex,34,0,40,6
1748428182908,ASTR 200,A00,911523,Sandstrom; Karin Marie,29,0,30,1
1748428183935,ASTR 201,A00,911524,Broekgaarden; Floor Suzan,30,0,30,0
1748428184962,ASTR 213,A00,911525,Keres; Dusan,28,0,30,2
1748428185987,ASTR 250,A00,911526,Theissen; Christopher Alexander & Hosseinzadeh; Griffin Alex,27,0,30,3
1748428187013,ASTR 251,A00,911527,Theissen; Christopher Alexander & Hosseinzadeh; Griffin Alex,27,0,30,3
1748428188063,AWP 3,001,910489,Staff,12,0,12,0
1748428188063,AWP 3,002,910490,Staff,12,0,12,0
1748428188063,AWP 3,003,910491,Staff,12,0,12,0
1748428188063,AWP 3,004,910492,Staff,12,0,12,0
1748428188063,AWP 3,005,910493,Staff,12,0,12,0
1748428188063,AWP 3,006,910495,Staff,12,0,12,0
1748428188063,AWP 3,007,910498,Staff,12,0,12,0
1748428188063,AWP 3,008,910509,Staff,12,0,12,0
1748428188063,AWP 3,009,910516,Staff,12,0,12,0
1748428188063,AWP 3,010,910525,Staff,12,0,12,0
1748428188063,AWP 3,011,910531,Staff,12,0,12,0
1748428188063,AWP 3,012,910532,Staff,12,0,12,0
1748428188063,AWP 3,013,910533,Staff,12,0,12,0
1748428188063,AWP 3,014,910534,Staff,12,0,12,0
1748428188063,AWP 3,015,910535,Staff,12,0,12,0
1748428188063,AWP 3,016,910536,Staff,12,0,12,0
1748428188063,AWP 3,017,910537,Staff,12,0,12,0
1748428188063,AWP 3,018,910538,Staff,12,0,12,0
1748428188063,AWP 3,019,910539,Staff,0,0,0,0
1748428188063,AWP 3,020,910540,Staff,0,0,0,0
1748428188063,AWP 3,021,910541,Staff,12,0,12,0
1748428188063,AWP 3,022,910542,Staff,0,0,0,0
1748428188063,AWP 3,023,910543,Staff,12,0,12,0
1748428188063,AWP 3,024,910545,Staff,12,0,12,0
1748428188063,AWP 3,025,910546,Staff,12,0,12,0
1748428188063,AWP 3,026,910547,Staff,12,0,12,0
1748428188063,AWP 3,027,910548,Staff,12,0,12,0
1748428188063,AWP 3,028,910549,Staff,12,0,12,0
1748428188063,AWP 3,029,910550,Staff,0,0,0,0
1748428188063,AWP 3,030,910551,Staff,0,0,0,0
1748428188063,AWP 3,031,910552,Staff,12,0,12,0
1748428188063,AWP 3,032,910553,Staff,12,0,12,0
1748428188063,AWP 3,033,910554,Staff,12,0,12,0
1748428188063,AWP 3,034,910555,Staff,12,0,12,0
1748428188063,AWP 3,035,910557,Staff,12,0,12,0
1748428188063,AWP 3,036,910558,Staff,12,0,12,0
1748428188063,AWP 3,037,910559,Staff,12,0,12,0
1748428188063,AWP 3,038,910560,Staff,12,0,12,0
1748428188063,AWP 3,039,910561,Staff,12,0,12,0
1748428188063,AWP 3,040,910562,Staff,12,0,12,0
1748428188063,AWP 3,041,910563,Staff,12,0,12,0
1748428188063,AWP 3,042,910564,Staff,12,0,12,0
1748428188063,AWP 3,043,910565,Staff,12,0,12,0
1748428188063,AWP 3,044,910566,Staff,12,0,12,0
1748428188063,AWP 3,045,910567,Staff,12,0,12,0
1748428188063,AWP 3,046,910568,Staff,12,0,12,0
1748428188063,AWP 3,047,910569,Staff,12,0,12,0
1748428188063,AWP 3,048,910570,Staff,12,0,12,0
1748428188063,AWP 3,049,910571,Staff,12,0,12,0
1748428188063,AWP 3,050,910576,Staff,12,0,12,0
1748428188063,AWP 3,051,910629,Staff,12,0,12,0
1748428188063,AWP 3,052,910630,Staff,12,0,12,0
1748428188063,AWP 3,053,910632,Staff,12,0,12,0
1748428188063,AWP 3,054,910633,Staff,12,0,12,0
1748428188063,AWP 3,055,910635,Staff,12,0,12,0
1748428188063,AWP 3,056,910636,Staff,12,0,12,0
1748428188063,AWP 3,057,910638,Staff,12,0,12,0
1748428188063,AWP 3,058,910640,Staff,0,0,0,0
1748428188063,AWP 3,059,910641,Staff,12,0,12,0
1748428188063,AWP 3,060,910645,Staff,12,0,12,0
1748428188063,AWP 3,061,910646,Staff,12,0,12,0
1748428188063,AWP 3,062,910648,Staff,12,0,12,0
1748428188063,AWP 3,063,910649,Staff,12,0,12,0
1748428188063,AWP 3,064,910653,Staff,12,0,12,0
1748428188063,AWP 3,065,910654,Staff,12,0,12,0
1748428188063,AWP 3,066,910656,Staff,12,0,12,0
1748428188063,AWP 3,067,910657,Staff,12,0,12,0
1748428188063,AWP 3,068,910659,Staff,15,0,15,0
1748428188063,AWP 3,069,910660,Staff,0,0,0,0
1748428188063,AWP 3,070,910662,Staff,12,0,12,0
1748428188063,AWP 3,071,910665,Staff,0,0,0,0
1748428188063,AWP 3,072,910667,Staff,12,0,12,0
1748428188063,AWP 3,073,970938,Staff,12,0,12,0
1748428188063,AWP 3,074,970939,Staff,12,0,12,0
1748428188063,AWP 3,075,970940,Staff,0,0,0,0
1748428188063,AWP 3,076,970941,Staff,12,0,12,0
1748428188063,AWP 3,077,970942,Staff,12,0,12,0
1748428188063,AWP 3,078,970943,Staff,0,0,0,0
1748428188063,AWP 3,079,970944,Staff,12,0,12,0
1748428188063,AWP 3,080,970945,Staff,0,0,0,0
1748428188063,AWP 3,081,971140,Staff,0,0,0,0
1748428188063,AWP 3,082,971141,Staff,0,0,0,0
1748428188063,AWP 3,083,971142,Staff,0,0,0,0
1748428188063,AWP 3,084,971152,Staff,0,0,0,0
1748428188063,AWP 3,085,971315,Staff,0,0,0,0
1748428189091,AWP 4B,B00,910682,Staff,0,0,0,0
1748428189091,AWP 4B,C00,910701,Staff,0,0,0,1
1748428190123,BENG 1,A01,911565,Khojah; Reem I,26,0,30,4
1748428190123,BENG 1,A02,911567,Khojah; Reem I,30,0,30,0
1748428190123,BENG 1,A03,911568,Khojah; Reem I,29,0,30,1
1748428191150,BENG 2,A00,911569,Khojah; Reem I,28,0,30,2
1748428192180,BENG 98,001,969809,Sah; Robert Lie-Yuan,9999,0,9999,0
1748428193208,BENG 99,001,969810,Sah; Robert Lie-Yuan,9999,0,9999,0
1748428194236,BENG 100,A01,911579,Taylor Amos; Alyssa C,35,0,50,15
1748428195323,BENG 110,A01,911582,Mc Culloch; Andrew Douglas,5,0,30,25
1748428195323,BENG 110,A02,911584,Mc Culloch; Andrew Douglas,17,0,30,13
1748428196352,BENG 122A,A01,958030,Cauwenberghs; Gert,54,0,70,16
1748428197381,BENG 133,A01,911589,Mali; Prashant Gulab Ram,33,0,40,7
1748428198409,BENG 135,A01,911653,Staff,32,0,40,8
1748428199436,BENG 141,A01,911674,Staff,29,0,40,11
1748428200464,BENG 161A,A01,911676,Fraley; Stephanie I.,16,0,35,19
1748428200464,BENG 161A,A02,957945,Fraley; Stephanie I.,29,0,35,6
1748428201489,BENG 162,A01,911682,Mali; Prashant Gulab Ram,0,0,30,30
1748428201489,BENG 162,A02,911683,Mali; Prashant Gulab Ram,25,0,30,5
1748428202517,BENG 166A,A02,911685,Sah; Robert Lie-Yuan,11,0,35,24
1748428203545,BENG 183,A01,911688,Zhong; Sheng,35,0,120,85
1748428204575,BENG 187B,A00,911689,Taylor Amos; Alyssa C,52,0,120,68
1748428205602,BENG 188A,A01,911691,Taylor Amos; Alyssa C,131,0,170,39
1748428206634,BENG 196,A00,911692,Cabrales; Pedro,5,0,5,0
1748428207661,BENG 197,A00,911693,Cabrales; Pedro,9999,0,9999,0
1748428208688,BENG 198,001,969812,Sah; Robert Lie-Yuan,9999,0,9999,0
1748428209715,BENG 211,A00,911720,Smarr; Benjamin,2,0,30,28
1748428210745,BENG 216,A01,911722,Cauwenberghs; Gert,1,0,40,39
1748428211777,BENG 219,A00,911723,Schoeneberg; Johannes,0,0,0,0
1748428212806,BENG 221,A00,911724,Valdez-Jasso; Daniela,27,0,70,43
1748428213832,BENG 226,A01,911727,Schmid-Schoenbein; Geert W,54,0,120,66
1748428214859,BENG 230A,A00,911728,Huang; Xiaohua,59,0,120,61
1748428215887,BENG 241A,A01,911730,Cyphert; Erika Leah,0,0,50,50
1748428216914,BENG 242,A00,911731,Cai; Shengqiang,16,0,40,24
1748428217946,BENG 247A,A00,911732,Shi; Lingyan,31,0,55,24
1748428218973,BENG 247B,A00,911733,Aran; Kiana,0,0,30,30
1748428220001,BENG 254,A01,911735,Hasty; Jeff M,0,0,20,20
1748428221029,BENG 260,A01,911737,Silva; Gabriel,15,0,45,30
1748428222057,BENG 280A,A00,911738,Liu; Thomas Tao-Ming & McVeigh; Elliot R.,34,0,70,36
1748428223083,BENG 281,A00,911739,Zhong; Sheng,5,0,90,85
1748428224110,BENG 282,A00,911740,Cabrales; Pedro,19,0,100,81
1748428225138,BENG 292,A01,911742,Ross; Camille,20,0,20,0
1748428226165,BENG 294A,A00,911743,King; Kevin R,25,0,50,25
1748428227196,BENG 295,A00,911744,Watson; John Thomas,9999,0,9999,0
1748428228223,BGGN 202,A00,943331,Kadonaga; James T,52,0,60,8
1748428229247,BGGN 204,A00,943332,Shurin; Jonathan,11,0,20,9
1748428230278,BGGN 206A,A00,943343,Bennett; Eric J,50,0,50,0
1748428231305,BGGN 208,A00,943344,Meyer; Justin Raymond & Bennett; Eric J,50,0,50,0
1748428232333,BGGN 213,A00,943349,Grant; Barry J,48,0,48,0
1748428233359,BGGN 214,A00,943351,Suel; Gurol Mehmet,23,0,50,27
1748428234386,BGGN 220,A00,943352,Dickinson; Alexandra Jazz & Pruneda-Paz; Jose L.,24,0,50,26
1748428235411,BGGN 227,A00,943372,Huffaker; Alisa,44,0,50,6
1748428236441,BGGN 249A,A01,969612,Bloodgood; Brenda Laurie,0,0,0,0
1748428236441,BGGN 249A,A02,969639,Bloodgood; Brenda Laurie,0,0,0,0
1748428237475,BGGN 260,A01,946423,Silva; Gabriel,15,0,15,0
1748428238733,BGGN 271,001,967097,Akbari; Omar Sultan,9999,0,9999,0
1748428238733,BGGN 271,002,967098,Allen; Nicola J,9999,0,9999,0
1748428238733,BGGN 271,003,967099,Alperin; Mariann,9999,0,9999,0
1748428238733,BGGN 271,004,967238,Antal; Corina Elena,9998,0,9999,1
1748428238733,BGGN 271,005,967365,Banghart; Matthew Ryan,9999,0,9999,0
1748428238733,BGGN 271,006,967368,Bier; Ethan,9999,0,9999,0
1748428238733,BGGN 271,007,967371,Boss; Gerard R.,9999,0,9999,0
1748428238733,BGGN 271,008,967375,Bouvet; Michael,9999,0,9999,0
1748428238733,BGGN 271,009,967376,Breen; Ellen C.,9999,0,9999,0
1748428238733,BGGN 271,010,967382,Bui; Jack D,9999,0,9999,0
1748428238733,BGGN 271,011,967391,Burnett; Lindsey,9998,0,9999,1
1748428238733,BGGN 271,012,967407,Caffrey; Conor,9999,0,9999,0
1748428238733,BGGN 271,013,967429,Castle; Michael James,9999,0,9999,0
1748428238733,BGGN 271,014,967431,Chang; John Tzu-yu,9999,0,9999,0
1748428238733,BGGN 271,015,967448,Chen; Xu,9999,0,9999,0
1748428238733,BGGN 271,016,967449,Cheng; Christine Shiang-Ling,9999,0,9999,0
1748428238733,BGGN 271,017,967464,Cheresh; David A.,9999,0,9999,0
1748428238733,BGGN 271,018,967496,Cherqui; Stephanie,9999,0,9999,0
1748428238733,BGGN 271,019,967500,Chu; Hiutung,9999,0,9999,0
1748428238733,BGGN 271,020,967559,Church; Kellie Breen,9999,0,9999,0
1748428238733,BGGN 271,021,967560,Cleland; Elsa Eleanor,9999,0,9999,0
1748428238733,BGGN 271,022,967561,Cohen; Shiran,9999,0,9999,0
1748428238733,BGGN 271,023,967562,Coufal; Nicole Gabriele,9999,0,9999,0
1748428238733,BGGN 271,024,967563,Croker; Ben Adam,9999,0,9999,0
1748428238733,BGGN 271,025,967564,Crotty Alexander; Laura E,9999,0,9999,0
1748428238733,BGGN 271,026,967565,Daugherty; Matthew Dorton,9998,0,9999,1
1748428238733,BGGN 271,027,967566,De Silva; Shermin,9999,0,9999,0
1748428238733,BGGN 271,028,967567,Dhar; Debanjan,9999,0,9999,0
1748428238733,BGGN 271,029,967568,Dixon; Jesse,9999,0,9999,0
1748428238733,BGGN 271,030,967569,Doherty; Taylor Alan,9998,0,9999,1
1748428238733,BGGN 271,031,967570,Dore; Kim Bohemie,9999,0,9999,0
1748428238733,BGGN 271,032,967571,Dorrestein; Pieter,9999,0,9999,0
1748428238733,BGGN 271,033,967572,Dulawa; Stephanie Carole,9999,0,9999,0
1748428238733,BGGN 271,034,967573,Fang; Xi,9999,0,9999,0
1748428238733,BGGN 271,035,967575,Farley; Emma Kristen,9998,0,9999,1
1748428238733,BGGN 271,036,967576,Ferguson; Cole John,9999,0,9999,0
1748428238733,BGGN 271,037,967578,Fisch; Kathleen Marie,9999,0,9999,0
1748428238733,BGGN 271,038,967579,George; Olivier,9999,0,9999,0
1748428238733,BGGN 271,039,967580,Ghosh; Pradipta,9998,0,9999,1
1748428238733,BGGN 271,040,967581,Glasgow; Stacey Marie,9999,0,9999,0
1748428238733,BGGN 271,041,967582,Golden; James W,9999,0,9999,0
1748428238733,BGGN 271,042,967583,Gonzalez Gamboa; Ivonne,9999,0,9999,0
1748428238733,BGGN 271,043,967584,Goren; Alon M,9999,0,9999,0
1748428238733,BGGN 271,044,967650,Guatelli; John C,9999,0,9999,0
1748428238733,BGGN 271,045,967651,Guma; Monica,9998,0,9999,1
1748428238733,BGGN 271,046,967652,Gustafsson; Asa Birgitta,9999,0,9999,0
1748428238733,BGGN 271,047,967655,Hamdoun; Amr,9999,0,9999,0
1748428238733,BGGN 271,048,967657,Hao; Nan,9999,0,9999,0
1748428238733,BGGN 271,049,967658,Hasty; Jeff M,9999,0,9999,0
1748428238733,BGGN 271,050,967660,Jiang; Qingfei,9998,0,9999,1
1748428238733,BGGN 271,051,967661,Jin; Chunyu,9999,0,9999,0
1748428238733,BGGN 271,052,967662,Jin; Yishi,9999,0,9999,0
1748428238733,BGGN 271,053,967663,Joshi; Shweta,9998,0,9999,1
1748428238733,BGGN 271,054,967664,Ju; Won-Kyu,9998,0,9999,1
1748428238733,BGGN 271,055,967665,Jun; Suckjoon,9999,0,9999,0
1748428238733,BGGN 271,056,967666,Kaech; Susan Michelle,9999,0,9999,0
1748428238733,BGGN 271,057,967668,Kauffman; Alexander,9998,0,9999,1
1748428238733,BGGN 271,058,967670,Kiger; Amy,9999,0,9999,0
1748428238733,BGGN 271,059,967720,Koloski; Miranda Jane,9998,0,9999,1
1748428238733,BGGN 271,060,967864,Komiyama; Takaki,9999,0,9999,0
1748428238733,BGGN 271,061,967865,Kronenberg; Mitchell E.,9998,0,9999,1
1748428238733,BGGN 271,062,967866,Kufareva; Irina,9999,0,9999,0
1748428238733,BGGN 271,063,967867,Lee; Yun Sok,9999,0,9999,0
1748428238733,BGGN 271,064,967869,Leutgeb; Stefan,9999,0,9999,0
1748428238733,BGGN 271,065,967870,Lewis; Warren G.,9999,0,9999,0
1748428238733,BGGN 271,066,967871,Li; Willis Xiaowei,9998,0,9999,1
1748428238733,BGGN 271,067,967872,Lim; Byungkook,9999,0,9999,0
1748428238733,BGGN 271,068,967873,Lo; Stanley M.,9998,0,9999,1
1748428238733,BGGN 271,069,967874,Lopez Ramirez; Miguel Alej,9999,0,9999,0
1748428238733,BGGN 271,070,967875,Lu; Li-Fan,9998,0,9999,1
1748428238733,BGGN 271,071,967877,Lu; Pengzhe,9999,0,9999,0
1748428238733,BGGN 271,072,967878,Lyons; Deirdre Colleen,9999,0,9999,0
1748428238733,BGGN 271,073,967879,Lyumkis; Dmitry Evgenievich,9999,0,9999,0
1748428238733,BGGN 271,074,967880,Mandyam; Chitra,9999,0,9999,0
1748428238733,BGGN 271,075,967881,McConville; Patrick James,9999,0,9999,0
1748428238733,BGGN 271,076,967882,Mertens; Jerome Stefan,9999,0,9999,0
1748428238733,BGGN 271,077,967884,Morris; Gerald P,9999,0,9999,0
1748428238733,BGGN 271,078,967885,Muroyama; Andrew David,9999,0,9999,0
1748428238733,BGGN 271,079,967886,Murre; Cornelis,9999,0,9999,0
1748428238733,BGGN 271,080,967887,Neal; Sonya E,9999,0,9999,0
1748428238733,BGGN 271,081,967889,Newton; Alexandra C.,9999,0,9999,0
1748428238733,BGGN 271,082,967890,Nieh; James Charles,9999,0,9999,0
1748428238733,BGGN 271,083,967893,Niwa; Maho,9999,0,9999,0
1748428238733,BGGN 271,084,967894,Pantham; Priyadarshini,9999,0,9999,0
1748428238733,BGGN 271,085,967895,Parast; Mana,9999,0,9999,0
1748428238733,BGGN 271,086,967899,Perry; Michael William,9999,0,9999,0
1748428238733,BGGN 271,087,967900,Pillus; Lorraine,9998,0,9999,1
1748428238733,BGGN 271,088,967902,Pogliano; Joseph,9999,0,9999,0
1748428238733,BGGN 271,089,967903,Pruneda-Paz; Jose L.,9999,0,9999,0
1748428238733,BGGN 271,090,967904,Raffatellu; Manuela,9999,0,9999,0
1748428238733,BGGN 271,091,967906,Rana; Tariq,9999,0,9999,0
1748428238733,BGGN 271,092,967907,Rao; Anjana,9998,0,9999,1
1748428238733,BGGN 271,093,967908,Raz; Eyal,9998,0,9999,1
1748428238733,BGGN 271,094,967909,Gaulton; Kyle J,9999,0,9999,0
1748428238733,BGGN 271,095,967910,Rifkin; Scott,9998,0,9999,1
1748428238733,BGGN 271,096,967912,Risbrough; Victoria Blythe,9999,0,9999,0
1748428238733,BGGN 271,097,967916,Rose; Noah Hartmann,9999,0,9999,0
1748428238733,BGGN 271,098,967917,Rouse; Gregory W.,9999,0,9999,0
1748428238733,BGGN 271,099,967918,Saier; Milton H.,9999,0,9999,0
1748428238733,BGGN 271,100,967919,Saltiel; Alan,9998,0,9999,1
1748428238733,BGGN 271,101,967920,Sanchez-Lopez; Elsa,9999,0,9999,0
1748428238733,BGGN 271,102,967921,Schenk; Simon,9999,0,9999,0
1748428238733,BGGN 271,103,967922,Schroeder; Julian I,9998,0,9999,1
1748428238733,BGGN 271,104,967923,Sebat; Lilia Mikhailovna,9999,0,9999,0
1748428238733,BGGN 271,105,967925,Sen; George L,9999,0,9999,0
1748428238733,BGGN 271,106,967926,Shaner; Nathan C.,9999,0,9999,0
1748428238733,BGGN 271,107,967927,Shao; Jianhua,9999,0,9999,0
1748428238733,BGGN 271,108,967928,Shurin; Jonathan,9998,0,9999,1
1748428238733,BGGN 271,109,967929,Sicklick; Jason Keith,9999,0,9999,0
1748428238733,BGGN 271,110,967931,Signer; Robert,9999,0,9999,0
1748428238733,BGGN 271,111,967932,Sigurdson; Christina,9999,0,9999,0
1748428238733,BGGN 271,112,967934,Simonson; Tatum Sasha Summ,9999,0,9999,0
1748428238733,BGGN 271,113,967935,Spitzer; Nicholas,9999,0,9999,0
1748428238733,BGGN 271,114,967936,Steinmetz; Nicole F,9999,0,9999,0
1748428238733,BGGN 271,115,967938,Su; Chih-Ying,9999,0,9999,0
1748428238733,BGGN 271,116,967939,Telese; Francesca,9999,0,9999,0
1748428238733,BGGN 271,117,967942,Towers; Christina Garlingt,9999,0,9999,0
1748428238733,BGGN 271,118,967943,Tye; Kay M,9999,0,9999,0
1748428238733,BGGN 271,119,967945,Wahlin; Karl Jonas,9997,0,9999,2
1748428238733,BGGN 271,120,967947,Wang; Shizhen,9999,0,9999,0
1748428238733,BGGN 271,121,967949,Wang; Jean Yin Jen,9999,0,9999,0
1748428238733,BGGN 271,122,967952,Webster; Nicholas J G,9999,0,9999,0
1748428238733,BGGN 271,123,967953,Weiskopf; Daniela,9998,0,9999,1
1748428238733,BGGN 271,124,967954,Welsbie; Derek,9999,0,9999,0
1748428238733,BGGN 271,125,967956,Wildonger; Jill Cathleen,9999,0,9999,0
1748428238733,BGGN 271,126,967957,Yelon; Deborah,9999,0,9999,0
1748428238733,BGGN 271,127,967958,Yeo; Eugene Wei-Ming,9998,0,9999,1
1748428238733,BGGN 271,128,967959,Ying; Wei,9998,0,9999,1
1748428238733,BGGN 271,129,967960,Young; Jared W.,9999,0,9999,0
1748428238733,BGGN 271,130,967961,Zage; Peter,9999,0,9999,0
1748428238733,BGGN 271,131,967962,Zengler; Karsten B,9999,0,9999,0
1748428238733,BGGN 271,132,967963,Zhang; Jin,9999,0,9999,0
1748428238733,BGGN 271,133,967964,Zhao; Yunde,9999,0,9999,0
1748428238733,BGGN 271,134,967965,Zheng; Ye,9998,0,9999,1
1748428238733,BGGN 271,135,967966,Zhou; Huilin,9998,0,9999,1
1748428238733,BGGN 271,136,967970,Zou; Yimin,9998,0,9999,1
1748428239761,BGGN 272,A00,943373,Lo; Stanley M.,14,0,15,1
1748428240788,BGGN 275,A00,943374,Pogliano; Joseph,0,0,0,0
1748428241814,BGGN 276,A00,943378,Pogliano; Joseph,0,0,0,0
1748428242842,BGJC 204,A00,943407,Lu; Li-Fan & Chang; John Tzu-yu,9998,0,9999,1
1748428243871,BGJC 215,A00,943417,Tour; Ella,9,0,10,1
1748428244957,BGRD 200,001,965406,Akbari; Omar Sultan,9999,0,9999,0
1748428244957,BGRD 200,002,965407,Allen; Eric,9999,0,9999,0
1748428244957,BGRD 200,003,965408,Allen; Nicola J,9998,0,9999,1
1748428244957,BGRD 200,004,965427,Alperin; Mariann,9999,0,9999,0
1748428244957,BGRD 200,005,965428,Amaro; Rommie E,9998,0,9999,1
1748428244957,BGRD 200,006,965429,Antal; Corina Elena,9998,0,9999,1
1748428244957,BGRD 200,007,965731,Asahina; Kenta,9999,0,9999,0
1748428244957,BGRD 200,008,965732,Augustine; Vineet,9999,0,9999,0
1748428244957,BGRD 200,009,965733,Ayres; Janelle Samantha,9998,0,9999,1
1748428244957,BGRD 200,010,965734,Banghart; Matthew Ryan,9999,0,9999,0
1748428244957,BGRD 200,011,965735,Barton; Andrew David,9999,0,9999,0
1748428244957,BGRD 200,012,965736,Bayless; Daniel Wilson,9999,0,9999,0
1748428244957,BGRD 200,013,965737,Benna; Marcus K,9999,0,9999,0
1748428244957,BGRD 200,014,965738,Bennett; Eric J,9999,0,9999,0
1748428244957,BGRD 200,015,965739,Bier; Ethan,9999,0,9999,0
1748428244957,BGRD 200,016,965740,Bloodgood; Brenda Laurie,9999,0,9999,0
1748428244957,BGRD 200,017,965741,Boss; Gerard R.,9999,0,9999,0
1748428244957,BGRD 200,018,966029,Bouvet; Michael,9999,0,9999,0
1748428244957,BGRD 200,019,966054,Breen; Ellen C.,9999,0,9999,0
1748428244957,BGRD 200,020,966072,Bui; Jack D,9999,0,9999,0
1748428244957,BGRD 200,021,966073,Burnett; Lindsey,9998,0,9999,1
1748428244957,BGRD 200,022,966080,Caffrey; Conor,9999,0,9999,0
1748428244957,BGRD 200,023,966082,Callaway; Edward M,9999,0,9999,0
1748428244957,BGRD 200,024,966087,Castle; Michael James,9999,0,9999,0
1748428244957,BGRD 200,025,966089,Chaim; Isaac,9999,0,9999,0
1748428244957,BGRD 200,026,966092,Chang; John Tzu-yu,9999,0,9999,0
1748428244957,BGRD 200,027,966094,Chen; Xu,9999,0,9999,0
1748428244957,BGRD 200,028,966095,Cheng; Christine Shiang-Ling,9999,0,9999,0
1748428244957,BGRD 200,029,966099,Cheresh; David A.,9999,0,9999,0
1748428244957,BGRD 200,030,966103,Cherqui; Stephanie,9999,0,9999,0
1748428244957,BGRD 200,031,966104,Chu; Hiutung,9999,0,9999,0
1748428244957,BGRD 200,032,966107,Church; Kellie Breen,9999,0,9999,0
1748428244957,BGRD 200,033,966108,Cleland; Elsa Eleanor,9997,0,9999,2
1748428244957,BGRD 200,034,966111,Cohen; Shiran,9999,0,9999,0
1748428244957,BGRD 200,035,966112,Cooper; Kimberly Lynn,9999,0,9999,0
1748428244957,BGRD 200,036,966114,Coufal; Nicole Gabriele,9999,0,9999,0
1748428244957,BGRD 200,037,966115,Croker; Ben Adam,9999,0,9999,0
1748428244957,BGRD 200,038,966116,Crotty Alexander; Laura E,9999,0,9999,0
1748428244957,BGRD 200,039,966117,Daugherty; Matthew Dorton,9997,0,9999,2
1748428244957,BGRD 200,040,966118,De Silva; Shermin,9998,0,9999,1
1748428244957,BGRD 200,041,966119,Desai; Arshad,9999,0,9999,0
1748428244957,BGRD 200,042,966120,Dhar; Debanjan,9999,0,9999,0
1748428244957,BGRD 200,043,966121,Dickinson; Alexandra Jazz,9999,0,9999,0
1748428244957,BGRD 200,044,966123,Dixon; Jesse,9999,0,9999,0
1748428244957,BGRD 200,045,966125,Doherty; Taylor Alan,9998,0,9999,1
1748428244957,BGRD 200,046,966128,Dore; Kim Bohemie,9999,0,9999,0
1748428244957,BGRD 200,047,966129,Dorrestein; Pieter,9999,0,9999,0
1748428244957,BGRD 200,048,966130,Dulawa; Stephanie Carole,9999,0,9999,0
1748428244957,BGRD 200,049,966131,Ecker; Joseph R,9999,0,9999,0
1748428244957,BGRD 200,050,966174,Engle; Dannielle D,9998,0,9999,1
1748428244957,BGRD 200,051,966179,Ernst; Andreas,9999,0,9999,0
1748428244957,BGRD 200,052,966182,Esko; Jeffrey D.,9999,0,9999,0
1748428244957,BGRD 200,053,966183,Fang; Xi,9999,0,9999,0
1748428244957,BGRD 200,054,966184,Farley; Emma Kristen,9998,0,9999,1
1748428244957,BGRD 200,055,966187,Ferguson; Cole John,9999,0,9999,0
1748428244957,BGRD 200,056,966190,Fisch; Kathleen Marie,9999,0,9999,0
1748428244957,BGRD 200,057,966193,Gage; Fred H,9999,0,9999,0
1748428244957,BGRD 200,058,966194,George; Monique Leana,9998,0,9999,1
1748428244957,BGRD 200,059,966196,George; Olivier,9999,0,9999,0
1748428244957,BGRD 200,060,966202,Ghosh; Pradipta,9998,0,9999,1
1748428244957,BGRD 200,061,966203,Glasgow; Stacey Marie,9999,0,9999,0
1748428244957,BGRD 200,062,966204,Glass; Christopher,9999,0,9999,0
1748428244957,BGRD 200,063,966226,Golden; James W,9999,0,9999,0
1748428244957,BGRD 200,064,966231,Goldrath; Ananda,9999,0,9999,0
1748428244957,BGRD 200,065,966232,Gonzalez Gamboa; Ivonne,9999,0,9999,0
1748428244957,BGRD 200,066,966233,Goren; Alon M,9999,0,9999,0
1748428244957,BGRD 200,067,966245,Guatelli; John C,9999,0,9999,0
1748428244957,BGRD 200,068,966247,Guma; Monica,9998,0,9999,1
1748428244957,BGRD 200,069,966253,Gustafsson; Asa Birgitta,9999,0,9999,0
1748428244957,BGRD 200,070,966255,Gutkind; Jorge Silvio,9998,0,9999,1
1748428244957,BGRD 200,071,966260,Hamdoun; Amr,9999,0,9999,0
1748428244957,BGRD 200,072,966262,Hampton; Randolph Y.,9998,0,9999,1
1748428244957,BGRD 200,073,966263,Hao; Nan,9999,0,9999,0
1748428244957,BGRD 200,074,966265,Hargreaves; Diana Clare,9997,0,9999,2
1748428244957,BGRD 200,075,966268,Hasty; Jeff M,9999,0,9999,0
1748428244957,BGRD 200,076,966270,Hollern; Daniel Patrick,9999,0,9999,0
1748428244957,BGRD 200,077,966271,Holway; David A.,9998,0,9999,1
1748428244957,BGRD 200,078,966272,Huffaker; Alisa,9999,0,9999,0
1748428244957,BGRD 200,079,966273,Hui; Enfu,9999,0,9999,0
1748428244957,BGRD 200,080,966275,Hwa; Terence T.,9999,0,9999,0
1748428244957,BGRD 200,081,966276,Jackrel; Sara,9998,0,9999,1
1748428244957,BGRD 200,082,966277,Jiang; Qingfei,9998,0,9999,1
1748428244957,BGRD 200,083,966281,Jin; Chunyu,9999,0,9999,0
1748428244957,BGRD 200,084,966283,Jin; Yishi,9999,0,9999,0
1748428244957,BGRD 200,085,966287,Joshi; Shweta,9999,0,9999,0
1748428244957,BGRD 200,086,966290,Ju; Won-Kyu,9998,0,9999,1
1748428244957,BGRD 200,087,966291,Jun; Suckjoon,9999,0,9999,0
1748428244957,BGRD 200,088,966292,Kadonaga; James T,9999,0,9999,0
1748428244957,BGRD 200,089,966293,Kaech; Susan Michelle,9999,0,9999,0
1748428244957,BGRD 200,090,966295,Kauffman; Alexander,9998,0,9999,1
1748428244957,BGRD 200,091,966301,Kendrick; Agnieszka Anasta,9999,0,9999,0
1748428244957,BGRD 200,092,966302,Kiger; Amy,9999,0,9999,0
1748428244957,BGRD 200,093,966314,Knight; Robin,9999,0,9999,0
1748428244957,BGRD 200,094,966315,Koloski; Miranda Jane,9998,0,9999,1
1748428244957,BGRD 200,095,966339,Komiyama; Takaki,9998,0,9999,1
1748428244957,BGRD 200,096,966351,Kosuri; Pallav,9999,0,9999,0
1748428244957,BGRD 200,097,966361,Kronenberg; Mitchell E.,9999,0,9999,0
1748428244957,BGRD 200,098,966374,Kryazhimskiy; Sergey A,9999,0,9999,0
1748428244957,BGRD 200,099,966377,Kufareva; Irina,9999,0,9999,0
1748428244957,BGRD 200,100,966380,Lee; Christopher Tingkuang,9999,0,9999,0
1748428244957,BGRD 200,101,966383,Lee; Kuo Fen,9999,0,9999,0
1748428244957,BGRD 200,102,966387,Lee; Yun Sok,9999,0,9999,0
1748428244957,BGRD 200,103,966397,Leutgeb; Jill K.,9999,0,9999,0
1748428244957,BGRD 200,104,966446,Leutgeb; Stefan,9998,0,9999,1
1748428244957,BGRD 200,105,966478,Lewis; Warren G.,9999,0,9999,0
1748428244957,BGRD 200,106,966490,Li; Willis Xiaowei,9998,0,9999,1
1748428244957,BGRD 200,107,966491,Lim; Byungkook,9998,0,9999,1
1748428244957,BGRD 200,108,966494,Lo; Stanley M.,9998,0,9999,1
1748428244957,BGRD 200,109,966499,Looger; Loren Lee,9998,0,9999,1
1748428244957,BGRD 200,110,966500,Lopez Ramirez; Miguel Alej,9999,0,9999,0
1748428244957,BGRD 200,111,966510,Lovett-Barron; Matthew Rod,9998,0,9999,1
1748428244957,BGRD 200,112,966513,Lu; Li-Fan,9998,0,9999,1
1748428244957,BGRD 200,113,966515,Lu; Pengzhe,9999,0,9999,0
1748428244957,BGRD 200,114,966522,Lykke-Andersen; Jens,9999,0,9999,0
1748428244957,BGRD 200,115,966526,Lyons; Deirdre Colleen,9999,0,9999,0
1748428244957,BGRD 200,116,966528,Lyumkis; Dmitry Evgenievich,9999,0,9999,0
1748428244957,BGRD 200,117,966531,Mandyam; Chitra,9999,0,9999,0
1748428244957,BGRD 200,118,966537,Manor; Uri,9999,0,9999,0
1748428244957,BGRD 200,119,966538,Mayfield; Stephen P.,9998,0,9999,1
1748428244957,BGRD 200,120,966539,McConville; Patrick James,9999,0,9999,0
1748428244957,BGRD 200,121,966546,Mertens; Jerome Stefan,9999,0,9999,0
1748428244957,BGRD 200,122,966586,Meyer; Justin Raymond,9999,0,9999,0
1748428244957,BGRD 200,123,966587,Morris; Gerald P,9999,0,9999,0
1748428244957,BGRD 200,124,966588,Mueller; Lena,9998,0,9999,1
1748428244957,BGRD 200,125,966590,Muroyama; Andrew David,9999,0,9999,0
1748428244957,BGRD 200,126,966591,Murre; Cornelis,9999,0,9999,0
1748428244957,BGRD 200,127,966593,Neal; Sonya E,9998,0,9999,1
1748428244957,BGRD 200,128,966594,Newton; Alexandra C.,9999,0,9999,0
1748428244957,BGRD 200,129,966596,Nieh; James Charles,9999,0,9999,0
1748428244957,BGRD 200,130,966597,Niwa; Maho,9999,0,9999,0
1748428244957,BGRD 200,131,966605,Nizet; Victor F.,9999,0,9999,0
1748428244957,BGRD 200,132,966606,Oegema; Karen,9999,0,9999,0
1748428244957,BGRD 200,133,966608,Panda; Satchidananda,9998,0,9999,1
1748428244957,BGRD 200,134,966610,Pantham; Priyadarshini,9999,0,9999,0
1748428244957,BGRD 200,135,966612,Parast; Mana,9999,0,9999,0
1748428244957,BGRD 200,136,966613,Pasquinelli; Amy,9999,0,9999,0
1748428244957,BGRD 200,137,966615,Pekkurnaz Banghart; Gulcin,9999,0,9999,0
1748428244957,BGRD 200,138,966639,Perry; Michael William,9998,0,9999,1
1748428244957,BGRD 200,139,966640,Pillus; Lorraine,9998,0,9999,1
1748428244957,BGRD 200,140,966654,Pogliano; Joseph,9999,0,9999,0
1748428244957,BGRD 200,141,966700,Pogliano; Kit J.,9999,0,9999,0
1748428244957,BGRD 200,142,966701,Pruneda-Paz; Jose L.,9999,0,9999,0
1748428244957,BGRD 200,143,966744,Raffatellu; Manuela,9999,0,9999,0
1748428244957,BGRD 200,144,966745,Ramanan; Deepshika,9998,0,9999,1
1748428244957,BGRD 200,145,966746,Rana; Tariq,9999,0,9999,0
1748428244957,BGRD 200,146,966747,Rao; Anjana,9999,0,9999,0
1748428244957,BGRD 200,147,966811,Raz; Eyal,9998,0,9999,1
1748428244957,BGRD 200,149,966817,Gaulton; Kyle J,9999,0,9999,0
1748428244957,BGRD 200,150,966824,Rennison; Diana,9999,0,9999,0
1748428244957,BGRD 200,151,966828,Reyes De Barboza; Nabora S,9999,0,9999,0
1748428244957,BGRD 200,152,966837,Rifkin; Scott,9998,0,9999,1
1748428244957,BGRD 200,153,966839,Risbrough; Victoria Blythe,9999,0,9999,0
1748428244957,BGRD 200,154,966846,Rivera; Fabian Chavez,9999,0,9999,0
1748428244957,BGRD 200,155,966851,Rohner; Patrick Thomas,9999,0,9999,0
1748428244957,BGRD 200,156,966859,Rose; Noah Hartmann,9999,0,9999,0
1748428244957,BGRD 200,157,966874,Rosenfeld; Michael G,9999,0,9999,0
1748428244957,BGRD 200,158,966882,Rouse; Gregory W.,9999,0,9999,0
1748428244957,BGRD 200,159,966885,Saier; Milton H.,9999,0,9999,0
1748428244957,BGRD 200,160,966923,Saltiel; Alan,9998,0,9999,1
1748428244957,BGRD 200,161,966926,Sanchez-Lopez; Elsa,9999,0,9999,0
1748428244957,BGRD 200,162,966927,Saphire; Erica Ollmann,9999,0,9999,0
1748428244957,BGRD 200,163,966931,Schenk; Simon,9999,0,9999,0
1748428244957,BGRD 200,164,966938,Schroeder; Julian I,9999,0,9999,0
1748428244957,BGRD 200,165,966966,Sebat; Lilia Mikhailovna,9999,0,9999,0
1748428244957,BGRD 200,166,966978,Sen; George L,9999,0,9999,0
1748428244957,BGRD 200,167,966981,Shah; Sameer B,9999,0,9999,0
1748428244957,BGRD 200,168,966982,Shaner; Nathan C.,9999,0,9999,0
1748428244957,BGRD 200,169,966983,Shao; Jianhua,9999,0,9999,0
1748428244957,BGRD 200,170,966984,Sharpee; Tatyana,9999,0,9999,0
1748428244957,BGRD 200,171,966985,Shaw; Reuben,9999,0,9999,0
1748428244957,BGRD 200,172,966986,Shurin; Jonathan,9997,0,9999,2
1748428244957,BGRD 200,173,966987,Sicklick; Jason Keith,9999,0,9999,0
1748428244957,BGRD 200,174,966988,Signer; Robert,9999,0,9999,0
1748428244957,BGRD 200,175,966989,Sigurdson; Christina,9999,0,9999,0
1748428244957,BGRD 200,176,966991,Simonson; Tatum Sasha Summ,9999,0,9999,0
1748428244957,BGRD 200,177,966992,Soncin; Francesca,9999,0,9999,0
1748428244957,BGRD 200,178,966993,Spitzer; Nicholas,9999,0,9999,0
1748428244957,BGRD 200,179,966994,Steinmetz; Nicole F,9999,0,9999,0
1748428244957,BGRD 200,180,966995,Su; Chih-Ying,9999,0,9999,0
1748428244957,BGRD 200,181,966996,Suel; Gurol Mehmet,9998,0,9999,1
1748428244957,BGRD 200,182,966997,Sun; Xin,9998,0,9999,1
1748428244957,BGRD 200,183,966998,Telese; Francesca,9998,0,9999,1
1748428244957,BGRD 200,184,966999,Towers; Christina Garlingt,9999,0,9999,0
1748428244957,BGRD 200,185,967000,Traver; David,9999,0,9999,0
1748428244957,BGRD 200,186,967001,Troemel; Emily Ruth,9998,0,9999,1
1748428244957,BGRD 200,187,967002,Tye; Kay M,9999,0,9999,0
1748428244957,BGRD 200,188,967003,Vijayanand; Pandurangan,9999,0,9999,0
1748428244957,BGRD 200,189,967004,Villa Rodriguez; Elizabeth,9999,0,9999,0
1748428244957,BGRD 200,190,967005,Wahlin; Karl Jonas,9997,0,9999,2
1748428244957,BGRD 200,191,967009,Wang; Shizhen,9999,0,9999,0
1748428244957,BGRD 200,192,967010,Wang; Jean Yin Jen,9999,0,9999,0
1748428244957,BGRD 200,193,967011,Webster; Nicholas J G,9999,0,9999,0
1748428244957,BGRD 200,194,967016,Weiskopf; Daniela,9998,0,9999,1
1748428244957,BGRD 200,195,967020,Welsbie; Derek,9999,0,9999,0
1748428244957,BGRD 200,196,967022,Wildonger; Jill Cathleen,9998,0,9999,1
1748428244957,BGRD 200,197,967027,Winzeler; Elizabeth A,9998,0,9999,1
1748428244957,BGRD 200,198,967029,Wodarz; Dominik Franz Xave,9999,0,9999,0
1748428244957,BGRD 200,199,967033,Yelon; Deborah,9998,0,9999,1
1748428244957,BGRD 200,200,967034,Yeo; Eugene Wei-Ming,9998,0,9999,1
1748428244957,BGRD 200,201,967040,Ying; Wei,9998,0,9999,1
1748428244957,BGRD 200,202,967052,Young; Jared W.,9999,0,9999,0
1748428244957,BGRD 200,203,967057,Zage; Peter,9999,0,9999,0
1748428244957,BGRD 200,204,967070,Zengler; Karsten B,9998,0,9999,1
1748428244957,BGRD 200,206,967081,Zhang; Jin,9999,0,9999,0
1748428244957,BGRD 200,207,967083,Zhao; Yunde,9999,0,9999,0
1748428244957,BGRD 200,208,967086,Zheng; Binhai,9999,0,9999,0
1748428244957,BGRD 200,209,967091,Zheng; Ye,9999,0,9999,0
1748428244957,BGRD 200,210,967093,Zhou; Huilin,9999,0,9999,0
1748428244957,BGRD 200,211,967095,Zou; Yimin,9998,0,9999,1
1748428244957,BGRD 200,212,967096,Zuniga; Elina I,9999,0,9999,0
1748428244957,BGRD 200,213,967978,Biering; Scott,9999,0,9999,0
1748428245988,BGSE 200,A00,943418,Tour; Ella & Petrie; Katherine Lynn,9999,0,9999,0
1748428247016,BGSE 205,A00,943419,Muroyama; Andrew David,46,0,50,4
1748428247016,BGSE 205,C00,943420,Russell; Alistair B,44,0,50,6
1748428247016,BGSE 205,D00,943421,Villa Rodriguez; Elizabeth,41,0,50,9
1748428247016,BGSE 205,E00,960271,Lim; Byungkook,45,0,50,5
1748428248044,BIBC 100,A01,959758,Flagg; Matthew Paul,0,0,38,38
1748428248044,BIBC 100,A02,959759,Flagg; Matthew Paul,0,0,38,38
1748428248044,BIBC 100,A03,959760,Flagg; Matthew Paul,0,0,38,38
1748428248044,BIBC 100,A04,959761,Flagg; Matthew Paul,0,0,36,36
1748428249080,BIBC 102,A01,959209,Pekkurnaz Banghart; Gulcin,0,0,34,34
1748428249080,BIBC 102,A02,959258,Pekkurnaz Banghart; Gulcin,0,0,34,34
1748428249080,BIBC 102,A03,959300,Pekkurnaz Banghart; Gulcin,0,0,35,35
1748428249080,BIBC 102,A04,959302,Pekkurnaz Banghart; Gulcin,0,0,34,34
1748428249080,BIBC 102,B01,959307,Pekkurnaz Banghart; Gulcin,0,0,34,34
1748428249080,BIBC 102,B02,959309,Pekkurnaz Banghart; Gulcin,0,0,34,34
1748428249080,BIBC 102,B03,959310,Pekkurnaz Banghart; Gulcin,0,0,33,33
1748428249080,BIBC 102,B04,959311,Pekkurnaz Banghart; Gulcin,0,0,34,34
1748428250119,BIBC 103,A01,942080,Grossman; Emily N,0,0,24,24
1748428250119,BIBC 103,A02,942081,Grossman; Emily N,0,0,24,24
1748428250119,BIBC 103,B01,942083,Grossman; Emily N,0,0,24,24
1748428250119,BIBC 103,B02,942129,Grossman; Emily N,0,0,24,24
1748428250119,BIBC 103,C01,942131,Burg; Michael,0,0,24,24
1748428250119,BIBC 103,C02,942152,Burg; Michael,0,0,24,24
1748428250119,BIBC 103,D01,942169,Burg; Michael,0,0,24,24
1748428250119,BIBC 103,D02,942170,Burg; Michael,0,0,24,24
1748428251157,BICD 100,A01,959831,Day; Christopher D,53,0,61,8
1748428251157,BICD 100,A02,959832,Day; Christopher D,49,0,61,12
1748428251157,BICD 100,A03,959833,Day; Christopher D,43,0,61,18
1748428251157,BICD 100,A04,959834,Day; Christopher D,57,0,61,4
1748428251157,BICD 100,B01,959749,McDonnell; Lisa Marie,0,0,61,61
1748428251157,BICD 100,B02,959750,McDonnell; Lisa Marie,0,0,61,61
1748428251157,BICD 100,B03,959751,McDonnell; Lisa Marie,0,0,61,61
1748428251157,BICD 100,B04,959752,McDonnell; Lisa Marie,37,0,61,24
1748428251157,BICD 100,C01,959835,Yelon; Deborah,0,0,61,61
1748428251157,BICD 100,C02,959836,Yelon; Deborah,54,0,61,7
1748428251157,BICD 100,C03,959837,Yelon; Deborah,61,0,61,0
1748428251157,BICD 100,C04,959838,Yelon; Deborah,57,0,61,4
1748428252184,BICD 110,A01,959312,Kiger; Amy,59,0,123,64
1748428252184,BICD 110,A02,959315,Kiger; Amy,94,0,122,28
1748428253216,BICD 130,A01,942207,Perry; Michael William,0,0,48,48
1748428253216,BICD 130,A02,942208,Perry; Michael William,37,0,48,11
1748428253216,BICD 130,A03,942209,Perry; Michael William,29,0,48,19
1748428253216,BICD 130,A04,942236,Perry; Michael William,19,0,48,29
1748428254246,BICD 140,A01,942372,Zuniga; Elina I,42,0,49,7
1748428254246,BICD 140,A02,942492,Zuniga; Elina I,45,0,49,4
1748428254246,BICD 140,A03,942493,Zuniga; Elina I,48,0,49,1
1748428254246,BICD 140,A04,942494,Zuniga; Elina I,46,0,49,3
1748428255275,BIEB 102,A01,942496,Butler; Shannon Rhey,182,0,248,66
1748428256302,BIEB 121,A00,942497,Holway; David A.,0,0,32,32
1748428256302,BIEB 121,B00,942498,Butler; Shannon Rhey,0,0,32,32
1748428257333,BIEB 141,A01,942500,Kryazhimskiy; Sergey A,23,0,40,17
1748428258360,BIEB 146,A01,942502,Petrie; Katherine Lynn,41,0,89,48
1748428258360,BIEB 146,A02,942503,Petrie; Katherine Lynn,0,0,88,88
1748428258360,BIEB 146,A03,942504,Petrie; Katherine Lynn,2,0,88,86
1748428258360,BIEB 146,A04,942505,Petrie; Katherine Lynn,21,0,89,68
1748428259388,BIEB 150,A01,942507,Rennison; Diana,28,0,41,13
1748428259388,BIEB 150,A02,942508,Rennison; Diana,32,0,41,9
1748428259388,BIEB 150,A03,942509,Rennison; Diana,36,0,41,5
1748428259388,BIEB 150,A04,942510,Rennison; Diana,6,0,40,34
1748428260416,BIEB 174,A01,942512,Cleland; Elsa Eleanor & Barton; Andrew David,9,0,41,32
1748428260416,BIEB 174,A02,942513,Cleland; Elsa Eleanor & Barton; Andrew David,37,0,41,4
1748428260416,BIEB 174,A03,942514,Cleland; Elsa Eleanor & Barton; Andrew David,35,0,41,6
1748428260416,BIEB 174,A04,942515,Cleland; Elsa Eleanor & Barton; Andrew David,30,0,40,10
1748428261449,BILD 1,A01,959729,Ochoa Mikrut; Stacy Daniel,50,0,60,10
1748428261449,BILD 1,A02,959730,Ochoa Mikrut; Stacy Daniel,46,0,59,13
1748428261449,BILD 1,A03,959731,Ochoa Mikrut; Stacy Daniel,48,0,59,11
1748428261449,BILD 1,A04,959732,Ochoa Mikrut; Stacy Daniel,50,0,59,9
1748428261449,BILD 1,B01,959733,Cooper; Andrew Michael,46,0,60,14
1748428261449,BILD 1,B02,959734,Cooper; Andrew Michael,58,0,59,1
1748428261449,BILD 1,B03,959735,Cooper; Andrew Michael,54,0,59,5
1748428261449,BILD 1,B04,959736,Cooper; Andrew Michael,50,0,59,9
1748428261449,BILD 1,C01,959737,Rusert; Jessica Marie,58,0,60,2
1748428261449,BILD 1,C02,959738,Rusert; Jessica Marie,59,0,59,0
1748428261449,BILD 1,C03,959739,Rusert; Jessica Marie,49,0,59,10
1748428261449,BILD 1,C04,959740,Rusert; Jessica Marie,55,0,59,4
1748428262494,BILD 2,A01,959013,Reyes Gonzalez; Catalina,28,0,57,29
1748428262494,BILD 2,A02,959016,Reyes Gonzalez; Catalina,51,0,57,6
1748428262494,BILD 2,A03,959017,Reyes Gonzalez; Catalina,46,0,56,10
1748428262494,BILD 2,A04,959018,Reyes Gonzalez; Catalina,51,0,55,4
1748428262494,BILD 2,B01,959078,Reyes Gonzalez; Catalina,42,0,57,15
1748428262494,BILD 2,B02,959095,Reyes Gonzalez; Catalina,50,0,57,7
1748428262494,BILD 2,B03,959165,Reyes Gonzalez; Catalina,55,0,56,1
1748428262494,BILD 2,B04,959169,Reyes Gonzalez; Catalina,54,0,55,1
1748428263533,BILD 3,A01,959741,Stockwell; Sarah R,56,0,60,4
1748428263533,BILD 3,A02,959742,Stockwell; Sarah R,57,0,59,2
1748428263533,BILD 3,A03,959743,Stockwell; Sarah R,59,0,59,0
1748428263533,BILD 3,A04,959744,Stockwell; Sarah R,55,0,59,4
1748428263533,BILD 3,B01,959745,Stockwell; Sarah R,55,0,60,5
1748428263533,BILD 3,B02,959746,Stockwell; Sarah R,59,0,59,0
1748428263533,BILD 3,B03,959747,Stockwell; Sarah R,56,0,59,3
1748428263533,BILD 3,B04,959748,Stockwell; Sarah R,58,0,59,1
1748428263533,BILD 3,C01,959823,Hammond; LaTisha Marie,47,0,60,13
1748428263533,BILD 3,C02,959824,Hammond; LaTisha Marie,48,0,59,11
1748428263533,BILD 3,C03,959825,Hammond; LaTisha Marie,56,0,59,3
1748428263533,BILD 3,C04,959826,Hammond; LaTisha Marie,58,0,59,1
1748428263533,BILD 3,D01,959827,Hammond; LaTisha Marie,43,0,60,17
1748428263533,BILD 3,D02,959828,Hammond; LaTisha Marie,49,0,59,10
1748428263533,BILD 3,D03,959829,Hammond; LaTisha Marie,52,0,59,7
1748428263533,BILD 3,D04,959830,Hammond; LaTisha Marie,56,0,59,3
1748428264574,BILD 4,A01,940749,Gonzalez Gamboa; Ivonne,0,0,0,0
1748428264574,BILD 4,A02,940750,Gonzalez Gamboa; Ivonne,0,0,0,0
1748428264574,BILD 4,A03,940909,Gonzalez Gamboa; Ivonne,0,0,0,0
1748428264574,BILD 4,A04,940922,Gonzalez Gamboa; Ivonne,0,0,0,0
1748428264574,BILD 4,A05,940925,Gonzalez Gamboa; Ivonne,0,0,0,0
1748428264574,BILD 4,A06,941008,Gonzalez Gamboa; Ivonne,0,0,0,0
1748428264574,BILD 4,A07,941009,Gonzalez Gamboa; Ivonne,0,0,0,0
1748428264574,BILD 4,A08,941114,Gonzalez Gamboa; Ivonne,0,0,0,0
1748428264574,BILD 4,B01,941116,Reuther; Keefe,0,0,0,0
1748428264574,BILD 4,B02,941119,Reuther; Keefe,0,0,0,0
1748428264574,BILD 4,B03,941120,Reuther; Keefe,0,0,0,0
1748428264574,BILD 4,B04,941143,Reuther; Keefe,0,0,0,0
1748428264574,BILD 4,B05,941182,Reuther; Keefe,0,0,0,0
1748428264574,BILD 4,B06,941183,Reuther; Keefe,0,0,0,0
1748428264574,BILD 4,B07,941184,Reuther; Keefe,0,0,0,0
1748428264574,BILD 4,B08,941202,Reuther; Keefe,0,0,0,0
1748428264574,BILD 4,C01,941209,Lo; Stanley M.,0,0,0,0
1748428264574,BILD 4,C02,941226,Lo; Stanley M.,0,0,0,0
1748428264574,BILD 4,C03,941228,Lo; Stanley M.,0,0,0,0
1748428264574,BILD 4,C04,941284,Lo; Stanley M.,0,0,0,0
1748428264574,BILD 4,C05,941394,Lo; Stanley M.,0,0,0,0
1748428264574,BILD 4,C06,941473,Lo; Stanley M.,0,0,0,0
1748428264574,BILD 4,C07,941905,Lo; Stanley M.,0,0,0,0
1748428264574,BILD 4,C08,941906,Lo; Stanley M.,0,0,0,0
1748428264574,BILD 4,D01,941908,Lo; Stanley M.,0,0,0,0
1748428264574,BILD 4,D02,941925,Lo; Stanley M.,0,0,0,0
1748428264574,BILD 4,D03,941926,Lo; Stanley M.,0,0,0,0
1748428264574,BILD 4,D04,941927,Lo; Stanley M.,0,0,0,0
1748428264574,BILD 4,D05,941928,Lo; Stanley M.,0,0,0,0
1748428264574,BILD 4,D06,941943,Lo; Stanley M.,0,0,0,0
1748428264574,BILD 4,D07,941944,Lo; Stanley M.,0,0,0,0
1748428264574,BILD 4,D08,941973,Lo; Stanley M.,0,0,0,0
1748428265602,BILD 5,A01,959177,Mueller; Liam O'Connor,0,0,0,0
1748428265602,BILD 5,A02,959178,Mueller; Liam O'Connor,0,0,0,0
1748428265602,BILD 5,A03,959179,Mueller; Liam O'Connor,0,0,0,0
1748428265602,BILD 5,A04,959181,Mueller; Liam O'Connor,0,0,0,0
1748428265602,BILD 5,B01,959183,Mueller; Liam O'Connor,0,0,0,0
1748428265602,BILD 5,B02,959184,Mueller; Liam O'Connor,0,0,0,0
1748428265602,BILD 5,B03,959188,Mueller; Liam O'Connor,0,0,0,0
1748428265602,BILD 5,B04,959189,Mueller; Liam O'Connor,0,0,0,0
1748428265602,BILD 5,C01,959190,Reuther; Keefe,0,0,0,0
1748428265602,BILD 5,C02,959191,Reuther; Keefe,0,0,0,0
1748428265602,BILD 5,C03,959196,Reuther; Keefe,0,0,0,0
1748428265602,BILD 5,C04,959199,Reuther; Keefe,0,0,0,0
1748428266629,BILD 10,A01,942020,Ochoa Mikrut; Stacy Daniel,40,0,40,0
1748428266629,BILD 10,A02,942033,Ochoa Mikrut; Stacy Daniel,35,0,39,4
1748428266629,BILD 10,A03,942045,Ochoa Mikrut; Stacy Daniel,32,0,39,7
1748428266629,BILD 10,A04,942046,Ochoa Mikrut; Stacy Daniel,30,0,39,9
1748428267661,BILD 87,A00,942047,Saier; Milton H.,20,0,20,0
1748428267661,BILD 87,B00,942060,Saier; Milton H.,20,0,20,0
1748428268691,BIMM 100,A01,959797,Lykke-Andersen; Jens,37,0,50,13
1748428268691,BIMM 100,A02,959798,Lykke-Andersen; Jens,5,0,50,45
1748428268691,BIMM 100,A03,959799,Lykke-Andersen; Jens,0,0,50,50
1748428268691,BIMM 100,A04,959800,Lykke-Andersen; Jens,3,0,50,47
1748428268691,BIMM 100,B01,959807,Pruneda-Paz; Jose L.,1,0,50,49
1748428268691,BIMM 100,B02,959808,Pruneda-Paz; Jose L.,0,0,50,50
1748428268691,BIMM 100,B03,959809,Pruneda-Paz; Jose L.,7,0,50,43
1748428268691,BIMM 100,B04,959810,Pruneda-Paz; Jose L.,37,0,50,13
1748428268691,BIMM 100,C01,959762,Pasquinelli; Amy,0,0,54,54
1748428268691,BIMM 100,C02,959763,Pasquinelli; Amy,20,0,54,34
1748428268691,BIMM 100,C03,959764,Pasquinelli; Amy,32,0,54,22
1748428268691,BIMM 100,C04,959765,Pasquinelli; Amy,47,0,54,7
1748428269722,BIMM 101,A01,942520,Meaders; Clara Leigh,0,0,24,24
1748428269722,BIMM 101,A02,942521,Meaders; Clara Leigh,0,0,24,24
1748428269722,BIMM 101,B01,942523,Meaders; Clara Leigh,0,0,24,24
1748428269722,BIMM 101,B02,942524,Meaders; Clara Leigh,0,0,24,24
1748428269722,BIMM 101,C01,942690,McDonnell; Lisa Marie,0,0,24,24
1748428269722,BIMM 101,C02,942755,McDonnell; Lisa Marie,0,0,24,24
1748428269722,BIMM 101,D01,942757,Day; Christopher D,0,0,24,24
1748428269722,BIMM 101,D02,942758,Day; Christopher D,12,0,24,12
1748428269722,BIMM 101,E01,942760,Cooper; Andrew Michael,0,0,24,24
1748428269722,BIMM 101,E02,942761,Cooper; Andrew Michael,0,0,24,24
1748428269722,BIMM 101,F01,942763,Rusert; Jessica Marie,14,0,24,10
1748428269722,BIMM 101,F02,942764,Rusert; Jessica Marie,19,0,24,5
1748428270754,BIMM 120,A01,942766,Saier; Milton H.,40,0,48,8
1748428270754,BIMM 120,A02,942767,Saier; Milton H.,40,0,48,8
1748428270754,BIMM 120,A03,942768,Saier; Milton H.,15,0,48,33
1748428270754,BIMM 120,A04,942769,Saier; Milton H.,0,0,48,48
1748428271784,BIMM 121,A01,942771,Gustafson-Brown; Cindy,0,0,24,24
1748428271784,BIMM 121,A02,942772,Gustafson-Brown; Cindy,0,0,24,24
1748428271784,BIMM 121,B01,942774,Gustafson-Brown; Cindy,0,0,24,24
1748428271784,BIMM 121,B02,942775,Gustafson-Brown; Cindy,5,0,24,19
1748428271784,BIMM 121,C01,942777,Pirino; Giorgia,0,0,24,24
1748428271784,BIMM 121,C02,942778,Pirino; Giorgia,0,0,24,24
1748428271784,BIMM 121,D01,942780,Pirino; Giorgia,0,0,24,24
1748428271784,BIMM 121,D02,942781,Pirino; Giorgia,0,0,24,24
1748428272815,BIMM 122,A01,942783,Russell; Alistair B,19,0,44,25
1748428272815,BIMM 122,A02,942784,Russell; Alistair B,29,0,44,15
1748428272815,BIMM 122,A03,942785,Russell; Alistair B,35,0,44,9
1748428272815,BIMM 122,A04,942786,Russell; Alistair B,30,0,44,14
1748428273842,BIMM 128,A01,942788,Hao; Nan,0,0,30,30
1748428273842,BIMM 128,A02,942789,Hao; Nan,0,0,31,31
1748428273842,BIMM 128,A03,942790,Hao; Nan,0,0,31,31
1748428273842,BIMM 128,A04,942791,Hao; Nan,0,0,31,31
1748428274869,BIMM 143,A01,942793,Grant; Barry J,13,0,40,27
1748428274869,BIMM 143,B01,942795,Bozinovic; Goran,21,0,40,19
1748428275897,BIMM 143R,A01,942797,Bozinovic; Goran,0,0,40,40
1748428276931,BIMM 194,A00,942798,Golden; Susan S.,5,0,32,27
1748428276931,BIMM 194,B00,942799,Golden; James W,21,0,32,11
1748428276931,BIMM 194,C00,942800,Karlseder; Jan & Saghatelian; Alan,0,0,32,32
1748428277960,BIOM 200A,A00,911746,Gordts; Philip,30,0,30,0
1748428278984,BIOM 200B,A00,911747,Gordts; Philip,35,0,35,0
1748428280009,BIOM 201,A00,911749,Daneman; Richard,35,0,35,0
1748428281036,BIOM 202,A01,911753,Corbett; Kevin Daniel,35,0,35,0
1748428282065,BIOM 203A,A00,911755,Corbett; Kevin Daniel,35,0,35,0
1748428283092,BIOM 218,A00,911756,Gagneux; Pascal,11,0,12,1
1748428284121,BIOM 219,A00,911757,Ross; Camille,20,0,20,0
1748428285149,BIOM 242,A00,911758,Hamilton; Bruce Alan,19,0,20,1
1748428286176,BIOM 293,A00,911759,Gustafsson; Asa Birgitta,35,0,35,0
1748428287205,BIOM 295,A00,911760,Joiner; William J.,0,0,0,0
1748428288230,BIOM 296,A00,911761,Yaksh; Tony L.,35,0,35,0
1748428289258,BIPN 100,A01,959801,Leutgeb; Stefan,0,0,36,36
1748428289258,BIPN 100,A02,959802,Leutgeb; Stefan,0,0,36,36
1748428289258,BIPN 100,A03,959803,Leutgeb; Stefan,3,0,36,33
1748428289258,BIPN 100,A04,959804,Leutgeb; Stefan,0,0,36,36
1748428289258,BIPN 100,B01,959766,Cooke; James Edward,33,0,41,8
1748428289258,BIPN 100,B02,959767,Cooke; James Edward,39,0,41,2
1748428289258,BIPN 100,B03,959768,Cooke; James Edward,37,0,40,3
1748428289258,BIPN 100,B04,959769,Cooke; James Edward,37,0,40,3
1748428289258,BIPN 100,C01,959770,Cooke; James Edward,35,0,41,6
1748428289258,BIPN 100,C02,959771,Cooke; James Edward,40,0,41,1
1748428289258,BIPN 100,C03,959772,Cooke; James Edward,37,0,40,3
1748428289258,BIPN 100,C04,959773,Cooke; James Edward,38,0,40,2
1748428289258,BIPN 100,D01,959811,Yang; Mingyu,0,0,41,41
1748428289258,BIPN 100,D02,959812,Yang; Mingyu,0,0,41,41
1748428289258,BIPN 100,D03,959813,Yang; Mingyu,0,0,40,40
1748428289258,BIPN 100,D04,959814,Yang; Mingyu,0,0,40,40
1748428290284,BIPN 103,A01,942981,Yang; Mingyu,0,0,48,48
1748428291316,BIPN 105,A01,942983,Armour; Jon Christopher,0,0,21,21
1748428291316,BIPN 105,A02,942984,Armour; Jon Christopher,0,0,21,21
1748428291316,BIPN 105,B01,942989,Armour; Jon Christopher,0,0,21,21
1748428291316,BIPN 105,B02,942990,Armour; Jon Christopher,0,0,21,21
1748428292349,BIPN 118,A01,960886,Banghart; Matthew Ryan,23,0,30,7
1748428292349,BIPN 118,A02,960889,Banghart; Matthew Ryan,24,0,30,6
1748428292349,BIPN 118,A03,960891,Banghart; Matthew Ryan,23,0,30,7
1748428292349,BIPN 118,A04,960892,Banghart; Matthew Ryan,27,0,30,3
1748428293377,BIPN 140,A01,942992,Owens; Melinda Tsao-Ying,8,0,32,24
1748428293377,BIPN 140,A02,942994,Owens; Melinda Tsao-Ying,0,0,32,32
1748428293377,BIPN 140,A03,942995,Owens; Melinda Tsao-Ying,1,0,32,31
1748428293377,BIPN 140,A04,942996,Owens; Melinda Tsao-Ying,9,0,30,21
1748428293377,BIPN 140,B01,942998,Owens; Melinda Tsao-Ying,4,0,32,28
1748428293377,BIPN 140,B02,942999,Owens; Melinda Tsao-Ying,3,0,32,29
1748428293377,BIPN 140,B03,943000,Owens; Melinda Tsao-Ying,18,0,32,14
1748428293377,BIPN 140,B04,943001,Owens; Melinda Tsao-Ying,23,0,30,7
1748428294413,BIPN 145,A01,943083,Maita; Isabella Vincenza,0,0,42,42
1748428294413,BIPN 145,B01,943085,Marino; Marc J,13,0,42,29
1748428294413,BIPN 145,C01,943108,Marino; Marc J,0,0,42,42
1748428295440,BIPN 148,A01,943119,Leutgeb; Jill K.,15,0,39,24
1748428295440,BIPN 148,A02,943120,Leutgeb; Jill K.,16,0,39,23
1748428295440,BIPN 148,A03,943121,Leutgeb; Jill K.,33,0,39,6
1748428295440,BIPN 148,A04,943201,Leutgeb; Jill K.,27,0,39,12
1748428296472,BIPN 189,A00,943247,Gentner; Tim,0,0,25,25
1748428297497,BISP 182,A00,943255,Pogliano; Joseph,9999,0,9999,0
1748428298529,BISP 194,A00,943261,Wertheim; Joel Okrent,0,0,32,32
1748428299628,BNFO 281,A00,961454,Gaasterland; Theresa,13,0,40,27
1748428300654,BNFO 283,A00,961457,Benner; Christopher William,69,0,100,31
1748428301684,BNFO 294,A01,961499,Ross; Camille,39,0,50,11
1748428302723,CAT 1,A01,915666,Bronstein; Phoebe Malan,13,0,16,3
1748428302723,CAT 1,A02,915673,Bronstein; Phoebe Malan,15,0,16,1
1748428302723,CAT 1,A03,915727,Bronstein; Phoebe Malan,16,0,16,0
1748428302723,CAT 1,A04,915728,Bronstein; Phoebe Malan,16,0,16,0
1748428302723,CAT 1,A05,915729,Bronstein; Phoebe Malan,16,0,16,0
1748428302723,CAT 1,A06,915730,Bronstein; Phoebe Malan,13,0,16,3
1748428302723,CAT 1,A07,915731,Bronstein; Phoebe Malan,16,0,16,0
1748428302723,CAT 1,A08,915732,Bronstein; Phoebe Malan,16,0,16,0
1748428302723,CAT 1,A09,915733,Bronstein; Phoebe Malan,14,0,16,2
1748428302723,CAT 1,A10,915734,Bronstein; Phoebe Malan,16,0,16,0
1748428302723,CAT 1,A11,915751,Bronstein; Phoebe Malan,16,0,16,0
1748428302723,CAT 1,A12,915752,Bronstein; Phoebe Malan,15,0,16,1
1748428302723,CAT 1,A13,915753,Bronstein; Phoebe Malan,15,0,16,1
1748428302723,CAT 1,A14,915754,Bronstein; Phoebe Malan,16,0,16,0
1748428302723,CAT 1,A15,915755,Bronstein; Phoebe Malan,16,0,16,0
1748428302723,CAT 1,A16,915756,Bronstein; Phoebe Malan,16,0,16,0
1748428302723,CAT 1,B01,915763,Bronstein; Phoebe Malan,15,0,16,1
1748428302723,CAT 1,B02,915764,Bronstein; Phoebe Malan,15,0,16,1
1748428302723,CAT 1,B03,915765,Bronstein; Phoebe Malan,14,0,16,2
1748428302723,CAT 1,B04,915766,Bronstein; Phoebe Malan,16,0,16,0
1748428302723,CAT 1,B05,915767,Bronstein; Phoebe Malan,12,0,16,4
1748428302723,CAT 1,B06,915768,Bronstein; Phoebe Malan,16,0,16,0
1748428302723,CAT 1,B07,915769,Bronstein; Phoebe Malan,16,0,16,0
1748428302723,CAT 1,B08,915770,Bronstein; Phoebe Malan,16,0,16,0
1748428302723,CAT 1,B09,915771,Bronstein; Phoebe Malan,16,0,16,0
1748428302723,CAT 1,B10,915772,Bronstein; Phoebe Malan,16,0,16,0
1748428302723,CAT 1,B11,915773,Bronstein; Phoebe Malan,16,0,16,0
1748428302723,CAT 1,B12,915774,Bronstein; Phoebe Malan,15,0,16,1
1748428302723,CAT 1,B13,915775,Bronstein; Phoebe Malan,16,0,16,0
1748428302723,CAT 1,B14,915776,Bronstein; Phoebe Malan,15,0,16,1
1748428302723,CAT 1,B15,915777,Bronstein; Phoebe Malan,14,0,16,2
1748428302723,CAT 1,B16,915778,Bronstein; Phoebe Malan,16,0,16,0
1748428302723,CAT 1,C01,915780,Algaze; Guillermo,11,0,16,5
1748428302723,CAT 1,C02,915781,Algaze; Guillermo,16,0,16,0
1748428302723,CAT 1,C03,915782,Algaze; Guillermo,15,0,16,1
1748428302723,CAT 1,C04,915783,Algaze; Guillermo,16,0,16,0
1748428302723,CAT 1,C05,915784,Algaze; Guillermo,16,0,16,0
1748428302723,CAT 1,C06,915785,Algaze; Guillermo,16,0,16,0
1748428302723,CAT 1,C07,915786,Algaze; Guillermo,16,0,16,0
1748428302723,CAT 1,C08,915787,Algaze; Guillermo,15,0,16,1
1748428302723,CAT 1,C09,915788,Algaze; Guillermo,16,0,16,0
1748428302723,CAT 1,C10,915790,Algaze; Guillermo,16,0,16,0
1748428302723,CAT 1,C11,915791,Algaze; Guillermo,16,0,16,0
1748428302723,CAT 1,C12,915792,Algaze; Guillermo,16,0,16,0
1748428302723,CAT 1,C13,915793,Algaze; Guillermo,16,0,16,0
1748428302723,CAT 1,C14,915794,Algaze; Guillermo,16,0,16,0
1748428302723,CAT 1,D01,915796,Marchisotto; Jennifer Anne,16,0,16,0
1748428302723,CAT 1,D02,915797,Marchisotto; Jennifer Anne,15,0,16,1
1748428302723,CAT 1,D03,915798,Marchisotto; Jennifer Anne,16,0,16,0
1748428302723,CAT 1,D04,915799,Marchisotto; Jennifer Anne,12,0,16,4
1748428302723,CAT 1,D05,915800,Marchisotto; Jennifer Anne,16,0,16,0
1748428302723,CAT 1,D06,915801,Marchisotto; Jennifer Anne,16,0,16,0
1748428302723,CAT 1,D07,915802,Marchisotto; Jennifer Anne,15,0,16,1
1748428302723,CAT 1,D08,915803,Marchisotto; Jennifer Anne,16,0,16,0
1748428302723,CAT 1,D09,915804,Marchisotto; Jennifer Anne,16,0,16,0
1748428302723,CAT 1,D10,915805,Marchisotto; Jennifer Anne,16,0,16,0
1748428302723,CAT 1,D11,915806,Marchisotto; Jennifer Anne,15,0,16,1
1748428302723,CAT 1,D12,915807,Marchisotto; Jennifer Anne,16,0,16,0
1748428302723,CAT 1,D13,915808,Marchisotto; Jennifer Anne,15,0,16,1
1748428302723,CAT 1,D14,915809,Marchisotto; Jennifer Anne,15,0,16,1
1748428303749,CAT 88,A00,969796,Popko; Elizabeth Ashley,0,0,0,0
1748428304776,CAT 90,A00,915812,Geibel; William,7,0,15,8
1748428305803,CAT 124,A01,915814,Rose; Becca Rae,0,0,20,20
1748428305803,CAT 124,B01,961453,Geibel; William,14,0,20,6
1748428306844,CAT 125,001,915815,Delaville; Romain,18,0,20,2
1748428306844,CAT 125,003,915817,Bigham; David Joseph,12,0,20,8
1748428306844,CAT 125,004,915818,Bigham; David Joseph,3,0,20,17
1748428306844,CAT 125,005,915819,Marchisotto; Jennifer Anne,11,0,20,9
1748428306844,CAT 125,006,915820,Marchisotto; Jennifer Anne,0,0,20,20
1748428306844,CAT 125,007,915821,Morales; Celeste Georgianna,12,0,20,8
1748428306844,CAT 125,008,915822,Morales; Celeste Georgianna,15,0,20,5
1748428306844,CAT 125,009,915823,Morales; Celeste Georgianna,18,0,20,2
1748428306844,CAT 125,010,915824,Irwin; Matthew Joseph,18,0,20,2
1748428306844,CAT 125,011,915825,Irwin; Matthew Joseph,15,0,20,5
1748428306844,CAT 125,012,915826,Irwin; Matthew Joseph,15,0,20,5
1748428306844,CAT 125,013,915827,Vanderschuit; Maya Alysia,16,0,20,4
1748428306844,CAT 125,014,915828,Vanderschuit; Maya Alysia,18,0,20,2
1748428306844,CAT 125,015,915829,Vanderschuit; Maya Alysia,15,0,20,5
1748428306844,CAT 125,016,915830,Rose; Becca Rae,5,0,20,15
1748428306844,CAT 125,017,915831,Rose; Becca Rae,4,0,20,16
1748428306844,CAT 125,018,915832,Hyland; Tina Mae,13,0,20,7
1748428306844,CAT 125,019,915833,Hyland; Tina Mae,17,0,20,3
1748428307872,CAT 125R,A00,915834,Hyland; Tina Mae,0,0,20,20
1748428307872,CAT 125R,B00,915835,Hyland; Tina Mae,0,0,20,20
1748428307872,CAT 125R,C00,915836,Hyland; Tina Mae,0,0,20,20
1748428307872,CAT 125R,D00,915837,Tosun; Adriana,0,0,20,20
1748428307872,CAT 125R,E00,915838,Smith; Lauryn Alissa,0,0,20,20
1748428307872,CAT 125R,F00,915839,Smith; Lauryn Alissa,0,0,20,20
1748428307872,CAT 125R,G00,915840,Smith; Lauryn Alissa,0,0,20,20
1748428308900,CAT 200,A00,915841,Popko; Elizabeth Ashley,17,0,20,3
1748428309929,CCE 1,A00,915063,Bigley; Michele Heather,30,0,40,10
1748428309929,CCE 1,B00,915064,Bigley; Michele Heather,36,0,40,4
1748428310978,CCE 2,001,915067,Santos; Vabianna Daria,0,0,20,20
1748428310978,CCE 2,002,915068,Santos; Vabianna Daria,0,0,20,20
1748428310978,CCE 2,003,915069,Santos; Vabianna Daria,18,0,20,2
1748428310978,CCE 2,004,915070,Staff,17,0,20,3
1748428310978,CCE 2,005,915071,Staff,15,0,20,5
1748428310978,CCE 2,006,915072,Staff,8,0,20,12
1748428310978,CCE 2,007,915073,Staff,10,0,20,10
1748428310978,CCE 2,008,915074,Staff,0,0,20,20
1748428310978,CCE 2,009,915090,Staff,5,0,20,15
1748428310978,CCE 2,010,915104,Merryman; Ashley,0,0,20,20
1748428310978,CCE 2,011,915114,Merryman; Ashley,0,0,20,20
1748428310978,CCE 2,012,915136,Merryman; Ashley,0,0,20,20
1748428310978,CCE 2,013,915176,Staff,13,0,20,7
1748428310978,CCE 2,014,915177,Staff,20,0,20,0
1748428310978,CCE 2,015,915178,Staff,17,0,20,3
1748428310978,CCE 2,016,915179,Staff,15,0,20,5
1748428312008,CCE 3,001,915194,Labat Ii; Michael Luis,13,0,20,7
1748428312008,CCE 3,002,915195,Labat Ii; Michael Luis,17,0,20,3
1748428312008,CCE 3,003,915196,Labat Ii; Michael Luis,17,0,20,3
1748428312008,CCE 3,004,915197,Lee; Kassandra,16,0,20,4
1748428312008,CCE 3,005,915198,Lee; Kassandra,6,0,20,14
1748428312008,CCE 3,006,915199,Lee; Kassandra,10,0,20,10
1748428312008,CCE 3,007,915200,Garcia; Kathryn Mary,0,0,20,20
1748428312008,CCE 3,008,915201,Garcia; Kathryn Mary,2,0,20,18
1748428313040,CCE 120,A01,915203,Quijada; David,26,0,30,4
1748428313040,CCE 120,B01,915205,Quijada; David,17,0,30,13
1748428313040,CCE 120,C01,915207,Williams; Danielle,21,0,30,9
1748428313040,CCE 120,D01,915275,Crawford; James,26,0,30,4
1748428313040,CCE 120,E01,915323,Kenley; Nicole,0,0,30,30
1748428313040,CCE 120,F01,915325,Kenley; Nicole,5,0,30,25
1748428314069,CENG 4,A01,913054,Li; Yanran,35,0,36,1
1748428314069,CENG 4,A02,913055,Li; Yanran,36,0,36,0
1748428314069,CENG 4,A03,913058,Li; Yanran,36,0,36,0
1748428314069,CENG 4,A04,913060,Li; Yanran,36,0,36,0
1748428315097,CENG 15,A01,913087,Lubarda; Vlado,69,0,70,1
1748428316127,CENG 100,A00,913088,Powell; Alyssa,108,0,120,12
1748428317161,CENG 101A,A00,913089,Opatkiewicz; Justin Paul,107,0,146,39
1748428318187,CENG 110,A01,913091,Powell; Alyssa,15,0,24,9
1748428319214,CENG 120,A00,913092,Opatkiewicz; Justin Paul,96,0,146,50
1748428320240,CENG 122,A00,913093,Li; Wan-Lu,120,0,140,20
1748428321268,CENG 170,A01,913196,Drews; Aaron,7,0,25,18
1748428321268,CENG 170,A02,913202,Drews; Aaron,4,0,25,21
1748428321268,CENG 170,A03,913204,Drews; Aaron,5,0,30,25
1748428322295,CENG 175,A00,913205,Steinmetz; Nicole F,14,0,35,21
1748428323324,CENG 205,A00,913207,Jahed Motlagh; Zeinab,54,0,70,16
1748428324354,CENG 210A,A00,913209,Shah; Nisarg,50,0,50,0
1748428325380,CENG 211,A00,913211,Sirbuly; Donald,23,0,25,2
1748428326411,CENG 213,A00,913213,Fenning; David,25,0,25,0
1748428327440,CENG 221A,A00,913214,Liu; Ping,38,0,50,12
1748428328466,CENG 252,A00,913215,Chen; Zheng,42,0,50,8
1748428329494,CGS 2A,A01,915347,Martin Sandino; Amanda Maria Yoland,11,0,15,4
1748428329494,CGS 2A,A02,915348,Martin Sandino; Amanda Maria Yoland,12,0,15,3
1748428329494,CGS 2A,A03,915375,Martin Sandino; Amanda Maria Yoland,11,0,15,4
1748428329494,CGS 2A,A04,915376,Martin Sandino; Amanda Maria Yoland,15,0,15,0
1748428330520,CGS 100A,A00,915379,Perez; Roy,16,0,31,15
1748428331547,CGS 109,A00,915458,Cuong; Marisol,36,0,40,4
1748428332575,CGS 110,A00,915463,Cuong; Marisol,27,0,30,3
1748428333601,CGS 113,A00,915465,Martin Sandino; Amanda Maria Yoland,8,0,16,8
1748428334635,CGS 134,A00,915498,Chatti; Deepti,17,0,32,15
1748428335666,CGS 150,A00,915508,Taylor-Garcia; Daphne,13,0,16,3
1748428336692,CGS 187,A00,915515,Martin Sandino; Amanda Maria Yoland,13,0,16,3
1748428337722,CGS 190,A00,915516,Taylor-Garcia; Daphne,7,0,7,0
1748428338751,CGS 208,A00,915517,Kang; Byung Chu,1,0,1,0
1748428339792,CHEM 4,A01,958051,Brydges; Stacey,39,0,40,1
1748428339792,CHEM 4,A02,958052,Brydges; Stacey,38,0,40,2
1748428339792,CHEM 4,A03,958053,Brydges; Stacey,37,0,40,3
1748428339792,CHEM 4,A04,958054,Brydges; Stacey,39,0,40,1
1748428339792,CHEM 4,A05,958055,Brydges; Stacey,40,0,40,0
1748428339792,CHEM 4,A06,958056,Brydges; Stacey,38,0,40,2
1748428339792,CHEM 4,A07,958057,Brydges; Stacey,40,0,40,0
1748428339792,CHEM 4,A08,958058,Brydges; Stacey,40,0,40,0
1748428339792,CHEM 4,B01,958059,Brydges; Stacey,40,0,40,0
1748428339792,CHEM 4,B02,958060,Brydges; Stacey,40,0,40,0
1748428339792,CHEM 4,B03,958061,Brydges; Stacey,40,0,40,0
1748428339792,CHEM 4,B04,958062,Brydges; Stacey,36,0,40,4
1748428339792,CHEM 4,B05,958063,Brydges; Stacey,38,0,40,2
1748428339792,CHEM 4,B06,958064,Brydges; Stacey,39,0,40,1
1748428339792,CHEM 4,B07,958065,Brydges; Stacey,40,0,40,0
1748428339792,CHEM 4,B08,958066,Brydges; Stacey,40,0,40,0
1748428340829,CHEM 6A,A01,958094,Stallings; Dontarie M,5,0,8,3
1748428340829,CHEM 6A,A02,958095,Stallings; Dontarie M,4,0,8,4
1748428340829,CHEM 6A,A03,958096,Stallings; Dontarie M,7,0,8,1
1748428340829,CHEM 6A,A04,958097,Stallings; Dontarie M,8,0,8,0
1748428340829,CHEM 6A,A05,958098,Stallings; Dontarie M,8,0,8,0
1748428340829,CHEM 6A,A06,958099,Stallings; Dontarie M,8,0,8,0
1748428340829,CHEM 6A,A07,958100,Stallings; Dontarie M,8,0,8,0
1748428340829,CHEM 6A,A08,958101,Stallings; Dontarie M,8,0,8,0
1748428340829,CHEM 6A,A09,958102,Stallings; Dontarie M,0,0,0,0
1748428340829,CHEM 6A,B01,958136,Stallings; Dontarie M,0,0,8,8
1748428340829,CHEM 6A,B02,958137,Stallings; Dontarie M,5,0,8,3
1748428340829,CHEM 6A,B03,958138,Stallings; Dontarie M,8,0,8,0
1748428340829,CHEM 6A,B04,958139,Stallings; Dontarie M,7,0,8,1
1748428340829,CHEM 6A,B05,958140,Stallings; Dontarie M,0,0,8,8
1748428340829,CHEM 6A,B06,958141,Stallings; Dontarie M,3,0,8,5
1748428340829,CHEM 6A,B07,958143,Stallings; Dontarie M,2,0,8,6
1748428340829,CHEM 6A,B08,958144,Stallings; Dontarie M,8,0,8,0
1748428340829,CHEM 6A,B09,958145,Stallings; Dontarie M,0,0,0,0
1748428340829,CHEM 6A,C01,958146,Schurmeier; Kimberly,6,0,8,2
1748428340829,CHEM 6A,C02,958147,Schurmeier; Kimberly,7,0,8,1
1748428340829,CHEM 6A,C03,958148,Schurmeier; Kimberly,8,0,8,0
1748428340829,CHEM 6A,C04,958149,Schurmeier; Kimberly,8,0,8,0
1748428340829,CHEM 6A,C05,958150,Schurmeier; Kimberly,8,0,8,0
1748428340829,CHEM 6A,C06,958151,Schurmeier; Kimberly,6,0,8,2
1748428340829,CHEM 6A,C07,958152,Schurmeier; Kimberly,8,0,8,0
1748428340829,CHEM 6A,C08,958153,Schurmeier; Kimberly,7,0,8,1
1748428340829,CHEM 6A,C09,958154,Schurmeier; Kimberly,0,0,0,0
1748428340829,CHEM 6A,D01,958155,Schurmeier; Kimberly,3,0,8,5
1748428340829,CHEM 6A,D02,958156,Schurmeier; Kimberly,3,0,8,5
1748428340829,CHEM 6A,D03,958157,Schurmeier; Kimberly,4,0,8,4
1748428340829,CHEM 6A,D04,958158,Schurmeier; Kimberly,6,0,8,2
1748428340829,CHEM 6A,D05,958159,Schurmeier; Kimberly,7,0,8,1
1748428340829,CHEM 6A,D06,958160,Schurmeier; Kimberly,7,0,8,1
1748428340829,CHEM 6A,D07,958161,Schurmeier; Kimberly,8,0,8,0
1748428340829,CHEM 6A,D08,958162,Schurmeier; Kimberly,8,0,8,0
1748428340829,CHEM 6A,D09,958195,Schurmeier; Kimberly,0,0,0,0
1748428340829,CHEM 6A,E01,958203,Zid; Brian M,0,0,8,8
1748428340829,CHEM 6A,E02,958206,Zid; Brian M,6,0,8,2
1748428340829,CHEM 6A,E03,958207,Zid; Brian M,7,0,8,1
1748428340829,CHEM 6A,E04,958350,Zid; Brian M,8,0,8,0
1748428340829,CHEM 6A,E05,958361,Zid; Brian M,7,0,8,1
1748428340829,CHEM 6A,E06,958373,Zid; Brian M,2,0,8,6
1748428340829,CHEM 6A,E07,958394,Zid; Brian M,7,0,8,1
1748428340829,CHEM 6A,E08,958395,Zid; Brian M,1,0,8,7
1748428340829,CHEM 6A,E09,958396,Zid; Brian M,0,0,0,0
1748428340829,CHEM 6A,F01,958397,Ortony; Julia Helen,8,0,8,0
1748428340829,CHEM 6A,F02,958407,Ortony; Julia Helen,0,0,8,8
1748428340829,CHEM 6A,F03,958409,Ortony; Julia Helen,2,0,8,6
1748428340829,CHEM 6A,F04,958417,Ortony; Julia Helen,6,0,8,2
1748428340829,CHEM 6A,F05,958422,Ortony; Julia Helen,8,0,8,0
1748428340829,CHEM 6A,F06,958425,Ortony; Julia Helen,8,0,8,0
1748428340829,CHEM 6A,F07,958428,Ortony; Julia Helen,7,0,8,1
1748428340829,CHEM 6A,F08,958442,Ortony; Julia Helen,8,0,8,0
1748428340829,CHEM 6A,F09,958488,Ortony; Julia Helen,0,0,0,0
1748428340829,CHEM 6A,G01,958489,Ortony; Julia Helen,7,0,8,1
1748428340829,CHEM 6A,G02,958490,Ortony; Julia Helen,8,0,8,0
1748428340829,CHEM 6A,G03,958491,Ortony; Julia Helen,3,0,8,5
1748428340829,CHEM 6A,G04,958499,Ortony; Julia Helen,2,0,8,6
1748428340829,CHEM 6A,G05,958500,Ortony; Julia Helen,4,0,8,4
1748428340829,CHEM 6A,G06,958501,Ortony; Julia Helen,8,0,8,0
1748428340829,CHEM 6A,G07,958502,Ortony; Julia Helen,8,0,8,0
1748428340829,CHEM 6A,G08,958636,Ortony; Julia Helen,8,0,8,0
1748428340829,CHEM 6A,G09,958637,Ortony; Julia Helen,0,0,0,0
1748428341858,CHEM 6B,A01,958638,Bussey; Thomas J,15,0,22,7
1748428341858,CHEM 6B,A02,958641,Bussey; Thomas J,0,0,22,22
1748428341858,CHEM 6B,A03,958646,Bussey; Thomas J,0,0,22,22
1748428341858,CHEM 6B,A04,958648,Bussey; Thomas J,11,0,22,11
1748428341858,CHEM 6B,A05,958650,Bussey; Thomas J,7,0,22,15
1748428341858,CHEM 6B,A06,958652,Bussey; Thomas J,18,0,22,4
1748428341858,CHEM 6B,A07,958653,Bussey; Thomas J,20,0,22,2
1748428341858,CHEM 6B,A08,958654,Bussey; Thomas J,19,0,22,3
1748428341858,CHEM 6B,A09,958710,Bussey; Thomas J,21,0,22,1
1748428341858,CHEM 6B,A10,958713,Bussey; Thomas J,21,0,22,1
1748428342885,CHEM 6C,A01,958743,Yuen Zhou; Joel,22,0,38,16
1748428342885,CHEM 6C,A02,958744,Yuen Zhou; Joel,20,0,38,18
1748428342885,CHEM 6C,A03,958745,Yuen Zhou; Joel,28,0,38,10
1748428342885,CHEM 6C,A04,958746,Yuen Zhou; Joel,30,0,38,8
1748428342885,CHEM 6C,A05,958747,Yuen Zhou; Joel,36,0,38,2
1748428342885,CHEM 6C,A06,958748,Yuen Zhou; Joel,23,0,38,15
1748428342885,CHEM 6C,A07,958749,Yuen Zhou; Joel,23,0,38,15
1748428342885,CHEM 6C,A08,958750,Yuen Zhou; Joel,12,0,38,26
1748428342885,CHEM 6C,A09,958751,Yuen Zhou; Joel,28,0,38,10
1748428343917,CHEM 7L,A01,912668,Leigh; Brian,0,0,24,24
1748428343917,CHEM 7L,A02,912669,Leigh; Brian,0,0,24,24
1748428343917,CHEM 7L,A03,912670,Leigh; Brian,0,0,24,24
1748428343917,CHEM 7L,A04,912671,Leigh; Brian,0,0,24,24
1748428343917,CHEM 7L,A05,912672,Leigh; Brian,0,0,24,24
1748428343917,CHEM 7L,A06,912673,Leigh; Brian,0,0,20,20
1748428343917,CHEM 7L,A07,912674,Leigh; Brian,0,0,24,24
1748428343917,CHEM 7L,A08,912675,Leigh; Brian,0,0,24,24
1748428343917,CHEM 7L,A09,912676,Leigh; Brian,0,0,24,24
1748428343917,CHEM 7L,A10,912677,Leigh; Brian,0,0,24,24
1748428343917,CHEM 7L,B01,912680,Leigh; Brian,0,0,24,24
1748428343917,CHEM 7L,B02,912681,Leigh; Brian,0,0,24,24
1748428343917,CHEM 7L,B03,912682,Leigh; Brian,0,0,24,24
1748428343917,CHEM 7L,B04,912683,Leigh; Brian,0,0,24,24
1748428343917,CHEM 7L,B05,912684,Leigh; Brian,0,0,24,24
1748428343917,CHEM 7L,B06,912685,Leigh; Brian,0,0,24,24
1748428343917,CHEM 7L,B07,912686,Leigh; Brian,0,0,24,24
1748428343917,CHEM 7L,B08,912687,Leigh; Brian,0,0,24,24
1748428343917,CHEM 7L,B09,912688,Leigh; Brian,0,0,24,24
1748428343917,CHEM 7L,B10,912689,Leigh; Brian,0,0,24,24
1748428344961,CHEM 40A,A01,958809,Bertrand; Guy,0,0,34,34
1748428344961,CHEM 40A,A02,958811,Bertrand; Guy,0,0,29,29
1748428344961,CHEM 40A,A03,958812,Bertrand; Guy,0,0,34,34
1748428344961,CHEM 40A,A04,958813,Bertrand; Guy,0,0,34,34
1748428344961,CHEM 40A,A05,958814,Bertrand; Guy,0,0,34,34
1748428344961,CHEM 40A,A06,958816,Bertrand; Guy,0,0,34,34
1748428344961,CHEM 40A,A07,958822,Bertrand; Guy,0,0,34,34
1748428344961,CHEM 40A,A08,958824,Bertrand; Guy,0,0,34,34
1748428344961,CHEM 40A,B01,958825,Bertrand; Guy,0,0,34,34
1748428344961,CHEM 40A,B02,958826,Bertrand; Guy,0,0,34,34
1748428344961,CHEM 40A,B03,958828,Bertrand; Guy,0,0,34,34
1748428344961,CHEM 40A,B04,958829,Bertrand; Guy,0,0,34,34
1748428344961,CHEM 40A,B05,958898,Bertrand; Guy,0,0,34,34
1748428344961,CHEM 40A,B06,958899,Bertrand; Guy,0,0,34,34
1748428344961,CHEM 40A,B07,958900,Bertrand; Guy,0,0,34,34
1748428344961,CHEM 40A,B08,958901,Bertrand; Guy,0,0,34,34
1748428344961,CHEM 40A,C01,958086,Yang; Jerry,29,0,34,5
1748428344961,CHEM 40A,C02,958087,Yang; Jerry,32,0,34,2
1748428344961,CHEM 40A,C03,958088,Yang; Jerry,31,0,34,3
1748428344961,CHEM 40A,C04,958089,Yang; Jerry,34,0,34,0
1748428344961,CHEM 40A,C05,958090,Yang; Jerry,34,0,34,0
1748428344961,CHEM 40A,C06,958091,Yang; Jerry,27,0,34,7
1748428344961,CHEM 40A,C07,958092,Yang; Jerry,29,0,34,5
1748428344961,CHEM 40A,C08,958093,Yang; Jerry,27,0,34,7
1748428344961,CHEM 40A,D01,958113,Albizati; Kim F.,0,0,34,34
1748428344961,CHEM 40A,D02,958114,Albizati; Kim F.,0,0,34,34
1748428344961,CHEM 40A,D03,958115,Albizati; Kim F.,0,0,34,34
1748428344961,CHEM 40A,D04,958116,Albizati; Kim F.,0,0,34,34
1748428344961,CHEM 40A,D05,958117,Albizati; Kim F.,0,0,34,34
1748428344961,CHEM 40A,D06,958118,Albizati; Kim F.,0,0,34,34
1748428344961,CHEM 40A,D07,958119,Albizati; Kim F.,0,0,34,34
1748428344961,CHEM 40A,D08,958120,Albizati; Kim F.,0,0,34,34
1748428345994,CHEM 40B,A01,958752,Molinski; Tadeusz,0,0,31,31
1748428345994,CHEM 40B,A02,958754,Molinski; Tadeusz,0,0,32,32
1748428345994,CHEM 40B,A03,958755,Molinski; Tadeusz,0,0,32,32
1748428345994,CHEM 40B,A04,958756,Molinski; Tadeusz,0,0,32,32
1748428345994,CHEM 40B,A05,958757,Molinski; Tadeusz,0,0,32,32
1748428345994,CHEM 40B,A06,958758,Molinski; Tadeusz,0,0,32,32
1748428345994,CHEM 40B,A07,958759,Molinski; Tadeusz,0,0,32,32
1748428345994,CHEM 40B,A08,958760,Molinski; Tadeusz,2,0,32,30
1748428345994,CHEM 40B,A09,958761,Molinski; Tadeusz,32,0,32,0
1748428347023,CHEM 41A,A01,958071,Klosterman; Jeremy K,0,0,22,22
1748428347023,CHEM 41A,A02,958072,Klosterman; Jeremy K,1,0,36,35
1748428347023,CHEM 41A,A03,958073,Klosterman; Jeremy K,16,0,36,20
1748428347023,CHEM 41A,A04,958074,Klosterman; Jeremy K,32,0,36,4
1748428347023,CHEM 41A,A05,958075,Klosterman; Jeremy K,0,0,0,0
1748428347023,CHEM 41A,A06,958076,Klosterman; Jeremy K,24,0,36,12
1748428347023,CHEM 41A,A07,958077,Klosterman; Jeremy K,3,0,36,33
1748428347023,CHEM 41A,A08,958078,Klosterman; Jeremy K,0,0,36,36
1748428347023,CHEM 41A,A09,958079,Klosterman; Jeremy K,36,0,36,0
1748428348056,CHEM 41C,A01,958105,Tor; Yitzhak,0,0,38,38
1748428348056,CHEM 41C,A02,958106,Tor; Yitzhak,0,0,40,40
1748428349087,CHEM 43A,A01,912711,Lam; Tin Yiu,0,0,24,24
1748428349087,CHEM 43A,A02,912712,Lam; Tin Yiu,0,0,24,24
1748428349087,CHEM 43A,A03,912713,Lam; Tin Yiu,0,0,24,24
1748428349087,CHEM 43A,A04,912714,Lam; Tin Yiu,0,0,24,24
1748428349087,CHEM 43A,A05,912715,Lam; Tin Yiu,0,0,24,24
1748428349087,CHEM 43A,A06,912716,Lam; Tin Yiu,0,0,24,24
1748428349087,CHEM 43A,A07,912717,Lam; Tin Yiu,0,0,24,24
1748428349087,CHEM 43A,A08,912718,Lam; Tin Yiu,0,0,24,24
1748428349087,CHEM 43A,A09,912719,Lam; Tin Yiu,0,0,24,24
1748428349087,CHEM 43A,A10,912720,Lam; Tin Yiu,0,0,24,24
1748428349087,CHEM 43A,B01,912722,Lam; Tin Yiu,0,0,24,24
1748428349087,CHEM 43A,B02,912723,Lam; Tin Yiu,0,0,24,24
1748428349087,CHEM 43A,B03,912724,Lam; Tin Yiu,0,0,19,19
1748428349087,CHEM 43A,B04,912725,Lam; Tin Yiu,0,0,24,24
1748428349087,CHEM 43A,B05,912726,Lam; Tin Yiu,0,0,24,24
1748428349087,CHEM 43A,B06,912727,Lam; Tin Yiu,0,0,24,24
1748428349087,CHEM 43A,B07,912728,Lam; Tin Yiu,0,0,24,24
1748428349087,CHEM 43A,B08,912729,Lam; Tin Yiu,0,0,24,24
1748428349087,CHEM 43A,B09,912730,Lam; Tin Yiu,0,0,24,24
1748428349087,CHEM 43A,B10,912731,Lam; Tin Yiu,0,0,24,24
1748428350115,CHEM 96,A00,960251,Bussey; Thomas J,15,0,20,5
1748428351146,CHEM 100A,A01,912734,Leigh; Brian,0,0,24,24
1748428351146,CHEM 100A,A02,912735,Leigh; Brian,0,0,24,24
1748428351146,CHEM 100A,A03,912736,Leigh; Brian,0,0,24,24
1748428351146,CHEM 100A,A04,912737,Leigh; Brian,0,0,24,24
1748428351146,CHEM 100A,A05,912738,Leigh; Brian,0,0,24,24
1748428351146,CHEM 100A,A06,912739,Leigh; Brian,0,0,24,24
1748428352174,CHEM 108,A01,912741,Ghosh; Gourisankar,0,0,24,24
1748428352174,CHEM 108,A02,912742,Ghosh; Gourisankar,0,0,24,24
1748428352174,CHEM 108,A03,912743,Ghosh; Gourisankar,13,0,24,11
1748428352174,CHEM 108,A04,912744,Ghosh; Gourisankar,23,0,24,1
1748428353201,CHEM 109,A01,912746,Muller; Ulrich K.,0,0,24,24
1748428353201,CHEM 109,A02,912747,Muller; Ulrich K.,0,0,24,24
1748428353201,CHEM 109,A03,912748,Muller; Ulrich K.,0,0,24,24
1748428353201,CHEM 109,A04,912749,Muller; Ulrich K.,15,0,24,9
1748428354233,CHEM 114A,A01,958067,Toor; Navtej,23,0,30,7
1748428354233,CHEM 114A,A02,958068,Toor; Navtej,18,0,30,12
1748428354233,CHEM 114A,A03,958069,Toor; Navtej,15,0,30,15
1748428354233,CHEM 114A,A04,958070,Toor; Navtej,0,0,30,30
1748428354233,CHEM 114A,B01,958080,Guseman; Alex,0,0,30,30
1748428354233,CHEM 114A,B02,958081,Guseman; Alex,0,0,30,30
1748428354233,CHEM 114A,B03,958082,Guseman; Alex,20,0,30,10
1748428354233,CHEM 114A,B04,958083,Guseman; Alex,24,0,30,6
1748428355261,CHEM 114D,A00,912752,Ghosh; Gourisankar,11,0,20,9
1748428356287,CHEM 116,A01,958121,Godula; Kamil,35,0,50,15
1748428356287,CHEM 116,A02,958122,Godula; Kamil,28,0,50,22
1748428357318,CHEM 117,A00,912754,Jones; Lisa Michelle,89,0,100,11
1748428358350,CHEM 126A,A01,958126,Schoeneberg; Johannes,14,0,35,21
1748428358350,CHEM 126A,A02,958127,Schoeneberg; Johannes,4,0,35,31
1748428358350,CHEM 126A,A03,958128,Schoeneberg; Johannes,0,0,35,35
1748428358350,CHEM 126A,A04,958129,Schoeneberg; Johannes,1,0,35,34
1748428358350,CHEM 126A,A05,958130,Schoeneberg; Johannes,34,0,35,1
1748428358350,CHEM 126A,A06,958131,Schoeneberg; Johannes,25,0,35,10
1748428359378,CHEM 130,A01,958084,Sinha; Amitabha,6,0,35,29
1748428359378,CHEM 130,A02,958085,Sinha; Amitabha,21,0,35,14
1748428360404,CHEM 142,A00,912758,Godula; Kamil,112,0,135,23
1748428361434,CHEM 143C,A01,912760,Klosterman; Jeremy K,8,0,24,16
1748428361434,CHEM 143C,A02,912761,Klosterman; Jeremy K,11,0,24,13
1748428362461,CHEM 152,A00,912762,Schmidt; Valerie A,18,0,30,12
1748428363487,CHEM 163,A00,912763,Jones; Lisa Michelle,1,0,10,9
1748428364512,CHEM 171,A01,958103,Slade; Jonathan,30,0,40,10
1748428364512,CHEM 171,A02,958104,Slade; Jonathan,36,0,40,4
1748428365541,CHEM 204,A00,912765,Ghosh; Partho,29,0,30,1
1748428366567,CHEM 209,A00,912766,Toor; Navtej,36,0,40,4
1748428367594,CHEM 213A,A00,912767,Guseman; Alex,46,0,50,4
1748428368621,CHEM 214,A00,912768,Ghosh; Gourisankar,18,0,20,2
1748428369651,CHEM 216,A00,912769,Godula; Kamil,28,0,30,2
1748428370677,CHEM 219A,A00,912770,Zid; Brian M,43,0,45,2
1748428371706,CHEM 222,A00,912771,Graeve; Olivia A,4,0,5,1
1748428372732,CHEM 224,A00,912772,Rinehart; Jeffrey Dennis,19,0,20,1
1748428373762,CHEM 227,A00,912773,Schimpf; Alina M,28,0,30,2
1748428375818,CHEM 231,A00,912775,Yong; Haiwang,20,0,20,0
1748428376847,CHEM 232A,A00,963071,Yuen Zhou; Joel,15,0,15,0
1748428377872,CHEM 234,A00,912776,Pun; Andrew Brian,39,0,40,1
1748428378898,CHEM 242,A00,912777,Godula; Kamil,22,0,25,3
1748428379927,CHEM 252,A00,912778,Schmidt; Valerie A,27,0,30,3
1748428380954,CHEM 263,A00,912779,Jones; Lisa Michelle,28,0,30,2
1748428381981,CHEM 291,A00,912780,Staff,20,0,20,0
1748428383009,CHEM 294,A00,912781,Staff,49,0,50,1
1748428384035,CHIN 10AD,A01,913381,Liu; Mingming,10,0,12,2
1748428384035,CHIN 10AD,A02,913382,Liu; Mingming,10,0,12,2
1748428385062,CHIN 10AM,A01,913384,Chen; Pei-Chia,9,0,12,3
1748428385062,CHIN 10AM,A02,913385,Chen; Pei-Chia,10,0,12,2
1748428386090,CHIN 10AN,A01,913387,Xu; Li,10,0,10,0
1748428386090,CHIN 10AN,A02,913388,Xu; Li,10,0,10,0
1748428386090,CHIN 10AN,B01,913390,Xu; Li,9,0,10,1
1748428386090,CHIN 10AN,B02,913391,Xu; Li,8,0,10,2
1748428386090,CHIN 10AN,C01,913393,Xu; Li,12,0,12,0
1748428386090,CHIN 10AN,C02,913394,Xu; Li,11,0,12,1
1748428387119,CHIN 20AD,A01,913396,Liu; Mingming,12,0,14,2
1748428387119,CHIN 20AD,A02,913397,Liu; Mingming,13,0,14,1
1748428388146,CHIN 20AM,A01,913399,Wang; Xiao,11,0,12,1
1748428388146,CHIN 20AM,A02,913400,Wang; Xiao,9,0,12,3
1748428388146,CHIN 20AM,B01,913402,Wang; Xiao,12,0,12,0
1748428388146,CHIN 20AM,B02,913403,Wang; Xiao,12,0,12,0
1748428389175,CHIN 20AN,A01,913405,Anderson; Qin-Hong,8,0,12,4
1748428389175,CHIN 20AN,A02,913406,Anderson; Qin-Hong,7,0,12,5
1748428389175,CHIN 20AN,B01,913408,Anderson; Qin-Hong,6,0,12,6
1748428389175,CHIN 20AN,B02,913409,Anderson; Qin-Hong,9,0,12,3
1748428389175,CHIN 20AN,C01,913411,Anderson; Qin-Hong,11,0,12,1
1748428390200,CHIN 100AM,A00,913412,Wang; Xiao,12,0,15,3
1748428391227,CHIN 100AN,A00,913413,Chen; Pei-Chia,8,0,15,7
1748428392254,CHIN 185A,A00,913414,Liu; Mingming,15,0,15,0
1748428393280,CLIN 294A,A00,914822,Weingarten; Amanda Gooding,10,0,10,0
1748428394308,CLIN 296,A00,914825,Moore; David Joseph,100,0,100,0
1748428394308,CLIN 296,B00,914826,Brookman; Lauren Irene,5,0,5,0
1748428395335,CLIN 297,A00,914827,Wall; Tamara Lynn,100,0,100,0
1748428396363,CLRE 254,A00,914830,Vaida; Florin,9997,0,9999,2
1748428397393,CLRE 255,A01,914832,Cuomo; Raphael Eduardo,9997,0,9999,2
1748428398424,CLRE 256,A01,914835,Morris; Sheldon,9996,0,9999,3
1748428399451,CLRE 257,A00,914836,Mehta; Ravindra L.,9997,0,9999,2
1748428400480,CLRE 258,A00,914839,Mehta; Ravindra L.,9997,0,9999,2
1748428401508,CLRE 260,A00,914840,Cuomo; Raphael Eduardo,9999,0,9999,0
1748428402534,CLRE 295A,A00,914845,Cuomo; Raphael Eduardo,9999,0,9999,0
1748428403616,CLRE 297,001,914847,Cuomo; Raphael Eduardo,9999,0,9999,0
1748428404642,CLX 87,A00,913379,Castro; Robert Jess,20,0,20,0
1748428405675,COGR 200A,A00,914800,Dewaard; Andrew Michael,5,0,5,0
1748428406704,COGR 200C,A00,914801,Irani; Lilly C,5,0,5,0
1748428407731,COGR 225A,A00,914803,McKenzie; Kerry V.,10,0,10,0
1748428408757,COGR 225C,A00,914804,McKenzie; Kerry V.,9,0,10,1
1748428409785,COGR 275,A00,914805,Jack; Caroline Sarah,9,0,10,1
1748428409785,COGR 275,B00,914807,Zilberg; Elana,9,0,10,1
1748428409785,COGR 275,C00,914809,Goldfarb; Brian,7,0,10,3
1748428410820,COGS 1,A01,913420,Beatty-Martinez; Anne,47,0,56,9
1748428410820,COGS 1,A02,913421,Beatty-Martinez; Anne,39,0,56,17
1748428410820,COGS 1,A03,913422,Beatty-Martinez; Anne,51,0,55,4
1748428410820,COGS 1,A04,913423,Beatty-Martinez; Anne,46,0,50,4
1748428410820,COGS 1,A05,913424,Beatty-Martinez; Anne,41,0,50,9
1748428410820,COGS 1,A06,913425,Beatty-Martinez; Anne,44,0,50,6
1748428410820,COGS 1,A07,913426,Beatty-Martinez; Anne,48,0,50,2
1748428410820,COGS 1,A08,913427,Beatty-Martinez; Anne,45,0,50,5
1748428411848,COGS 2,A01,913429,Boyle; Mary E. T.,49,0,50,1
1748428411848,COGS 2,A02,913430,Boyle; Mary E. T.,47,0,50,3
1748428411848,COGS 2,A03,913431,Boyle; Mary E. T.,46,0,50,4
1748428411848,COGS 2,A04,913432,Boyle; Mary E. T.,49,0,50,1
1748428411848,COGS 2,A05,913433,Boyle; Mary E. T.,47,0,50,3
1748428412876,COGS 3,A01,913435,Boyle; Mary E. T.,48,0,60,12
1748428412876,COGS 3,A02,913436,Boyle; Mary E. T.,52,0,60,8
1748428413905,COGS 9,A01,913439,Khosla; Meenakshi,48,0,50,2
1748428413905,COGS 9,A02,913440,Khosla; Meenakshi,49,0,50,1
1748428413905,COGS 9,A03,913441,Khosla; Meenakshi,48,0,50,2
1748428413905,COGS 9,A04,913442,Khosla; Meenakshi,46,0,50,4
1748428413905,COGS 9,A05,913443,Khosla; Meenakshi,44,0,50,6
1748428413905,COGS 9,A06,913444,Khosla; Meenakshi,46,0,50,4
1748428414933,COGS 10,A01,913446,Staff,41,0,50,9
1748428414933,COGS 10,A02,913447,Staff,46,0,50,4
1748428414933,COGS 10,A03,913448,Staff,47,0,50,3
1748428414933,COGS 10,A04,913449,Staff,47,0,50,3
1748428414933,COGS 10,A05,913450,Staff,50,0,50,0
1748428414933,COGS 10,A06,913451,Staff,45,0,50,5
1748428415961,COGS 11,A01,913453,Boroditsky; Lera,142,0,149,7
1748428416995,COGS 14A,A01,913455,Creel; Sarah,29,0,50,21
1748428416995,COGS 14A,A02,913456,Creel; Sarah,37,0,50,13
1748428416995,COGS 14A,A03,913457,Creel; Sarah,42,0,50,8
1748428416995,COGS 14A,A04,913458,Creel; Sarah,45,0,50,5
1748428416995,COGS 14A,A05,913459,Creel; Sarah,47,0,50,3
1748428416995,COGS 14A,A06,913460,Creel; Sarah,48,0,50,2
1748428416995,COGS 14A,A07,913461,Creel; Sarah,46,0,50,4
1748428418022,COGS 14B,A01,913463,Barrera; Steven James,32,0,50,18
1748428418022,COGS 14B,A02,913464,Barrera; Steven James,45,0,50,5
1748428418022,COGS 14B,A03,913465,Barrera; Steven James,40,0,50,10
1748428418022,COGS 14B,A04,913466,Barrera; Steven James,46,0,50,4
1748428418022,COGS 14B,A05,913467,Barrera; Steven James,40,0,50,10
1748428419048,COGS 15,A01,913469,Bergen; Benjamin,57,0,60,3
1748428419048,COGS 15,A02,913470,Bergen; Benjamin,57,0,60,3
1748428420076,COGS 17,A01,913472,Johnson; Christine M.,38,0,50,12
1748428420076,COGS 17,A02,913473,Johnson; Christine M.,47,0,50,3
1748428420076,COGS 17,A03,913474,Johnson; Christine M.,39,0,50,11
1748428420076,COGS 17,A04,913475,Johnson; Christine M.,42,0,50,8
1748428420076,COGS 17,A05,913476,Johnson; Christine M.,48,0,50,2
1748428420076,COGS 17,A06,913477,Johnson; Christine M.,48,0,50,2
1748428420076,COGS 17,A07,913478,Johnson; Christine M.,50,0,54,4
1748428420076,COGS 17,A08,913479,Johnson; Christine M.,43,0,56,13
1748428421112,COGS 18,A01,913481,Morgan; Eric,27,0,35,8
1748428421112,COGS 18,A02,913482,Morgan; Eric,30,0,35,5
1748428421112,COGS 18,A03,913483,Morgan; Eric,29,0,35,6
1748428421112,COGS 18,A04,913484,Morgan; Eric,32,0,35,3
1748428421112,COGS 18,A05,913485,Morgan; Eric,31,0,35,4
1748428421112,COGS 18,A06,913486,Morgan; Eric,31,0,35,4
1748428421112,COGS 18,A07,913487,Morgan; Eric,30,0,35,5
1748428421112,COGS 18,A08,913488,Morgan; Eric,31,0,35,4
1748428421112,COGS 18,A09,913520,Morgan; Eric,27,0,35,8
1748428421112,COGS 18,B01,968089,Morgan; Eric,34,0,35,1
1748428421112,COGS 18,B02,968090,Morgan; Eric,35,0,35,0
1748428421112,COGS 18,B03,968091,Morgan; Eric,35,0,35,0
1748428421112,COGS 18,B04,968092,Morgan; Eric,35,0,35,0
1748428421112,COGS 18,B05,968093,Morgan; Eric,35,0,35,0
1748428421112,COGS 18,B06,968094,Morgan; Eric,35,0,35,0
1748428421112,COGS 18,B07,968095,Morgan; Eric,35,0,35,0
1748428421112,COGS 18,B08,968096,Morgan; Eric,34,0,35,1
1748428421112,COGS 18,B09,968097,Morgan; Eric,34,0,35,1
1748428422140,COGS 100,A01,913580,Staff,58,0,60,2
1748428422140,COGS 100,A02,913581,Staff,55,0,60,5
1748428422140,COGS 100,A03,913621,Staff,55,0,60,5
1748428422140,COGS 100,A04,913622,Staff,55,0,60,5
1748428422140,COGS 100,A05,913663,Staff,54,0,60,6
1748428423171,COGS 101A,A01,913705,Barrera; Steven James,37,0,50,13
1748428423171,COGS 101A,A02,913709,Barrera; Steven James,35,0,50,15
1748428423171,COGS 101A,A03,913713,Barrera; Steven James,18,0,50,32
1748428423171,COGS 101A,A04,913715,Barrera; Steven James,25,0,50,25
1748428423171,COGS 101A,A05,913718,Barrera; Steven James,44,0,50,6
1748428423171,COGS 101A,A06,913721,Barrera; Steven James,36,0,50,14
1748428423171,COGS 101A,A07,913722,Barrera; Steven James,41,0,50,9
1748428424198,COGS 101B,A01,913725,Hoffman; Drew Ellen,26,0,50,24
1748428424198,COGS 101B,A02,913726,Hoffman; Drew Ellen,44,0,50,6
1748428424198,COGS 101B,A03,913727,Hoffman; Drew Ellen,47,0,50,3
1748428424198,COGS 101B,A04,913730,Hoffman; Drew Ellen,50,0,50,0
1748428425224,COGS 102A,A01,968009,Staff,41,0,48,7
1748428425224,COGS 102A,A02,968010,Staff,36,0,48,12
1748428425224,COGS 102A,A03,968011,Staff,47,0,50,3
1748428426259,COGS 107A,A01,913748,Rangel; Lara M,44,0,56,12
1748428426259,COGS 107A,A02,913750,Rangel; Lara M,43,0,54,11
1748428426259,COGS 107A,A03,913751,Rangel; Lara M,31,0,50,19
1748428426259,COGS 107A,A04,913754,Rangel; Lara M,20,0,50,30
1748428426259,COGS 107A,A05,913755,Rangel; Lara M,27,0,50,23
1748428426259,COGS 107A,A06,913756,Rangel; Lara M,0,0,50,50
1748428427286,COGS 107B,A01,968098,Staff,0,0,50,50
1748428427286,COGS 107B,A02,968099,Staff,6,0,50,44
1748428427286,COGS 107B,A03,968102,Staff,37,0,49,12
1748428428327,COGS 108,A01,913846,Fleischer; Jason G,0,0,56,56
1748428428327,COGS 108,A02,913847,Fleischer; Jason G,17,0,56,39
1748428428327,COGS 108,A03,913858,Fleischer; Jason G,20,0,50,30
1748428428327,COGS 108,A04,913899,Fleischer; Jason G,44,0,55,11
1748428428327,COGS 108,A05,913984,Fleischer; Jason G,29,0,50,21
1748428428327,COGS 108,A06,914035,Fleischer; Jason G,31,0,50,19
1748428428327,COGS 108,A07,914036,Fleischer; Jason G,36,0,50,14
1748428428327,COGS 108,A08,914037,Fleischer; Jason G,44,0,50,6
1748428428327,COGS 108,B01,914039,Fleischer; Jason G,38,0,50,12
1748428428327,COGS 108,B02,914040,Fleischer; Jason G,48,0,50,2
1748428428327,COGS 108,B03,914172,Fleischer; Jason G,32,0,50,18
1748428428327,COGS 108,B04,914182,Fleischer; Jason G,36,0,50,14
1748428428327,COGS 108,B05,914185,Fleischer; Jason G,28,0,50,22
1748428428327,COGS 108,B06,914188,Fleischer; Jason G,19,0,50,31
1748428428327,COGS 108,B07,914209,Fleischer; Jason G,39,0,54,15
1748428428327,COGS 108,B08,914210,Fleischer; Jason G,49,0,56,7
1748428429357,COGS 109,A01,968106,Mukamel; Eran A,30,0,48,18
1748428429357,COGS 109,A02,968107,Mukamel; Eran A,39,0,49,10
1748428429357,COGS 109,A03,968108,Mukamel; Eran A,47,0,49,2
1748428430388,COGS 111,A01,914261,Hoffman; Drew Ellen,34,0,50,16
1748428430388,COGS 111,A02,914262,Hoffman; Drew Ellen,49,0,50,1
1748428430388,COGS 111,A03,914263,Hoffman; Drew Ellen,46,0,50,4
1748428430388,COGS 111,A04,914264,Hoffman; Drew Ellen,28,0,50,22
1748428431415,COGS 115,A01,914266,Deak; Gedeon O.,35,0,70,35
1748428432445,COGS 116,A01,914268,Greene; Deanna Jacquelyn,49,0,70,21
1748428433472,COGS 118A,A01,914270,Tu; Zhuowen,30,0,50,20
1748428433472,COGS 118A,A02,914271,Tu; Zhuowen,31,0,50,19
1748428433472,COGS 118A,A03,914272,Tu; Zhuowen,7,0,50,43
1748428433472,COGS 118A,A04,914273,Tu; Zhuowen,6,0,50,44
1748428434498,COGS 118B,A01,969817,De Sa; Virginia,32,0,49,17
1748428434498,COGS 118B,A02,969818,De Sa; Virginia,34,0,49,15
1748428434498,COGS 118B,A03,969819,De Sa; Virginia,31,0,49,18
1748428434498,COGS 118B,A04,969822,De Sa; Virginia,43,0,49,6
1748428435527,COGS 125,A00,968043,Klemmer; Scott R,48,0,50,2
1748428436553,COGS 128,A01,914278,Staff,16,0,50,34
1748428436553,COGS 128,A02,914279,Staff,0,0,50,50
1748428437579,COGS 143,A01,914284,Johnson; Christine M.,16,0,40,24
1748428438607,COGS 150,A01,968112,Staff,36,0,50,14
1748428438607,COGS 150,A02,968113,Staff,44,0,49,5
1748428438607,COGS 150,A03,968114,Staff,43,0,48,5
1748428439634,COGS 151,A00,968044,Coulson; Seana M,48,0,50,2
1748428440665,COGS 160,A00,914286,Kirsh; David Joel,25,0,25,0
1748428441694,COGS 165,A01,914291,Kiyonaga; Anastasia,0,0,50,50
1748428442725,COGS 187A,A01,914293,Kirsh; David Joel,0,0,50,50
1748428442725,COGS 187A,A02,914294,Kirsh; David Joel,0,0,50,50
1748428442725,COGS 187A,A03,914295,Kirsh; David Joel,16,0,49,33
1748428443751,COGS 189,A00,914296,De Sa; Virginia,119,0,200,81
1748428444780,COGS 190A,A00,914297,Staff,9999,0,9999,0
1748428445808,COGS 194,A00,914298,Hill; Seth J,9999,0,9999,0
1748428446836,COGS 203,A00,914326,Zettersten; Martin,11,0,20,9
1748428447866,COGS 210A,001,914327,Kirsh; David Joel,9999,0,9999,0
1748428447866,COGS 210A,002,914328,Greene; Deanna Jacquelyn,9998,0,9999,1
1748428447866,COGS 210A,003,914329,Xia; Haijun,9998,0,9999,1
1748428447866,COGS 210A,004,914330,Nitz; Douglas A.,9999,0,9999,0
1748428447866,COGS 210A,005,914331,Hollan; James D.,9999,0,9999,0
1748428447866,COGS 210A,006,914332,De Sa; Virginia,9998,0,9999,1
1748428447866,COGS 210A,007,914333,Rossano; Federico,9999,0,9999,0
1748428447866,COGS 210A,008,914334,Kiyonaga; Anastasia,9999,0,9999,0
1748428447866,COGS 210A,009,914335,Coulson; Seana M,9998,0,9999,1
1748428448893,COGS 211A,A00,914336,Boroditsky; Lera,9995,0,9999,4
1748428449921,COGS 230,A00,914337,Munyaka; Imani N. S.,3,0,15,12
1748428450947,COGS 234,A00,970720,Xia; Haijun,4,0,20,16
1748428451976,COGS 260,A00,914340,Voytek; Bradley Thomas,9994,0,9999,5
1748428453006,COMM 10,A01,914366,Whitworth-Smith; Andrew C,6,0,10,4
1748428453006,COMM 10,A02,914367,Whitworth-Smith; Andrew C,7,0,10,3
1748428453006,COMM 10,A03,914368,Whitworth-Smith; Andrew C,9,0,10,1
1748428453006,COMM 10,A04,914369,Whitworth-Smith; Andrew C,6,0,10,4
1748428453006,COMM 10,A05,914370,Whitworth-Smith; Andrew C,10,0,10,0
1748428453006,COMM 10,A06,914371,Whitworth-Smith; Andrew C,9,0,10,1
1748428453006,COMM 10,A07,914372,Whitworth-Smith; Andrew C,9,0,10,1
1748428453006,COMM 10,A08,914373,Whitworth-Smith; Andrew C,7,0,10,3
1748428453006,COMM 10,A09,914374,Whitworth-Smith; Andrew C,9,0,10,1
1748428453006,COMM 10,A10,914375,Whitworth-Smith; Andrew C,10,0,10,0
1748428453006,COMM 10,A11,914376,Whitworth-Smith; Andrew C,6,0,10,4
1748428453006,COMM 10,A12,914377,Whitworth-Smith; Andrew C,10,0,10,0
1748428454037,COMM 20,A01,914385,Hill; Erin Truesdell,75,0,75,0
1748428455068,COMM 40,A00,914386,Jack; Caroline Sarah,61,0,75,14
1748428456094,COMM 50,A00,914387,Staff,21,0,25,4
1748428457125,COMM 80,A01,914389,Staff,77,0,80,3
1748428458159,COMM 100A,A01,914391,Harb; Anthony Joseph,1,0,10,9
1748428458159,COMM 100A,A02,914392,Harb; Anthony Joseph,0,0,10,10
1748428458159,COMM 100A,A03,914393,Harb; Anthony Joseph,0,0,10,10
1748428458159,COMM 100A,A04,914394,Harb; Anthony Joseph,0,0,10,10
1748428458159,COMM 100A,A05,914395,Harb; Anthony Joseph,0,0,10,10
1748428458159,COMM 100A,A06,914396,Harb; Anthony Joseph,0,0,10,10
1748428458159,COMM 100A,A07,914397,Harb; Anthony Joseph,1,0,10,9
1748428458159,COMM 100A,A08,914398,Harb; Anthony Joseph,6,0,10,4
1748428458159,COMM 100A,A09,914399,Harb; Anthony Joseph,7,0,10,3
1748428458159,COMM 100A,A10,914400,Harb; Anthony Joseph,7,0,10,3
1748428459188,COMM 101,A01,914404,Martinico; Daniel J,8,0,15,7
1748428459188,COMM 101,A02,914405,Martinico; Daniel J,2,0,15,13
1748428459188,COMM 101,A03,914406,Martinico; Daniel J,1,0,15,14
1748428459188,COMM 101,A04,914407,Martinico; Daniel J,13,0,15,2
1748428460216,COMM 101K,A00,914408,Staff,0,0,0,0
1748428461244,COMM 101M,A00,914409,Halm; Gavin Patrick,10,0,18,8
1748428462270,COMM 101N,A00,914410,Martinico; Daniel J,4,0,16,12
1748428463296,COMM 101T,A00,914411,Davis; Zeinabu I.,12,0,18,6
1748428464324,COMM 102C,A01,914417,Campion; Camille E,0,0,6,6
1748428464324,COMM 102C,A02,914423,Campion; Camille E,0,0,6,6
1748428464324,COMM 102C,A03,914432,Campion; Camille E,0,0,6,6
1748428465355,COMM 106,A00,914439,Kidman; Shawna F,54,0,70,16
1748428466381,COMM 106F,A00,914442,Hill; Erin Truesdell,23,0,42,19
1748428467410,COMM 106N,A00,914480,Hallin; Daniel C,46,0,70,24
1748428468438,COMM 108D,A00,914491,Goldfarb; Brian,45,0,46,1
1748428469463,COMM 113T,A00,914493,Dominguez Rubio; Fernando,43,0,46,3
1748428470489,COMM 114E,A00,914767,Pavon Aramburu; Maria Laur,41,0,44,3
1748428471517,COMM 114I,A00,914768,Rojo Solis; Juan Jose,39,0,44,5
1748428472544,COMM 115,A00,914769,Alac; Morana,35,0,46,11
1748428473572,COMM 119,A01,914771,Staff,50,0,50,0
1748428474599,COMM 120M,A00,914773,Abuelhiga; Soraya Jill,37,0,44,7
1748428475629,COMM 127,A00,914774,Abuelhiga; Soraya Jill,33,0,44,11
1748428476657,COMM 133,A00,914775,Dewey; Matthew D,35,0,44,9
1748428477684,COMM 134,A00,914777,Kidman; Shawna F,31,0,44,13
1748428478711,COMM 135,A00,914778,Davis; Zeinabu I.,43,0,46,3
1748428479739,COMM 142,A00,914779,McKenna; Denise,22,0,44,22
1748428480766,COMM 146,A00,914780,Halm; Gavin Patrick,34,0,44,10
1748428480766,COMM 146,B00,968068,Ybarra; Megan,41,0,44,3
1748428481796,COMM 148,A00,914785,Staff,0,0,0,0
1748428482824,COMM 164,A00,914786,Dominguez Rubio; Fernando,9,0,25,16
1748428483850,COMM 173,A00,914787,Alac; Morana,4,0,25,21
1748428484876,COMM 177,A00,914788,Rojo Solis; Juan Jose,2,0,25,23
1748428485909,COMM 185,A00,914792,Boateng; Boatema,21,0,25,4
1748428486940,COMM 190,B00,914793,Staff,0,0,23,23
1748428486940,COMM 190,C00,914794,Staff,10,0,23,13
1748428486940,COMM 190,D00,914795,Hassanpour; Anvar,4,0,23,19
1748428487967,COMM 194,A00,954115,Hill; Seth J,9999,0,9999,0
1748428488994,COMM 196A,A00,914796,Dewaard; Andrew Michael,0,0,0,1
1748428490026,CSE 3,A50,914849,Alvarado; Christine J.,49,0,50,1
1748428490026,CSE 3,A51,914850,Alvarado; Christine J.,49,0,50,1
1748428490026,CSE 3,A52,914852,Alvarado; Christine J.,46,0,46,0
1748428491054,CSE 6R,A01,914856,Soosai Raj; Adalbert Geral,238,0,250,12
1748428492090,CSE 8A,A50,914860,Soosai Raj; Adalbert Geral,2,0,3,1
1748428492090,CSE 8A,A51,914868,Soosai Raj; Adalbert Geral,0,0,3,3
1748428492090,CSE 8A,A52,914870,Soosai Raj; Adalbert Geral,1,0,3,2
1748428492090,CSE 8A,A53,914871,Soosai Raj; Adalbert Geral,1,0,3,2
1748428492090,CSE 8A,A54,914872,Soosai Raj; Adalbert Geral,2,0,3,1
1748428492090,CSE 8A,A55,914873,Soosai Raj; Adalbert Geral,2,0,3,1
1748428492090,CSE 8A,A56,914875,Soosai Raj; Adalbert Geral,3,0,3,0
1748428492090,CSE 8A,A57,914876,Soosai Raj; Adalbert Geral,1,0,3,2
1748428493122,CSE 11,A01,958990,Cao; Yingjun,0,0,50,50
1748428493122,CSE 11,B01,959775,Ochoa; Benjamin Lawrence,103,0,115,12
1748428494149,CSE 12,A01,958991,Cao; Yingjun,0,0,100,100
1748428495183,CSE 20,A01,959784,Jones; Miles E,0,0,25,25
1748428495183,CSE 20,A02,968053,Jones; Miles E,1,0,25,24
1748428496212,CSE 21,A01,959776,Jones; Miles E,0,0,30,30
1748428496212,CSE 21,A02,968059,Jones; Miles E,2,0,30,28
1748428497241,CSE 29,A50,914888,Politz; Joseph Gibbs,0,0,10,10
1748428497241,CSE 29,A51,914889,Politz; Joseph Gibbs,0,0,10,10
1748428497241,CSE 29,A52,914891,Politz; Joseph Gibbs,0,0,10,10
1748428497241,CSE 29,A53,914892,Politz; Joseph Gibbs,0,0,10,10
1748428497241,CSE 29,B50,914897,Shalev; Aaron D,0,0,10,10
1748428497241,CSE 29,B51,914898,Shalev; Aaron D,0,0,10,10
1748428497241,CSE 29,B52,914900,Shalev; Aaron D,0,0,10,10
1748428497241,CSE 29,B53,914901,Shalev; Aaron D,0,0,10,10
1748428498274,CSE 30,A01,959778,Eldon; John,0,0,15,15
1748428499302,CSE 87,A00,914904,Moshiri; Niema,20,0,20,0
1748428500335,CSE 89,A00,914906,Minnes Kemp; Mor Mia,100,0,100,0
1748428500335,CSE 89,B00,969276,Minnes Kemp; Mor Mia,100,0,100,0
1748428501365,CSE 95,A00,914907,Cao; Yingjun,100,0,100,0
1748428502398,CSE 100,A01,959787,Moshiri; Niema,0,0,75,75
1748428503428,CSE 100R,A01,914911,Moshiri; Niema,0,0,125,125
1748428504459,CSE 101,A01,958995,Impagliazzo; Russell,0,0,30,30
1748428504459,CSE 101,A02,958998,Impagliazzo; Russell,0,0,30,30
1748428504459,CSE 101,A03,959000,Impagliazzo; Russell,0,0,30,30
1748428504459,CSE 101,B01,959777,Liu; Qipeng,94,0,175,81
1748428505494,CSE 103,A01,959001,Freund; Yoav,69,0,96,27
1748428506522,CSE 105,A01,959785,Lovett; Shachar,0,0,45,45
1748428507601,CSE 107,A01,959002,Bellare; Mihir,81,0,96,15
1748428508629,CSE 110,A50,914923,Coblenz; Michael J,10,0,50,40
1748428508629,CSE 110,A51,914925,Coblenz; Michael J,18,0,50,32
1748428508629,CSE 110,A52,914926,Coblenz; Michael J,44,0,50,6
1748428508629,CSE 110,A53,914928,Coblenz; Michael J,33,0,50,17
1748428508629,CSE 110,A54,914930,Coblenz; Michael J,42,0,50,8
1748428508629,CSE 110,A55,914931,Coblenz; Michael J,36,0,45,9
1748428509657,CSE 118,A50,914934,Weibel; Nadir,16,0,25,9
1748428510682,CSE 120,A01,959780,Voelker; Geoffrey M.,130,0,295,165
1748428511709,CSE 127,A01,959795,Savage; Stefan,88,0,192,104
1748428512735,CSE 130,A01,959003,Polikarpova; Nadezhda,118,0,145,27
1748428513763,CSE 131,A01,914941,Politz; Joseph Gibbs,33,0,50,17
1748428514789,CSE 132A,A01,959790,Gupta; Amarnath,141,0,196,55
1748428515816,CSE 134B,A01,959005,Powell; Thomas Allan,115,0,146,31
1748428516843,CSE 140,A01,914947,Orailoglu; Alex,124,0,146,22
1748428517870,CSE 140L,A01,914949,Orailoglu; Alex,112,0,146,34
1748428518905,CSE 141,A01,959006,Pannuto; Patrick William,79,0,146,67
1748428519933,CSE 141L,A01,961134,Eldon; John,75,0,146,71
1748428520959,CSE 142,A01,959781,Swanson; Steven James,250,0,295,45
1748428521985,CSE 150A,A01,959774,Bonjour; Trevor,101,0,225,124
1748428523017,CSE 150B,A01,959791,Solares; Edwin A,187,0,196,9
1748428524047,CSE 151A,A01,959782,Dasgupta; Sanjoy,186,0,250,64
1748428524047,CSE 151A,B01,959783,Dasgupta; Sanjoy,226,0,250,24
1748428525079,CSE 152A,A01,959792,Su; Hao,0,0,0,0
1748428526106,CSE 158,A01,959793,McAuley; Julian John,99,0,196,97
1748428527137,CSE 158R,A01,914961,McAuley; Julian John,449,0,550,101
1748428527137,CSE 158R,B01,968064,McAuley; Julian John,100,0,100,0
1748428528165,CSE 167,A01,959796,Li; Tzumao,110,0,192,82
1748428529196,CSE 170,A01,914965,Vaccaro; Kristen Marie,13,0,20,7
1748428529196,CSE 170,A02,914967,Vaccaro; Kristen Marie,0,0,20,20
1748428529196,CSE 170,A03,914968,Vaccaro; Kristen Marie,17,0,20,3
1748428529196,CSE 170,A04,914969,Vaccaro; Kristen Marie,15,0,20,5
1748428529196,CSE 170,A05,914970,Vaccaro; Kristen Marie,17,0,20,3
1748428529196,CSE 170,A06,914971,Vaccaro; Kristen Marie,18,0,20,2
1748428529196,CSE 170,A07,914972,Vaccaro; Kristen Marie,16,0,19,3
1748428529196,CSE 170,A08,914973,Vaccaro; Kristen Marie,0,0,19,19
1748428529196,CSE 170,A09,914974,Vaccaro; Kristen Marie,8,0,19,11
1748428529196,CSE 170,A10,969577,Vaccaro; Kristen Marie,18,0,19,1
1748428530222,CSE 190,A00,914975,Vaccaro; Kristen Marie,146,0,146,0
1748428531249,CSE 191,A00,914976,Minnes Kemp; Mor Mia,9999,0,9999,0
1748428532275,CSE 193,A01,959007,Bonjour; Trevor,50,0,50,0
1748428533308,CSE 194,A01,959009,Munyaka; Imani N. S.,6,0,60,54
1748428534339,CSE 197,001,914980,Minnes Kemp; Mor Mia,9999,0,9999,0
1748428535370,CSE 202,A00,914981,Liu; Qipeng,0,0,0,0
1748428536400,CSE 206A,A00,914982,Micciancio; Daniele,0,0,0,0
1748428537429,CSE 207B,A00,914983,Heninger; Nadia A,0,0,0,0
1748428538455,CSE 209A,A00,914984,Impagliazzo; Russell,0,0,0,0
1748428539481,CSE 209B,A00,914985,Bellare; Mihir,0,0,0,0
1748428540510,CSE 210,A00,914986,Powell; Thomas Allan,0,0,0,0
1748428541537,CSE 216,A00,914987,Munyaka; Imani N. S.,0,0,0,0
1748428542568,CSE 221,A00,914988,Ousterhout; Amy,0,0,0,0
1748428543594,CSE 227,A00,914989,Fernandes; Earlence T,0,0,0,0
1748428544621,CSE 229A,A00,914990,Snoeren; Alex C.,0,0,0,0
1748428545650,CSE 229C,A00,914993,Fernandes; Earlence T,0,0,0,0
1748428546677,CSE 237C,A00,914994,Kastner; Ryan Charles,0,0,0,0
1748428547710,CSE 239B,A00,914996,D'Antoni; Loris,0,0,0,0
1748428548737,CSE 240A,A00,914997,Tullsen; Dean Michael,0,0,0,0
1748428549767,CSE 249E,A00,914998,Pannuto; Patrick William,0,0,0,0
1748428550795,CSE 250A,A00,914999,Bonjour; Trevor,0,0,0,0
1748428551824,CSE 252A,A00,915000,Ochoa; Benjamin Lawrence,0,0,0,0
1748428552851,CSE 258,A01,959794,McAuley; Julian John,0,0,0,0
1748428553878,CSE 258R,A01,915004,McAuley; Julian John,0,0,0,0
1748428554909,CSE 259,A00,915005,Prithviraj; Ammanabrolu,0,0,0,0
1748428555938,CSE 260,A01,959011,Chin; Bryan W.,0,0,0,0
1748428556966,CSE 270,A01,959012,Chern; Albert Ren-Haur,0,0,0,0
1748428557994,CSE 276A,A00,915009,Christensen; Henrik I,0,0,0,0
1748428559021,CSE 290,A00,915013,Bafna; Vineet,0,0,0,0
1748428559021,CSE 290,B00,915014,Nakashole; Ndapandula,0,0,0,0
1748428559021,CSE 290,C00,915015,Ramamoorthi; Ravi,0,0,0,0
1748428559021,CSE 290,D00,915017,Tullsen; Dean Michael,0,0,0,0
1748428559021,CSE 290,F00,915020,Vaccaro; Kristen Marie,0,0,0,0
1748428560049,CSE 291A,A00,915021,Yu; Qi,0,0,0,0
1748428560049,CSE 291A,B00,915022,Weibel; Nadir,0,0,0,0
1748428560049,CSE 291A,C00,915049,Munyaka; Imani N. S.,0,0,0,0
1748428560049,CSE 291A,D00,968730,Zhang; Yiying,0,0,0,0
1748428561077,CSE 291P,A00,915050,D'Antoni; Loris,0,0,0,0
1748428561077,CSE 291P,B00,915051,Ding; Yufei,0,0,0,0
1748428562104,CSE 291T,A00,915052,Grier; Daniel T,0,0,0,0
1748428562104,CSE 291T,B00,915053,Heninger; Nadia A,0,0,0,0
1748428563133,CSE 291Y,A00,915054,Fernandes; Earlence T,0,0,0,0
1748428564165,CSE 292,A00,968504,Ousterhout; Amy,0,0,0,0
1748428565215,CSE 293,001,968115,Bafna; Vineet,9999,0,9999,0
1748428565215,CSE 293,002,968116,Bellare; Mihir,9999,0,9999,0
1748428565215,CSE 293,003,968122,Berg-Kirkpatrick; Taylor D,9999,0,9999,0
1748428565215,CSE 293,004,968298,Chandraker; Manmohan Krishna,9999,0,9999,0
1748428565215,CSE 293,005,968317,Cheng; Chung Kuan,9999,0,9999,0
1748428565215,CSE 293,006,968334,Christensen; Henrik I,9999,0,9999,0
1748428565215,CSE 293,007,968339,Coblenz; Michael J,9999,0,9999,0
1748428565215,CSE 293,008,968345,Cottrell; Garrison W,9999,0,9999,0
1748428565215,CSE 293,009,968346,Deutsch; Alin Bernard,9999,0,9999,0
1748428565215,CSE 293,010,968357,Esmaeilzadeh; Hadi,9999,0,9999,0
1748428565215,CSE 293,011,968359,Freund; Yoav,9999,0,9999,0
1748428565215,CSE 293,012,968427,Griswold; William G.,9999,0,9999,0
1748428565215,CSE 293,013,968472,Gymrek; Melissa Ann,9999,0,9999,0
1748428565215,CSE 293,014,968473,Heninger; Nadia A,9999,0,9999,0
1748428565215,CSE 293,015,968480,Impagliazzo; Russell,9999,0,9999,0
1748428565215,CSE 293,016,968489,Jhala; Ranjit,9999,0,9999,0
1748428565215,CSE 293,017,968490,Kahng; Andrew Byun,9999,0,9999,0
1748428565215,CSE 293,018,968494,Kane; Daniel Mertz,9999,0,9999,0
1748428565215,CSE 293,019,968495,Kriegman; David J,9999,0,9999,0
1748428565215,CSE 293,020,968496,Kumar; Arun Kumar,9999,0,9999,0
1748428565215,CSE 293,021,968497,Lerner; Sorin,9999,0,9999,0
1748428565215,CSE 293,022,968498,Lovett; Shachar,9999,0,9999,0
1748428565215,CSE 293,023,968499,McAuley; Julian John,9999,0,9999,0
1748428565215,CSE 293,024,968501,Micciancio; Daniele,9999,0,9999,0
1748428565215,CSE 293,025,968502,Orailoglu; Alex,9999,0,9999,0
1748428565215,CSE 293,026,968503,Pannuto; Patrick William,9999,0,9999,0
1748428565215,CSE 293,027,968505,Paturi; Ramamohan,9999,0,9999,0
1748428565215,CSE 293,028,968506,Polikarpova; Nadezhda,9999,0,9999,0
1748428565215,CSE 293,029,968507,Politz; Joseph Gibbs,9999,0,9999,0
1748428565215,CSE 293,030,968508,Porter; George M,9999,0,9999,0
1748428565215,CSE 293,031,968509,Porter; Leonard Emerson,9999,0,9999,0
1748428565215,CSE 293,032,968510,Ramamoorthi; Ravi,9999,0,9999,0
1748428565215,CSE 293,033,968511,Riek; Laurel D,9999,0,9999,0
1748428565215,CSE 293,034,968512,Sahoo; Debashis,9999,0,9999,0
1748428565215,CSE 293,035,968513,Saul; Lawrence,9999,0,9999,0
1748428565215,CSE 293,036,968514,Savage; Stefan,9999,0,9999,0
1748428565215,CSE 293,037,968515,Schulze; Jurgen P.,9999,0,9999,0
1748428565215,CSE 293,038,968516,Snoeren; Alex C.,9999,0,9999,0
1748428565215,CSE 293,039,968517,Shang; Jingbo,9999,0,9999,0
1748428565215,CSE 293,040,968575,Stefan; Deian,9999,0,9999,0
1748428565215,CSE 293,041,968580,Su; Hao,9999,0,9999,0
1748428565215,CSE 293,042,968589,Swanson; Steven James,9999,0,9999,0
1748428565215,CSE 293,043,968639,Tullsen; Dean Michael,9999,0,9999,0
1748428565215,CSE 293,044,968674,Vaccaro; Kristen Marie,9999,0,9999,0
1748428565215,CSE 293,045,968681,Voelker; Geoffrey M.,9999,0,9999,0
1748428565215,CSE 293,046,968692,Zhao; Jishen,9999,0,9999,0
1748428565215,CSE 293,047,968694,Zhou; Yuan-Yuan,9999,0,9999,0
1748428565215,CSE 293,048,968702,Gao; Sicun,9999,0,9999,0
1748428565215,CSE 293,049,968703,Weibel; Nadir,9999,0,9999,0
1748428565215,CSE 293,050,968704,Gupta; Rajesh K.,9999,0,9999,0
1748428565215,CSE 293,051,968705,Soosai Raj; Adalbert Geral,9999,0,9999,0
1748428566242,CSE 294,A00,915055,Orailoglu; Alex,0,0,0,0
1748428567273,CSS 1,A01,958041,Staff,31,0,41,10
1748428567273,CSS 1,A02,958042,Staff,41,0,41,0
1748428567273,CSS 1,A03,958043,Staff,33,0,41,8
1748428567273,CSS 1,A04,958044,Staff,39,0,41,2
1748428568298,CSS 120,A01,915059,Staff,0,0,0,0
1748428569326,CSS 204,A01,915061,Long; Bria,0,0,0,0
1748428570352,CSS 209,A00,915062,Staff,14,0,40,26
1748428571379,DDPM 200,A00,919742,Ma; Joseph David,35,0,35,0
1748428572406,DDPM 201,A00,919743,Ma; Joseph David,35,0,35,0
1748428573436,DDPM 202,A00,919761,Reed; Chantal,35,0,35,0
1748428574473,DDPM 203,A00,963085,Momper; Jeremiah D,40,0,40,0
1748428575515,DOC 1,A01,916077,Staff,4,0,4,0
1748428575515,DOC 1,A02,916080,Staff,1,0,4,3
1748428575515,DOC 1,A03,916081,Staff,1,0,4,3
1748428575515,DOC 1,A04,916082,Staff,3,0,4,1
1748428575515,DOC 1,A05,916083,Staff,2,0,4,2
1748428575515,DOC 1,A06,916084,Staff,4,0,4,0
1748428575515,DOC 1,A07,916085,Staff,4,0,4,0
1748428575515,DOC 1,A08,916096,Staff,4,0,4,0
1748428575515,DOC 1,A09,916097,Staff,4,0,4,0
1748428575515,DOC 1,A10,916099,Staff,4,0,4,0
1748428575515,DOC 1,A11,916170,Staff,0,0,0,0
1748428575515,DOC 1,A12,916186,Staff,0,0,0,0
1748428575515,DOC 1,A13,916203,Staff,4,0,4,0
1748428575515,DOC 1,A14,916222,Staff,4,0,4,0
1748428575515,DOC 1,A15,916223,Staff,4,0,4,0
1748428575515,DOC 1,A16,916224,Staff,4,0,4,0
1748428575515,DOC 1,B01,916279,Staff,4,0,4,0
1748428575515,DOC 1,B02,916281,Staff,2,0,4,2
1748428575515,DOC 1,B03,916282,Staff,3,0,4,1
1748428575515,DOC 1,B04,916283,Staff,3,0,4,1
1748428575515,DOC 1,B05,916284,Staff,2,0,4,2
1748428575515,DOC 1,B06,916285,Staff,3,0,4,1
1748428575515,DOC 1,B07,916287,Staff,4,0,4,0
1748428575515,DOC 1,B08,916288,Staff,3,0,4,1
1748428575515,DOC 1,B09,916289,Staff,0,0,0,0
1748428575515,DOC 1,B10,916290,Staff,0,0,0,0
1748428575515,DOC 1,B11,916349,Staff,4,0,4,0
1748428575515,DOC 1,B12,916375,Staff,4,0,4,0
1748428575515,DOC 1,B13,916381,Staff,3,0,4,1
1748428575515,DOC 1,B14,916382,Staff,2,0,4,2
1748428575515,DOC 1,B15,916383,Staff,4,0,4,0
1748428575515,DOC 1,B16,916384,Staff,3,0,4,1
1748428575515,DOC 1,C01,916386,Staff,4,0,4,0
1748428575515,DOC 1,C02,916387,Staff,4,0,4,0
1748428575515,DOC 1,C03,916388,Staff,4,0,4,0
1748428575515,DOC 1,C04,916389,Staff,0,0,4,4
1748428575515,DOC 1,C05,916390,Staff,2,0,4,2
1748428575515,DOC 1,C06,916391,Staff,2,0,4,2
1748428575515,DOC 1,C07,916392,Staff,4,0,4,0
1748428575515,DOC 1,C08,916417,Staff,4,0,4,0
1748428575515,DOC 1,C09,916418,Staff,0,0,0,0
1748428575515,DOC 1,C10,916426,Staff,0,0,0,0
1748428575515,DOC 1,C11,916497,Staff,4,0,4,0
1748428575515,DOC 1,C12,916506,Staff,3,0,4,1
1748428575515,DOC 1,C13,916507,Staff,3,0,4,1
1748428575515,DOC 1,C14,916508,Staff,3,0,4,1
1748428575515,DOC 1,C15,916509,Staff,4,0,4,0
1748428575515,DOC 1,C16,916510,Staff,4,0,4,0
1748428575515,DOC 1,D01,916512,Staff,4,0,4,0
1748428575515,DOC 1,D02,916513,Staff,4,0,4,0
1748428575515,DOC 1,D03,916514,Staff,4,0,4,0
1748428575515,DOC 1,D04,916515,Staff,4,0,4,0
1748428575515,DOC 1,D05,916516,Staff,1,0,4,3
1748428575515,DOC 1,D06,916555,Staff,4,0,4,0
1748428575515,DOC 1,D07,916581,Staff,4,0,4,0
1748428575515,DOC 1,D08,916582,Staff,4,0,4,0
1748428575515,DOC 1,D09,916583,Staff,0,0,0,0
1748428575515,DOC 1,D10,916584,Staff,0,0,0,0
1748428575515,DOC 1,D11,916585,Staff,4,0,4,0
1748428575515,DOC 1,D12,916586,Staff,4,0,4,0
1748428575515,DOC 1,D13,916587,Staff,4,0,4,0
1748428575515,DOC 1,D14,916588,Staff,4,0,4,0
1748428575515,DOC 1,D15,916589,Staff,3,0,4,1
1748428575515,DOC 1,D16,916590,Staff,4,0,4,0
1748428576550,DOC 100D,A00,916591,Pass; Natalye,22,0,25,3
1748428576550,DOC 100D,B00,916838,Pass; Natalye,22,0,25,3
1748428577583,DSC 10,A01,915848,Tiefenbruck; Janine LoBue,0,0,0,0
1748428577583,DSC 10,B01,915851,Tiefenbruck; Janine LoBue,0,0,0,0
1748428577583,DSC 10,C01,915854,Tiefenbruck; Janine LoBue,0,0,0,0
1748428578614,DSC 20,A01,915857,Langlois; Marina,87,0,90,3
1748428579645,DSC 30,A01,915859,Liao; Soohyun Nam,175,0,180,5
1748428580676,DSC 40A,A01,915861,Mishne; Gal,167,0,180,13
1748428581704,DSC 40B,A01,915863,Langlois; Marina,126,0,149,23
1748428582731,DSC 80,A01,915865,Eldridge; Justin Matthew,117,0,145,28
1748428582731,DSC 80,B01,915867,Eldridge; Justin Matthew,140,0,145,5
1748428583762,DSC 95,A01,915869,Langlois; Marina,50,0,50,0
1748428584788,DSC 100,A01,915871,Shannon; Kyle Michael,97,0,150,53
1748428585815,DSC 102,A01,915890,Kolovos; Alexandros,128,0,150,22
1748428586850,DSC 106,A01,915892,Lau; Samuel Ethan,74,0,90,16
1748428586850,DSC 106,B01,915894,Lau; Samuel Ethan,53,0,90,37
1748428587879,DSC 140A,A01,915896,Ustun; Tevfik Berk,135,0,150,15
1748428588907,DSC 161,A00,968072,Roberts; Margaret Earling,24,0,25,1
1748428589942,DSC 180A,A01,915898,Bellur; Umesh,0,0,0,0
1748428589942,DSC 180A,A02,969828,Bellur; Umesh,0,0,0,0
1748428589942,DSC 180A,A03,969829,Bellur; Umesh,0,0,0,0
1748428589942,DSC 180A,A04,969830,Bellur; Umesh,0,0,0,0
1748428589942,DSC 180A,A05,969831,Bellur; Umesh,0,0,0,0
1748428589942,DSC 180A,A06,969833,Bellur; Umesh,0,0,0,0
1748428589942,DSC 180A,A07,969835,Bellur; Umesh,0,0,0,0
1748428589942,DSC 180A,A08,969836,Bellur; Umesh,0,0,0,0
1748428589942,DSC 180A,A09,969978,Bellur; Umesh,0,0,0,0
1748428589942,DSC 180A,A10,969985,Bellur; Umesh,0,0,0,0
1748428589942,DSC 180A,A11,969986,Bellur; Umesh,0,0,0,0
1748428589942,DSC 180A,A12,970002,Bellur; Umesh,0,0,0,0
1748428589942,DSC 180A,A13,970008,Bellur; Umesh,0,0,0,0
1748428589942,DSC 180A,A14,970011,Bellur; Umesh,0,0,0,0
1748428589942,DSC 180A,A15,970014,Bellur; Umesh,0,0,0,0
1748428589942,DSC 180A,A16,970019,Bellur; Umesh,0,0,0,0
1748428589942,DSC 180A,A17,970020,Bellur; Umesh,0,0,0,0
1748428589942,DSC 180A,B01,915901,Bellur; Umesh,0,0,0,0
1748428589942,DSC 180A,B02,915902,Bellur; Umesh,0,0,0,0
1748428589942,DSC 180A,B03,970021,Bellur; Umesh,0,0,0,0
1748428589942,DSC 180A,B04,970024,Bellur; Umesh,0,0,0,0
1748428589942,DSC 180A,B05,970025,Bellur; Umesh,0,0,0,0
1748428589942,DSC 180A,B06,970028,Bellur; Umesh,0,0,0,0
1748428589942,DSC 180A,B07,970030,Bellur; Umesh,0,0,0,0
1748428589942,DSC 180A,B08,970031,Bellur; Umesh,0,0,0,0
1748428589942,DSC 180A,B09,970034,Bellur; Umesh,0,0,0,0
1748428589942,DSC 180A,B10,970035,Bellur; Umesh,0,0,0,0
1748428589942,DSC 180A,B11,970042,Bellur; Umesh,0,0,0,0
1748428589942,DSC 180A,B12,970043,Bellur; Umesh,0,0,0,0
1748428589942,DSC 180A,B13,970047,Bellur; Umesh,0,0,0,0
1748428589942,DSC 180A,B14,970049,Bellur; Umesh,0,0,0,0
1748428589942,DSC 180A,B15,970050,Bellur; Umesh,0,0,0,0
1748428589942,DSC 180A,B16,970052,Bellur; Umesh,0,0,0,0
1748428589942,DSC 180A,B17,970057,Bellur; Umesh,0,0,0,0
1748428589942,DSC 180A,B18,970060,Bellur; Umesh,0,0,0,0
1748428589942,DSC 180A,B19,970063,Bellur; Umesh,0,0,0,0
1748428589942,DSC 180A,B20,970068,Bellur; Umesh,0,0,0,0
1748428589942,DSC 180A,B21,970070,Bellur; Umesh,0,0,0,0
1748428589942,DSC 180A,B22,970071,Bellur; Umesh,0,0,0,0
1748428589942,DSC 180A,B23,970075,Bellur; Umesh,0,0,0,0
1748428589942,DSC 180A,B24,970076,Bellur; Umesh,0,0,0,0
1748428589942,DSC 180A,B25,970083,Bellur; Umesh,0,0,0,0
1748428589942,DSC 180A,B26,970072,Bellur; Umesh,0,0,0,0
1748428590972,DSC 190,A01,915904,Schwartzman; Armin,176,0,200,24
1748428590972,DSC 190,C01,915908,Ma; Yian,48,0,60,12
1748428592000,DSC 197,001,971692,Eldridge; Justin Matthew,9999,0,9999,0
1748428593032,DSC 200,A00,915909,Watson-Parris; Duncan,0,0,100,100
1748428594059,DSC 204A,A00,915910,Zhang; Hao,65,0,90,25
1748428595088,DSC 207R,A01,915912,Soosai Raj; Adalbert Geral,99,0,100,1
1748428596116,DSC 209R,A01,915922,Lau; Samuel Ethan,34,0,75,41
1748428597146,DSC 210,A00,915979,Weng; Tsui-Wei (lily),0,0,100,100
1748428598173,DSC 212,A00,915984,Mazumdar; Arya,0,0,90,90
1748428599204,DSC 215R,A01,916032,Saab; Rayan,99,0,100,1
1748428601263,DSC 241,A00,916052,Aoi; Mikio C,81,0,90,9
1748428602288,DSC 256R,A01,916054,McAuley; Julian John,42,0,100,58
1748428603315,DSC 257R,A01,916057,Dasgupta; Sanjoy,50,0,75,25
1748428604344,DSC 261,A00,916058,Salimi; Babak,0,0,90,90
1748428605381,DSC 291,A00,916059,Rahman; Tauhidur,0,0,60,60
1748428605381,DSC 291,B00,916060,Wang; Yuxiang,0,0,60,60
1748428605381,DSC 291,C00,916061,Li; Aobo,0,0,40,40
1748428606408,DSC 293,A00,916062,Ustun; Tevfik Berk,9983,0,9999,16
1748428607447,DSC 294,001,970730,Danks; David J,9999,0,9999,0
1748428607447,DSC 294,002,970731,Hu; Zhiting,9999,0,9999,0
1748428607447,DSC 294,003,970732,Schwartzman; Armin,9999,0,9999,0
1748428607447,DSC 294,004,970739,Salimi; Babak,9999,0,9999,0
1748428607447,DSC 294,005,970742,Wang; Yuxiang,9999,0,9999,0
1748428607447,DSC 294,006,970749,Huang; Biwei,9999,0,9999,0
1748428607447,DSC 294,007,970751,Amariuta-Bartell; Tiffany,9999,0,9999,0
1748428607447,DSC 294,008,970754,Smarr; Benjamin,9999,0,9999,0
1748428607447,DSC 294,009,970755,Jin; Haojian,9999,0,9999,0
1748428607447,DSC 294,010,970758,Ma; Yian,9999,0,9999,0
1748428607447,DSC 294,011,970763,Warstadt; Alexander Scott,9999,0,9999,0
1748428607447,DSC 294,012,970764,Wang; Yusu,9999,0,9999,0
1748428607447,DSC 294,013,970766,Lau; Samuel Ethan,9999,0,9999,0
1748428607447,DSC 294,014,970771,Politis; Dimitris,9999,0,9999,0
1748428608476,DSE 200,A00,915842,Staff,30,0,30,0
1748428609500,DSE 203,A00,915844,Staff,20,0,20,0
1748428610529,DSE 220,A00,915845,Staff,20,0,20,0
1748428611607,DSE 290,A00,915846,Staff,30,0,30,0
1748428612639,DSGN 1,A01,913417,Meyer; Michael Wayne,0,0,50,50
1748428612639,DSGN 1,A02,913418,Meyer; Michael Wayne,14,0,50,36
1748428614693,DSGN 118,A01,914325,Xia; Haijun,0,0,50,50
1748428615719,DSGN 201,A00,970721,Eikey; Elizabeth Victoria,10,0,20,10
1748428616750,ECE 5,A01,917741,Morris; Karcher William,0,0,0,0
1748428616750,ECE 5,A02,917742,Morris; Karcher William,0,0,0,0
1748428616750,ECE 5,A03,917775,Morris; Karcher William,0,0,0,0
1748428616750,ECE 5,A04,917804,Morris; Karcher William,0,0,0,0
1748428616750,ECE 5,A05,917811,Morris; Karcher William,0,0,0,0
1748428616750,ECE 5,A06,917816,Morris; Karcher William,0,0,0,0
1748428617777,ECE 15,A01,917850,Schurgers; Curt,0,0,0,0
1748428617777,ECE 15,A02,917851,Schurgers; Curt,0,0,0,0
1748428618808,ECE 17,A01,917878,Sahay; Rajeev,61,0,65,4
1748428619834,ECE 18,A01,917886,Sahay; Rajeev,42,0,50,8
1748428620862,ECE 25,A50,917898,Liu; Zhaowei,0,0,0,0
1748428620862,ECE 25,A51,917900,Liu; Zhaowei,0,0,0,0
1748428620862,ECE 25,A52,917904,Liu; Zhaowei,0,0,0,0
1748428620862,ECE 25,A53,969573,Liu; Zhaowei,0,0,0,0
1748428621894,ECE 30,A50,917909,Mir Arabbaygi; Siavash,11,0,30,19
1748428621894,ECE 30,A51,917910,Mir Arabbaygi; Siavash,21,0,30,9
1748428621894,ECE 30,A52,917912,Mir Arabbaygi; Siavash,29,0,30,1
1748428622926,ECE 35,A50,917993,Schurgers; Curt,0,0,0,0
1748428622926,ECE 35,A51,917994,Schurgers; Curt,0,0,0,0
1748428622926,ECE 35,A52,918000,Schurgers; Curt,0,0,0,0
1748428622926,ECE 35,A53,918001,Schurgers; Curt,0,0,0,0
1748428622926,ECE 35,A54,918072,Schurgers; Curt,0,0,0,0
1748428622926,ECE 35,A55,918078,Schurgers; Curt,0,0,0,0
1748428622926,ECE 35,B50,918131,Schurgers; Curt,0,0,0,0
1748428622926,ECE 35,B51,918135,Schurgers; Curt,0,0,0,0
1748428622926,ECE 35,B52,918146,Schurgers; Curt,0,0,0,0
1748428622926,ECE 35,B53,918147,Schurgers; Curt,0,0,0,0
1748428622926,ECE 35,B54,918148,Schurgers; Curt,0,0,0,0
1748428622926,ECE 35,B55,918149,Schurgers; Curt,0,0,0,0
1748428623953,ECE 45,A01,918151,Zeger; Kenneth A.,94,0,120,26
1748428624990,ECE 65,A50,918356,Baghdadchi; Saharnaz,1,0,30,29
1748428624990,ECE 65,A51,918470,Baghdadchi; Saharnaz,17,0,30,13
1748428624990,ECE 65,A52,918477,Baghdadchi; Saharnaz,25,0,30,5
1748428626021,ECE 100,A01,918485,Baghdadchi; Saharnaz,0,0,30,30
1748428626021,ECE 100,A02,918486,Baghdadchi; Saharnaz,1,0,30,29
1748428626021,ECE 100,A03,918488,Baghdadchi; Saharnaz,0,0,30,30
1748428626021,ECE 100,A04,918490,Baghdadchi; Saharnaz,22,0,30,8
1748428627051,ECE 101,A01,918495,Zheng; Yang,21,0,75,54
1748428627051,ECE 101,A02,918497,Zheng; Yang,51,0,75,24
1748428628078,ECE 102,A00,918499,Hsueh; Tzu-Chien,52,0,100,48
1748428629108,ECE 103,A01,918621,Ng; Tse Nga,45,0,60,15
1748428630143,ECE 107,A01,918642,Fullerton; Eric E,31,0,70,39
1748428631170,ECE 108,A01,918661,Turakhia; Yatish Girish,6,0,70,64
1748428632197,ECE 109,A01,918758,Poveda Fonseca; Jorge,122,0,149,27
1748428633223,ECE 111,A01,918766,Koushanfar; Farinaz,46,0,75,29
1748428634260,ECE 121A,A50,918857,Esmaili; Gholamreza,11,0,24,13
1748428634260,ECE 121A,A51,918888,Esmaili; Gholamreza,15,0,24,9
1748428634260,ECE 121A,A52,918889,Esmaili; Gholamreza,2,0,24,22
1748428635292,ECE 128A,A00,918911,Esmaili; Gholamreza,53,0,75,22
1748428636319,ECE 135A,A01,918931,Kuzum; Duygu,24,0,40,16
1748428637348,ECE 143,A00,918936,Staff,0,0,0,3
1748428638374,ECE 148,A01,918940,Silberman; Jack,14,0,24,10
1748428639401,ECE 155,A01,919022,Gonzalez Prelcic; Nuria,20,0,25,5
1748428640427,ECE 158A,A01,919041,Javidi; Tara,58,0,70,12
1748428641456,ECE 161A,A01,919070,Meyer; Florian,65,0,80,15
1748428642486,ECE 164,A00,919098,Hall; Drew A.,100,0,146,46
1748428643522,ECE 166,A50,919250,Rebeiz; Gabriel,0,0,30,30
1748428643522,ECE 166,A51,919254,Rebeiz; Gabriel,23,0,30,7
1748428643522,ECE 166,A52,919262,Rebeiz; Gabriel,29,0,30,1
1748428643522,ECE 166,A53,919316,Rebeiz; Gabriel,28,0,30,2
1748428644554,ECE 171B,A01,919338,Shi; Yuanyuan,36,0,50,14
1748428645586,ECE 174,A01,919371,Wang; Jun-Kun,77,0,100,23
1748428646618,ECE 180,A00,968047,Fainman; Yeshaiahu,30,0,30,0
1748428647650,ECE 182,A01,962444,Fainman; Yeshaiahu,24,0,30,6
1748428648678,ECE 197,001,919379,Mercier; Patrick Philip,9999,0,9999,0
1748428649707,ECE 198,001,919418,Nguyen; Truong Quang,9999,0,9999,0
1748428650736,ECE 201,A00,919420,Lo; Yu-Hwa,0,0,0,0
1748428651767,ECE 203,A01,919506,Mercier; Patrick Philip,0,0,0,0
1748428652794,ECE 207A,A00,919507,Liu; Thomas Tao-Ming & McVeigh; Elliot R.,0,0,0,0
1748428653821,ECE 212AN,A00,919508,Nomura; Kenji,0,0,0,0
1748428654857,ECE 222A,A00,919524,Rebeiz; Gabriel,0,0,0,0
1748428655883,ECE 225A,A00,919525,Orlitsky; Alon,0,0,0,0
1748428656913,ECE 230A,A00,919526,Nomura; Kenji,0,0,0,0
1748428657944,ECE 238A,A00,919540,Luo; Jian,0,0,0,0
1748428658969,ECE 240A,A00,919541,Ndao; Abdoulaye,0,0,0,0
1748428660001,ECE 247A,A00,919553,Shi; Lingyan,0,0,0,0
1748428661030,ECE 247B,A00,919562,Aran; Kiana,0,0,0,0
1748428662057,ECE 250,A00,919563,Naghizadeh Ardabili; Parinaz,0,0,0,0
1748428663089,ECE 251C,A00,919583,Parhi; Rahul,0,0,0,0
1748428664115,ECE 253,A00,919597,Nguyen; Truong Quang,0,0,0,0
1748428665142,ECE 255A,A00,919638,Orlitsky; Alon,0,0,0,0
1748428666167,ECE 257A,A01,919640,Zhang; Xinyu,0,0,0,0
1748428667195,ECE 258A,A00,919653,Heath Jr.; Robert Wendell,0,0,0,0
1748428668226,ECE 260A,A01,919655,Eldon; John,0,0,0,0
1748428669252,ECE 264C,A00,919656,Galton; Ian A,0,0,0,0
1748428670280,ECE 265C,A00,919672,Staff,0,0,0,0
1748428671308,ECE 271A,A00,919673,Vasconcelos; Nuno,0,0,0,0
1748428672334,ECE 276C,A00,919674,Yip; Michael,0,0,0,0
1748428673365,ECE 283,A00,919675,Le; Hanh-Phuc,0,0,0,0
1748428673365,ECE 283,B00,919676,Hall; Drew A.,0,0,0,0
1748428674392,ECE 284,A00,919691,Kang; Mingu,0,0,0,0
1748428675422,ECE 285,A00,919718,Naghizadeh Ardabili; Parinaz,0,0,0,0
1748428676465,ECON 1,A01,917129,Famulari; Melissa,33,0,40,7
1748428676465,ECON 1,A02,917130,Famulari; Melissa,39,0,40,1
1748428676465,ECON 1,A03,917131,Famulari; Melissa,45,0,45,0
1748428676465,ECON 1,B01,917133,Famulari; Melissa,39,0,40,1
1748428676465,ECON 1,B02,917134,Famulari; Melissa,38,0,40,2
1748428676465,ECON 1,B03,917135,Famulari; Melissa,45,0,45,0
1748428676465,ECON 1,C01,917137,Levkoff; Steven B.,53,0,60,7
1748428676465,ECON 1,C02,917138,Levkoff; Steven B.,60,0,60,0
1748428676465,ECON 1,C03,917139,Levkoff; Steven B.,59,0,60,1
1748428676465,ECON 1,C04,917140,Levkoff; Steven B.,60,0,60,0
1748428676465,ECON 1,C05,917141,Levkoff; Steven B.,59,0,60,1
1748428676465,ECON 1,D01,917144,Levkoff; Steven B.,44,0,50,6
1748428676465,ECON 1,D02,917145,Levkoff; Steven B.,50,0,50,0
1748428676465,ECON 1,D03,917146,Levkoff; Steven B.,50,0,50,0
1748428676465,ECON 1,D04,917154,Levkoff; Steven B.,50,0,50,0
1748428677492,ECON 2,A01,917160,Crane; Meredith Helen,35,0,45,10
1748428677492,ECON 2,A02,917164,Crane; Meredith Helen,43,0,45,2
1748428678520,ECON 3,A01,917170,Ma; Alyson Chan,41,0,60,19
1748428679546,ECON 4,A01,917174,Brooks; Marcus Raymond,0,0,0,0
1748428680573,ECON 5,A01,917177,Staff,12,0,30,18
1748428680573,ECON 5,B01,917182,Staff,16,0,30,14
1748428680573,ECON 5,C01,917193,Dai; Yinlin,0,0,30,30
1748428681601,ECON 86,A00,917197,Muendler; Marc,95,0,100,5
1748428682631,ECON 100A,A01,917209,Newhouse; Herbert S,32,0,50,18
1748428682631,ECON 100A,A02,917212,Newhouse; Herbert S,34,0,50,16
1748428682631,ECON 100A,A03,917213,Newhouse; Herbert S,41,0,50,9
1748428682631,ECON 100A,B01,917216,Newhouse; Herbert S,0,0,50,50
1748428682631,ECON 100A,B02,917298,Newhouse; Herbert S,21,0,50,29
1748428682631,ECON 100A,B03,917301,Newhouse; Herbert S,44,0,50,6
1748428683662,ECON 100B,A01,917305,Crane; Meredith Helen,0,0,75,75
1748428683662,ECON 100B,B01,917309,Crane; Meredith Helen,0,0,75,75
1748428684692,ECON 100C,A01,917311,Staff,0,0,25,25
1748428685717,ECON 109,A01,917313,Shishkin; Denis,58,0,65,7
1748428685717,ECON 109,B01,917315,Shishkin; Denis,59,0,75,16
1748428686744,ECON 110A,A01,917336,Jaimovich; Nir,44,0,70,26
1748428686744,ECON 110A,B01,917339,Jaimovich; Nir,19,0,37,18
1748428686744,ECON 110A,B02,917341,Jaimovich; Nir,36,0,38,2
1748428687771,ECON 110B,A01,917388,Trottner; Fabian Gunter We,0,0,50,50
1748428687771,ECON 110B,A02,917389,Trottner; Fabian Gunter We,0,0,50,50
1748428687771,ECON 110B,A03,917390,Trottner; Fabian Gunter We,14,0,50,36
1748428687771,ECON 110B,B01,917396,Trottner; Fabian Gunter We,24,0,50,26
1748428688799,ECON 120A,A01,917401,Dai; Yinlin,21,0,50,29
1748428688799,ECON 120A,A02,917405,Dai; Yinlin,40,0,50,10
1748428688799,ECON 120A,B01,917408,Dai; Yinlin,0,0,40,40
1748428688799,ECON 120A,B02,917409,Dai; Yinlin,0,0,40,40
1748428688799,ECON 120A,B03,917410,Dai; Yinlin,30,0,40,10
1748428689829,ECON 120B,A01,917415,Candido; Maria Teresa,0,0,98,98
1748428689829,ECON 120B,A02,917418,Candido; Maria Teresa,78,0,98,20
1748428689829,ECON 120B,B01,917422,Candido; Maria Teresa,33,0,98,65
1748428689829,ECON 120B,B02,917423,Candido; Maria Teresa,75,0,98,23
1748428690863,ECON 120C,A01,917505,Candido; Maria Teresa,81,0,146,65
1748428691890,ECON 121,A00,917511,Vogl; Tom Saul,68,0,70,2
1748428691890,ECON 121,B00,917516,Vogl; Tom Saul,55,0,70,15
1748428692916,ECON 130,A00,917518,Staff,165,0,190,25
1748428693944,ECON 131,A00,917519,Jacobsen; Mark,56,0,120,64
1748428694975,ECON 139,A00,917520,Arnold; David Hall,21,0,50,29
1748428696000,ECON 152,A00,917523,Fadlon; Yizhak,87,0,90,3
1748428696000,ECON 152,B00,917524,Fadlon; Yizhak,88,0,90,2
1748428697033,ECON 181,A00,965256,Esfahani; Sara,88,0,100,12
1748428698064,ECON 186,A00,917525,Ross; Stephen Geoffrey,80,0,110,30
1748428699092,ECON 191B,A00,917527,Cullen; Julie,20,0,20,0
1748428700120,ECON 200A,A00,917529,Shishkin; Denis,20,0,20,0
1748428701146,ECON 204,A00,917531,Watson; Joel Christopher,25,0,25,0
1748428702172,ECON 205,A00,917532,Du; Songzi,20,0,20,0
1748428703199,ECON 210A,A00,917536,Alon; Titan Michael,20,0,20,0
1748428704226,ECON 220A,A00,917537,Elliott; Graham,20,0,20,0
1748428705257,ECON 220D,A00,917538,Hamilton; James D.,22,0,30,8
1748428706284,ECON 221,A00,960527,Zhu; Ying,20,0,20,0
1748428707313,ECON 232,A00,917539,Fadlon; Yizhak,18,0,20,2
1748428708342,ECON 242,A00,917540,Vogl; Tom Saul & Lee; Munseob,17,0,20,3
1748428709369,ECON 250A,A00,917544,Berman; Eli & Betts; Julian & Arnold; David Hall,21,0,25,4
1748428710395,ECON 262,A00,917546,Trevino; Isabel,20,0,20,0
1748428711423,ECON 268,A00,917547,Boomhower; Judson P,18,0,20,2
1748428712448,ECON 280,A00,917549,Arnold; David Hall,20,0,20,0
1748428713480,ECON 281,A00,917550,Jacobsen; Mark,20,0,20,0
1748428713480,ECON 281,B00,917553,Jaimovich; Nir,15,0,20,5
1748428714510,ECON 285,A00,917554,Bharadwaj; Prashant & Zhu; Ying,24,0,25,1
1748428715596,ECON 286,A00,917556,Ma; Xinwei,20,0,20,0
1748428715596,ECON 286,B00,917558,Eckert; Fabian Paul & Wu; Pak Yeung,20,0,20,0
1748428715596,ECON 286,C00,917559,Bharadwaj; Prashant,20,0,20,0
1748428715596,ECON 286,D00,969571,Cullen; Julie,20,0,20,0
1748428715596,ECON 286,E00,969572,Vespa; Emanuel Ignacio,19,0,20,1
1748428716621,ECON 296,A00,917565,Bharadwaj; Prashant & Zhu; Ying,24,0,25,1
1748428717651,EDS 31,A00,960270,Bussey; Thomas J,5,0,10,5
1748428718679,EDS 88,A00,960441,Bintliff; Amy S.V.,16,0,20,4
1748428719707,EDS 110R,A01,943452,Wishard Guerra; Alison G.,33,0,60,27
1748428719707,EDS 110R,B01,960792,Wishard Guerra; Alison G.,20,0,20,0
1748428720734,EDS 111,A00,969314,Cohen; Shana R,31,0,60,29
1748428721760,EDS 112,A00,969313,Chapman; Thandeka K,32,0,50,18
1748428722787,EDS 114,A01,943493,Eguchi; Emi,19,0,20,1
1748428722787,EDS 114,A02,943494,Eguchi; Emi,18,0,20,2
1748428723816,EDS 115,A00,943495,Jones; Gabrielle Anastasia,46,0,60,14
1748428724851,EDS 117,A01,943675,Jones; Makeba,17,0,37,20
1748428724851,EDS 117,A02,943682,Jones; Makeba,36,0,37,1
1748428724851,EDS 117,A03,943683,Jones; Makeba,33,0,38,5
1748428724851,EDS 117,A04,943691,Jones; Makeba,35,0,38,3
1748428724851,EDS 117,B01,943693,Jones; Gabrielle Anastasia,21,0,30,9
1748428724851,EDS 117,B02,943694,Jones; Gabrielle Anastasia,27,0,30,3
1748428724851,EDS 117,B03,943695,Jones; Gabrielle Anastasia,28,0,30,2
1748428724851,EDS 117,B04,943696,Jones; Gabrielle Anastasia,30,0,30,0
1748428725880,EDS 124AR,A00,943698,Simon; Elizabeth A,129,0,150,21
1748428725880,EDS 124AR,B00,943699,Simon; Elizabeth A,149,0,150,1
1748428725880,EDS 124AR,C00,961307,Simon; Elizabeth A,40,0,40,0
1748428726907,EDS 124BR,A00,943700,Eguchi; Emi,122,0,150,28
1748428726907,EDS 124BR,B00,961276,Eguchi; Emi,20,0,20,0
1748428727933,EDS 125,A00,943701,Jones; Gabrielle Anastasia,49,0,60,11
1748428728960,EDS 129A,A01,943703,Heinzman; Erica M.,48,0,50,2
1748428729987,EDS 130,A01,943705,Staff,6,0,20,14
1748428729987,EDS 130,A02,943706,Staff,18,0,20,2
1748428729987,EDS 130,A03,943707,Staff,20,0,20,0
1748428731011,EDS 131,A01,943709,Staff,8,0,20,12
1748428731011,EDS 131,A02,943710,Staff,17,0,20,3
1748428732039,EDS 133,A01,960443,Bintliff; Amy S.V.,20,0,25,5
1748428732039,EDS 133,A02,960447,Bintliff; Amy S.V.,15,0,15,0
1748428733075,EDS 139,A00,943725,Heinzman; Erica M.,40,0,50,10
1748428733075,EDS 139,B00,943726,Staff,29,0,50,21
1748428733075,EDS 139,C00,943788,Staff,34,0,50,16
1748428733075,EDS 139,E00,943802,Bintliff; Amy S.V.,42,0,50,8
1748428733075,EDS 139,F00,960448,Bintliff; Amy S.V.,40,0,40,0
1748428734105,EDS 149,A00,943814,Black; Alison Michelle,20,0,20,0
1748428735146,EDS 201,A00,943816,Fine; Sarah,44,0,45,1
1748428736174,EDS 203,A01,943818,Eguchi; Emi,44,0,45,1
1748428737203,EDS 205A,A00,943819,Staff,44,0,45,1
1748428738228,EDS 246,A01,943855,Cohen; Shana R,10,0,10,0
1748428739258,EDS 250,A00,943856,Chapman; Thandeka K,49,0,50,1
1748428740285,EDS 251,A00,943862,Wishard Guerra; Alison G.,10,0,10,0
1748428741315,EDS 257,A00,943863,Datnow; Amanda Lee,7,0,10,3
1748428742342,EDS 283,A00,943871,Daly; Alan J.,15,0,15,0
1748428743372,EDS 285,A00,943872,Daly; Alan J.,15,0,15,0
1748428744403,EDS 286,A00,943873,Daly; Alan J.,15,0,15,0
1748428745435,EDS 289D,A00,943874,Hofstetter; Carolyn,15,0,15,0
1748428746464,EDS 292,A00,943876,Hofstetter; Carolyn,15,0,15,0
1748428747497,EDS 296,001,970523,Aragon; Maria Jose,9999,0,9999,0
1748428747497,EDS 296,002,970539,Bintliff; Amy S.V.,9997,0,9999,2
1748428747497,EDS 296,003,970543,Chapman; Thandeka K,9999,0,9999,0
1748428747497,EDS 296,004,970544,Clarke; Sherice Nicole,9999,0,9999,0
1748428747497,EDS 296,005,970587,Cohen; Shana R,9998,0,9999,1
1748428747497,EDS 296,006,970606,Daly; Alan J.,9998,0,9999,1
1748428747497,EDS 296,007,970607,Datnow; Amanda Lee,9997,0,9999,2
1748428747497,EDS 296,008,970608,Eguchi; Emi,9999,0,9999,0
1748428747497,EDS 296,009,970609,Fine; Sarah,9999,0,9999,0
1748428747497,EDS 296,010,970614,Hofstetter; Carolyn,9998,0,9999,1
1748428747497,EDS 296,011,970615,Hopkins; Megan Beth,9998,0,9999,1
1748428747497,EDS 296,012,970616,Jones; Makeba,9999,0,9999,0
1748428747497,EDS 296,013,970631,Jones; Gabrielle Anastasia,9999,0,9999,0
1748428747497,EDS 296,014,970636,Mamas; Christoforos,9998,0,9999,1
1748428747497,EDS 296,015,970649,Phuong; Andrew,9999,0,9999,0
1748428747497,EDS 296,016,970670,Pollock; Mica,9999,0,9999,0
1748428747497,EDS 296,017,970671,Wishard Guerra; Alison G.,9998,0,9999,1
1748428748524,EDS 297,001,972987,Staff,1,0,1,0
1748428749555,ENG 5,A00,916064,Rodriguez; Ruben,70,0,70,0
1748428750582,ENG 10,A00,916066,Evdokimenko; Ekaterina,58,0,60,2
1748428751611,ENG 15,A00,916067,Evdokimenko; Ekaterina,24,0,30,6
1748428752638,ENG 100D,A00,916069,Ngo; Anh-Thu T.,23,0,50,27
1748428753665,ENG 100L,A00,916070,Kleissl; Jan,8,0,8,0
1748428753665,ENG 100L,B00,916071,Bratton; Maryann,8,0,8,0
1748428753665,ENG 100L,C00,916072,Goldberg; Charles G.,8,0,8,0
1748428753665,ENG 100L,D00,916073,de Oliveira; Mauricio,8,0,8,0
1748428753665,ENG 100L,E00,916074,Bratton; Maryann,8,0,8,0
1748428753665,ENG 100L,F00,916075,Boyle; Mary E. T.,8,0,8,0
1748428754694,ENVR 30,A01,959899,Amoa-Bosompem; Michael,17,0,30,13
1748428754694,ENVR 30,A02,959900,Amoa-Bosompem; Michael,27,0,30,3
1748428754694,ENVR 30,A03,959901,Amoa-Bosompem; Michael,26,0,30,4
1748428754694,ENVR 30,A04,959902,Amoa-Bosompem; Michael,28,0,30,2
1748428754694,ENVR 30,A05,959903,Amoa-Bosompem; Michael,29,0,30,1
1748428754694,ENVR 30,A06,959904,Amoa-Bosompem; Michael,30,0,30,0
1748428755723,ENVR 102,A00,960031,Laughing; Cheron,23,0,25,2
1748428756753,ERC 20,A00,921227,Evans; Ivan T,30,0,30,0
1748428756753,ERC 20,B00,921229,Evans; Ivan T,30,0,30,0
1748428757781,ERC 88,A00,961214,Peterson; Johanna L,19,0,20,1
1748428758815,ESYS 101,A01,921233,Taylor; Jennifer Rebecca,21,0,32,11
1748428758815,ESYS 101,A02,921234,Taylor; Jennifer Rebecca,14,0,32,18
1748428758815,ESYS 101,A03,921235,Taylor; Jennifer Rebecca,20,0,32,12
1748428758815,ESYS 101,A04,921241,Taylor; Jennifer Rebecca,26,0,32,6
1748428759844,ESYS 187A,A01,921248,Hetherington; Elizabeth Dorsey,30,0,40,10
1748428759844,ESYS 187A,B01,921250,Shipp; Lauren Elizabeth,27,0,40,13
1748428760877,ETHN 1,A01,919800,Wilson; Brenda K,13,0,15,2
1748428760877,ETHN 1,A02,919843,Wilson; Brenda K,14,0,15,1
1748428760877,ETHN 1,A03,920214,Wilson; Brenda K,15,0,15,0
1748428760877,ETHN 1,A04,920215,Wilson; Brenda K,14,0,15,1
1748428760877,ETHN 1,A05,920223,Wilson; Brenda K,15,0,15,0
1748428760877,ETHN 1,A06,920224,Wilson; Brenda K,15,0,15,0
1748428760877,ETHN 1,A07,920225,Wilson; Brenda K,15,0,15,0
1748428760877,ETHN 1,A08,920226,Wilson; Brenda K,12,0,15,3
1748428760877,ETHN 1,A09,920237,Wilson; Brenda K,15,0,15,0
1748428760877,ETHN 1,A10,920368,Wilson; Brenda K,15,0,15,0
1748428760877,ETHN 1,A11,920402,Wilson; Brenda K,15,0,15,0
1748428760877,ETHN 1,A12,920406,Wilson; Brenda K,15,0,15,0
1748428760877,ETHN 1,A13,920410,Wilson; Brenda K,14,0,15,1
1748428760877,ETHN 1,A14,920441,Wilson; Brenda K,14,0,15,1
1748428761905,ETHN 20R,A01,920461,Sasaki; Christen T,0,0,15,15
1748428761905,ETHN 20R,A02,920467,Sasaki; Christen T,0,0,15,15
1748428761905,ETHN 20R,A03,920468,Sasaki; Christen T,0,0,15,15
1748428761905,ETHN 20R,A04,920470,Sasaki; Christen T,0,0,15,15
1748428762933,ETHN 100A,A00,920489,Patel; Shaista,18,0,35,17
1748428763959,ETHN 101TV,A01,920518,Gallagher-Geurtsen; Tricia Meghan,21,0,25,4
1748428763959,ETHN 101TV,A02,920519,Gallagher-Geurtsen; Tricia Meghan,20,0,25,5
1748428763959,ETHN 101TV,A03,920522,Gallagher-Geurtsen; Tricia Meghan,24,0,25,1
1748428763959,ETHN 101TV,A04,920523,Gallagher-Geurtsen; Tricia Meghan,22,0,25,3
1748428764990,ETHN 110,A00,920528,Klann; Mary Cameron,27,0,35,8
1748428766017,ETHN 116,A00,920529,Cuong; Marisol,29,0,35,6
1748428767049,ETHN 120,A00,920542,Tran; Ly Thi Hai,31,0,35,4
1748428768079,ETHN 122A,A00,920559,Museus; Samuel David,30,0,35,5
1748428769111,ETHN 125R,A00,920694,Sasaki; Christen T,0,0,35,35
1748428770137,ETHN 130,A00,920703,Frank; Ross H.,28,0,30,2
1748428771171,ETHN 139,A00,920704,Ruiz; Ariana,18,0,20,2
1748428772199,ETHN 150,A00,920717,Taylor-Garcia; Daphne,16,0,16,0
1748428773228,ETHN 161,A00,920826,Browne; Errol Tsekani,33,0,35,2
1748428774258,ETHN 174,A00,963091,Staff,15,0,15,0
1748428775283,ETHN 186,A00,959881,Perez; Roy,25,0,30,5
1748428776310,ETHN 187,A00,920860,Martin Sandino; Amanda Maria Yoland,16,0,16,0
1748428777337,ETHN 189,A00,920861,Museus; Samuel David,18,0,20,2
1748428778361,ETHN 200A,A00,920862,Espiritu; Yen,7,0,10,3
1748428779389,ETHN 230,A00,920864,Perreira; Christopher Michael,8,0,10,2
1748428780417,ETIM 289,A00,921224,Patel; Shaista,10,0,10,0
1748428781443,EXPR 100,A00,964355,Staff,9999,0,9999,0
1748428782469,EXPR 105,A00,964356,Staff,9999,0,9999,0
1748428783495,EXPR 201,A00,964357,Staff,9999,0,9999,0
1748428784527,EXPR 205,A00,964358,Staff,9999,0,9999,0
1748428785560,FILM 71,A01,960804,Park; Joanne Moeun,0,0,11,11
1748428785560,FILM 71,B01,960877,Park; Joanne Moeun,3,0,11,8
1748428786592,FILM 72,A01,964349,Kroopf; Jackson Stanford,9,0,11,2
1748428786592,FILM 72,B01,964351,Kroopf; Jackson Stanford,9,0,11,2
1748428787622,FILM 73,A01,964345,Staff,0,0,0,0
1748428787622,FILM 73,B01,964347,Kroopf; Jackson Stanford,7,0,11,4
1748428788649,FMPH 291,A00,969582,Tsuyuki; Kiyomi,10,0,10,0
1748428789678,FPM 291,A00,922036,Rabin; Adrienn Borsika & Stadnick; Nicole & Aarons; Gregory A,12,0,12,0
1748428790712,GLBH 20,A00,921344,Elwardani; Nile Regina,137,0,146,9
1748428791747,GLBH 100,A00,921503,Jenkins; Janis A.,5,0,12,7
1748428791747,GLBH 100,B00,921504,Schonberg; Jeffrey,18,0,20,2
1748428792774,GLBH 111,A01,921733,Burgos; Jose L.,17,0,17,0
1748428792774,GLBH 111,B01,921862,Burgos; Jose L.,17,0,17,0
1748428793800,GLBH 114,A00,921864,Olivas Hernandez; Olga Lid,42,0,50,8
1748428794831,GLBH 116,A00,921865,Villarino; Margarita,41,0,45,4
1748428795862,GLBH 117,A00,921873,Villarino; Margarita,40,0,40,0
1748428796889,GLBH 118,A00,921884,Wilson; Brenda K,25,0,32,7
1748428797918,GLBH 119,A00,921956,Elwardani; Nile Regina,40,0,40,0
1748428798946,GLBH 148,A00,921961,Walkover; Lillian B,75,0,100,25
1748428799973,GLBH 181,A00,921962,Burgos; Jose L.,188,0,216,28
1748428801000,GLBH 200,A00,921963,Schonberg; Jeffrey,15,0,18,3
1748428802026,GLBH 201,A00,921982,Staff,16,0,18,2
1748428803054,GLBH 248,A00,921999,Kaiser; Bronwyn Nicole,16,0,18,2
1748428804083,GPEC 243,A00,946441,McCord; Gordon Carlos,96,0,100,4
1748428805116,GSS 20,A00,923030,Siapno; Jacqueline A,38,0,40,2
1748428805116,GSS 20,B00,923031,Siapno; Jacqueline A,36,0,40,4
1748428806150,HDS 1,A01,923033,Reese; Clarissa Jane,25,0,25,0
1748428806150,HDS 1,A02,923034,Reese; Clarissa Jane,20,0,25,5
1748428806150,HDS 1,A03,923035,Reese; Clarissa Jane,19,0,25,6
1748428806150,HDS 1,A04,923036,Reese; Clarissa Jane,22,0,25,3
1748428806150,HDS 1,A05,923037,Reese; Clarissa Jane,22,0,25,3
1748428806150,HDS 1,A06,923038,Reese; Clarissa Jane,23,0,25,2
1748428806150,HDS 1,A07,923039,Reese; Clarissa Jane,24,0,25,1
1748428807179,HDS 60,A01,923041,Staff,25,0,30,5
1748428807179,HDS 60,A02,923042,Staff,21,0,30,9
1748428808207,HDS 111,A00,923043,Staff,13,0,40,27
1748428809238,HDS 124,A00,923044,Staff,29,0,40,11
1748428810267,HDS 150,A00,923045,Staff,20,0,20,0
1748428811297,HDS 175,A00,923046,Staff,14,0,25,11
1748428812325,HDS 181,A01,923048,Staff,30,0,30,0
1748428813351,HDS 191,A01,923050,Reese; Clarissa Jane,25,0,25,0
1748428814380,HIEA 112,A00,922103,Matsumura; Wendy Y,92,0,115,23
1748428815407,HIEA 153,A00,922106,Henry; Todd A.,43,0,51,8
1748428816435,HIEU 108,A00,922108,Balberg; Mira,29,0,70,41
1748428817463,HIEU 114,A00,959889,Staff,59,0,70,11
1748428818492,HIEU 139,A00,922110,Strasser; Ulrike,40,0,51,11
1748428819577,HIEU 140,A00,922111,Radcliff; Pamela B.,58,0,65,7
1748428820607,HIEU 154,A00,922113,Hansen; Jan Eric,55,0,65,10
1748428821635,HIEU 158,A00,922116,Hertz; Deborah,61,0,70,9
1748428822663,HIEU 171,A00,922117,Hertz; Deborah,15,0,15,0
1748428823690,HIEU 271,A00,922189,Hertz; Deborah,0,0,0,0
1748428824719,HIGR 200,A00,922191,Matsumura; Wendy Y,10,0,10,0
1748428825748,HIGR 210,A00,922221,Muscolino; Micah S,8,0,10,2
1748428826775,HIGR 222,A00,963094,Biess; Frank Peter,10,0,10,0
1748428827802,HIGR 238,A00,922242,McKenzie; Kerry V.,9,0,10,1
1748428828832,HIGR 240,A00,922253,McKenzie; Kerry V.,10,0,10,0
1748428829861,HIGR 267A,A00,922256,Widener; Daniel,8,0,10,2
1748428831918,HILA 114,A00,922118,Cowan; Benjamin A,42,0,65,23
1748428832944,HILA 131,A00,922125,Vitz; Matthew,91,0,99,8
1748428833972,HILA 161,A00,922126,Cowan; Benjamin A,12,0,15,3
1748428835004,HILD 2A,A01,922043,Staff,31,0,32,1
1748428835004,HILD 2A,A02,922044,Staff,31,0,32,1
1748428835004,HILD 2A,A03,922046,Staff,28,0,32,4
1748428835004,HILD 2A,A04,922047,Staff,32,0,32,0
1748428835004,HILD 2A,A05,922051,Staff,30,0,32,2
1748428836032,HILD 7A,A01,922063,Widener; Daniel,31,0,32,1
1748428836032,HILD 7A,A02,922066,Widener; Daniel,31,0,32,1
1748428836032,HILD 7A,A03,922067,Widener; Daniel,32,0,32,0
1748428836032,HILD 7A,A04,922070,Widener; Daniel,28,0,32,4
1748428836032,HILD 7A,A05,922072,Widener; Daniel,32,0,32,0
1748428836032,HILD 7A,A06,922074,Widener; Daniel,32,0,32,0
1748428836032,HILD 7A,A07,922078,Widener; Daniel,29,0,32,3
1748428836032,HILD 7A,A08,922080,Widener; Daniel,32,0,32,0
1748428836032,HILD 7A,A09,922081,Widener; Daniel,32,0,32,0
1748428836032,HILD 7A,A10,922082,Widener; Daniel,32,0,32,0
1748428836032,HILD 7A,A11,922083,Widener; Daniel,32,0,32,0
1748428836032,HILD 7A,A12,922084,Widener; Daniel,32,0,32,0
1748428837062,HILD 10,A01,922089,Muscolino; Micah S,30,0,32,2
1748428837062,HILD 10,A02,922090,Muscolino; Micah S,28,0,32,4
1748428837062,HILD 10,A03,922092,Muscolino; Micah S,31,0,32,1
1748428837062,HILD 10,A04,922095,Muscolino; Micah S,30,0,32,2
1748428838092,HILD 14,A01,959886,Murillo; Dana V.,26,0,32,6
1748428838092,HILD 14,A02,959887,Murillo; Dana V.,32,0,32,0
1748428839123,HINE 144,A00,922132,Provence; Michael,40,0,45,5
1748428840149,HINE 186,A00,922133,Provence; Michael,15,0,15,0
1748428841176,HISA 110,A00,922136,De; Aniket,38,0,45,7
1748428842205,HISA 122,A00,959884,De; Aniket,12,0,15,3
1748428843237,HISC 107,A00,922137,Golan; Tal,41,0,45,4
1748428844265,HISC 131,A00,922148,Golan; Tal,45,0,51,6
1748428845293,HITO 87,A00,922097,Patterson; Patrick H.,0,0,0,0
1748428845293,HITO 87,B00,922098,Patterson; Patrick H.,0,0,0,0
1748428846320,HITO 100,A00,922150,Martinez-Matsuda; Veronica,0,0,17,17
1748428847348,HITO 193,A00,954127,Hill; Seth J,9999,0,9999,0
1748428848377,HITO 194,001,970059,Hertz; Deborah,1,0,1,0
1748428848377,HITO 194,002,970084,Daly; Heather Marie,1,0,1,0
1748428848377,HITO 194,003,970086,Plant; Rebecca Jo,1,0,1,0
1748428848377,HITO 194,004,970093,Henry; Todd A.,1,0,1,0
1748428848377,HITO 194,005,970094,Biess; Frank Peter,1,0,1,0
1748428848377,HITO 194,006,970095,Shafir; Nir,1,0,1,0
1748428848377,HITO 194,007,970099,Martinez-Matsuda; Veronica,1,0,1,0
1748428848377,HITO 194,008,970101,De; Aniket,1,0,1,0
1748428848377,HITO 194,009,970126,Kwak; Nancy,1,0,1,0
1748428848377,HITO 194,010,970128,Muscolino; Micah S,1,0,1,0
1748428848377,HITO 194,011,970129,Hendrickson; Gerald M.,1,0,1,0
1748428848377,HITO 194,012,970132,Balberg; Mira,1,0,1,0
1748428849403,HITO 196,A00,922151,Man; Simeon S,14,0,22,8
1748428850431,HIUS 105,A00,922152,Bermudez; Rosie Cano,22,0,35,13
1748428851458,HIUS 106,A00,922154,Bermudez; Rosie Cano,52,0,65,13
1748428852485,HIUS 144,A00,922156,Daly; Heather Marie,31,0,35,4
1748428853510,HIUS 158,A00,922163,Frank; Ross H.,12,0,20,8
1748428854539,HIUS 181,A00,922187,Daly; Heather Marie,8,0,15,7
1748428855568,HIUS 281,A00,922264,Daly; Heather Marie,0,0,0,0
1748428856598,HUM 1,A01,946360,Markman; Kristina,14,0,15,1
1748428856598,HUM 1,A02,946361,Markman; Kristina,12,0,15,3
1748428856598,HUM 1,A03,946362,Markman; Kristina,14,0,15,1
1748428856598,HUM 1,A04,946363,Markman; Kristina,11,0,15,4
1748428856598,HUM 1,A05,946364,Markman; Kristina,14,0,15,1
1748428856598,HUM 1,A06,946365,Markman; Kristina,14,0,15,1
1748428856598,HUM 1,A07,946366,Markman; Kristina,14,0,15,1
1748428856598,HUM 1,A08,946367,Markman; Kristina,12,0,15,3
1748428856598,HUM 1,A09,946368,Markman; Kristina,13,0,15,2
1748428856598,HUM 1,A10,946369,Markman; Kristina,11,0,15,4
1748428856598,HUM 1,A11,946370,Markman; Kristina,6,0,15,9
1748428856598,HUM 1,A12,946371,Markman; Kristina,15,0,15,0
1748428857642,HUM 3,A01,946373,West; Geoffrey Scott,20,0,28,8
1748428857642,HUM 3,A02,946374,West; Geoffrey Scott,14,0,28,14
1748428857642,HUM 3,A03,946375,West; Geoffrey Scott,13,0,28,15
1748428857642,HUM 3,A04,946376,West; Geoffrey Scott,9,0,28,19
1748428857642,HUM 3,A05,946377,West; Geoffrey Scott,8,0,28,20
1748428857642,HUM 3,A06,946378,West; Geoffrey Scott,22,0,28,6
1748428857642,HUM 3,A07,946379,West; Geoffrey Scott,23,0,28,5
1748428857642,HUM 3,A08,946380,West; Geoffrey Scott,15,0,28,13
1748428857642,HUM 3,A09,946381,West; Geoffrey Scott,0,0,0,0
1748428857642,HUM 3,A10,946382,West; Geoffrey Scott,0,0,0,0
1748428857642,HUM 3,C01,946393,Crum; Matthew Stephen,0,0,0,0
1748428857642,HUM 3,C02,946394,Crum; Matthew Stephen,0,0,0,0
1748428857642,HUM 3,C03,946395,Crum; Matthew Stephen,17,0,28,11
1748428857642,HUM 3,C04,946396,Crum; Matthew Stephen,25,0,28,3
1748428857642,HUM 3,C05,946397,Crum; Matthew Stephen,16,0,28,12
1748428857642,HUM 3,C06,946398,Crum; Matthew Stephen,20,0,28,8
1748428857642,HUM 3,C07,946399,Crum; Matthew Stephen,24,0,28,4
1748428857642,HUM 3,C08,946400,Crum; Matthew Stephen,26,0,28,2
1748428857642,HUM 3,C09,946401,Crum; Matthew Stephen,18,0,28,10
1748428857642,HUM 3,C10,946402,Crum; Matthew Stephen,22,0,28,6
1748428857642,HUM 3,D01,946404,Rodriguez; Bretton Sigfred,4,0,28,24
1748428857642,HUM 3,D02,946405,Rodriguez; Bretton Sigfred,16,0,28,12
1748428857642,HUM 3,D03,946406,Rodriguez; Bretton Sigfred,25,0,28,3
1748428857642,HUM 3,D04,946407,Rodriguez; Bretton Sigfred,12,0,28,16
1748428857642,HUM 3,D05,946408,Rodriguez; Bretton Sigfred,12,0,28,16
1748428857642,HUM 3,D06,946409,Rodriguez; Bretton Sigfred,19,0,28,9
1748428857642,HUM 3,D07,946410,Rodriguez; Bretton Sigfred,0,0,0,0
1748428857642,HUM 3,D08,946411,Rodriguez; Bretton Sigfred,0,0,0,0
1748428857642,HUM 3,D09,946412,Rodriguez; Bretton Sigfred,7,0,28,21
1748428857642,HUM 3,D10,946413,Rodriguez; Bretton Sigfred,20,0,28,8
1748428858670,HUM 88,A00,969578,Markman; Kristina,0,0,0,0
1748428859699,HUM 100,A00,946414,West; Geoffrey Scott,14,0,16,2
1748428859699,HUM 100,B00,946415,West; Geoffrey Scott,15,0,16,1
1748428859699,HUM 100,C00,946416,Zavodny; Tatiana Sophia,13,0,16,3
1748428859699,HUM 100,D00,946417,Zavodny; Tatiana Sophia,15,0,16,1
1748428859699,HUM 100,E00,946419,Zavodny; Tatiana Sophia,15,0,16,1
1748428859699,HUM 100,F00,946420,Crum; Matthew Stephen,0,0,0,0
1748428859699,HUM 100,G00,946421,Crum; Matthew Stephen,0,0,0,0
1748428859699,HUM 100,H00,946422,Crum; Matthew Stephen,16,0,16,0
1748428859699,HUM 100,I00,946424,Staff,0,0,0,0
1748428859699,HUM 100,J00,946425,Crum; Matthew Stephen,16,0,16,0
1748428859699,HUM 100,K00,946426,Staff,0,0,0,0
1748428860735,INTL 100,A01,960908,Feuer; Anna Stagg,9,0,20,11
1748428860735,INTL 100,A02,960964,Feuer; Anna Stagg,16,0,20,4
1748428860735,INTL 100,A03,961088,Feuer; Anna Stagg,15,0,20,5
1748428860735,INTL 100,A04,961091,Feuer; Anna Stagg,17,0,20,3
1748428860735,INTL 100,A05,961100,Feuer; Anna Stagg,16,0,20,4
1748428860735,INTL 100,A06,961130,Feuer; Anna Stagg,19,0,20,1
1748428861768,INTL 101,A01,923053,McIntosh; Justin,1,0,30,29
1748428861768,INTL 101,A02,923055,McIntosh; Justin,8,0,30,22
1748428861768,INTL 101,A03,923127,McIntosh; Justin,5,0,30,25
1748428861768,INTL 101,A04,923140,McIntosh; Justin,0,0,30,30
1748428861768,INTL 101,A05,923148,McIntosh; Justin,9,0,30,21
1748428861768,INTL 101,A06,923186,McIntosh; Justin,10,0,30,20
1748428862795,INTL 102,A01,923194,Prather; Lauren R,3,0,30,27
1748428862795,INTL 102,A02,923195,Prather; Lauren R,4,0,30,26
1748428862795,INTL 102,A03,923199,Prather; Lauren R,13,0,30,17
1748428862795,INTL 102,A04,923202,Prather; Lauren R,7,0,30,23
1748428863824,INTL 190,A00,923203,Segui; Alan S,0,0,0,5
1748428863824,INTL 190,B00,923205,Segui; Alan S,0,0,0,9
1748428863824,INTL 190,C00,923219,Lee; Munseob,0,0,0,5
1748428864850,INTL 190H,A00,923247,Feuer; Anna Stagg,0,0,0,1
1748428865888,JAPN 10A,A01,923258,Kamioka; Sachiko,22,0,23,1
1748428865888,JAPN 10A,B01,923261,Ross; Kayoko F,23,0,23,0
1748428865888,JAPN 10A,C01,923265,Sato; Kyoko,20,0,23,3
1748428865888,JAPN 10A,D01,923268,Inada; Minori,22,0,23,1
1748428865888,JAPN 10A,E01,923270,Tipton; Yuko,9,0,12,3
1748428865888,JAPN 10A,E02,923273,Tipton; Yuko,12,0,12,0
1748428865888,JAPN 10A,F01,923352,Ross; Kayoko F,11,0,12,1
1748428865888,JAPN 10A,F02,923355,Ross; Kayoko F,12,0,12,0
1748428865888,JAPN 10A,G01,923358,McKee; Mayumi Mochizuki,7,0,10,3
1748428865888,JAPN 10A,G02,923360,McKee; Mayumi Mochizuki,6,0,10,4
1748428865888,JAPN 10A,H01,923365,Sato; Kyoko,8,0,12,4
1748428865888,JAPN 10A,H02,923370,Sato; Kyoko,12,0,12,0
1748428865888,JAPN 10A,I01,923373,Inada; Minori,8,0,12,4
1748428865888,JAPN 10A,I02,923374,Inada; Minori,8,0,12,4
1748428865888,JAPN 10A,J01,923376,McKee; Mayumi Mochizuki,11,0,12,1
1748428865888,JAPN 10A,J02,923428,McKee; Mayumi Mochizuki,11,0,12,1
1748428865888,JAPN 10A,K01,923433,Tipton; Yuko,5,0,10,5
1748428865888,JAPN 10A,K02,923437,Tipton; Yuko,9,0,10,1
1748428865888,JAPN 10A,L01,923439,Sato; Kyoko,12,0,12,0
1748428865888,JAPN 10A,L02,923449,Sato; Kyoko,11,0,12,1
1748428865888,JAPN 10A,M01,923455,Kamioka; Sachiko,22,0,23,1
1748428865888,JAPN 10A,N01,923459,McKee; Mayumi Mochizuki,22,0,23,1
1748428866916,JAPN 10AR,A01,923462,Tipton; Yuko,17,0,20,3
1748428867949,JAPN 20A,A01,923470,Takeda; Izumi,21,0,23,2
1748428867949,JAPN 20A,B01,923473,Iwamoto; Naoki,9,0,12,3
1748428867949,JAPN 20A,B02,923475,Iwamoto; Naoki,6,0,12,6
1748428867949,JAPN 20A,C01,923519,Takeda; Izumi,0,0,12,12
1748428867949,JAPN 20A,C02,923520,Takeda; Izumi,4,0,12,8
1748428867949,JAPN 20A,D01,923623,Iwamoto; Naoki,11,0,12,1
1748428867949,JAPN 20A,D02,923625,Iwamoto; Naoki,11,0,12,1
1748428867949,JAPN 20A,E01,923627,Simpson; Junko Tokuda,12,0,20,8
1748428868980,JAPN 130A,A01,923630,Kamioka; Sachiko,14,0,15,1
1748428868980,JAPN 130A,B01,923634,Ross; Kayoko F,11,0,15,4
1748428870007,JAPN 135A,A00,923636,Iwamoto; Naoki,10,0,20,10
1748428871034,JAPN 137A,A00,923638,Simpson; Junko Tokuda,19,0,20,1
1748428872061,JAPN 140A,A00,923640,Takeda; Izumi,18,0,20,2
1748428873089,JWSP 1,A01,921258,Shuster; Alana,19,0,20,1
1748428874120,JWSP 104,A01,921340,Shuster; Alana,15,0,15,0
1748428875151,LATI 10,A01,923694,Kennemore; Amy Michelle,22,0,28,6
1748428875151,LATI 10,A02,923695,Kennemore; Amy Michelle,25,0,28,3
1748428875151,LATI 10,A03,923707,Kennemore; Amy Michelle,25,0,28,3
1748428875151,LATI 10,A04,923713,Kennemore; Amy Michelle,27,0,28,1
1748428875151,LATI 10,A05,923720,Kennemore; Amy Michelle,28,0,28,0
1748428875151,LATI 10,A06,923723,Kennemore; Amy Michelle,30,0,30,0
1748428875151,LATI 10,A07,923745,Kennemore; Amy Michelle,26,0,30,4
1748428876179,LATI 50,A01,923778,Kokinis; Troy Andreas,27,0,30,3
1748428876179,LATI 50,A02,923779,Kokinis; Troy Andreas,28,0,30,2
1748428876179,LATI 50,A03,923780,Kokinis; Troy Andreas,29,0,30,1
1748428876179,LATI 50,A04,923783,Kokinis; Troy Andreas,28,0,30,2
1748428876179,LATI 50,A05,923784,Kokinis; Troy Andreas,30,0,30,0
1748428877205,LATI 166,A00,923785,Kokinis; Troy Andreas,117,0,120,3
1748428878236,LATI 170,A00,923787,Kennemore; Amy Michelle,45,0,60,15
1748428879266,LATI 180,A00,923788,Kennemore; Amy Michelle,52,0,60,8
1748428880295,LATI 184,A00,923790,Jimenez Cano; Nayeli Guada,29,0,30,1
1748428881322,LATI 200,A00,923791,Martin-Cabrera; Luis,7,0,10,3
1748428882354,LIAB 1A,A00,923983,Saab; Dima,12,0,14,2
1748428882354,LIAB 1A,B00,923984,Saab; Dima,8,0,14,6
1748428883379,LIAB 1AX,A00,923992,El Cheddadi; Youniss,25,0,28,3
1748428884408,LIAB 1D,A00,923996,Saab; Dima,7,0,14,7
1748428885437,LIAB 1DX,A00,923998,El Cheddadi; Youniss,10,0,14,4
1748428886466,LIFR 1A,A00,923999,Van Moer; Vinciane G,14,0,14,0
1748428886466,LIFR 1A,B00,924001,Van Moer; Vinciane G,14,0,14,0
1748428886466,LIFR 1A,C00,924003,Van Moer; Vinciane G,13,0,14,1
1748428886466,LIFR 1A,D00,924039,Van Moer; Vinciane G,12,0,14,2
1748428886466,LIFR 1A,E00,924044,Van Moer; Vinciane G,12,0,14,2
1748428886466,LIFR 1A,F00,924100,Van Moer; Vinciane G,10,0,14,4
1748428887494,LIFR 1AX,A00,924134,Van Moer; Vinciane G,26,0,28,2
1748428887494,LIFR 1AX,B00,924138,Van Moer; Vinciane G,24,0,28,4
1748428887494,LIFR 1AX,C00,924196,Van Moer; Vinciane G,26,0,28,2
1748428888522,LIFR 1B,A00,924197,Van Moer; Vinciane G,11,0,14,3
1748428888522,LIFR 1B,B00,924199,Van Moer; Vinciane G,11,0,14,3
1748428889551,LIFR 1BX,A00,924215,Van Moer; Vinciane G,23,0,28,5
1748428890578,LIFR 1D,A00,924216,Van Moer; Vinciane G,11,0,14,3
1748428890578,LIFR 1D,B00,924217,Van Moer; Vinciane G,12,0,14,2
1748428890578,LIFR 1D,C00,924218,Van Moer; Vinciane G,3,0,14,11
1748428891609,LIFR 1DX,A00,924219,Van Moer; Vinciane G,14,0,21,7
1748428891609,LIFR 1DX,B00,924220,Van Moer; Vinciane G,13,0,21,8
1748428892637,LIFR 11,A00,924221,Goodall; Grant Todd,10,0,10,0
1748428893665,LIGM 1A,A00,924222,Fischer-Grunski; Eva K,11,0,14,3
1748428893665,LIGM 1A,B00,924223,Fischer-Grunski; Eva K,13,0,14,1
1748428893665,LIGM 1A,C00,924224,Fischer-Grunski; Eva K,11,0,14,3
1748428893665,LIGM 1A,D00,924227,Fischer-Grunski; Eva K,11,0,14,3
1748428894695,LIGM 1AX,A00,924228,Fischer-Grunski; Eva K,28,0,28,0
1748428894695,LIGM 1AX,B00,924229,Fischer-Grunski; Eva K,19,0,28,9
1748428895721,LIGM 1D,A00,924230,Fischer-Grunski; Eva K,0,0,0,0
1748428895721,LIGM 1D,B00,924231,Fischer-Grunski; Eva K,12,0,14,2
1748428896748,LIGM 1DX,A00,924232,Fischer-Grunski; Eva K,0,0,0,0
1748428897785,LIGM 11,A00,924233,Goodall; Grant Todd,10,0,10,0
1748428898813,LIGN 5,A00,923794,Goodall; Grant Todd,112,0,120,8
1748428899844,LIGN 7,A00,923796,Mayberry; Rachel,115,0,120,5
1748428900870,LIGN 8,A00,923797,McIntosh; Justin,231,0,245,14
1748428901897,LIGN 17,A00,923798,Staff,232,0,245,13
1748428902931,LIGN 101,A01,923929,Bakovic; Eric John,26,0,30,4
1748428902931,LIGN 101,A02,923930,Bakovic; Eric John,26,0,30,4
1748428902931,LIGN 101,A04,923935,Bakovic; Eric John,19,0,30,11
1748428902931,LIGN 101,A05,923940,Bakovic; Eric John,23,0,30,7
1748428903967,LIGN 108,A00,923942,Rose; Sharon,29,0,35,6
1748428904998,LIGN 110,A01,923944,Garellek; Marc,15,0,27,12
1748428904998,LIGN 110,A02,923947,Garellek; Marc,14,0,27,13
1748428904998,LIGN 110,A03,923948,Garellek; Marc,20,0,27,7
1748428904998,LIGN 110,A04,923949,Garellek; Marc,4,0,27,23
1748428906025,LIGN 152,A00,967971,Caballero; Gabriela Hernandez,17,0,30,13
1748428907052,LIGN 160,A00,963083,Dudley; Rachel,39,0,50,11
1748428908079,LIGN 167,A00,923951,Warstadt; Alexander Scott,0,0,90,90
1748428909114,LIGN 179,A00,923955,Kluender; Robert,0,0,35,35
1748428910141,LIGN 188R,A00,923956,Clem; Emily,40,0,40,0
1748428911167,LIGN 200,A00,973075,Staff,0,0,0,0
1748428912194,LIGN 210,A00,923962,Garellek; Marc,10,0,10,0
1748428913218,LIGN 221,A00,923964,Clem; Emily,9,0,10,1
1748428914247,LIGN 236,A00,923965,Clem; Emily,8,0,10,2
1748428915277,LIGN 293,A00,923971,Caballero; Gabriela Hernandez,0,0,0,0
1748428916308,LIGN 296,001,950061,Ackerman; Farrell,10,0,10,0
1748428916308,LIGN 296,002,950062,Bakovic; Eric John,10,0,10,0
1748428916308,LIGN 296,003,950063,Bergen; Leon,10,0,10,0
1748428916308,LIGN 296,004,950064,Caballero; Gabriela Hernandez,10,0,10,0
1748428916308,LIGN 296,005,950065,Caponigro; Ivano,10,0,10,0
1748428916308,LIGN 296,006,950066,Clem; Emily,10,0,10,0
1748428916308,LIGN 296,007,950067,Dudley; Rachel,10,0,10,0
1748428916308,LIGN 296,008,950068,Garellek; Marc,10,0,10,0
1748428916308,LIGN 296,009,950070,Goodall; Grant Todd,9,0,10,1
1748428916308,LIGN 296,010,950071,Kehler; Andrew Scott,10,0,10,0
1748428916308,LIGN 296,011,950072,Kluender; Robert,10,0,10,0
1748428916308,LIGN 296,012,950073,Rose; Sharon,10,0,10,0
1748428916308,LIGN 296,013,950074,Styler; William Francis,10,0,10,0
1748428916308,LIGN 296,014,950075,Caponigro; Ivano,10,0,10,0
1748428917338,LIHL 112F,A00,923972,Pagkalinawan; Leticia Cant,15,0,28,13
1748428918364,LIHL 114F,A00,923973,Nguyen; Hoan Thi,8,0,28,20
1748428919391,LIHL 117F,A00,923974,Sadegholvad; Elham,19,0,20,1
1748428920419,LIHL 118,A00,923975,Chen; Areana Yen,23,0,28,5
1748428921446,LIHL 124F,A00,923976,Nguyen; Hoan Thi,17,0,20,3
1748428922474,LIHL 132F,A00,923978,Pagkalinawan; Leticia Cant,18,0,20,2
1748428923558,LIHL 134F,A00,923980,Nguyen; Hoan Thi,19,0,20,1
1748428924588,LIHL 138,A00,923982,Chen; Areana Yen,28,0,28,0
1748428925615,LIIT 1A,A00,924234,Carnelos; Chiara,11,0,14,3
1748428925615,LIIT 1A,B00,924235,Carnelos; Chiara,11,0,14,3
1748428925615,LIIT 1A,C00,924236,Carnelos; Chiara,13,0,14,1
1748428925615,LIIT 1A,D00,924237,Carnelos; Chiara,12,0,14,2
1748428926647,LIIT 1AX,A00,924238,Carnelos; Chiara,28,0,28,0
1748428926647,LIIT 1AX,B00,924239,Carnelos; Chiara,24,0,28,4
1748428927673,LIPO 1A,A00,924241,Paladini; Denise,13,0,14,1
1748428927673,LIPO 1A,B00,924242,Paladini; Denise,14,0,14,0
1748428928698,LIPO 1AX,A00,924243,De Abreu; Cassia,13,0,14,1
1748428928698,LIPO 1AX,B00,924244,De Abreu; Cassia,14,0,14,0
1748428929727,LIPO 1D,A00,924245,Paladini; Denise,11,0,14,3
1748428930753,LIPO 1DX,A00,924248,De Abreu; Cassia,14,0,14,0
1748428931784,LISL 1A,A00,924249,Lott; Margaret S.,9,0,14,5
1748428931784,LISL 1A,B00,924250,Lott; Margaret S.,11,0,14,3
1748428931784,LISL 1A,C00,924252,Lott; Margaret S.,7,0,14,7
1748428931784,LISL 1A,D00,924253,Lott; Margaret S.,12,0,14,2
1748428931784,LISL 1A,E00,924254,Lott; Margaret S.,4,0,14,10
1748428931784,LISL 1A,F00,924255,Lott; Margaret S.,13,0,14,1
1748428932814,LISL 1AR,A00,924257,Lott; Margaret S.,11,0,15,4
1748428932814,LISL 1AR,B00,924258,Lott; Margaret S.,10,0,15,5
1748428932814,LISL 1AR,C00,924260,Lott; Margaret S.,9,0,15,6
1748428932814,LISL 1AR,D00,968060,Lott; Margaret S.,3,0,3,0
1748428932814,LISL 1AR,E00,968061,Lott; Margaret S.,3,0,3,0
1748428932814,LISL 1AR,F00,968062,Lott; Margaret S.,3,0,3,0
1748428933849,LISL 1AX,A00,924261,Lott; Margaret S.,28,0,28,0
1748428933849,LISL 1AX,B00,924262,Lott; Margaret S.,18,0,28,10
1748428933849,LISL 1AX,C00,924263,Lott; Margaret S.,21,0,28,7
1748428934886,LISL 1B,A00,924264,Lott; Margaret S.,13,0,14,1
1748428934886,LISL 1B,B00,924265,Lott; Margaret S.,6,0,14,8
1748428934886,LISL 1B,C00,924302,Lott; Margaret S.,9,0,14,5
1748428934886,LISL 1B,D00,924304,Lott; Margaret S.,7,0,14,7
1748428934886,LISL 1B,E00,924305,Lott; Margaret S.,10,0,14,4
1748428934886,LISL 1B,F00,964375,Lott; Margaret S.,12,0,14,2
1748428935919,LISL 1BX,A00,924307,Lott; Margaret S.,12,0,28,16
1748428935919,LISL 1BX,B00,924308,Lott; Margaret S.,20,0,28,8
1748428935919,LISL 1BX,C00,924314,Lott; Margaret S.,28,0,28,0
1748428936948,LISL 1D,A00,924316,Lott; Margaret S.,0,0,14,14
1748428936948,LISL 1D,B00,924317,Lott; Margaret S.,0,0,14,14
1748428936948,LISL 1D,C00,924319,Lott; Margaret S.,0,0,14,14
1748428936948,LISL 1D,D00,924321,Lott; Margaret S.,0,0,14,14
1748428937987,LISL 1DX,A00,924323,Lott; Margaret S.,0,0,28,28
1748428937987,LISL 1DX,B00,924365,Lott; Margaret S.,0,0,28,28
1748428939019,LISP 1A,A00,924370,Munoz Sanchez; Alicia,12,0,14,2
1748428939019,LISP 1A,B00,924372,Munoz Sanchez; Alicia,8,0,14,6
1748428939019,LISP 1A,C00,924401,Munoz Sanchez; Alicia,0,0,14,14
1748428939019,LISP 1A,D00,924406,Munoz Sanchez; Alicia,3,0,14,11
1748428939019,LISP 1A,E00,924471,Munoz Sanchez; Alicia,0,0,14,14
1748428939019,LISP 1A,F00,924472,Munoz Sanchez; Alicia,4,0,14,10
1748428939019,LISP 1A,G00,924473,Munoz Sanchez; Alicia,11,0,14,3
1748428939019,LISP 1A,H00,924474,Munoz Sanchez; Alicia,9,0,14,5
1748428940046,LISP 1AX,A00,924478,Munoz Sanchez; Alicia,16,0,28,12
1748428940046,LISP 1AX,B00,924479,Munoz Sanchez; Alicia,26,0,28,2
1748428940046,LISP 1AX,C00,924484,Munoz Sanchez; Alicia,12,0,28,16
1748428940046,LISP 1AX,D00,924491,Munoz Sanchez; Alicia,18,0,28,10
1748428941088,LISP 1B,A00,924492,Munoz Sanchez; Alicia,12,0,14,2
1748428941088,LISP 1B,B00,924493,Munoz Sanchez; Alicia,6,0,14,8
1748428941088,LISP 1B,C00,924498,Munoz Sanchez; Alicia,13,0,14,1
1748428941088,LISP 1B,D00,924501,Munoz Sanchez; Alicia,13,0,14,1
1748428941088,LISP 1B,E00,924505,Munoz Sanchez; Alicia,11,0,14,3
1748428941088,LISP 1B,F00,924506,Munoz Sanchez; Alicia,9,0,14,5
1748428941088,LISP 1B,G00,924507,Munoz Sanchez; Alicia,10,0,14,4
1748428941088,LISP 1B,H00,924549,Munoz Sanchez; Alicia,12,0,14,2
1748428941088,LISP 1B,I00,924566,Munoz Sanchez; Alicia,13,0,14,1
1748428941088,LISP 1B,J00,924572,Munoz Sanchez; Alicia,13,0,14,1
1748428941088,LISP 1B,K00,924576,Munoz Sanchez; Alicia,12,0,14,2
1748428941088,LISP 1B,L00,924577,Munoz Sanchez; Alicia,13,0,14,1
1748428942127,LISP 1BX,A00,924578,Munoz Sanchez; Alicia,26,0,28,2
1748428942127,LISP 1BX,B00,924618,Munoz Sanchez; Alicia,24,0,28,4
1748428942127,LISP 1BX,C00,924619,Munoz Sanchez; Alicia,20,0,28,8
1748428942127,LISP 1BX,D00,924629,Munoz Sanchez; Alicia,24,0,28,4
1748428942127,LISP 1BX,E00,924635,Munoz Sanchez; Alicia,24,0,28,4
1748428942127,LISP 1BX,F00,924640,Munoz Sanchez; Alicia,27,0,28,1
1748428943165,LISP 1D,A00,924641,Munoz Sanchez; Alicia,10,0,14,4
1748428943165,LISP 1D,B00,924649,Munoz Sanchez; Alicia,10,0,14,4
1748428943165,LISP 1D,C00,924654,Munoz Sanchez; Alicia,11,0,14,3
1748428943165,LISP 1D,D00,924660,Munoz Sanchez; Alicia,7,0,14,7
1748428943165,LISP 1D,E00,924671,Munoz Sanchez; Alicia,5,0,14,9
1748428943165,LISP 1D,F00,924722,Munoz Sanchez; Alicia,6,0,14,8
1748428943165,LISP 1D,G00,924724,Munoz Sanchez; Alicia,8,0,14,6
1748428943165,LISP 1D,H00,924726,Munoz Sanchez; Alicia,9,0,14,5
1748428943165,LISP 1D,I00,924728,Munoz Sanchez; Alicia,13,0,14,1
1748428943165,LISP 1D,J00,924732,Munoz Sanchez; Alicia,14,0,14,0
1748428943165,LISP 1D,K00,924739,Munoz Sanchez; Alicia,13,0,14,1
1748428943165,LISP 1D,L00,924745,Munoz Sanchez; Alicia,12,0,14,2
1748428944201,LISP 1DX,A00,924747,Munoz Sanchez; Alicia,23,0,28,5
1748428944201,LISP 1DX,B00,924818,Munoz Sanchez; Alicia,27,0,28,1
1748428944201,LISP 1DX,C00,924819,Munoz Sanchez; Alicia,16,0,28,12
1748428944201,LISP 1DX,D00,924820,Munoz Sanchez; Alicia,23,0,28,5
1748428944201,LISP 1DX,E00,924821,Munoz Sanchez; Alicia,16,0,28,12
1748428944201,LISP 1DX,F00,924822,Munoz Sanchez; Alicia,22,0,28,6
1748428945228,LISP 15,A00,924823,Munoz Sanchez; Alicia,17,0,20,3
1748428946257,LISP 18,A00,924824,Munoz Sanchez; Alicia,14,0,20,6
1748428947292,LTAF 120,A00,925431,Zhiri; Oumelbanine,37,0,40,3
1748428948319,LTAM 100,A00,925432,Villafuerte Vazquez; Nadia,33,0,40,7
1748428949354,LTCH 101,A00,964372,Liao; Ping H,35,0,40,5
1748428950383,LTCO 285,A00,925806,Glaser; Amelia,0,0,0,0
1748428951415,LTCS 10,A00,924830,Bessett; Ryan Matthew,39,0,40,1
1748428952445,LTCS 87,A00,969580,Nguyen; Hoang Tan,20,0,20,0
1748428952445,LTCS 87,B00,969581,Nguyen; Hoang Tan,20,0,20,0
1748428953473,LTCS 130,A00,925434,Kim; Joo Ok,36,0,40,4
1748428954501,LTCS 150,A00,925435,Mendoza; Andrea,36,0,40,4
1748428955539,LTCS 250,A00,925807,Sanchez Cruz; Jorge,9,0,15,6
1748428956571,LTEA 120A,A00,925438,Fiss; Geraldine Anna,16,0,40,24
1748428957598,LTEA 120B,A00,925439,Liao; Ping H,211,0,225,14
1748428958627,LTEA 132,A00,925441,Mendoza; Andrea,66,0,75,9
1748428959655,LTEA 143,A00,925443,Lee; Jin-Kyung,72,0,75,3
1748428960682,LTEA 145,A00,925444,Lee; Jin-Kyung,39,0,40,1
1748428961708,LTEN 21,A01,924832,Vitkus; Daniel J.,23,0,28,5
1748428961708,LTEN 21,A02,924833,Vitkus; Daniel J.,28,0,28,0
1748428962735,LTEN 28,A01,924835,Suzuki; Erin M.,26,0,28,2
1748428962735,LTEN 28,A02,924836,Suzuki; Erin M.,25,0,28,3
1748428962735,LTEN 28,A03,924837,Suzuki; Erin M.,25,0,28,3
1748428962735,LTEN 28,A04,924838,Suzuki; Erin M.,28,0,28,0
1748428962735,LTEN 28,A05,924839,Suzuki; Erin M.,28,0,28,0
1748428962735,LTEN 28,A06,924840,Suzuki; Erin M.,28,0,28,0
1748428962735,LTEN 28,A07,924841,Suzuki; Erin M.,28,0,28,0
1748428962735,LTEN 28,A08,924842,Suzuki; Erin M.,28,0,28,0
1748428963760,LTEN 113,A00,925449,Vitkus; Daniel J.,31,0,40,9
1748428964791,LTEN 152,A00,925450,Staff,13,0,40,27
1748428965818,LTEN 169,A00,925451,Ruiz; Ariana,34,0,40,6
1748428966856,LTEN 180,A00,925452,Ruiz; Ariana,9,0,20,11
1748428967882,LTEN 181,A00,925453,Suzuki; Erin M.,27,0,40,13
1748428968921,LTEN 185,A00,963086,Staff,23,0,25,2
1748428969968,LTEN 189,A00,925458,Vijay; Ameeth Varma,35,0,40,5
1748428971004,LTEN 271,A00,925808,Garofalo; Devin,13,0,15,2
1748428972044,LTEU 140,A00,925459,De Marchi Gherini; Adriana,33,0,40,7
1748428973085,LTEU 154,A00,925461,Morse; Ainsley,25,0,30,5
1748428974145,LTFR 2A,A01,924916,Ploye; Catherine,20,0,25,5
1748428975186,LTFR 2B,A01,924920,Ploye; Catherine,25,0,25,0
1748428976212,LTFR 104,A00,925462,Ploye; Catherine,25,0,25,0
1748428977238,LTGK 1,A00,924923,Murray; Kourtney Kristine,34,0,40,6
1748428978265,LTGK 104,A00,925465,Myerston Santana; Jacobo,29,0,30,1
1748428979292,LTGM 2A,A01,924926,Fischer-Grunski; Eva K,19,0,25,6
1748428980339,LTIT 2A,A01,925054,De Marchi Gherini; Adriana,19,0,25,6
1748428981372,LTKO 1A,A01,925085,Cho; Hye Jin,25,0,28,3
1748428981372,LTKO 1A,B01,925182,Cho; Hye Jin,25,0,28,3
1748428981372,LTKO 1A,C01,925210,Cho; Hye Jin,23,0,28,5
1748428981372,LTKO 1A,D01,925229,Staff,27,0,28,1
1748428981372,LTKO 1A,E01,925246,Staff,25,0,28,3
1748428981372,LTKO 1A,F01,925248,Yim; Nancy,26,0,28,2
1748428981372,LTKO 1A,G01,925323,Yim; Nancy,26,0,28,2
1748428981372,LTKO 1A,H01,925331,Yim; Nancy,25,0,28,3
1748428982402,LTKO 2A,A01,925333,Jung; Ji Yun,14,0,28,14
1748428982402,LTKO 2A,B01,925335,Jung; Ji Yun,24,0,28,4
1748428982402,LTKO 2A,C01,925338,Lee; Jeyseon,26,0,28,2
1748428983428,LTKO 130F,A00,925468,Lee; Jeyseon,22,0,25,3
1748428984471,LTLA 1,A00,925339,Murray; Kourtney Kristine,0,0,20,20
1748428985497,LTLA 100,A00,925470,Murray; Kourtney Kristine,39,0,40,1
1748428986526,LTRU 1A,A01,925342,Wells; Patricia Rebecca,22,0,28,6
1748428987552,LTRU 2A,A01,925345,Wells; Patricia Rebecca,19,0,20,1
1748428988591,LTRU 104B,A01,925473,Wells; Patricia Rebecca,20,0,20,0
1748428989640,LTRU 150,A00,925474,Morse; Ainsley,10,0,10,0
1748428990682,LTSP 2A,A01,925347,Staff,22,0,28,6
1748428990682,LTSP 2A,B01,925349,Staff,24,0,28,4
1748428991709,LTSP 2B,A01,925351,Staff,17,0,28,11
1748428992747,LTSP 2C,A01,925353,Mastromartino; Alexandra L,22,0,28,6
1748428993784,LTSP 2F,A00,925354,Mastromartino; Alexandra L,25,0,25,0
1748428994825,LTSP 3F,A00,925355,Dominguez; Noelia,24,0,25,1
1748428994825,LTSP 3F,B00,925356,Dominguez; Noelia,22,0,25,3
1748428995852,LTSP 87,A00,925357,Bessett; Ryan Matthew,20,0,20,0
1748428996890,LTSP 100A,A00,925595,Dominguez; Noelia,21,0,25,4
1748428997918,LTSP 100F,A00,925621,Bessett; Ryan Matthew,25,0,25,0
1748428997918,LTSP 100F,B00,925623,Bessett; Ryan Matthew,25,0,25,0
1748428997918,LTSP 100F,C00,925626,Martin-Cabrera; Luis,25,0,25,0
1748428998961,LTSP 116,A00,925629,Villafuerte Vazquez; Nadia,35,0,40,5
1748428999988,LTSP 172,A00,925637,Chacon; Gloria Elizabeth,36,0,40,4
1748429001015,LTSP 174,A00,925639,Chacon; Gloria Elizabeth,34,0,40,6
1748429002043,LTTH 210A,A00,925809,Fiss; Geraldine Anna,6,0,15,9
1748429003083,LTWL 10,A00,925358,Garofalo; Devin,40,0,40,0
1748429004110,LTWL 19A,A00,925360,Myerston Santana; Jacobo,39,0,40,1
1748429005157,LTWL 101,A00,925661,Kelting; Edward William,32,0,40,8
1748429006184,LTWL 165,A00,925748,Kim; Joo Ok,40,0,40,0
1748429007210,LTWL 167,A00,964371,Glaser; Amelia,40,0,40,0
1748429008238,LTWL 183,A00,925755,Cohen; Alain J. J.,34,0,40,6
1748429009264,LTWL 194,A00,925757,Vijay; Ameeth Varma,38,0,40,2
1748429010292,LTWR 8A,A01,925362,Springer; Anna Joy,28,0,28,0
1748429010292,LTWR 8A,A02,925363,Springer; Anna Joy,23,0,28,5
1748429010292,LTWR 8A,A03,925364,Springer; Anna Joy,23,0,28,5
1748429010292,LTWR 8A,A04,925365,Springer; Anna Joy,18,0,28,10
1748429011320,LTWR 8B,A01,925368,Lopez; Casandra,18,0,28,10
1748429011320,LTWR 8B,A02,925370,Lopez; Casandra,19,0,28,9
1748429011320,LTWR 8B,A03,925371,Lopez; Casandra,28,0,28,0
1748429011320,LTWR 8B,A04,925372,Lopez; Casandra,26,0,28,2
1748429012345,LTWR 100C,A00,925759,Staff,16,0,30,14
1748429013383,LTWR 100W,A00,925760,Forbes; Camille,0,0,15,15
1748429014421,LTWR 102W,A00,925761,Lopez; Casandra,6,0,15,9
1748429015465,LTWR 104AW,A00,925762,Hoang; Lily Kim,5,0,15,10
1748429016507,LTWR 106C,A00,925764,Ali; Mohammad Kazim,22,0,30,8
1748429017534,LTWR 113C,A00,925765,Wilkinson; Marco,28,0,30,2
1748429018561,LTWR 115C,A00,925766,Ali; Mohammad Kazim,23,0,30,7
1748429019589,LTWR 124C,A00,925801,Morse; Ainsley,29,0,30,1
1748429020616,LTWR 126C,A00,925802,Forbes; Camille,28,0,30,2
1748429021651,LTWR 148,A00,925804,Wilkinson; Marco,27,0,30,3
1748429022678,LTWR 194,A00,925805,Carroll; Amy Sara,30,0,40,10
1748429023706,LTWR 215,A00,925934,Hoang; Lily Kim,13,0,20,7
1748429024743,LTWR 220,A00,925935,Springer; Anna Joy,10,0,15,5
1748429025778,MAE 2,A01,931344,Anderson; Mark Ronald,0,0,1,1
1748429025778,MAE 2,A02,931345,Anderson; Mark Ronald,0,0,1,1
1748429025778,MAE 2,A03,931347,Anderson; Mark Ronald,0,0,1,1
1748429025778,MAE 2,B01,960499,Sadeghizadeh; Zahra,0,0,1,1
1748429025778,MAE 2,B02,960500,Sadeghizadeh; Zahra,0,0,1,1
1748429025778,MAE 2,B03,960501,Sadeghizadeh; Zahra,0,0,1,1
1748429026831,MAE 3,A01,931355,Delson; Nathan Joseph,8,0,11,3
1748429026831,MAE 3,A02,931356,Delson; Nathan Joseph,10,0,11,1
1748429026831,MAE 3,A03,931357,Delson; Nathan Joseph,10,0,11,1
1748429026831,MAE 3,A04,931358,Delson; Nathan Joseph,11,0,11,0
1748429026831,MAE 3,B01,931360,Qi; Huihui,0,0,11,11
1748429026831,MAE 3,B02,931361,Qi; Huihui,5,0,11,6
1748429026831,MAE 3,B03,931362,Qi; Huihui,9,0,11,2
1748429026831,MAE 3,B04,931364,Qi; Huihui,10,0,11,1
1748429027911,MAE 8,A01,931368,Pham; Hieu Tan,90,0,100,10
1748429028939,MAE 11,A00,931369,Nomura; Keiko K.,83,0,180,97
1748429029966,MAE 20,A00,931371,Graeve; Olivia A,79,0,100,21
1748429030997,MAE 21,A01,931373,Cai; Shengqiang,1,0,10,9
1748429030997,MAE 21,A02,931375,Cai; Shengqiang,7,0,10,3
1748429030997,MAE 21,A03,931376,Cai; Shengqiang,1,0,10,9
1748429030997,MAE 21,A04,931377,Cai; Shengqiang,5,0,10,5
1748429030997,MAE 21,A05,931378,Cai; Shengqiang,10,0,10,0
1748429030997,MAE 21,A06,931381,Cai; Shengqiang,10,0,10,0
1748429030997,MAE 21,A07,931382,Cai; Shengqiang,8,0,10,2
1748429030997,MAE 21,A08,931384,Cai; Shengqiang,7,0,10,3
1748429030997,MAE 21,A09,931385,Cai; Shengqiang,8,0,10,2
1748429030997,MAE 21,A10,931386,Cai; Shengqiang,9,0,10,1
1748429032037,MAE 30A,A00,931387,Lubarda; Marko,29,0,70,41
1748429033065,MAE 40,A00,931388,Cortes; Jorge,83,0,146,63
1748429034093,MAE 101A,A00,931389,Sarkar; Sutanu,94,0,150,56
1748429035146,MAE 101C,A00,931390,Seshadri; Kalyanasundaram,175,0,200,25
1748429036172,MAE 104,A00,931391,Pham; Hieu Tan,146,0,160,14
1748429037200,MAE 105,A00,931392,Bandaru; Prabhakar,135,0,180,45
1748429038230,MAE 107,A00,931393,Chen; Renkun,0,0,90,90
1748429038230,MAE 107,B00,931394,McEneaney; William Michael,45,0,90,45
1748429039287,MAE 108,A00,931395,Hao; Xuanting,91,0,120,29
1748429040316,MAE 113,A00,931396,Seshadri; Kalyanasundaram,92,0,130,38
1748429041355,MAE 114,A00,931399,Krasheninnikov; Sergei,37,0,40,3
1748429042399,MAE 120,A00,931400,Krasheninnikov; Sergei,36,0,50,14
1748429043426,MAE 122,A00,931402,Pawlak; Geno Ronald,43,0,70,27
1748429044452,MAE 131A,A00,931403,Lubarda; Marko,46,0,70,24
1748429045479,MAE 142,A00,931404,Anderson; Mark Ronald,21,0,60,39
1748429046506,MAE 143A,A00,931406,Diagne; Mamadou Lamine,98,0,125,27
1748429047532,MAE 148,A01,931409,Silberman; Jack,11,0,30,19
1748429048576,MAE 150,A00,931411,Friend; James Robert,139,0,192,53
1748429049604,MAE 153,A00,931413,Ghazinejad; Maziar,2,0,45,43
1748429050633,MAE 156A,A01,931416,Delson; Nathan Joseph,2,0,12,10
1748429050633,MAE 156A,A02,931417,Delson; Nathan Joseph,9,0,12,3
1748429050633,MAE 156A,A03,931418,Delson; Nathan Joseph,12,0,12,0
1748429050633,MAE 156A,A04,931419,Delson; Nathan Joseph,10,0,12,2
1748429050633,MAE 156A,A05,931420,Delson; Nathan Joseph,2,0,12,10
1748429050633,MAE 156A,A06,931421,Delson; Nathan Joseph,12,0,12,0
1748429051675,MAE 165,A00,931422,Scholtes Acevedo; Claire,19,0,30,11
1748429052704,MAE 170,A01,931424,Evdokimenko; Ekaterina,9,0,30,21
1748429052704,MAE 170,A02,931427,Evdokimenko; Ekaterina,14,0,30,16
1748429052704,MAE 170,A03,931428,Evdokimenko; Ekaterina,0,0,30,30
1748429052704,MAE 170,A04,931429,Evdokimenko; Ekaterina,14,0,30,16
1748429052704,MAE 170,A05,931430,Evdokimenko; Ekaterina,27,0,30,3
1748429052704,MAE 170,A06,931434,Evdokimenko; Ekaterina,23,0,30,7
1748429053745,MAE 180,A00,931436,Sadeghizadeh; Zahra,109,0,140,31
1748429054772,MAE 181,A00,931437,Bahadori; Mohammad Yousef,53,0,80,27
1748429055803,MAE 190,A00,971317,Marinoni; Alessandro & Krasheninnikov; Sergei,19,0,20,1
1748429056830,MAE 191,A01,931442,Qi; Huihui,19,0,20,1
1748429057858,MAE 201,A00,931445,Pawlak; Geno Ronald,36,0,90,54
1748429058895,MAE 202,A00,931452,Poulikakos; Lisa Voula,42,0,90,48
1748429059936,MAE 203,A00,931455,Frazier; Michael,26,0,90,64
1748429060970,MAE 205,A00,931456,Staff,9989,0,9999,10
1748429062008,MAE 208,A00,931457,Marinoni; Alessandro,52,0,150,98
1748429063039,MAE 210A,A00,931458,Saintillan; David,37,0,60,23
1748429064065,MAE 217A,A00,931459,Arefiev; Alexey,13,0,20,7
1748429065093,MAE 221A,A00,931460,Chen; Renkun,26,0,40,14
1748429066128,MAE 232A,A00,931464,Chen; Jiun-Shyan,3,0,35,32
1748429067154,MAE 233A,A00,931466,Luan; Haiwen,29,0,40,11
1748429068182,MAE 235,A00,954132,Krysl; Petr,0,0,0,0
1748429069210,MAE 249,A00,931472,Tolley; Michael Thomas,8,0,50,42
1748429070250,MAE 251,A00,931477,Graeve; Olivia A,12,0,15,3
1748429071277,MAE 257,A00,931478,Cai; Shengqiang,0,0,10,10
1748429072304,MAE 265A,A00,931480,Bandaru; Prabhakar,10,0,15,5
1748429073335,MAE 271A,A00,931481,Luo; Jian,9,0,10,1
1748429074363,MAE 280A,A00,931482,Kramer; Boris,61,0,110,49
1748429075402,MAE 283A,A00,931484,de Callafon; Raymond A,12,0,50,38
1748429076428,MAE 285,A00,931486,Friend; James Robert,30,0,30,0
1748429077456,MAE 287,A00,931488,Diagne; Mamadou Lamine,17,0,30,13
1748429078484,MAE 290A,A00,931490,Lindsey; Stephanie,42,0,70,28
1748429079520,MAE 294A,A00,931491,Becker; Janet Maria,14,0,20,6
1748429080551,MATH 2,A01,929271,Quarfoot; David James,22,0,25,3
1748429080551,MATH 2,B01,929278,Staff,21,0,25,4
1748429081600,MATH 3B,A01,929284,Hammock; Frances H,1,0,2,1
1748429081600,MATH 3B,A02,929312,Hammock; Frances H,1,0,2,1
1748429081600,MATH 3B,A03,967979,Hammock; Frances H,2,0,2,0
1748429081600,MATH 3B,A04,967980,Hammock; Frances H,1,0,2,1
1748429081600,MATH 3B,A05,967983,Hammock; Frances H,1,0,2,1
1748429081600,MATH 3B,A06,967984,Hammock; Frances H,2,0,2,0
1748429081600,MATH 3B,D01,929666,Staff,0,0,2,2
1748429081600,MATH 3B,D02,929667,Staff,0,0,2,2
1748429081600,MATH 3B,D03,929668,Staff,0,0,2,2
1748429081600,MATH 3B,D04,967987,Staff,0,0,2,2
1748429082629,MATH 3C,A01,929670,Staff,0,0,2,2
1748429082629,MATH 3C,A02,929671,Staff,0,0,2,2
1748429082629,MATH 3C,A03,929672,Staff,2,0,2,0
1748429082629,MATH 3C,A04,929673,Staff,2,0,2,0
1748429082629,MATH 3C,A05,967985,Staff,0,0,2,2
1748429082629,MATH 3C,A06,967986,Staff,1,0,2,1
1748429082629,MATH 3C,B01,929675,Staff,0,0,0,2
1748429082629,MATH 3C,B02,929676,Staff,0,0,2,2
1748429082629,MATH 3C,B03,929677,Staff,0,0,2,2
1748429082629,MATH 3C,B04,929679,Staff,0,0,2,2
1748429082629,MATH 3C,B05,967988,Staff,0,0,2,2
1748429082629,MATH 3C,B06,967989,Staff,0,0,2,2
1748429083669,MATH 4C,B01,929698,Anzaldo; Leesa B,0,0,0,2
1748429083669,MATH 4C,B02,929699,Anzaldo; Leesa B,4,0,4,0
1748429083669,MATH 4C,B03,929700,Anzaldo; Leesa B,3,0,4,1
1748429083669,MATH 4C,B04,929701,Anzaldo; Leesa B,4,0,4,0
1748429083669,MATH 4C,D01,929709,Staff,4,0,4,0
1748429083669,MATH 4C,D02,929710,Staff,3,0,4,1
1748429083669,MATH 4C,D03,967990,Staff,4,0,4,0
1748429083669,MATH 4C,D04,967991,Staff,4,0,4,0
1748429084705,MATH 10A,A01,929713,Staff,8,0,12,4
1748429084705,MATH 10A,A02,929715,Staff,12,0,12,0
1748429084705,MATH 10A,A03,929717,Staff,5,0,5,0
1748429084705,MATH 10A,A04,929718,Staff,5,0,5,0
1748429084705,MATH 10A,A05,929719,Staff,5,0,5,0
1748429084705,MATH 10A,A06,929720,Staff,4,0,5,1
1748429084705,MATH 10A,B01,929723,Eggers; John Dietrich,0,0,0,4
1748429084705,MATH 10A,B02,929724,Eggers; John Dietrich,0,0,4,4
1748429084705,MATH 10A,B03,929726,Eggers; John Dietrich,0,0,4,4
1748429084705,MATH 10A,B04,929727,Eggers; John Dietrich,0,0,4,4
1748429084705,MATH 10A,B05,929728,Eggers; John Dietrich,0,0,4,4
1748429084705,MATH 10A,B06,929729,Eggers; John Dietrich,1,0,4,3
1748429084705,MATH 10A,C01,929732,Staff,0,0,0,3
1748429084705,MATH 10A,C02,929734,Staff,0,0,4,4
1748429084705,MATH 10A,C03,929735,Staff,0,0,4,4
1748429084705,MATH 10A,C04,929736,Staff,0,0,4,4
1748429084705,MATH 10A,C05,929737,Staff,0,0,4,4
1748429084705,MATH 10A,C06,929739,Staff,0,0,4,4
1748429084705,MATH 10A,D01,929742,Staff,0,0,4,4
1748429084705,MATH 10A,D02,929743,Staff,0,0,4,4
1748429084705,MATH 10A,D03,929744,Staff,4,0,4,0
1748429084705,MATH 10A,D04,929746,Staff,4,0,4,0
1748429084705,MATH 10A,D05,929747,Staff,3,0,4,1
1748429084705,MATH 10A,D06,929748,Staff,4,0,4,0
1748429084705,MATH 10A,D07,968012,Staff,0,0,4,4
1748429084705,MATH 10A,D08,968013,Staff,3,0,4,1
1748429084705,MATH 10A,D09,968015,Staff,4,0,4,0
1748429084705,MATH 10A,D10,968017,Staff,2,0,4,2
1748429085752,MATH 10B,A01,929759,Bowers; Adam R.,0,0,10,10
1748429085752,MATH 10B,A02,929760,Bowers; Adam R.,0,0,10,10
1748429085752,MATH 10B,A03,929761,Bowers; Adam R.,0,0,10,10
1748429085752,MATH 10B,A04,929762,Bowers; Adam R.,0,0,10,10
1748429085752,MATH 10B,A05,929763,Bowers; Adam R.,0,0,10,10
1748429085752,MATH 10B,A06,929764,Bowers; Adam R.,0,0,10,10
1748429085752,MATH 10B,B01,929767,Staff,0,0,10,10
1748429085752,MATH 10B,B02,929770,Staff,7,0,10,3
1748429085752,MATH 10B,B03,929771,Staff,10,0,10,0
1748429085752,MATH 10B,B04,929772,Staff,9,0,10,1
1748429085752,MATH 10B,B05,929774,Staff,1,0,10,9
1748429085752,MATH 10B,B06,929775,Staff,10,0,10,0
1748429085752,MATH 10B,C01,929778,Huang; Lei,0,0,8,8
1748429085752,MATH 10B,C02,929779,Huang; Lei,0,0,10,10
1748429085752,MATH 10B,C03,929780,Huang; Lei,2,0,10,8
1748429085752,MATH 10B,C04,929781,Huang; Lei,8,0,10,2
1748429085752,MATH 10B,C05,929784,Huang; Lei,0,0,10,10
1748429085752,MATH 10B,C06,929785,Huang; Lei,2,0,10,8
1748429086788,MATH 10C,A01,929788,Staff,0,0,15,15
1748429086788,MATH 10C,A02,929789,Staff,0,0,15,15
1748429086788,MATH 10C,A03,929790,Staff,12,0,15,3
1748429086788,MATH 10C,A04,929791,Staff,13,0,15,2
1748429086788,MATH 10C,A05,929792,Staff,0,0,15,15
1748429086788,MATH 10C,A06,929793,Staff,0,0,15,15
1748429086788,MATH 10C,A07,929795,Staff,2,0,15,13
1748429086788,MATH 10C,A08,929796,Staff,15,0,15,0
1748429086788,MATH 10C,B01,929798,Staff,15,0,15,0
1748429086788,MATH 10C,B02,929799,Staff,0,0,15,15
1748429086788,MATH 10C,B03,929800,Staff,11,0,15,4
1748429086788,MATH 10C,B04,929802,Staff,14,0,15,1
1748429086788,MATH 10C,B05,929803,Staff,14,0,15,1
1748429086788,MATH 10C,B06,929805,Staff,15,0,15,0
1748429087828,MATH 11,A01,929807,Rava; Denise,0,0,25,25
1748429087828,MATH 11,A02,929808,Rava; Denise,0,0,25,25
1748429087828,MATH 11,A03,929809,Rava; Denise,0,0,25,25
1748429087828,MATH 11,A04,929811,Rava; Denise,0,0,25,25
1748429087828,MATH 11,B01,929816,Rava; Denise,0,0,25,25
1748429087828,MATH 11,B02,929817,Rava; Denise,0,0,25,25
1748429087828,MATH 11,B03,929818,Rava; Denise,0,0,25,25
1748429087828,MATH 11,B04,929819,Rava; Denise,0,0,25,25
1748429088880,MATH 18,C01,929841,Peca-Medlin; John Michael,4,0,10,6
1748429088880,MATH 18,C02,929843,Peca-Medlin; John Michael,7,0,10,3
1748429088880,MATH 18,C03,929844,Peca-Medlin; John Michael,3,0,10,7
1748429088880,MATH 18,C04,929845,Peca-Medlin; John Michael,0,0,10,10
1748429088880,MATH 18,C05,929846,Peca-Medlin; John Michael,2,0,10,8
1748429088880,MATH 18,C06,929848,Peca-Medlin; John Michael,0,0,10,10
1748429088880,MATH 18,D01,929852,Anzaldo; Leesa B,0,0,10,10
1748429088880,MATH 18,D02,929855,Anzaldo; Leesa B,0,0,10,10
1748429088880,MATH 18,D03,929856,Anzaldo; Leesa B,0,0,9,9
1748429088880,MATH 18,D04,929857,Anzaldo; Leesa B,0,0,10,10
1748429088880,MATH 18,D05,929858,Anzaldo; Leesa B,0,0,10,10
1748429088880,MATH 18,D06,929859,Anzaldo; Leesa B,0,0,10,10
1748429088880,MATH 18,E01,929862,Ganesan; Priyanga,0,0,10,10
1748429088880,MATH 18,E02,929863,Ganesan; Priyanga,0,0,10,10
1748429088880,MATH 18,E03,929865,Ganesan; Priyanga,0,0,10,10
1748429088880,MATH 18,E04,929866,Ganesan; Priyanga,8,0,10,2
1748429088880,MATH 18,E05,929867,Ganesan; Priyanga,10,0,10,0
1748429088880,MATH 18,E06,929869,Ganesan; Priyanga,10,0,10,0
1748429088880,MATH 18,F01,929872,Ganesan; Priyanga,12,0,20,8
1748429088880,MATH 18,F02,929873,Ganesan; Priyanga,17,0,20,3
1748429088880,MATH 18,F03,929874,Ganesan; Priyanga,19,0,20,1
1748429088880,MATH 18,F04,929875,Ganesan; Priyanga,19,0,20,1
1748429088880,MATH 18,F05,968018,Ganesan; Priyanga,12,0,12,0
1748429088880,MATH 18,F06,968019,Ganesan; Priyanga,11,0,12,1
1748429088880,MATH 18,F07,968020,Ganesan; Priyanga,10,0,12,2
1748429088880,MATH 18,F08,968022,Ganesan; Priyanga,11,0,12,1
1748429089911,MATH 20A,A01,929880,Bowers; Adam R.,23,0,25,2
1748429089911,MATH 20A,A02,929881,Bowers; Adam R.,24,0,25,1
1748429089911,MATH 20A,A03,929883,Bowers; Adam R.,1,0,5,4
1748429089911,MATH 20A,A04,929884,Bowers; Adam R.,4,0,5,1
1748429089911,MATH 20A,B01,929886,Staff,0,0,0,0
1748429089911,MATH 20A,B02,929887,Staff,3,0,5,2
1748429089911,MATH 20A,B03,929888,Staff,5,0,5,0
1748429089911,MATH 20A,B04,929889,Staff,5,0,5,0
1748429089911,MATH 20A,B05,929890,Staff,5,0,5,0
1748429089911,MATH 20A,B06,929891,Staff,5,0,5,0
1748429089911,MATH 20A,B07,967992,Staff,5,0,5,0
1748429089911,MATH 20A,B08,967993,Staff,5,0,5,0
1748429089911,MATH 20A,B09,967994,Staff,5,0,5,0
1748429089911,MATH 20A,B10,967995,Staff,5,0,5,0
1748429090954,MATH 20B,A01,929910,Staff,14,0,15,1
1748429090954,MATH 20B,A02,929911,Staff,15,0,15,0
1748429090954,MATH 20B,A03,929982,Staff,15,0,15,0
1748429090954,MATH 20B,A04,929983,Staff,15,0,15,0
1748429090954,MATH 20B,A05,929984,Staff,15,0,15,0
1748429090954,MATH 20B,A06,929985,Staff,15,0,15,0
1748429090954,MATH 20B,C01,930160,Staff,24,0,25,1
1748429090954,MATH 20B,C02,930186,Staff,25,0,25,0
1748429090954,MATH 20B,C03,930198,Staff,15,0,15,0
1748429090954,MATH 20B,C04,968000,Staff,15,0,15,0
1748429090954,MATH 20B,D01,930241,Chou; Raymond Oliver,13,0,25,12
1748429090954,MATH 20B,D02,930242,Chou; Raymond Oliver,23,0,25,2
1748429090954,MATH 20B,D03,930244,Chou; Raymond Oliver,0,0,15,15
1748429090954,MATH 20B,D04,968002,Chou; Raymond Oliver,0,0,13,13
1748429090954,MATH 20B,E01,930428,Wesley; William J,32,0,35,3
1748429090954,MATH 20B,E02,930529,Wesley; William J,35,0,35,0
1748429090954,MATH 20B,E03,968023,Wesley; William J,15,0,15,0
1748429090954,MATH 20B,E04,968024,Wesley; William J,15,0,15,0
1748429090954,MATH 20B,E05,968025,Wesley; William J,15,0,15,0
1748429090954,MATH 20B,E06,968026,Wesley; William J,15,0,15,0
1748429091989,MATH 20C,A01,930548,Staff,18,0,20,2
1748429091989,MATH 20C,A02,930554,Staff,19,0,20,1
1748429091989,MATH 20C,A03,930584,Staff,19,0,20,1
1748429091989,MATH 20C,A04,930606,Staff,20,0,20,0
1748429091989,MATH 20C,A05,930610,Staff,19,0,20,1
1748429091989,MATH 20C,A06,930641,Staff,20,0,20,0
1748429091989,MATH 20C,A07,968027,Staff,20,0,20,0
1748429091989,MATH 20C,A08,968028,Staff,20,0,20,0
1748429091989,MATH 20C,A09,968029,Staff,19,0,20,1
1748429091989,MATH 20C,A10,968031,Staff,20,0,20,0
1748429091989,MATH 20C,C01,930911,Staff,6,0,20,14
1748429091989,MATH 20C,C02,930940,Staff,16,0,20,4
1748429091989,MATH 20C,C03,930946,Staff,18,0,20,2
1748429091989,MATH 20C,C04,930959,Staff,20,0,20,0
1748429091989,MATH 20C,C05,930966,Staff,19,0,20,1
1748429091989,MATH 20C,C06,930974,Staff,16,0,20,4
1748429091989,MATH 20C,D01,931266,Hammock; Frances H,10,0,20,10
1748429091989,MATH 20C,D02,931267,Hammock; Frances H,14,0,17,3
1748429091989,MATH 20C,D03,931268,Hammock; Frances H,17,0,20,3
1748429091989,MATH 20C,D04,931269,Hammock; Frances H,19,0,20,1
1748429091989,MATH 20C,D05,931270,Hammock; Frances H,20,0,20,0
1748429091989,MATH 20C,D06,931271,Hammock; Frances H,18,0,20,2
1748429091989,MATH 20C,E01,931273,Staff,11,0,20,9
1748429091989,MATH 20C,E02,931274,Staff,19,0,20,1
1748429091989,MATH 20C,E03,931275,Staff,17,0,20,3
1748429091989,MATH 20C,E04,931276,Staff,19,0,20,1
1748429091989,MATH 20C,E05,931278,Staff,20,0,20,0
1748429091989,MATH 20C,E06,931279,Staff,20,0,20,0
1748429091989,MATH 20C,F01,931281,Staff,20,0,25,5
1748429091989,MATH 20C,F02,931282,Staff,22,0,25,3
1748429091989,MATH 20C,F03,931283,Staff,23,0,25,2
1748429091989,MATH 20C,F04,931285,Staff,24,0,25,1
1748429093017,MATH 20D,B01,931293,Upadrashta; Pranav Kumar,0,0,24,25
1748429093017,MATH 20D,B02,931294,Upadrashta; Pranav Kumar,0,0,30,30
1748429093017,MATH 20D,B03,931297,Upadrashta; Pranav Kumar,0,0,30,30
1748429093017,MATH 20D,B04,931298,Upadrashta; Pranav Kumar,8,0,30,22
1748429093017,MATH 20D,B05,931299,Upadrashta; Pranav Kumar,1,0,30,29
1748429093017,MATH 20D,B06,931300,Upadrashta; Pranav Kumar,25,0,30,5
1748429093017,MATH 20D,C01,931305,Upadrashta; Pranav Kumar,15,0,40,25
1748429093017,MATH 20D,C02,931306,Upadrashta; Pranav Kumar,38,0,40,2
1748429093017,MATH 20D,C03,931307,Upadrashta; Pranav Kumar,12,0,30,18
1748429093017,MATH 20D,C04,931308,Upadrashta; Pranav Kumar,26,0,30,4
1748429094048,MATH 20E,A01,931313,Staff,0,0,27,27
1748429094048,MATH 20E,A02,931315,Staff,19,0,27,8
1748429094048,MATH 20E,A03,931316,Staff,27,0,27,0
1748429094048,MATH 20E,A04,931317,Staff,27,0,27,0
1748429094048,MATH 20E,A05,968032,Staff,9,0,27,18
1748429094048,MATH 20E,A06,968033,Staff,24,0,27,3
1748429094048,MATH 20E,A07,968034,Staff,27,0,27,0
1748429094048,MATH 20E,A08,968035,Staff,26,0,27,1
1748429094048,MATH 20E,C01,931327,Staff,0,0,23,23
1748429094048,MATH 20E,C02,931329,Staff,0,0,27,27
1748429094048,MATH 20E,C03,931331,Staff,0,0,27,27
1748429094048,MATH 20E,C04,931332,Staff,0,0,27,27
1748429094048,MATH 20E,C05,931333,Staff,0,0,27,27
1748429094048,MATH 20E,C06,931334,Staff,7,0,27,20
1748429095076,MATH 31AH,A01,931337,Nandi; Achinta Kumar,5,0,5,0
1748429095076,MATH 31AH,A02,931340,Nandi; Achinta Kumar,5,0,5,0
1748429096105,MATH 87,A00,970775,Harel; Guershon,0,0,0,0
1748429096105,MATH 87,B00,970803,Meyer; David A.,0,0,0,0
1748429097134,MATH 88,A00,967999,Seward; Brandon M.,30,0,35,5
1748429098163,MATH 96,A00,931341,Kane; Daniel Mertz,0,0,0,0
1748429099199,MATH 100A,A01,927335,De Vleming; Kristin Elizab,21,0,30,9
1748429099199,MATH 100A,A02,927337,De Vleming; Kristin Elizab,24,0,30,6
1748429099199,MATH 100A,B01,927341,De Vleming; Kristin Elizab,2,0,30,28
1748429099199,MATH 100A,B02,927342,De Vleming; Kristin Elizab,8,0,30,22
1748429100225,MATH 102,B01,927348,Harel; Guershon,2,0,30,28
1748429100225,MATH 102,B02,927349,Harel; Guershon,22,0,30,8
1748429101256,MATH 103A,B01,927370,Staff,16,0,30,14
1748429101256,MATH 103A,B02,927378,Staff,29,0,30,1
1748429101256,MATH 103A,B03,969574,Staff,27,0,30,3
1748429101256,MATH 103A,C01,927381,Staff,13,0,30,17
1748429101256,MATH 103A,C02,927385,Staff,24,0,30,6
1748429101256,MATH 103A,D01,927388,Suk; Andrew Hoon,0,0,30,30
1748429101256,MATH 103A,D02,927389,Suk; Andrew Hoon,0,0,30,30
1748429102291,MATH 105,A01,927391,Ganapathy; Karthik,26,0,35,9
1748429102291,MATH 105,A02,927454,Ganapathy; Karthik,29,0,35,6
1748429103322,MATH 109,B01,927493,Xiao; Ming,0,0,5,5
1748429103322,MATH 109,B02,927494,Xiao; Ming,0,0,5,5
1748429103322,MATH 109,C01,927500,Xiao; Ming,0,0,5,5
1748429103322,MATH 109,C02,927501,Xiao; Ming,0,0,5,5
1748429103322,MATH 109,D01,927516,Buzaglo; Lucas,0,0,5,5
1748429103322,MATH 109,D02,927517,Buzaglo; Lucas,0,0,5,5
1748429103322,MATH 109,E01,927519,Buzaglo; Lucas,0,0,5,5
1748429103322,MATH 109,E02,927552,Buzaglo; Lucas,0,0,5,5
1748429104351,MATH 111A,A01,927559,Meyer; David A.,0,0,35,35
1748429105378,MATH 120A,A01,927572,Eggers; John Dietrich,13,0,30,17
1748429105378,MATH 120A,A02,927574,Eggers; John Dietrich,29,0,30,1
1748429106412,MATH 140A,A01,927580,Spolaor; Luca,0,0,30,30
1748429106412,MATH 140A,A02,927582,Spolaor; Luca,6,0,30,24
1748429106412,MATH 140A,B01,927588,Ioana; Adrian,0,0,30,30
1748429106412,MATH 140A,B02,927599,Ioana; Adrian,0,0,30,30
1748429107449,MATH 142A,B01,927620,Bejenaru; Ioan,0,0,30,30
1748429107449,MATH 142A,B02,927750,Bejenaru; Ioan,13,0,30,17
1748429107449,MATH 142A,C01,927789,Staff,25,0,30,5
1748429107449,MATH 142A,C02,927815,Staff,30,0,30,0
1748429107449,MATH 142A,C03,969575,Staff,25,0,30,5
1748429107449,MATH 142A,D01,927829,Staff,15,0,30,15
1748429107449,MATH 142A,D02,927832,Staff,30,0,30,0
1748429108482,MATH 153,A01,927862,Harel; Guershon,26,0,35,9
1748429109511,MATH 154,A01,928077,Kane; Daniel Mertz,27,0,35,8
1748429109511,MATH 154,A02,928083,Kane; Daniel Mertz,35,0,35,0
1748429109511,MATH 154,A03,928085,Kane; Daniel Mertz,0,0,35,35
1748429109511,MATH 154,A04,928086,Kane; Daniel Mertz,20,0,35,15
1748429110546,MATH 170A,A01,928146,Tian; Xiaochuan,0,0,30,30
1748429110546,MATH 170A,A02,928225,Tian; Xiaochuan,1,0,30,29
1748429110546,MATH 170A,A03,928231,Tian; Xiaochuan,26,0,30,4
1748429110546,MATH 170A,A04,928237,Tian; Xiaochuan,30,0,30,0
1748429110546,MATH 170A,B01,928244,Huang; Lei,23,0,30,7
1748429110546,MATH 170A,B02,928273,Huang; Lei,30,0,30,0
1748429110546,MATH 170A,B03,928274,Huang; Lei,18,0,30,12
1748429110546,MATH 170A,B04,928276,Huang; Lei,28,0,30,2
1748429111577,MATH 173A,A01,928278,Ding; Lijun,0,0,30,30
1748429111577,MATH 173A,A02,928319,Ding; Lijun,0,0,30,30
1748429111577,MATH 173A,A03,928322,Ding; Lijun,0,0,30,30
1748429111577,MATH 173A,A04,928377,Ding; Lijun,0,0,30,30
1748429111577,MATH 173A,B01,928383,Cloninger; Alexander,0,0,30,30
1748429111577,MATH 173A,B02,928384,Cloninger; Alexander,0,0,30,30
1748429111577,MATH 173A,B03,928385,Cloninger; Alexander,0,0,30,30
1748429111577,MATH 173A,B04,928386,Cloninger; Alexander,0,0,30,30
1748429112605,MATH 174,A01,928397,Cheng; Li-Tien,15,0,28,13
1748429112605,MATH 174,A02,928402,Cheng; Li-Tien,23,0,28,5
1748429113637,MATH 180A,A01,928408,Staff,0,0,25,25
1748429113637,MATH 180A,A02,928409,Staff,18,0,25,7
1748429113637,MATH 180A,A03,928416,Staff,23,0,25,2
1748429113637,MATH 180A,A04,928417,Staff,21,0,25,4
1748429113637,MATH 180A,B01,928428,Peca-Medlin; John Michael,0,0,25,25
1748429113637,MATH 180A,B02,928435,Peca-Medlin; John Michael,11,0,25,14
1748429113637,MATH 180A,B03,928436,Peca-Medlin; John Michael,20,0,25,5
1748429113637,MATH 180A,B04,928453,Peca-Medlin; John Michael,21,0,25,4
1748429113637,MATH 180A,C01,928466,Dixit; Rishabh,20,0,25,5
1748429113637,MATH 180A,C02,928467,Dixit; Rishabh,25,0,25,0
1748429113637,MATH 180A,C03,928506,Dixit; Rishabh,22,0,25,3
1748429113637,MATH 180A,C04,928511,Dixit; Rishabh,25,0,25,0
1748429114664,MATH 180C,A01,928520,Schweinsberg; Jason,0,0,35,35
1748429114664,MATH 180C,A02,928527,Schweinsberg; Jason,0,0,35,35
1748429115692,MATH 181B,A01,928538,Lou; Zhipeng,3,0,30,27
1748429115692,MATH 181B,A02,928539,Lou; Zhipeng,21,0,30,9
1748429115692,MATH 181B,A03,928543,Lou; Zhipeng,27,0,30,3
1748429116724,MATH 183,A01,928545,Quarfoot; David James,0,0,22,22
1748429116724,MATH 183,A02,928560,Quarfoot; David James,0,0,22,22
1748429116724,MATH 183,A03,928565,Quarfoot; David James,0,0,22,22
1748429116724,MATH 183,A04,928566,Quarfoot; David James,0,0,22,22
1748429116724,MATH 183,A05,928567,Quarfoot; David James,0,0,22,22
1748429116724,MATH 183,A06,928568,Quarfoot; David James,0,0,22,22
1748429117756,MATH 184,A01,928587,Chou; Raymond Oliver,13,0,35,22
1748429117756,MATH 184,A02,928592,Chou; Raymond Oliver,29,0,35,6
1748429117756,MATH 184,A03,928593,Chou; Raymond Oliver,32,0,35,3
1748429117756,MATH 184,A04,928594,Chou; Raymond Oliver,35,0,35,0
1748429118784,MATH 187A,A01,928609,Ganapathy; Karthik,0,0,25,25
1748429118784,MATH 187A,A02,928614,Ganapathy; Karthik,0,0,25,25
1748429118784,MATH 187A,A03,928615,Ganapathy; Karthik,0,0,25,25
1748429118784,MATH 187A,A04,928616,Ganapathy; Karthik,7,0,25,18
1748429118784,MATH 187A,A05,928617,Ganapathy; Karthik,0,0,25,25
1748429118784,MATH 187A,A06,928618,Ganapathy; Karthik,12,0,25,13
1748429119815,MATH 190A,A01,928685,Roberts; Justin Deritter,15,0,35,20
1748429120842,MATH 197,001,973284,Kedlaya; Kiran S.,9999,0,9999,0
1748429121870,MATH 200A,A00,928693,Salehi Golsefidy; Alireza,20,0,20,0
1748429122897,MATH 201A,A00,928694,Wenzl; Hans G,20,0,20,0
1748429123923,MATH 202A,A00,928732,Novak; Jonathan I,15,0,20,5
1748429124949,MATH 203A,A00,928743,Izadi; Elham,20,0,20,0
1748429125982,MATH 204A,A00,928764,Sorensen; Claus M,19,0,20,1
1748429127008,MATH 208,A00,928765,Staff,10,0,10,0
1748429128037,MATH 209,A00,928766,Staff,10,0,10,0
1748429129065,MATH 210A,A00,928808,Miller; Pearson,19,0,20,1
1748429130090,MATH 211A,A00,928809,Staff,10,0,10,0
1748429131117,MATH 211B,A00,928811,Staff,10,0,10,0
1748429132214,MATH 216A,A00,928812,Webber; Robert Jacobs,12,0,20,8
1748429133241,MATH 218,A00,928828,Staff,9,0,10,1
1748429134268,MATH 220A,A00,928829,Ebenfelt; Peter F,15,0,20,5
1748429135321,MATH 240A,A00,928830,Spolaor; Luca,17,0,20,3
1748429136354,MATH 241A,A00,928831,Zlatos; Andrej,14,0,20,6
1748429137385,MATH 242,A00,928903,Bejenaru; Ioan,16,0,20,4
1748429138414,MATH 243,A00,928911,Staff,10,0,10,0
1748429139441,MATH 248,A00,928919,Staff,10,0,10,0
1748429140472,MATH 251A,A00,928970,Sam; Steven V,18,0,20,2
1748429141502,MATH 258,A00,928973,Staff,10,0,10,0
1748429142532,MATH 259A,A00,929052,Staff,18,0,20,2
1748429143559,MATH 261A,A00,929059,Warnke; Lutz Peter,10,0,20,10
1748429144585,MATH 269,A00,929060,Staff,10,0,10,0
1748429145612,MATH 270A,A00,929061,Dumitriu; Ioana,8,0,20,12
1748429146640,MATH 273A,A00,929063,Leok; Melvin,17,0,20,3
1748429147673,MATH 274,A01,929069,Cheng; Li-Tien,5,0,5,0
1748429147673,MATH 274,A02,929071,Cheng; Li-Tien,5,0,5,0
1748429148707,MATH 277A,A00,929073,Grier; Daniel T,18,0,20,2
1748429148707,MATH 277A,B00,929080,Nie; Jiawang,20,0,20,0
1748429149736,MATH 278A,A00,929092,Staff,10,0,10,0
1748429150763,MATH 278B,A00,929105,Staff,10,0,10,0
1748429151791,MATH 278C,A00,929113,Staff,10,0,10,0
1748429152818,MATH 280A,A00,929117,Ang; Jie Jun,7,0,20,13
1748429153850,MATH 281A,A00,929120,Lou; Zhipeng,9,0,20,11
1748429154881,MATH 282A,A00,929138,Zhang; Danna,4,0,20,16
1748429155912,MATH 283,A00,929153,Tesler; Glenn,0,0,0,17
1748429156940,MATH 287A,A00,967998,Politis; Dimitris,9,0,15,6
1748429157966,MATH 288,A00,929158,Staff,9,0,10,1
1748429158999,MATH 290A,A00,929180,McKernan; James,18,0,20,2
1748429160027,MATH 292,A00,929185,Staff,10,0,10,0
1748429161054,MATH 295,A00,929189,Staff,15,0,15,0
1748429162090,MATH 297,001,929218,Gamst; Anthony Collins,0,0,0,0
1748429163123,MATS 200,A00,927075,Graeve; Olivia A,9983,0,9999,16
1748429164158,MATS 201A,A00,927076,Luo; Jian,36,0,50,14
1748429165185,MATS 202,A00,927102,Staff,37,0,50,13
1748429166216,MATS 227,A00,927103,Graeve; Olivia A,36,0,50,14
1748429167243,MATS 251A,A00,927139,Bandaru; Prabhakar,40,0,50,10
1748429168269,MATS 257,A00,927140,Cai; Shengqiang,8,0,20,12
1748429169301,MATS 295,A00,927151,Graeve; Olivia A,9999,0,9999,0
1748429169301,MATS 295,B00,927152,Kummel; Andrew C,9999,0,9999,0
1748429170378,MCWP 40,001,945345,Guillen; Melinda,3,0,3,0
1748429170378,MCWP 40,002,945347,Guillen; Melinda,0,0,3,3
1748429170378,MCWP 40,003,945348,Guillen; Melinda,0,0,3,3
1748429170378,MCWP 40,004,945379,Wastal; Carrie King,3,0,3,0
1748429170378,MCWP 40,005,945382,Wastal; Carrie King,2,0,3,1
1748429170378,MCWP 40,006,945383,Compas; Sean Matthew,0,0,3,3
1748429170378,MCWP 40,007,945387,Bartulis; Jason Michael,3,0,3,0
1748429170378,MCWP 40,008,945388,Wastal; Carrie King,2,0,3,1
1748429170378,MCWP 40,009,945391,Wastal; Carrie King,3,0,3,0
1748429170378,MCWP 40,011,945394,Bartulis; Jason Michael,3,0,3,0
1748429170378,MCWP 40,012,945395,Carter; Jennifer A,3,0,3,0
1748429170378,MCWP 40,013,945396,Carter; Jennifer A,2,0,3,1
1748429170378,MCWP 40,014,945429,Carter; Jennifer A,2,0,3,1
1748429170378,MCWP 40,015,945432,Smith; Haydee Marie,3,0,3,0
1748429170378,MCWP 40,016,945433,Smith; Haydee Marie,3,0,3,0
1748429170378,MCWP 40,017,945435,Smith; Haydee Marie,3,0,3,0
1748429170378,MCWP 40,018,945436,Pham; Vincent Minhduc,3,0,3,0
1748429170378,MCWP 40,019,945453,Pham; Vincent Minhduc,3,0,3,0
1748429170378,MCWP 40,020,945459,Pham; Vincent Minhduc,3,0,3,0
1748429170378,MCWP 40,023,945469,Montejo; Carolina,3,0,3,0
1748429170378,MCWP 40,024,945472,Montejo; Carolina,3,0,3,0
1748429170378,MCWP 40,026,945708,Compas; Sean Matthew,3,0,3,0
1748429170378,MCWP 40,027,945710,Duru; Nur,2,0,3,1
1748429170378,MCWP 40,028,945714,Duru; Nur,1,0,3,2
1748429170378,MCWP 40,029,945715,Duru; Nur,2,0,3,1
1748429170378,MCWP 40,030,945718,Compas; Sean Matthew,0,0,3,3
1748429171411,MCWP 40R,A00,945742,Miller; Elizabeth Deen,0,0,0,1
1748429171411,MCWP 40R,B00,945743,Miller; Elizabeth Deen,0,0,0,0
1748429171411,MCWP 40R,C00,945744,Miller; Elizabeth Deen,0,0,0,1
1748429172438,MCWP 50,001,945745,Wastal; Carrie King,2,0,15,13
1748429172438,MCWP 50,002,945746,Carter; Andrea L,18,0,20,2
1748429172438,MCWP 50,003,945788,Carter; Andrea L,11,0,20,9
1748429172438,MCWP 50,004,945887,Carter; Andrea L,7,0,20,13
1748429173481,MCWP 125,001,945901,Nies; Laurie Elizabeth,3,0,3,0
1748429173481,MCWP 125,002,945902,Nies; Laurie Elizabeth,3,0,3,0
1748429173481,MCWP 125,003,945904,Redela; Pamela Morgan,3,0,3,0
1748429173481,MCWP 125,004,945930,Redela; Pamela Morgan,3,0,3,0
1748429173481,MCWP 125,005,945931,Redela; Pamela Morgan,3,0,3,0
1748429173481,MCWP 125,006,945932,Silva; Kelly B,3,0,3,0
1748429173481,MCWP 125,007,945933,Silva; Kelly B,3,0,3,0
1748429173481,MCWP 125,009,945935,Krone; Jarret,3,0,3,0
1748429173481,MCWP 125,010,945940,Krone; Jarret,3,0,3,0
1748429173481,MCWP 125,011,945941,Krone; Jarret,3,0,3,0
1748429173481,MCWP 125,012,945942,Morshed; Michael James,3,0,3,0
1748429173481,MCWP 125,013,945943,Morshed; Michael James,3,0,3,0
1748429173481,MCWP 125,014,945944,Morshed; Michael James,3,0,3,0
1748429174511,MGT 3,A00,945992,Wagner; Timothy Ryan,96,0,98,2
1748429175539,MGT 4,A01,945994,Brooks; Marcus Raymond,80,0,90,10
1748429176568,MGT 5,A00,945995,Molloie Jr.; William H,134,0,150,16
1748429177601,MGT 12,A00,945996,Lindenberger; Wade Douglas,63,0,98,35
1748429177601,MGT 12,B00,945997,Pecore; Joseph P.,58,0,98,40
1748429178630,MGT 16,A00,945998,Buchanan; Harold G,96,0,98,2
1748429178630,MGT 16,B00,946005,Buchanan; Harold G,90,0,98,8
1748429178630,MGT 16,C00,946006,Campbell; Robert Harold,92,0,98,6
1748429178630,MGT 16,D00,946007,Campbell; Robert Harold,93,0,98,5
1748429178630,MGT 16,E00,946022,Lindenberger; Wade Douglas,42,0,98,56
1748429179660,MGT 18,A00,946040,McKay; Michael J,95,0,98,3
1748429179660,MGT 18,B00,946041,McKay; Michael J,96,0,98,2
1748429179660,MGT 18,C00,946044,McKay; Michael J,96,0,98,2
1748429179660,MGT 18,D00,946047,Chamberlain; Travis Dean,98,0,98,0
1748429179660,MGT 18,E00,946051,Chamberlain; Travis Dean,96,0,98,2
1748429179660,MGT 18,F00,960148,Chamberlain; Travis Dean,0,0,0,2
1748429180686,MGT 45,A00,946055,Pecore; Joseph P.,80,0,150,70
1748429180686,MGT 45,B00,946057,Pecore; Joseph P.,118,0,150,32
1748429181714,MGT 52,A00,946059,Staff,77,0,98,21
1748429182740,MGT 71,A00,946060,Goodarzi; Shadi,0,0,98,98
1748429182740,MGT 71,B00,946061,Erat; Sanjiv,0,0,98,98
1748429182740,MGT 71,D00,960149,Staff,0,0,98,98
1748429183767,MGT 100,A00,946069,Yavorsky; Daniel Ryan,0,0,98,98
1748429184794,MGT 103,A00,946081,Ehrich; Kristine R,96,0,98,2
1748429184794,MGT 103,C00,946083,Ehrich; Kristine R,75,0,98,23
1748429184794,MGT 103,D00,946084,Ehrich; Kristine R,57,0,98,41
1748429184794,MGT 103,E00,946138,Bates; Kenneth Walter,82,0,98,16
1748429185822,MGT 105,A00,946139,Bates; Kenneth Walter,0,0,98,98
1748429186853,MGT 108R,A00,946141,Amir; On,888,0,999,111
1748429187885,MGT 109,A00,946142,Staff,13,0,98,85
1748429188913,MGT 112,A00,960205,Zimmermann; Carsten,30,0,98,68
1748429189946,MGT 119,A00,946144,Schurr; Amos Shlomo,96,0,98,2
1748429189946,MGT 119,B00,946153,Staff,97,0,98,1
1748429190978,MGT 121A,A00,946154,Wang; Helen Shan,89,0,98,9
1748429190978,MGT 121A,B00,946188,Wang; Helen Shan,96,0,98,2
1748429192004,MGT 127R,A00,946197,Zhu; Kevin Xiaoguo,70,0,98,28
1748429193031,MGT 131A,A00,946227,Brooks; Marcus Raymond,91,0,98,7
1748429194064,MGT 132,A00,946230,Blakley; Bruce,76,0,98,22
1748429195091,MGT 135,A00,946234,Anderson; John Charles,1,0,40,39
1748429196118,MGT 137,A00,960206,Lindenberger; Wade Douglas,0,0,98,98
1748429197146,MGT 151R,A00,946235,Staff,64,0,98,34
1748429198179,MGT 153,A00,946242,Perols; Johan Lars,0,0,90,90
1748429198179,MGT 153,B00,946244,Perols; Johan Lars,0,0,90,90
1748429199208,MGT 158,A00,946247,Bliss; Barbara Ann,85,0,98,13
1748429200239,MGT 160,A00,946265,Johnson; Erik Barry,30,0,90,60
1748429200239,MGT 160,B00,946266,Johnson; Erik Barry,58,0,90,32
1748429201273,MGT 162,A00,946267,Demill; Burritt,85,0,98,13
1748429201273,MGT 162,B00,946269,Demill; Burritt,67,0,98,31
1748429202304,MGT 162R,A00,946270,Gneezy; Uri,0,0,150,150
1748429203339,MGT 164,A00,946271,McKay; Mary A,88,0,98,10
1748429203339,MGT 164,B00,946272,McKay; Mary A,80,0,98,18
1748429203339,MGT 164,C00,946273,McKay; Mary A,88,0,98,10
1748429203339,MGT 164,D00,946274,Meyer; Alison Bloomfield,0,0,98,98
1748429204368,MGT 166,A00,946276,Moran; Cathleen L.,40,0,60,20
1748429204368,MGT 166,B00,946277,Moran; Cathleen L.,84,0,98,14
1748429204368,MGT 166,C00,946278,Moran; Cathleen L.,94,0,98,4
1748429205399,MGT 167,A00,946279,Jacob; Jo Dee C,88,0,98,10
1748429205399,MGT 167,B00,946280,Klaas; Jeffrey David,97,0,98,1
1748429207459,MGT 172,A00,946282,Hedges; Kathleen & Royal; Rebecca,92,0,98,6
1748429207459,MGT 172,B00,946283,Hedges; Kathleen,73,0,98,25
1748429207459,MGT 172,C00,946284,Zimmermann; Carsten,0,0,0,3
1748429208486,MGT 172R,A00,946285,Erat; Sanjiv,134,0,150,16
1748429209514,MGT 173,A00,946286,Hayes; Sherry Lorine,66,0,98,32
1748429210544,MGT 175,A00,946287,Gopal; Christopher S.,81,0,90,9
1748429211575,MGT 180,A00,946288,Bliss; Barbara Ann,96,0,150,54
1748429211575,MGT 180,B00,946289,Buti; Krisztina,140,0,150,10
1748429211575,MGT 180,C00,960207,Buti; Krisztina,142,0,150,8
1748429212603,MGT 181,A00,946290,Buchanan; Harold G,17,0,120,103
1748429213640,MGT 183,A00,960208,Staff,53,0,98,45
1748429214667,MGT 185,A00,946291,Dunn; Louis Jean,69,0,98,29
1748429215693,MGT 187,A00,946292,Dunn; Louis Jean,43,0,98,55
1748429216719,MGT 189,A00,946293,Staff,88,0,98,10
1748429217746,MGT 228,A00,946294,Sadoff; Sally,16,0,20,4
1748429218772,MGT 286,A00,946295,Staff,20,0,20,0
1748429219803,MGT 296,001,969295,Gneezy; Ayelet,2,0,3,1
1748429219803,MGT 296,002,969296,Amir; On,3,0,3,0
1748429219803,MGT 296,003,969297,Amir; On & Karmarkar; Uma R,2,0,3,1
1748429219803,MGT 296,004,969298,Liu; Jun,3,0,3,0
1748429219803,MGT 296,005,969300,Hansen; Karsten T.,2,0,3,1
1748429219803,MGT 296,006,969301,Erat; Sanjiv,2,0,3,1
1748429219803,MGT 296,007,969302,Avenancio-Leon; Carlos,3,0,3,0
1748429219803,MGT 296,008,969303,Engelberg; Joseph Edward,3,0,3,0
1748429219803,MGT 296,009,969304,Zhang; Zhe,3,0,3,0
1748429219803,MGT 296,010,969305,Oveis; Christopher S,3,0,3,0
1748429219803,MGT 296,011,969306,Zhu; Kevin Xiaoguo & Gneezy; Ayelet,3,0,3,0
1748429219803,MGT 296,012,969307,Luo; Danqi,3,0,3,0
1748429219803,MGT 296,013,969309,Oveis; Christopher S & Campbell; Elizabeth L,3,0,3,0
1748429219803,MGT 296,014,969310,Serra Garcia; Marta & Gneezy; Uri,3,0,3,0
1748429219803,MGT 296,015,969311,Rai; Tage S,3,0,3,0
1748429220839,MMW 11,A01,925937,Herbst; Matthew,4,0,4,0
1748429220839,MMW 11,A02,925938,Herbst; Matthew,3,0,4,1
1748429220839,MMW 11,A03,925939,Herbst; Matthew,4,0,4,0
1748429220839,MMW 11,A04,925940,Herbst; Matthew,4,0,4,0
1748429220839,MMW 11,A05,925941,Herbst; Matthew,0,0,0,0
1748429220839,MMW 11,A06,925942,Herbst; Matthew,0,0,0,0
1748429220839,MMW 11,A07,925975,Herbst; Matthew,3,0,4,1
1748429220839,MMW 11,A08,926004,Herbst; Matthew,3,0,4,1
1748429220839,MMW 11,A09,926021,Herbst; Matthew,3,0,4,1
1748429220839,MMW 11,A10,926064,Herbst; Matthew,4,0,4,0
1748429220839,MMW 11,A11,926067,Herbst; Matthew,4,0,4,0
1748429220839,MMW 11,A12,926072,Herbst; Matthew,4,0,4,0
1748429220839,MMW 11,B01,926211,Chang; Edmond Yi-Teh,3,0,4,1
1748429220839,MMW 11,B02,926212,Chang; Edmond Yi-Teh,4,0,4,0
1748429220839,MMW 11,B03,926213,Chang; Edmond Yi-Teh,4,0,4,0
1748429220839,MMW 11,B04,926214,Chang; Edmond Yi-Teh,4,0,4,0
1748429220839,MMW 11,B05,926215,Chang; Edmond Yi-Teh,4,0,4,0
1748429220839,MMW 11,B06,926216,Chang; Edmond Yi-Teh,4,0,4,0
1748429220839,MMW 11,B07,926217,Chang; Edmond Yi-Teh,4,0,4,0
1748429220839,MMW 11,B08,926218,Chang; Edmond Yi-Teh,3,0,4,1
1748429220839,MMW 11,B09,926219,Chang; Edmond Yi-Teh,4,0,4,0
1748429220839,MMW 11,B10,926220,Chang; Edmond Yi-Teh,4,0,4,0
1748429220839,MMW 11,B11,926221,Chang; Edmond Yi-Teh,0,0,0,0
1748429220839,MMW 11,B12,926233,Chang; Edmond Yi-Teh,0,0,0,0
1748429220839,MMW 11,C01,926237,Chang; Edmond Yi-Teh,4,0,4,0
1748429220839,MMW 11,C02,926238,Chang; Edmond Yi-Teh,4,0,4,0
1748429220839,MMW 11,C03,926239,Chang; Edmond Yi-Teh,3,0,4,1
1748429220839,MMW 11,C04,926240,Chang; Edmond Yi-Teh,4,0,4,0
1748429220839,MMW 11,C05,926241,Chang; Edmond Yi-Teh,4,0,4,0
1748429220839,MMW 11,C06,926242,Chang; Edmond Yi-Teh,4,0,4,0
1748429220839,MMW 11,C07,926243,Chang; Edmond Yi-Teh,4,0,4,0
1748429220839,MMW 11,C08,926244,Chang; Edmond Yi-Teh,4,0,4,0
1748429220839,MMW 11,C09,926245,Chang; Edmond Yi-Teh,0,0,0,0
1748429220839,MMW 11,C10,926301,Chang; Edmond Yi-Teh,0,0,0,0
1748429220839,MMW 11,C11,926303,Chang; Edmond Yi-Teh,4,0,4,0
1748429220839,MMW 11,C12,926305,Chang; Edmond Yi-Teh,4,0,4,0
1748429221869,MMW 14,A01,926309,Carreras; Maria Victoria,0,0,0,0
1748429221869,MMW 14,A02,926470,Carreras; Maria Victoria,0,0,0,0
1748429221869,MMW 14,A03,926472,Carreras; Maria Victoria,0,0,28,28
1748429221869,MMW 14,A04,926474,Carreras; Maria Victoria,0,0,28,28
1748429221869,MMW 14,A05,926475,Carreras; Maria Victoria,0,0,28,28
1748429221869,MMW 14,A06,926476,Carreras; Maria Victoria,0,0,28,28
1748429221869,MMW 14,A07,926477,Carreras; Maria Victoria,0,0,28,28
1748429221869,MMW 14,A08,926513,Carreras; Maria Victoria,0,0,28,28
1748429221869,MMW 14,A09,926514,Carreras; Maria Victoria,0,0,0,0
1748429221869,MMW 14,A10,926515,Carreras; Maria Victoria,0,0,0,0
1748429222899,MMW 121,A01,926517,Adamiak; Patrick John,0,0,0,0
1748429222899,MMW 121,A02,926548,Adamiak; Patrick John,0,0,0,0
1748429222899,MMW 121,A03,926549,Adamiak; Patrick John,0,0,4,4
1748429222899,MMW 121,A04,926550,Adamiak; Patrick John,2,0,4,2
1748429222899,MMW 121,A05,926551,Adamiak; Patrick John,0,0,4,4
1748429222899,MMW 121,A06,926552,Adamiak; Patrick John,3,0,4,1
1748429222899,MMW 121,A07,926585,Adamiak; Patrick John,3,0,4,1
1748429222899,MMW 121,A08,926590,Adamiak; Patrick John,3,0,4,1
1748429222899,MMW 121,A09,926641,Adamiak; Patrick John,0,0,0,0
1748429222899,MMW 121,A10,926658,Adamiak; Patrick John,0,0,0,0
1748429222899,MMW 121,B01,926680,Adamiak; Patrick John,0,0,4,4
1748429222899,MMW 121,B02,926691,Adamiak; Patrick John,0,0,4,4
1748429222899,MMW 121,B03,926710,Adamiak; Patrick John,2,0,4,2
1748429222899,MMW 121,B04,926714,Adamiak; Patrick John,4,0,4,0
1748429222899,MMW 121,B05,926750,Adamiak; Patrick John,0,0,4,4
1748429222899,MMW 121,B06,926765,Adamiak; Patrick John,4,0,4,0
1748429222899,MMW 121,B07,926769,Adamiak; Patrick John,3,0,4,1
1748429222899,MMW 121,B08,926953,Adamiak; Patrick John,3,0,4,1
1748429222899,MMW 121,B09,926954,Adamiak; Patrick John,0,0,0,0
1748429222899,MMW 121,B10,926955,Adamiak; Patrick John,0,0,0,0
1748429223925,MSED 295,A00,927153,Staff,5,0,5,0
1748429224957,MSED 296A,A00,927181,Rabin; Jeffrey Mark,13,0,15,2
1748429225985,MUS 1A,A01,931495,Staff,24,0,25,1
1748429225985,MUS 1A,A02,931499,Staff,21,0,25,4
1748429225985,MUS 1A,A03,931502,Staff,21,0,25,4
1748429225985,MUS 1A,A04,931503,Staff,25,0,25,0
1748429225985,MUS 1A,A05,931504,Staff,19,0,25,6
1748429225985,MUS 1A,A06,931505,Staff,22,0,25,3
1748429225985,MUS 1A,B01,931507,Staff,25,0,25,0
1748429225985,MUS 1A,B02,931530,Staff,22,0,25,3
1748429225985,MUS 1A,B03,931534,Staff,23,0,25,2
1748429225985,MUS 1A,B04,931536,Staff,24,0,25,1
1748429225985,MUS 1A,B05,931539,Staff,17,0,25,8
1748429225985,MUS 1A,B06,931541,Staff,13,0,25,12
1748429227012,MUS 2A,A01,931544,Carlson; Erik,40,0,40,0
1748429228041,MUS 2AK,A00,931545,Ohnishi; Takae,15,0,15,0
1748429228041,MUS 2AK,B00,931546,Ohnishi; Takae,15,0,15,0
1748429229076,MUS 4,A01,931551,Staff,24,0,25,1
1748429229076,MUS 4,A02,931552,Staff,25,0,25,0
1748429229076,MUS 4,A03,931553,Staff,24,0,25,1
1748429229076,MUS 4,A04,931554,Staff,25,0,25,0
1748429229076,MUS 4,A05,931558,Staff,24,0,25,1
1748429229076,MUS 4,A06,931561,Staff,25,0,25,0
1748429229076,MUS 4,A07,931562,Staff,25,0,25,0
1748429229076,MUS 4,A08,931563,Staff,25,0,25,0
1748429229076,MUS 4,A09,931564,Staff,25,0,25,0
1748429229076,MUS 4,A10,931566,Staff,25,0,25,0
1748429230114,MUS 6,A01,931573,Freitas Caetano; Marcelo,27,0,30,3
1748429230114,MUS 6,A02,931574,Freitas Caetano; Marcelo,28,0,30,2
1748429230114,MUS 6,A03,931677,Freitas Caetano; Marcelo,28,0,30,2
1748429230114,MUS 6,A04,931696,Freitas Caetano; Marcelo,30,0,30,0
1748429231142,MUS 8,A01,931732,Smythe; Cory Benjamin,12,0,25,13
1748429231142,MUS 8,A02,931737,Smythe; Cory Benjamin,17,0,25,8
1748429231142,MUS 8,A03,931761,Smythe; Cory Benjamin,25,0,25,0
1748429231142,MUS 8,A04,931920,Smythe; Cory Benjamin,23,0,25,2
1748429231142,MUS 8,A05,931925,Smythe; Cory Benjamin,21,0,25,4
1748429231142,MUS 8,A06,931943,Smythe; Cory Benjamin,19,0,25,6
1748429231142,MUS 8,A07,931948,Smythe; Cory Benjamin,22,0,25,3
1748429231142,MUS 8,A08,931955,Smythe; Cory Benjamin,17,0,25,8
1748429231142,MUS 8,A09,931964,Smythe; Cory Benjamin,25,0,25,0
1748429231142,MUS 8,A10,931974,Smythe; Cory Benjamin,24,0,25,1
1748429232175,MUS 13,A01,961328,Guy; Nancy,28,0,30,2
1748429232175,MUS 13,A02,961333,Guy; Nancy,30,0,30,0
1748429232175,MUS 13,A03,961343,Guy; Nancy,28,0,30,2
1748429232175,MUS 13,A04,961351,Guy; Nancy,30,0,30,0
1748429233202,MUS 14,A01,932176,McCormack; Timothy Matthew,29,0,30,1
1748429233202,MUS 14,A02,932183,McCormack; Timothy Matthew,29,0,30,1
1748429233202,MUS 14,A03,932186,McCormack; Timothy Matthew,30,0,30,0
1748429233202,MUS 14,A04,932190,McCormack; Timothy Matthew,29,0,30,1
1748429234229,MUS 15,A01,932270,Lou; Michelle Siulai,28,0,30,2
1748429234229,MUS 15,A02,932315,Lou; Michelle Siulai,29,0,30,1
1748429234229,MUS 15,A03,932316,Lou; Michelle Siulai,28,0,30,2
1748429234229,MUS 15,A04,932323,Lou; Michelle Siulai,30,0,30,0
1748429234229,MUS 15,A05,932325,Lou; Michelle Siulai,27,0,30,3
1748429234229,MUS 15,A06,932326,Lou; Michelle Siulai,27,0,30,3
1748429234229,MUS 15,A07,932327,Lou; Michelle Siulai,30,0,30,0
1748429234229,MUS 15,A08,932328,Lou; Michelle Siulai,28,0,30,2
1748429234229,MUS 15,A09,932366,Lou; Michelle Siulai,29,0,30,1
1748429234229,MUS 15,A10,932380,Lou; Michelle Siulai,25,0,30,5
1748429235259,MUS 17,A01,932416,Staff,0,0,0,0
1748429235259,MUS 17,A02,932423,Staff,0,0,0,0
1748429235259,MUS 17,A03,932437,Staff,0,0,0,0
1748429235259,MUS 17,A04,932447,Staff,0,0,0,0
1748429235259,MUS 17,A05,932460,Staff,0,0,0,0
1748429235259,MUS 17,A06,932466,Staff,0,0,0,0
1748429235259,MUS 17,A07,932475,Staff,0,0,0,0
1748429235259,MUS 17,A08,932479,Staff,0,0,0,0
1748429235259,MUS 17,A09,932480,Staff,0,0,0,0
1748429235259,MUS 17,A10,932481,Staff,0,0,0,0
1748429235259,MUS 17,A11,932487,Staff,0,0,0,8
1748429235259,MUS 17,A12,932490,Staff,0,0,0,1
1748429236342,MUS 19R,A01,932494,Britt; King James,7,0,25,18
1748429236342,MUS 19R,A02,932500,Britt; King James,20,0,25,5
1748429236342,MUS 19R,A03,932503,Britt; King James,24,0,25,1
1748429236342,MUS 19R,A04,932504,Britt; King James,23,0,25,2
1748429236342,MUS 19R,A05,932512,Britt; King James,25,0,25,0
1748429236342,MUS 19R,A06,932513,Britt; King James,17,0,25,8
1748429236342,MUS 19R,A07,932517,Britt; King James,22,0,25,3
1748429236342,MUS 19R,A08,932522,Britt; King James,20,0,25,5
1748429236342,MUS 19R,A09,960795,Britt; King James,25,0,25,0
1748429236342,MUS 19R,A10,960796,Britt; King James,15,0,25,10
1748429236342,MUS 19R,B01,960808,Britt; King James,5,0,5,0
1748429236342,MUS 19R,B02,960810,Britt; King James,4,0,5,1
1748429236342,MUS 19R,B03,960812,Britt; King James,5,0,5,0
1748429236342,MUS 19R,B04,960815,Britt; King James,5,0,5,0
1748429236342,MUS 19R,B05,960861,Britt; King James,5,0,5,0
1748429236342,MUS 19R,B06,960863,Britt; King James,5,0,5,0
1748429236342,MUS 19R,B07,960866,Britt; King James,5,0,5,0
1748429236342,MUS 19R,B08,960870,Britt; King James,5,0,5,0
1748429236342,MUS 19R,B09,960871,Britt; King James,5,0,5,0
1748429236342,MUS 19R,B10,960872,Britt; King James,5,0,5,0
1748429237370,MUS 32,001,931432,Dresser; Mark Stuart,5,0,5,0
1748429237370,MUS 32,002,931433,Smythe; Cory Benjamin,5,0,5,0
1748429237370,MUS 32,003,931438,Kenyatta; Kamau,5,0,5,0
1748429237370,MUS 32,004,931441,Curtis; Charles Rector,5,0,5,0
1748429237370,MUS 32,005,931443,Staff,5,0,5,0
1748429237370,MUS 32,006,931447,Terrazas Perez; Wilfrido D,5,0,5,0
1748429237370,MUS 32,007,931448,Ohnishi; Takae,5,0,5,0
1748429237370,MUS 32,008,931453,Burr; Anthony I,5,0,5,0
1748429237370,MUS 32,009,931454,Carlson; Erik,5,0,5,0
1748429238397,MUS 32V,A00,932529,Staff,5,0,5,0
1748429238397,MUS 32V,B00,932532,Staff,5,0,5,0
1748429239425,MUS 32VM,A00,932533,Staff,15,0,15,0
1748429240451,MUS 33A,A00,932538,Liang; Lei,16,0,17,1
1748429241477,MUS 43,A00,932540,Staff,79,0,96,17
1748429242502,MUS 95C,A00,932544,Staff,30,0,40,10
1748429243529,MUS 95D,A00,932547,Staff,30,0,30,0
1748429244561,MUS 95E,A00,932548,Staff,45,0,45,0
1748429245586,MUS 95F,A00,932549,Staff,40,0,40,0
1748429246613,MUS 95G,A00,932550,Anderson; Kenneth,374,0,395,21
1748429246613,MUS 95G,B00,932553,Anderson; Kenneth,381,0,395,14
1748429247641,MUS 95JC,A00,932555,Kenyatta; Kamau,25,0,25,0
1748429248670,MUS 95L,A00,932556,Staff,65,0,65,0
1748429249705,MUS 95P,A00,932564,Nourai; Keyavash,17,0,20,3
1748429249705,MUS 95P,B00,932565,Nourai; Keyavash,18,0,20,2
1748429250732,MUS 95W,A00,932567,Seshadri; Kartik,26,0,30,4
1748429250732,MUS 95W,B00,932570,Seshadri; Kartik,30,0,30,0
1748429251758,MUS 101A,A01,932575,Burr; Anthony I,31,0,35,4
1748429252782,MUS 107,A00,932578,Terrazas Perez; Wilfrido D,14,0,15,1
1748429253807,MUS 111,A00,932580,Liang; Lei,135,0,140,5
1748429254833,MUS 113,A00,932584,Curtis; Charles Rector,48,0,50,2
1748429255941,MUS 115,A00,932585,Narucki; Susan M,32,0,40,8
1748429256968,MUS 120A,A01,932593,Leslie Santana; Myrta,27,0,30,3
1748429257997,MUS 130,A00,932600,Ohnishi; Takae,35,0,35,0
1748429259032,MUS 132,001,931462,Dresser; Mark Stuart,5,0,5,0
1748429259032,MUS 132,002,931463,Smythe; Cory Benjamin,5,0,5,0
1748429259032,MUS 132,003,931465,Kenyatta; Kamau,5,0,5,0
1748429259032,MUS 132,004,931467,Curtis; Charles Rector,5,0,5,0
1748429259032,MUS 132,005,931468,Staff,5,0,5,0
1748429259032,MUS 132,006,931470,Terrazas Perez; Wilfrido D,5,0,5,0
1748429259032,MUS 132,007,931471,Ohnishi; Takae,5,0,5,0
1748429259032,MUS 132,008,931473,Burr; Anthony I,5,0,5,0
1748429259032,MUS 132,009,931474,Carlson; Erik,5,0,5,0
1748429260061,MUS 132R,A00,961401,Narucki; Susan M,5,0,5,0
1748429261085,MUS 132V,A00,961362,Narucki; Susan M,10,0,10,0
1748429261085,MUS 132V,B00,961397,Staff,10,0,10,0
1748429262111,MUS 134,A00,932601,Staff,30,0,30,0
1748429263137,MUS 137A,A00,932604,Kenyatta; Kamau,31,0,35,4
1748429264163,MUS 143,A00,932617,Staff,10,0,30,20
1748429265200,MUS 170,A01,932620,Freitas Caetano; Marcelo,45,0,50,5
1748429265200,MUS 170,A02,932623,Freitas Caetano; Marcelo,41,0,50,9
1748429266228,MUS 173A,A00,932625,Britt; King James,27,0,65,38
1748429267253,MUS 174A,A00,932649,Erbe; Tom,0,0,25,25
1748429268280,MUS 175,A00,932810,Smyth; Tamara R.,29,0,30,1
1748429269305,MUS 176,A00,932811,Yadegari; Shahrokh D,29,0,30,1
1748429270331,MUS 201A,A00,932812,Carlson; Erik,14,0,15,1
1748429271360,MUS 201C,A00,932818,Schick; Steven,15,0,15,0
1748429272384,MUS 203A,A00,932821,Lou; Michelle Siulai,15,0,15,0
1748429273413,MUS 203D,A00,932825,Davis; Anthony Curtis,10,0,10,0
1748429273413,MUS 203D,B00,932827,Liang; Lei,10,0,10,0
1748429273413,MUS 203D,C00,932828,Lou; Michelle Siulai,9,0,10,1
1748429273413,MUS 203D,D00,932830,Obermueller; Karola,9,0,10,1
1748429273413,MUS 203D,E00,932831,Steiger; Rand,10,0,10,0
1748429273413,MUS 203D,F00,961402,McCormack; Timothy Matthew,10,0,10,0
1748429274438,MUS 204,A00,932832,Obermueller; Karola,29,0,30,1
1748429275470,MUS 205,A00,932833,Guy; Nancy,15,0,15,0
1748429276495,MUS 206,B00,961403,Obermueller; Karola,14,0,15,1
1748429276495,MUS 206,C00,932839,Davis; Anthony Curtis,14,0,15,1
1748429277520,MUS 215A,A00,932985,Cimini; Amy Marie,15,0,15,0
1748429278556,MUS 228,A00,933096,Schick; Steven,13,0,15,2
1748429279581,MUS 229,A00,933148,McCormack; Timothy Matthew,14,0,15,1
1748429280611,MUS 232,001,931483,Dresser; Mark Stuart,5,0,5,0
1748429280611,MUS 232,002,931485,Kenyatta; Kamau,5,0,5,0
1748429280611,MUS 232,003,931487,Narucki; Susan M,4,0,5,1
1748429280611,MUS 232,004,931489,Schick; Steven,5,0,5,0
1748429280611,MUS 232,005,964353,Terrazas Perez; Wilfrido D,3,0,3,0
1748429281636,MUS 234,A00,933176,Erbe; Tom,20,0,20,0
1748429282665,MUS 270D,A00,969315,Smyth; Tamara R.,0,0,0,0
1748429283697,MUS 291,A00,933192,Curtis; Charles Rector,15,0,15,0
1748429284726,NANO 4,A01,912573,Vazquez Mena; Oscar,21,0,24,3
1748429284726,NANO 4,B01,912575,Vazquez Mena; Oscar,24,0,24,0
1748429284726,NANO 4,C01,912577,Vazquez Mena; Oscar,21,0,24,3
1748429284726,NANO 4,D01,912579,Vazquez Mena; Oscar,23,0,24,1
1748429285763,NANO 11,A00,912580,Fenning; David,143,0,146,3
1748429286790,NANO 15,A01,912583,Lubarda; Vlado,26,0,30,4
1748429287817,NANO 20L,A00,912584,Sirbuly; Donald,0,0,30,30
1748429287817,NANO 20L,B00,912585,Sirbuly; Donald,20,0,30,10
1748429288873,NANO 102,A00,912586,Tao; Andrea Rae,99,0,115,16
1748429289899,NANO 103,A00,912587,Jahed Motlagh; Zeinab,49,0,50,1
1748429290926,NANO 111,A00,912588,Vecchio; Kenneth S,51,0,60,9
1748429291955,NANO 119,A00,912589,Jokerst; Jesse Vincent,6,0,28,22
1748429291955,NANO 119,B00,912590,Jokerst; Jesse Vincent,26,0,28,2
1748429292984,NANO 148,A00,912591,Luo; Jian,55,0,70,15
1748429294011,NANO 150,A00,912592,Lubarda; Vlado,48,0,50,2
1748429295040,NANO 159,A00,912593,Wang; Joseph,44,0,50,6
1748429296064,NANO 175,A00,912594,Steinmetz; Nicole F,13,0,35,22
1748429297087,NANO 200,A00,912595,Jahed Motlagh; Zeinab,110,0,120,10
1748429298111,NANO 201,A00,912596,Sirbuly; Donald,49,0,60,11
1748429299138,NANO 202,A00,912597,Pascal; Tod A,60,0,60,0
1748429300167,NANO 203,A00,912598,Fenning; David,95,0,100,5
1748429301241,NANO 227,A00,912599,Graeve; Olivia A,14,0,15,1
1748429302276,NANO 247A,A00,912600,Shi; Lingyan,9,0,15,6
1748429303302,NANO 247B,A00,912601,Aran; Kiana,11,0,15,4
1748429304331,NANO 257,A00,912602,Cai; Shengqiang,32,0,35,3
1748429305371,NANO 265,A00,912603,Luo; Jian,9,0,10,1
1748429306400,NEU 276,A00,969333,Staff,0,0,0,0
1748429306400,NEU 276,A01,969334,Staff,0,0,0,0
1748429307426,NEUG 200A,A01,969326,Bloodgood; Brenda Laurie,0,0,0,0
1748429307426,NEUG 200A,A02,969327,Bloodgood; Brenda Laurie,0,0,0,0
1748429308454,NEUG 221,A00,969330,Dore; Kim Bohemie,6,0,6,0
1748429308454,NEUG 221,B00,969331,Bloodgood; Brenda Laurie,0,0,0,0
1748429309483,NEUG 265,A00,969329,Yaksh; Tony L.,10,0,10,0
1748429310508,NEUG 296,A00,969336,Bloodgood; Brenda Laurie,12,0,12,0
1748429311535,PH 40,A00,922279,Trinidad; Dennis Ryan,136,0,150,14
1748429311535,PH 40,B00,922283,Trinidad; Dennis Ryan,148,0,150,2
1748429312584,PH 50,A00,922284,Glockner; Susan Mariscal,160,0,175,15
1748429313612,PH 90,A00,964352,Larsen; Britta Ann,0,0,0,0
1748429314641,PH 91,A00,922286,Harrell; Maralee Mae,48,0,50,2
1748429315666,PH 101,A00,922287,Brouwer; Kimberly,0,0,50,50
1748429316691,PH 102,A01,922307,Rana; Brinda Kanti,0,0,25,25
1748429316691,PH 102,A02,922310,Rana; Brinda Kanti,0,0,25,25
1748429317725,PH 110,A00,922333,Zoumas-Morse; Christine E.,0,0,50,50
1748429318754,PH 120,A00,922392,McMenamin; Sara B,0,0,50,50
1748429319783,PH 120R,A00,922393,McMenamin; Sara B,0,0,50,50
1748429320808,PH 130,A00,922441,Kayser; Georgia Lyn,0,0,60,60
1748429321834,PH 157,A00,922444,Campbell; Chadwick Karl,28,0,50,22
1748429322858,PH 161,A00,922445,Zoumas-Morse; Christine E.,0,0,50,50
1748429323900,PH 193,A00,922468,Zoumas-Morse; Christine E.,0,0,0,0
1748429324925,PH 231,A00,970937,Hurst; Samantha,12,0,12,0
1748429325957,PH 258,A00,960659,Bazzi; Angela Robertson,15,0,15,0
1748429326982,PH 259,A00,960660,Bandoli; Gretchen,10,0,10,0
1748429328006,PH 275,A00,922474,Groessl; Erik Joseph,10,0,10,0
1748429329033,PH 280,A00,960661,Strong; David R & Skaathun; Britt Paige,10,0,10,0
1748429330076,PHAR 219,A00,954131,Ross; Camille,0,0,0,0
1748429331111,PHAR 236,A00,934403,Chen; Shu-Juan,10,0,10,0
1748429332140,PHAR 295,A00,934404,Joiner; William J.,14,0,15,1
1748429333167,PHB 221,A00,922708,Zou; Jingjing,22,0,39,17
1748429334193,PHB 224,A00,922793,Jain; Sonia,9,0,30,21
1748429335222,PHB 227,A00,922796,Liu; Lin,14,0,37,23
1748429336251,PHB 241,A00,970723,Vaida; Florin,9998,0,9999,1
1748429337276,PHB 243A,A01,922822,Tu; Xin,20,0,45,25
1748429338301,PHB 244A,A00,922870,Zhang; Xinlian,20,0,35,15
1748429339332,PHB 280,A00,922875,Messer; Karen Sue,69,0,70,1
1748429340410,PHB 281,A00,923029,Staff,62,0,65,3
1748429341436,PHIL 1,A00,934405,Sher; Gila,38,0,40,2
1748429342464,PHIL 10,A01,934409,Rudolph; Rachel Etta,34,0,39,5
1748429342464,PHIL 10,A02,934410,Rudolph; Rachel Etta,32,0,40,8
1748429342464,PHIL 10,A03,934414,Rudolph; Rachel Etta,31,0,40,9
1748429342464,PHIL 10,A04,934415,Rudolph; Rachel Etta,39,0,40,1
1748429342464,PHIL 10,A05,934416,Rudolph; Rachel Etta,35,0,40,5
1748429342464,PHIL 10,A06,934417,Rudolph; Rachel Etta,39,0,40,1
1748429343494,PHIL 12,A01,934419,Harrell; Maralee Mae,0,0,0,0
1748429343494,PHIL 12,A02,934422,Harrell; Maralee Mae,0,0,0,0
1748429343494,PHIL 12,A03,934423,Harrell; Maralee Mae,30,0,35,5
1748429343494,PHIL 12,A04,934425,Harrell; Maralee Mae,32,0,35,3
1748429344531,PHIL 13,A01,934427,Lamey; Andy M.,32,0,34,2
1748429344531,PHIL 13,A02,934429,Lamey; Andy M.,31,0,34,3
1748429344531,PHIL 13,A03,934430,Lamey; Andy M.,31,0,34,3
1748429344531,PHIL 13,A04,934432,Lamey; Andy M.,34,0,34,0
1748429345562,PHIL 25,A00,934434,Chen; Keming,65,0,70,5
1748429346590,PHIL 27,A01,934442,Brandt; Reuven A,0,0,33,33
1748429346590,PHIL 27,A02,934443,Brandt; Reuven A,7,0,33,26
1748429346590,PHIL 27,A03,934444,Brandt; Reuven A,10,0,33,23
1748429346590,PHIL 27,A04,934448,Brandt; Reuven A,0,0,33,33
1748429346590,PHIL 27,A05,934450,Brandt; Reuven A,19,0,33,14
1748429346590,PHIL 27,A06,934452,Brandt; Reuven A,0,0,33,33
1748429346590,PHIL 27,A07,934499,Brandt; Reuven A,0,0,33,33
1748429346590,PHIL 27,A08,934500,Brandt; Reuven A,5,0,33,28
1748429347624,PHIL 28,A01,934502,Brink; David O.,26,0,33,7
1748429347624,PHIL 28,A02,934506,Brink; David O.,26,0,33,7
1748429347624,PHIL 28,A03,934507,Brink; David O.,27,0,33,6
1748429347624,PHIL 28,A04,934512,Brink; David O.,8,0,33,25
1748429347624,PHIL 28,A05,934517,Brink; David O.,20,0,33,13
1748429347624,PHIL 28,A06,934518,Brink; David O.,0,0,33,33
1748429347624,PHIL 28,A07,934519,Brink; David O.,16,0,33,17
1748429347624,PHIL 28,A08,934520,Brink; David O.,27,0,33,6
1748429348652,PHIL 35,A00,934521,Vargas; Manuel Rogelio,138,0,140,2
1748429349680,PHIL 50,A00,934524,Nelkin; Dana Kay,124,0,140,16
1748429350711,PHIL 65,A00,934526,Rudolph; Rachel Etta,37,0,40,3
1748429351739,PHIL 110,A00,934529,Shields; Christopher John,38,0,42,4
1748429352765,PHIL 115,A00,934530,Nelkin; Dana Kay,15,0,20,5
1748429353794,PHIL 120,A00,934533,Kocurek; Alexander William,45,0,60,15
1748429354819,PHIL 125,A00,934534,Carr; Jennifer Rose,38,0,40,2
1748429355845,PHIL 138,A00,934535,Brink; David O.,29,0,40,11
1748429356873,PHIL 143,A00,934579,Cohen; Jonathan David,40,0,40,0
1748429357899,PHIL 148,A00,934580,Callender; Craig Adam,126,0,140,14
1748429358929,PHIL 149,A00,934581,Fulkerson; Matthew Todd,37,0,70,33
1748429359956,PHIL 158,A00,934593,Chen; Keming,20,0,40,20
1748429360983,PHIL 166,A00,934675,Lamey; Andy M.,27,0,40,13
1748429362008,PHIL 180,A00,934688,Hardimon; Michael O.,32,0,40,8
1748429363038,PHIL 200,A00,934719,Kovaka; Karenc,20,0,20,0
1748429364066,PHIL 201A,A00,934736,Shields; Christopher John,18,0,20,2
1748429365092,PHIL 209A,A00,934772,McKenzie; Kerry V.,10,0,10,0
1748429366119,PHIL 209C,A00,934787,McKenzie; Kerry V.,10,0,10,0
1748429367151,PHIL 222,A00,934789,Kocurek; Alexander William & Carr; Jennifer Rose,19,0,20,1
1748429368181,PHIL 260,A00,934791,Bazargan-Forward; Saba,18,0,20,2
1748429369208,PHIL 271,A00,934793,Vargas; Manuel Rogelio & Nelkin; Dana Kay & Fulkerson; Matthew Todd,9999,0,9999,0
1748429370236,PHIL 275,A00,934819,Watkins; Eric,9998,0,9999,1
1748429371266,PHIL 277,A00,934820,Tolley; Clinton,9997,0,9999,2
1748429372292,PHIL 278,A00,934821,Cohen; Jonathan David & Fulkerson; Matthew Todd,9999,0,9999,0
1748429373323,PHIL 280,A00,934827,Kovaka; Karenc,9999,0,9999,0
1748429374352,PHIL 281,A00,934828,Tolley; Clinton,9999,0,9999,0
1748429375377,PHIL 282,A00,934869,Bazargan-Forward; Saba,9999,0,9999,0
1748429376402,PHIL 283,A00,934870,Vargas; Manuel Rogelio & Tolley; Clinton,9999,0,9999,0
1748429377428,PHIL 286,A00,934871,Callender; Craig Adam & Chen; Keming,9999,0,9999,0
1748429378453,PHIL 287,A00,934872,Shields; Christopher John,9999,0,9999,0
1748429379493,PHIL 290,001,963258,Bazargan-Forward; Saba,9999,0,9999,0
1748429379493,PHIL 290,002,963281,Brandt; Reuven A,9999,0,9999,0
1748429379493,PHIL 290,003,963724,Brink; David O.,9999,0,9999,0
1748429379493,PHIL 290,004,963726,Callender; Craig Adam,9999,0,9999,0
1748429379493,PHIL 290,005,963740,Carr; Jennifer Rose,9999,0,9999,0
1748429379493,PHIL 290,006,963878,Cartwright; Nancy D.,9999,0,9999,0
1748429379493,PHIL 290,007,963888,Chen; Keming,9999,0,9999,0
1748429379493,PHIL 290,008,963889,Cohen; Jonathan David,9999,0,9999,0
1748429379493,PHIL 290,009,964028,Danks; David J,9999,0,9999,0
1748429379493,PHIL 290,010,964036,Fulkerson; Matthew Todd,9999,0,9999,0
1748429379493,PHIL 290,011,964044,Hardimon; Michael O.,9999,0,9999,0
1748429379493,PHIL 290,012,964084,Harrell; Maralee Mae,9999,0,9999,0
1748429379493,PHIL 290,013,964086,Johnson; Monte,9999,0,9999,0
1748429379493,PHIL 290,014,964093,Kocurek; Alexander William,9999,0,9999,0
1748429379493,PHIL 290,015,964101,Kovaka; Karenc,9999,0,9999,0
1748429379493,PHIL 290,016,964107,Lamey; Andy M.,9999,0,9999,0
1748429379493,PHIL 290,017,964113,Marechal; Patricia,9999,0,9999,0
1748429379493,PHIL 290,018,964125,McKenzie; Kerry V.,9999,0,9999,0
1748429379493,PHIL 290,019,964131,Nelkin; Dana Kay,9999,0,9999,0
1748429379493,PHIL 290,020,964132,Rickless; Samuel Charles,9999,0,9999,0
1748429379493,PHIL 290,021,964133,Rudolph; Rachel Etta,9999,0,9999,0
1748429379493,PHIL 290,022,964141,Sher; Gila,9999,0,9999,0
1748429379493,PHIL 290,023,964142,Shields; Christopher John,9999,0,9999,0
1748429379493,PHIL 290,024,964181,Tolley; Clinton,9999,0,9999,0
1748429379493,PHIL 290,025,964182,Vargas; Manuel Rogelio,9999,0,9999,0
1748429379493,PHIL 290,026,964232,Watkins; Eric,9999,0,9999,0
1748429379493,PHIL 290,027,964233,Yuan; Yuan,9999,0,9999,0
1748429380528,PHIL 295,001,964259,Bazargan-Forward; Saba,9999,0,9999,0
1748429380528,PHIL 295,002,964262,Brandt; Reuven A,9999,0,9999,0
1748429380528,PHIL 295,003,964263,Brink; David O.,9999,0,9999,0
1748429380528,PHIL 295,004,964264,Callender; Craig Adam,9999,0,9999,0
1748429380528,PHIL 295,005,964265,Carr; Jennifer Rose,9999,0,9999,0
1748429380528,PHIL 295,006,964266,Cartwright; Nancy D.,9999,0,9999,0
1748429380528,PHIL 295,007,964267,Chen; Keming,9999,0,9999,0
1748429380528,PHIL 295,008,964268,Cohen; Jonathan David,9999,0,9999,0
1748429380528,PHIL 295,009,964269,Danks; David J,9999,0,9999,0
1748429380528,PHIL 295,010,964270,Fulkerson; Matthew Todd,9999,0,9999,0
1748429380528,PHIL 295,011,964271,Hardimon; Michael O.,9999,0,9999,0
1748429380528,PHIL 295,012,964272,Harrell; Maralee Mae,9999,0,9999,0
1748429380528,PHIL 295,013,964273,Johnson; Monte,9999,0,9999,0
1748429380528,PHIL 295,014,964274,Kocurek; Alexander William,9999,0,9999,0
1748429380528,PHIL 295,015,964275,Kovaka; Karenc,9999,0,9999,0
1748429380528,PHIL 295,016,964276,Lamey; Andy M.,9999,0,9999,0
1748429380528,PHIL 295,017,964277,Marechal; Patricia,9999,0,9999,0
1748429380528,PHIL 295,018,964278,McKenzie; Kerry V.,9999,0,9999,0
1748429380528,PHIL 295,019,964279,Nelkin; Dana Kay,9999,0,9999,0
1748429380528,PHIL 295,020,964280,Rickless; Samuel Charles,9999,0,9999,0
1748429380528,PHIL 295,021,964281,Rudolph; Rachel Etta,9999,0,9999,0
1748429380528,PHIL 295,022,964282,Sher; Gila,9999,0,9999,0
1748429380528,PHIL 295,023,964283,Shields; Christopher John,9999,0,9999,0
1748429380528,PHIL 295,024,964284,Tolley; Clinton,9999,0,9999,0
1748429380528,PHIL 295,025,964285,Vargas; Manuel Rogelio,9999,0,9999,0
1748429380528,PHIL 295,026,964286,Watkins; Eric,9999,0,9999,0
1748429380528,PHIL 295,027,964287,Yuan; Yuan,9999,0,9999,0
1748429381557,PHYS 1A,A00,935435,Groisman; Alexander,434,0,589,155
1748429381557,PHYS 1A,B00,935437,Groisman; Alexander,456,0,600,144
1748429382600,PHYS 1AL,001,935439,Bal; Gurleen K & Frano Pereira; Alex M,18,0,30,12
1748429382600,PHYS 1AL,002,935440,Bal; Gurleen K & Frano Pereira; Alex M,25,0,30,5
1748429382600,PHYS 1AL,003,935443,Bal; Gurleen K & Frano Pereira; Alex M,0,0,30,30
1748429382600,PHYS 1AL,004,935445,Bal; Gurleen K & Frano Pereira; Alex M,0,0,30,30
1748429382600,PHYS 1AL,005,935448,Bal; Gurleen K & Frano Pereira; Alex M,0,0,30,30
1748429382600,PHYS 1AL,006,935449,Bal; Gurleen K & Frano Pereira; Alex M,0,0,30,30
1748429382600,PHYS 1AL,007,935451,Bal; Gurleen K & Frano Pereira; Alex M,0,0,30,30
1748429382600,PHYS 1AL,008,935452,Bal; Gurleen K & Frano Pereira; Alex M,1,0,30,29
1748429382600,PHYS 1AL,009,935454,Bal; Gurleen K & Frano Pereira; Alex M,9,0,30,21
1748429382600,PHYS 1AL,010,935589,Bal; Gurleen K & Frano Pereira; Alex M,17,0,30,13
1748429382600,PHYS 1AL,011,935590,Bal; Gurleen K & Frano Pereira; Alex M,15,0,19,4
1748429382600,PHYS 1AL,012,935591,Bal; Gurleen K & Frano Pereira; Alex M,29,0,30,1
1748429382600,PHYS 1AL,013,935652,Bal; Gurleen K & Frano Pereira; Alex M,0,0,30,30
1748429382600,PHYS 1AL,014,935675,Bal; Gurleen K & Frano Pereira; Alex M,0,0,30,30
1748429382600,PHYS 1AL,015,935680,Bal; Gurleen K & Frano Pereira; Alex M,0,0,30,30
1748429382600,PHYS 1AL,016,935703,Bal; Gurleen K & Frano Pereira; Alex M,0,0,30,30
1748429382600,PHYS 1AL,017,935704,Bal; Gurleen K & Frano Pereira; Alex M,9,0,30,21
1748429382600,PHYS 1AL,018,935729,Bal; Gurleen K & Frano Pereira; Alex M,12,0,30,18
1748429382600,PHYS 1AL,019,935825,Bal; Gurleen K & Frano Pereira; Alex M,23,0,30,7
1748429382600,PHYS 1AL,020,935826,Bal; Gurleen K & Frano Pereira; Alex M,27,0,30,3
1748429382600,PHYS 1AL,021,935946,Bal; Gurleen K & Frano Pereira; Alex M,28,0,30,2
1748429382600,PHYS 1AL,022,935947,Bal; Gurleen K & Frano Pereira; Alex M,30,0,30,0
1748429382600,PHYS 1AL,023,936029,Bal; Gurleen K & Frano Pereira; Alex M,4,0,30,26
1748429382600,PHYS 1AL,024,936031,Bal; Gurleen K & Frano Pereira; Alex M,12,0,30,18
1748429382600,PHYS 1AL,025,936033,Bal; Gurleen K & Frano Pereira; Alex M,19,0,30,11
1748429382600,PHYS 1AL,026,936034,Bal; Gurleen K & Frano Pereira; Alex M,19,0,30,11
1748429382600,PHYS 1AL,027,936036,Bal; Gurleen K & Frano Pereira; Alex M,6,0,30,24
1748429382600,PHYS 1AL,028,936038,Bal; Gurleen K & Frano Pereira; Alex M,22,0,30,8
1748429382600,PHYS 1AL,029,936044,Bal; Gurleen K & Frano Pereira; Alex M,20,0,30,10
1748429382600,PHYS 1AL,030,936045,Bal; Gurleen K & Frano Pereira; Alex M,27,0,30,3
1748429382600,PHYS 1AL,031,936054,Bal; Gurleen K & Frano Pereira; Alex M,28,0,30,2
1748429382600,PHYS 1AL,032,936056,Bal; Gurleen K & Frano Pereira; Alex M,28,0,30,2
1748429382600,PHYS 1AL,033,936057,Bal; Gurleen K & Frano Pereira; Alex M,0,0,30,30
1748429382600,PHYS 1AL,034,936059,Bal; Gurleen K & Frano Pereira; Alex M,1,0,30,29
1748429382600,PHYS 1AL,035,936060,Bal; Gurleen K & Frano Pereira; Alex M,11,0,30,19
1748429382600,PHYS 1AL,036,936063,Bal; Gurleen K & Frano Pereira; Alex M,21,0,30,9
1748429382600,PHYS 1AL,037,960551,Bal; Gurleen K & Frano Pereira; Alex M,25,0,30,5
1748429382600,PHYS 1AL,038,960592,Bal; Gurleen K & Frano Pereira; Alex M,28,0,30,2
1748429382600,PHYS 1AL,039,960618,Bal; Gurleen K & Frano Pereira; Alex M,29,0,30,1
1748429382600,PHYS 1AL,040,960644,Bal; Gurleen K & Frano Pereira; Alex M,30,0,30,0
1748429383627,PHYS 1B,A00,936064,Staff,216,0,360,144
1748429384657,PHYS 1BL,001,936066,Bal; Gurleen K & Frano Pereira; Alex M,1,0,29,28
1748429384657,PHYS 1BL,002,936067,Bal; Gurleen K & Frano Pereira; Alex M,0,0,30,30
1748429384657,PHYS 1BL,003,936068,Bal; Gurleen K & Frano Pereira; Alex M,5,0,30,25
1748429384657,PHYS 1BL,004,936072,Bal; Gurleen K & Frano Pereira; Alex M,0,0,30,30
1748429384657,PHYS 1BL,005,936074,Bal; Gurleen K & Frano Pereira; Alex M,0,0,30,30
1748429384657,PHYS 1BL,006,936075,Bal; Gurleen K & Frano Pereira; Alex M,0,0,30,30
1748429384657,PHYS 1BL,007,936116,Bal; Gurleen K & Frano Pereira; Alex M,7,0,30,23
1748429384657,PHYS 1BL,008,936125,Bal; Gurleen K & Frano Pereira; Alex M,14,0,30,16
1748429384657,PHYS 1BL,009,936128,Bal; Gurleen K & Frano Pereira; Alex M,12,0,30,18
1748429384657,PHYS 1BL,010,936145,Bal; Gurleen K & Frano Pereira; Alex M,14,0,30,16
1748429384657,PHYS 1BL,011,936146,Bal; Gurleen K & Frano Pereira; Alex M,0,0,30,30
1748429384657,PHYS 1BL,012,936147,Bal; Gurleen K & Frano Pereira; Alex M,6,0,30,24
1748429385685,PHYS 1C,A00,936148,Tsai; Philbert S,220,0,360,140
1748429386717,PHYS 1CL,001,936149,Bal; Gurleen K & Frano Pereira; Alex M,0,0,30,30
1748429386717,PHYS 1CL,002,936150,Bal; Gurleen K & Frano Pereira; Alex M,0,0,30,30
1748429386717,PHYS 1CL,003,936152,Bal; Gurleen K & Frano Pereira; Alex M,0,0,30,30
1748429386717,PHYS 1CL,004,936153,Bal; Gurleen K & Frano Pereira; Alex M,0,0,30,30
1748429386717,PHYS 1CL,005,936154,Bal; Gurleen K & Frano Pereira; Alex M,0,0,30,30
1748429386717,PHYS 1CL,006,936156,Bal; Gurleen K & Frano Pereira; Alex M,0,0,24,24
1748429386717,PHYS 1CL,007,936157,Bal; Gurleen K & Frano Pereira; Alex M,22,0,30,8
1748429386717,PHYS 1CL,008,936158,Bal; Gurleen K & Frano Pereira; Alex M,0,0,30,30
1748429386717,PHYS 1CL,009,936159,Bal; Gurleen K & Frano Pereira; Alex M,0,0,30,30
1748429386717,PHYS 1CL,010,936160,Bal; Gurleen K & Frano Pereira; Alex M,0,0,30,30
1748429386717,PHYS 1CL,011,936161,Bal; Gurleen K & Frano Pereira; Alex M,0,0,30,30
1748429386717,PHYS 1CL,012,936162,Bal; Gurleen K & Frano Pereira; Alex M,0,0,30,30
1748429387746,PHYS 2A,A01,936165,Shotwell; Brian,30,0,30,0
1748429387746,PHYS 2A,A02,936167,Shotwell; Brian,28,0,30,2
1748429387746,PHYS 2A,A03,936168,Shotwell; Brian,25,0,30,5
1748429387746,PHYS 2A,A04,936169,Shotwell; Brian,30,0,30,0
1748429387746,PHYS 2A,A05,936170,Shotwell; Brian,16,0,25,9
1748429387746,PHYS 2A,A06,936171,Shotwell; Brian,26,0,30,4
1748429387746,PHYS 2A,A07,936172,Shotwell; Brian,18,0,30,12
1748429387746,PHYS 2A,A08,936174,Shotwell; Brian,24,0,30,6
1748429387746,PHYS 2A,A09,936175,Shotwell; Brian,25,0,30,5
1748429387746,PHYS 2A,A10,936176,Shotwell; Brian,25,0,30,5
1748429387746,PHYS 2A,A11,936177,Shotwell; Brian,21,0,30,9
1748429387746,PHYS 2A,A12,936179,Shotwell; Brian,25,0,30,5
1748429388781,PHYS 2B,A01,936182,Barreiro Guerrero; Julio,13,0,30,17
1748429388781,PHYS 2B,A02,936183,Barreiro Guerrero; Julio,20,0,30,10
1748429388781,PHYS 2B,A03,936184,Barreiro Guerrero; Julio,20,0,30,10
1748429388781,PHYS 2B,A04,936185,Barreiro Guerrero; Julio,26,0,29,3
1748429388781,PHYS 2B,A05,936187,Barreiro Guerrero; Julio,27,0,30,3
1748429388781,PHYS 2B,A06,936217,Barreiro Guerrero; Julio,26,0,30,4
1748429388781,PHYS 2B,A07,936219,Barreiro Guerrero; Julio,23,0,30,7
1748429388781,PHYS 2B,A08,936220,Barreiro Guerrero; Julio,26,0,30,4
1748429388781,PHYS 2B,A09,936221,Barreiro Guerrero; Julio,29,0,30,1
1748429388781,PHYS 2B,A10,936224,Barreiro Guerrero; Julio,29,0,30,1
1748429388781,PHYS 2B,A11,936229,Barreiro Guerrero; Julio,28,0,30,2
1748429388781,PHYS 2B,A12,936231,Barreiro Guerrero; Julio,27,0,30,3
1748429389812,PHYS 2C,A01,936235,Tan; Tzer Han,23,0,30,7
1748429389812,PHYS 2C,A02,936236,Tan; Tzer Han,27,0,30,3
1748429389812,PHYS 2C,A03,936237,Tan; Tzer Han,22,0,30,8
1748429389812,PHYS 2C,A04,936246,Tan; Tzer Han,17,0,30,13
1748429389812,PHYS 2C,A05,936292,Tan; Tzer Han,16,0,28,12
1748429389812,PHYS 2C,A06,936300,Tan; Tzer Han,19,0,30,11
1748429389812,PHYS 2C,A07,936301,Tan; Tzer Han,8,0,30,22
1748429389812,PHYS 2C,A08,936302,Tan; Tzer Han,20,0,30,10
1748429389812,PHYS 2C,A09,936303,Tan; Tzer Han,26,0,30,4
1748429389812,PHYS 2C,A10,936304,Tan; Tzer Han,26,0,30,4
1748429389812,PHYS 2C,A11,936305,Tan; Tzer Han,12,0,30,18
1748429389812,PHYS 2C,A12,936332,Tan; Tzer Han,27,0,30,3
1748429389812,PHYS 2C,B01,936337,Tan; Tzer Han,0,0,30,30
1748429389812,PHYS 2C,B02,936470,Tan; Tzer Han,1,0,30,29
1748429389812,PHYS 2C,B03,936503,Tan; Tzer Han,21,0,30,9
1748429389812,PHYS 2C,B04,936533,Tan; Tzer Han,22,0,30,8
1748429389812,PHYS 2C,B05,936534,Tan; Tzer Han,20,0,30,10
1748429389812,PHYS 2C,B06,936535,Tan; Tzer Han,23,0,30,7
1748429389812,PHYS 2C,B07,936536,Tan; Tzer Han,25,0,30,5
1748429389812,PHYS 2C,B08,936537,Tan; Tzer Han,22,0,30,8
1748429389812,PHYS 2C,B09,936539,Tan; Tzer Han,26,0,30,4
1748429389812,PHYS 2C,B10,936540,Tan; Tzer Han,27,0,30,3
1748429389812,PHYS 2C,B11,936544,Tan; Tzer Han,28,0,30,2
1748429389812,PHYS 2C,B12,936548,Tan; Tzer Han,28,0,30,2
1748429390845,PHYS 2CL,A01,936555,Ni; Kaixuan,0,0,28,28
1748429390845,PHYS 2CL,A02,936556,Ni; Kaixuan,0,0,28,28
1748429390845,PHYS 2CL,A03,936557,Ni; Kaixuan,0,0,28,28
1748429390845,PHYS 2CL,A04,936559,Ni; Kaixuan,0,0,28,28
1748429390845,PHYS 2CL,A05,936566,Ni; Kaixuan,0,0,28,28
1748429390845,PHYS 2CL,A06,936582,Ni; Kaixuan,0,0,28,28
1748429390845,PHYS 2CL,A07,936583,Ni; Kaixuan,0,0,28,28
1748429391874,PHYS 2D,A01,936615,Sharma; Vivek A.,0,0,27,27
1748429392906,PHYS 2DL,A01,936627,Butov; Leonid,14,0,17,3
1748429392906,PHYS 2DL,A02,936628,Butov; Leonid,0,0,17,17
1748429392906,PHYS 2DL,A03,936629,Butov; Leonid,3,0,15,12
1748429392906,PHYS 2DL,A04,936630,Butov; Leonid,10,0,17,7
1748429392906,PHYS 2DL,A05,936631,Butov; Leonid,17,0,17,0
1748429392906,PHYS 2DL,A06,936632,Butov; Leonid,7,0,17,10
1748429392906,PHYS 2DL,A07,936633,Butov; Leonid,8,0,18,10
1748429393934,PHYS 4C,A01,936635,Chivukula; Raja S,22,0,43,21
1748429393934,PHYS 4C,A02,936636,Chivukula; Raja S,33,0,45,12
1748429393934,PHYS 4C,A03,936637,Chivukula; Raja S,38,0,45,7
1748429393934,PHYS 4C,A04,936638,Chivukula; Raja S,44,0,45,1
1748429394966,PHYS 12,A01,936640,Branson; James G,187,0,192,5
1748429395994,PHYS 87,A00,936641,Grinstein; Benjamin,20,0,20,0
1748429397025,PHYS 100A,A01,936643,Green; Daniel Richard,111,0,146,35
1748429398052,PHYS 110A,A01,936645,Dudko; Olga,107,0,146,39
1748429399080,PHYS 116,A00,936646,Diamond; Patrick H & Vergassola; Massimo,12,0,15,3
1748429400110,PHYS 130B,A01,936648,Keating; Brian,56,0,60,4
1748429401139,PHYS 133,A00,936649,Allen; Monica T,20,0,32,12
1748429402169,PHYS 136,A00,936650,Grinstein; Benjamin,42,0,50,8
1748429403197,PHYS 139,A00,936651,Hirsch; Jorge Eduardo,13,0,15,2
1748429403197,PHYS 139,B00,936663,Duarte; Javier Mauricio,0,0,0,10
1748429404223,PHYS 140A,A01,936723,Parker; Daniel E,54,0,60,6
1748429405249,PHYS 161,A01,936727,Fuller; George Michael,53,0,60,7
1748429406275,PHYS 175,A00,936728,Koslover; Elena F,11,0,15,4
1748429407305,PHYS 191,A00,936730,Yang; Liang,68,0,75,7
1748429408330,PHYS 200A,A01,936733,Di Ventra; Massimiliano,20,0,30,10
1748429409357,PHYS 201,A01,936736,Vergassola; Massimo,23,0,30,7
1748429410384,PHYS 210B,A00,936737,McGreevy; John A.,29,0,30,1
1748429411410,PHYS 211A,A00,936740,Butov; Leonid,28,0,30,2
1748429412441,PHYS 212A,A01,936873,Fogler; Michael M.,38,0,50,12
1748429413473,PHYS 215A,A00,936878,Shotwell; Brian,30,0,30,0
1748429414501,PHYS 216,A00,936879,Diamond; Patrick H & Vergassola; Massimo,15,0,15,0
1748429415527,PHYS 219,A00,936903,Allen; Monica T,5,0,5,0
1748429416552,PHYS 220,A01,936910,Arovas; Daniel P,30,0,30,0
1748429417579,PHYS 225A,A00,936911,Flauger; Raphael M,28,0,30,2
1748429418612,PHYS 239,A00,937172,Hirsch; Jorge Eduardo,14,0,15,1
1748429418612,PHYS 239,B00,937176,Duarte; Javier Mauricio,15,0,15,0
1748429418612,PHYS 239,C00,959883,Intriligator; Kenneth Arthur,30,0,30,0
1748429419639,PHYS 250,A00,937178,Hirsch; Jorge Eduardo,14,0,15,1
1748429420664,PHYS 251,A00,937182,Grinstein; Benjamin,15,0,15,0
1748429421689,PHYS 252,A00,937183,Diamond; Patrick H,15,0,15,0
1748429422715,PHYS 253,A00,937184,Fuller; George Michael,15,0,15,0
1748429423745,PHYS 254,A00,937185,Serra; Mattia,15,0,15,0
1748429424771,PHYS 255,A00,937186,Hwa; Terence T.,14,0,15,1
1748429425801,PHYS 260,A00,937187,Shpyrko; Oleg,49,0,50,1
1748429426827,PHYS 275,A00,937190,Koslover; Elena F,15,0,15,0
1748429427855,PHYS 279,A01,946429,Silva; Gabriel,0,0,0,0
1748429428882,PHYS 282,A00,937194,Hwa; Terence T.,20,0,20,0
1748429429910,POLI 5D,A01,937210,Staff,4,0,5,1
1748429429910,POLI 5D,B01,937219,Staff,5,0,5,0
1748429429910,POLI 5D,C01,937225,Dai; Yinlin,0,0,5,5
1748429430940,POLI 10D,A01,937228,Noble; Benjamin S,20,0,28,8
1748429430940,POLI 10D,A02,937229,Noble; Benjamin S,24,0,28,4
1748429430940,POLI 10D,A03,937230,Noble; Benjamin S,24,0,27,3
1748429430940,POLI 10D,A04,937231,Noble; Benjamin S,25,0,27,2
1748429430940,POLI 10D,A05,937238,Noble; Benjamin S,27,0,28,1
1748429430940,POLI 10D,A06,937243,Noble; Benjamin S,26,0,28,2
1748429431970,POLI 11D,A01,937360,Desposato; Scott,20,0,29,9
1748429431970,POLI 11D,A02,937430,Desposato; Scott,22,0,29,7
1748429431970,POLI 11D,A03,937445,Desposato; Scott,25,0,29,4
1748429431970,POLI 11D,A04,937446,Desposato; Scott,29,0,29,0
1748429431970,POLI 11D,A05,937447,Desposato; Scott,27,0,29,2
1748429431970,POLI 11D,A06,937463,Desposato; Scott,27,0,29,2
1748429433002,POLI 12D,A01,937472,Roeder; Philip G,16,0,20,4
1748429433002,POLI 12D,A02,937475,Roeder; Philip G,18,0,20,2
1748429433002,POLI 12D,A03,937485,Roeder; Philip G,17,0,19,2
1748429433002,POLI 12D,A04,937490,Roeder; Philip G,17,0,20,3
1748429433002,POLI 12D,A05,937500,Roeder; Philip G,19,0,20,1
1748429433002,POLI 12D,A06,937507,Roeder; Philip G,20,0,20,0
1748429434031,POLI 30D,A01,937510,Desposato; Scott,0,0,23,23
1748429434031,POLI 30D,A02,937530,Desposato; Scott,0,0,23,23
1748429434031,POLI 30D,A03,937531,Desposato; Scott,11,0,23,12
1748429434031,POLI 30D,A04,937532,Desposato; Scott,18,0,23,5
1748429434031,POLI 30D,A05,937591,Desposato; Scott,5,0,23,18
1748429434031,POLI 30D,A06,937592,Desposato; Scott,19,0,23,4
1748429435070,POLI 100H,A00,937593,Stout; Christopher Timothy,114,0,183,69
1748429436101,POLI 100I,A00,937594,Gause; LaGina,47,0,56,9
1748429437125,POLI 100V,A00,937596,Gause; LaGina,56,0,68,12
1748429438158,POLI 101A,A00,937597,Stout; Christopher Timothy,84,0,115,31
1748429439184,POLI 104A,A00,937598,Smith; Glenn Chatmas,207,0,290,83
1748429440219,POLI 104N,A00,937599,Stephens; Mattheus E,168,0,245,77
1748429441247,POLI 110A,A00,937600,Wiens; David,61,0,70,9
1748429442276,POLI 118,A00,937601,Wiens; David,69,0,94,25
1748429443303,POLI 122D,A00,937602,Strom; Kaare,15,0,70,55
1748429444384,POLI 125B,A00,937603,Naoi; Megumi,128,0,158,30
1748429445411,POLI 125D,A00,937604,Nichter; Simeon C,103,0,158,55
1748429446437,POLI 126,A00,937607,Nichter; Simeon C,43,0,120,77
1748429447476,POLI 133A,A00,937608,Naoi; Megumi,202,0,216,14
1748429448501,POLI 134D,A00,937609,Saiegh; Sebastian,62,0,75,13
1748429449532,POLI 143A,A00,937610,Slantchev; Branislav,147,0,158,11
1748429450564,POLI 145C,A00,937611,Fisk; David Lee,152,0,190,38
1748429451593,POLI 154,A00,937612,Fisk; David Lee,28,0,90,62
1748429452617,POLI 163,A00,937613,Saiegh; Sebastian,103,0,120,17
1748429453644,POLI 176,A00,968071,Roberts; Margaret Earling,23,0,45,22
1748429454675,POLI 191A,A00,937617,Stout; Christopher Timothy & Saiegh; Sebastian,25,0,25,0
1748429455706,POLI 194,A00,954111,Hill; Seth J,9999,0,9999,0
1748429456735,POLI 204A,A00,937618,Schneider; Christina,20,0,25,5
1748429457765,POLI 204B,A00,937619,Desposato; Scott,7,0,12,5
1748429458794,POLI 220B,A00,937621,Strom; Kaare,20,0,25,5
1748429459826,POLI 225,A00,937622,Thomas; Jakana,18,0,25,7
1748429460856,POLI 251,A00,937623,Noble; Benjamin S,24,0,25,1
1748429461882,POLI 252,A00,937624,Hajnal; Zoltan Lloyd,24,0,25,1
1748429463953,POLI 270,A00,973288,Roberts; Margaret Earling,24,0,25,1
1748429464983,POLI 279,A00,937626,Staff,8,0,12,4
1748429466010,POLI 280,A00,937628,Hafner-Burton; Emilie,21,0,25,4
1748429467039,POLI 281,A00,937629,Stout; Christopher Timothy,13,0,15,2
1748429468071,POLI 282,A00,937630,Roeder; Philip G,20,0,25,5
1748429469099,POLI 283,A00,937631,Slantchev; Branislav,18,0,25,7
1748429470127,POLI 285,A00,937632,Wiens; David,12,0,12,0
1748429471154,PSYC 1,A00,937633,Hurwitz; Ethan Scott,175,0,200,25
1748429472179,PSYC 2,A00,937634,Rose; Fred E.,133,0,150,17
1748429473205,PSYC 3R,A00,937693,Pilegard; Celeste Cristine,195,0,200,5
1748429474231,PSYC 6,A00,937694,McCullough; Michael E,142,0,150,8
1748429475261,PSYC 60,A01,957947,Lowe; Angela Beth,10,0,25,15
1748429475261,PSYC 60,A02,957948,Lowe; Angela Beth,17,0,25,8
1748429475261,PSYC 60,A03,957949,Lowe; Angela Beth,18,0,25,7
1748429475261,PSYC 60,A04,957950,Lowe; Angela Beth,24,0,25,1
1748429475261,PSYC 60,A05,957951,Lowe; Angela Beth,22,0,25,3
1748429475261,PSYC 60,A06,957952,Lowe; Angela Beth,22,0,25,3
1748429475261,PSYC 60,A07,957953,Lowe; Angela Beth,24,0,25,1
1748429475261,PSYC 60,B01,957954,Rickard; Timothy C.,24,0,25,1
1748429475261,PSYC 60,B02,957955,Rickard; Timothy C.,24,0,25,1
1748429475261,PSYC 60,B03,957956,Rickard; Timothy C.,25,0,25,0
1748429475261,PSYC 60,B04,957957,Rickard; Timothy C.,25,0,25,0
1748429475261,PSYC 60,B05,957958,Rickard; Timothy C.,24,0,25,1
1748429475261,PSYC 60,B06,957959,Rickard; Timothy C.,22,0,25,3
1748429475261,PSYC 60,B07,957960,Rickard; Timothy C.,22,0,25,3
1748429476288,PSYC 70,A01,957961,Pilegard; Celeste Cristine,6,0,25,19
1748429476288,PSYC 70,A02,957962,Pilegard; Celeste Cristine,19,0,25,6
1748429476288,PSYC 70,A03,957963,Pilegard; Celeste Cristine,19,0,25,6
1748429476288,PSYC 70,A04,957964,Pilegard; Celeste Cristine,21,0,25,4
1748429476288,PSYC 70,A05,957965,Pilegard; Celeste Cristine,24,0,25,1
1748429476288,PSYC 70,A06,957966,Pilegard; Celeste Cristine,23,0,25,2
1748429477315,PSYC 71,A01,937700,Geller; Emma Harlan,0,0,30,30
1748429477315,PSYC 71,A02,937701,Geller; Emma Harlan,0,0,30,30
1748429477315,PSYC 71,B01,937704,Steiner; Eric Tomas,0,0,25,25
1748429477315,PSYC 71,B02,937705,Steiner; Eric Tomas,0,0,25,25
1748429478344,PSYC 88,A00,937706,Dobkins; Karen R.,49,0,65,16
1748429479374,PSYC 100,A00,937707,Dickenson; Janna Alene,0,0,175,175
1748429480399,PSYC 101,A00,937709,Heyman; Gail D.,0,0,170,170
1748429481426,PSYC 104,A00,937711,Staff,0,0,175,175
1748429482452,PSYC 105,A00,937712,Geller; Emma Harlan,17,0,170,153
1748429483479,PSYC 106,A00,937713,Gremel; Christina M,89,0,170,81
1748429484507,PSYC 108,A00,937714,Adrian; Julia Anna,145,0,170,25
1748429485539,PSYC 114,A01,937720,Winkielman; Piotr,0,0,50,50
1748429486566,PSYC 122,A00,937724,Moranton; Nirelia Melbina-,241,0,250,9
1748429487593,PSYC 124,A00,937726,Chapman; Eddie Nathaniel,276,0,348,72
1748429488620,PSYC 137,A00,937727,Jolly; Eshin,248,0,295,47
1748429489649,PSYC 145,A00,937732,Lau; Aubrey,277,0,295,18
1748429490675,PSYC 154,A00,937734,Lacefield; Katharine I,18,0,300,282
1748429491701,PSYC 155,A00,937735,Dickenson; Janna Alene,139,0,295,156
1748429492727,PSYC 167,A00,937750,Walker; Caren Michelle,0,0,25,25
1748429493753,PSYC 169,A00,937751,Staff,212,0,250,38
1748429494780,PSYC 171,A00,937752,Mukku; Dhananjaya,149,0,216,67
1748429495806,PSYC 174,A00,937784,Staff,141,0,146,5
1748429496834,PSYC 178,A00,937788,Glaser; Dale,100,0,146,46
1748429497861,PSYC 181,A00,937814,Anagnostaras; Stephan,140,0,300,160
1748429498890,PSYC 184,A00,937816,Staff,267,0,295,28
1748429499917,PSYC 189,A00,937868,Gentner; Tim,13,0,55,42
1748429500945,PSYC 193,A00,937897,Chapman; Eddie Nathaniel,27,0,35,8
1748429500945,PSYC 193,B00,937917,Gorman; Michael R.,35,0,35,0
1748429500945,PSYC 193,C00,937918,Powell; Lindsey Jane,22,0,24,2
1748429501978,PSYC 193L,A01,937930,Brown; Sandra A,64,0,65,1
1748429501978,PSYC 193L,B01,937939,Lacefield; Katharine I,194,0,216,22
1748429503007,PSYC 194A,A01,937949,Heyman; Gail D.,35,0,35,0
1748429504034,PSYC 201A,A01,937954,Long; Bria,8,0,15,7
1748429505061,PSYC 205,A00,937976,Harris; Christine Renee,12,0,20,8
1748429506093,PSYC 217,A00,937977,Barner; David A.,16,0,20,4
1748429507121,PSYC 221,A00,937979,Dobkins; Karen R.,16,0,20,4
1748429508158,PSYC 224,A00,938013,Mukku; Dhananjaya,28,0,30,2
1748429509184,PSYC 242,A00,938016,Powell; Lindsey Jane,26,0,30,4
1748429510210,PSYC 244,A00,938017,Ferreira; Victor,15,0,20,5
1748429511242,PSYC 269,A00,938024,Schachner; Adena,19,0,20,1
1748429512272,PSYC 270A,A00,938028,Dobkins; Karen R.,13,0,20,7
1748429513298,PSYC 272,A00,938029,Lin; Chujun,14,0,20,6
1748429513298,PSYC 272,B00,938039,Wixted; John T,18,0,20,2
1748429514327,PSYC 274,A00,938042,McCullough; Michael E,26,0,30,4
1748429515354,PSYC 275,A00,938043,Brady; Timothy Francis,28,0,30,2
1748429516380,PSYC 280,A00,938055,Serences; John Thomas,70,0,80,10
1748429517415,PSYC 296,001,952632,Anagnostaras; Stephan,9999,0,9999,0
1748429517415,PSYC 296,002,952633,Aron; Adam,9999,0,9999,0
1748429517415,PSYC 296,003,952634,Mukku; Dhananjaya,9999,0,9999,0
1748429517415,PSYC 296,004,952635,Barner; David A.,9999,0,9999,0
1748429517415,PSYC 296,005,952636,Schachner; Adena,9999,0,9999,0
1748429517415,PSYC 296,006,952637,Brady; Timothy Francis,9999,0,9999,0
1748429517415,PSYC 296,007,952639,Brashier; Nadia Marie,9999,0,9999,0
1748429517415,PSYC 296,008,952640,Brown; Sandra A,9999,0,9999,0
1748429517415,PSYC 296,009,952641,Carver; Leslie J.,9998,0,9999,1
1748429517415,PSYC 296,010,952642,Chapman; Eddie Nathaniel,9999,0,9999,0
1748429517415,PSYC 296,011,952643,Dickenson; Janna Alene,9999,0,9999,0
1748429517415,PSYC 296,012,952644,Dobkins; Karen R.,9997,0,9999,2
1748429517415,PSYC 296,013,952646,Ferreira; Victor,9999,0,9999,0
1748429517415,PSYC 296,014,952647,Geller; Emma Harlan,9999,0,9999,0
1748429517415,PSYC 296,015,952648,Gentner; Tim,9999,0,9999,0
1748429517415,PSYC 296,016,952650,Gorman; Michael R.,9999,0,9999,0
1748429517415,PSYC 296,017,952651,Gremel; Christina M,9999,0,9999,0
1748429517415,PSYC 296,018,952652,Harris; Christine Renee,9999,0,9999,0
1748429517415,PSYC 296,019,952654,Heyman; Gail D.,9999,0,9999,0
1748429517415,PSYC 296,020,952655,Lin; Chujun,9999,0,9999,0
1748429517415,PSYC 296,021,952659,Long; Bria,9999,0,9999,0
1748429517415,PSYC 296,022,952660,McCullough; Michael E,9999,0,9999,0
1748429517415,PSYC 296,023,952661,Mc Kenzie; Craig R.M.,9999,0,9999,0
1748429517415,PSYC 296,024,952663,Miller; Cory T.,9998,0,9999,1
1748429517415,PSYC 296,025,952664,Oesch; Nicholas W,9999,0,9999,0
1748429517415,PSYC 296,026,952665,Pilegard; Celeste Cristine,9999,0,9999,0
1748429517415,PSYC 296,027,952666,Powell; Lindsey Jane,9999,0,9999,0
1748429517415,PSYC 296,028,952667,Rickard; Timothy C.,9999,0,9999,0
1748429517415,PSYC 296,029,952668,Serences; John Thomas,9999,0,9999,0
1748429517415,PSYC 296,030,952669,Walker; Caren Michelle,9998,0,9999,1
1748429517415,PSYC 296,031,952670,Winkielman; Piotr,9999,0,9999,0
1748429517415,PSYC 296,032,952671,Wixted; John T,9998,0,9999,1
1748429517415,PSYC 296,033,952673,Jolly; Eshin,9998,0,9999,1
1748429518443,REV 20,A00,946356,Yu; Paul K L,30,0,30,0
1748429518443,REV 20,B00,946357,Yu; Paul K L,30,0,30,0
1748429519476,REV 87,B00,969668,Rodriguez; Bretton Sigfred,20,0,20,0
1748429520506,SE 1,A01,938060,Van Den Einde; Yael Dahlia,0,0,9,9
1748429520506,SE 1,A02,938076,Van Den Einde; Yael Dahlia,0,0,8,8
1748429520506,SE 1,A03,938077,Van Den Einde; Yael Dahlia,0,0,8,8
1748429520506,SE 1,B01,938097,Van Den Einde; Yael Dahlia,0,0,9,9
1748429520506,SE 1,B02,938098,Van Den Einde; Yael Dahlia,0,0,8,8
1748429520506,SE 1,B03,938109,Van Den Einde; Yael Dahlia,0,0,8,8
1748429521533,SE 101A,A01,938120,Morrison; Machel Leigh,165,0,250,85
1748429522563,SE 101C,A01,938148,Zhu; Qiang,178,0,250,72
1748429523590,SE 105,A01,938153,Qiao; Yu,78,0,120,42
1748429524617,SE 125,A01,938218,Conte; Joel P,166,0,210,44
1748429525649,SE 130A,A00,938219,Loh; Kenneth J. H.,69,0,165,96
1748429526677,SE 131B,A01,938221,Krysl; Petr,119,0,210,91
1748429527703,SE 142,A01,938223,Kim; Hyonny,20,0,27,7
1748429527703,SE 142,A02,938236,Kim; Hyonny,23,0,27,4
1748429527703,SE 142,A03,938237,Kim; Hyonny,19,0,27,8
1748429527703,SE 142,A04,938238,Kim; Hyonny,19,0,22,3
1748429528737,SE 163,A01,938240,Lanza Di Scalea; Francesco,17,0,19,2
1748429528737,SE 163,A02,938241,Lanza Di Scalea; Francesco,16,0,19,3
1748429528737,SE 163,A03,938254,Lanza Di Scalea; Francesco,16,0,17,1
1748429529771,SE 180,A00,938255,Elgamal; Ahmed,142,0,170,28
1748429530799,SE 181,A01,938280,McCartney; John Scott,1,0,24,23
1748429530799,SE 181,A02,938281,McCartney; John Scott,6,0,24,18
1748429530799,SE 181,A03,938296,McCartney; John Scott,1,0,24,23
1748429530799,SE 181,A04,938297,McCartney; John Scott,0,0,24,24
1748429530799,SE 181,A05,938299,McCartney; John Scott,20,0,24,4
1748429530799,SE 181,A06,938320,McCartney; John Scott,22,0,24,2
1748429530799,SE 181,A07,938324,McCartney; John Scott,8,0,24,16
1748429531825,SE 201A,A00,938329,Mosqueda; Gilberto,35,0,65,30
1748429532859,SE 203A,A00,938331,Tsampras; Georgios,32,0,65,33
1748429533891,SE 212,A00,938332,Uang; Chia-Ming,28,0,68,40
1748429534919,SE 220,A00,965249,Mosqueda; Gilberto,28,0,36,8
1748429535951,SE 223,A00,969767,Staff,19,0,25,6
1748429536984,SE 233,A00,938555,Krysl; Petr,19,0,50,31
1748429538009,SE 241,A00,938333,Elgamal; Ahmed,0,0,20,20
1748429539039,SE 244,A00,938334,Elgamal; Ahmed,39,0,40,1
1748429540066,SE 248,A00,938363,McCartney; John Scott,20,0,30,10
1748429541100,SE 253A,A01,938448,Kim; Hyonny,2,0,5,3
1748429541100,SE 253A,A02,938451,Kim; Hyonny,3,0,5,2
1748429541100,SE 253A,A03,938452,Kim; Hyonny,3,0,5,2
1748429541100,SE 253A,A04,938453,Kim; Hyonny,2,0,2,0
1748429542125,SE 263,A01,938460,Lanza Di Scalea; Francesco,15,0,17,2
1748429542125,SE 263,A02,938461,Lanza Di Scalea; Francesco,11,0,17,6
1748429542125,SE 263,A03,938462,Lanza Di Scalea; Francesco,10,0,16,6
1748429543151,SE 271,A00,938464,Asaro; Robert J,25,0,32,7
1748429544176,SE 276A,A00,938465,Chen; Jiun-Shyan,18,0,35,17
1748429545207,SE 285,A00,938466,Kim; Hyunsun Alicia,18,0,20,2
1748429546231,SE 286,A00,938523,Kim; Hyunsun Alicia,13,0,20,7
1748429547266,SE 290,A00,938524,Lanza Di Scalea; Francesco,41,0,100,59
1748429548373,SE 296,001,953990,Asaro; Robert J,9999,0,9999,0
1748429548373,SE 296,002,953992,Chen; Jiun-Shyan,9999,0,9999,0
1748429548373,SE 296,003,953998,Conte; Joel P,9999,0,9999,0
1748429548373,SE 296,004,953999,Elgamal; Ahmed,9999,0,9999,0
1748429548373,SE 296,005,954001,Hutchinson; Tara,9999,0,9999,0
1748429548373,SE 296,006,954003,Jandaghi Semnani; Shabnam,9999,0,9999,0
1748429548373,SE 296,007,954004,Kim; Hyonny,9999,0,9999,0
1748429548373,SE 296,008,954005,Kim; Hyunsun Alicia,9999,0,9999,0
1748429548373,SE 296,009,954007,Kosmatka; John B,9999,0,9999,0
1748429548373,SE 296,010,954009,Krysl; Petr,9999,0,9999,0
1748429548373,SE 296,011,954011,Kuester; Falko,9999,0,9999,0
1748429548373,SE 296,012,954014,Lanza Di Scalea; Francesco,9999,0,9999,0
1748429548373,SE 296,013,954015,Loh; Kenneth J. H.,9999,0,9999,0
1748429548373,SE 296,014,954021,McCartney; John Scott,9999,0,9999,0
1748429548373,SE 296,015,954023,Morrison; Machel Leigh,9999,0,9999,0
1748429548373,SE 296,016,954024,Mosqueda; Gilberto,9999,0,9999,0
1748429548373,SE 296,017,954028,Qiao; Yu,9999,0,9999,0
1748429548373,SE 296,018,954030,Shing; P. Benson,9999,0,9999,0
1748429548373,SE 296,019,954031,Todd; Michael,9998,0,9999,1
1748429548373,SE 296,020,954033,Tomac; Ingrid,9999,0,9999,0
1748429548373,SE 296,021,954037,Tsampras; Georgios,9999,0,9999,0
1748429548373,SE 296,022,954040,Uang; Chia-Ming,9999,0,9999,0
1748429548373,SE 296,023,954043,Van Den Einde; Yael Dahlia,9999,0,9999,0
1748429548373,SE 296,024,954044,Zhu; Qiang,9999,0,9999,0
1748429548373,SE 296,025,954046,Tehrani; Mehran,9999,0,9999,0
1748429548373,SE 296,026,954047,Palermo; Alessandro,9999,0,9999,0
1748429548373,SE 296,027,954049,Chadha; Mayank,9999,0,9999,0
1748429549401,SIO 3,A01,938657,Hetherington; Elizabeth Dorsey,33,0,37,4
1748429549401,SIO 3,A02,938665,Hetherington; Elizabeth Dorsey,36,0,37,1
1748429550430,SIO 15,A00,938667,Laske; Gabi,292,0,348,56
1748429551460,SIO 20R,A01,938679,Russell; Lynn M.,144,0,200,56
1748429552501,SIO 25,A01,938684,Hildebrand; John A,33,0,40,7
1748429552501,SIO 25,A02,938685,Hildebrand; John A,39,0,40,1
1748429552501,SIO 25,A03,938963,Hildebrand; John A,40,0,40,0
1748429552501,SIO 25,A04,939110,Hildebrand; John A,40,0,40,0
1748429552501,SIO 25,A05,939116,Hildebrand; John A,40,0,40,0
1748429552501,SIO 25,A06,939149,Hildebrand; John A,40,0,40,0
1748429552501,SIO 25,A07,939158,Hildebrand; John A,40,0,40,0
1748429552501,SIO 25,A08,939173,Hildebrand; John A,40,0,40,0
1748429552501,SIO 25,A09,939180,Hildebrand; John A,40,0,40,0
1748429552501,SIO 25,A10,939228,Hildebrand; John A,40,0,40,0
1748429553530,SIO 30,A01,939230,Aluwihare; Lihini & Gille; Sarah T,33,0,37,4
1748429553530,SIO 30,A02,939231,Aluwihare; Lihini & Baumann-Pickering ; Simone,37,0,37,0
1748429553530,SIO 30,A03,939232,Aluwihare; Lihini & Gille; Sarah T,34,0,37,3
1748429553530,SIO 30,A04,939233,Aluwihare; Lihini & Gille; Sarah T,31,0,37,6
1748429553530,SIO 30,A05,939234,Aluwihare; Lihini & Gille; Sarah T,38,0,38,0
1748429553530,SIO 30,A06,939235,Aluwihare; Lihini & Gille; Sarah T,37,0,38,1
1748429553530,SIO 30,A07,939236,Aluwihare; Lihini & Gille; Sarah T,36,0,38,2
1748429553530,SIO 30,A08,939237,Aluwihare; Lihini & Gille; Sarah T,36,0,38,2
1748429554563,SIO 50,A01,939239,Cook; Geoffrey W,8,0,20,12
1748429554563,SIO 50,A02,939240,Cook; Geoffrey W,11,0,20,9
1748429555621,SIO 87,A00,939242,Norris; Joel Roland,20,0,20,0
1748429555621,SIO 87,B00,939306,Cook; Geoffrey W,20,0,20,0
1748429555621,SIO 87,C00,939327,Cook; Geoffrey W,20,0,20,0
1748429556653,SIO 100,A00,939328,Odlum; Margaret Larkin,0,0,30,30
1748429557685,SIO 101,A01,939330,Aluwihare; Lihini & Decima; Moira R.,0,0,35,35
1748429557685,SIO 101,A02,939331,Aluwihare; Lihini & Decima; Moira R.,12,0,35,23
1748429558717,SIO 103,A01,939371,Parnell-Turner; Ross Ernes,6,0,20,14
1748429559744,SIO 105,A00,939372,Driscoll; Neal W.,8,0,20,12
1748429560770,SIO 117,A01,939375,Keeling; Ralph F.,14,0,25,11
1748429561802,SIO 122,A01,939377,Lyons; Deirdre Colleen,6,0,30,24
1748429562833,SIO 124,A00,961131,Lukowski; April Lynn,34,0,65,31
1748429563869,SIO 132,A01,939379,Kacev; David & Hechinger; Ryan F.,9,0,34,25
1748429563869,SIO 132,A02,939380,Kacev; David & Hechinger; Ryan F.,28,0,34,6
1748429563869,SIO 132,A03,939381,Kacev; David & Hechinger; Ryan F.,19,0,34,15
1748429563869,SIO 132,A04,939480,Kacev; David & Hechinger; Ryan F.,26,0,34,8
1748429563869,SIO 132,A05,939481,Kacev; David & Hechinger; Ryan F.,18,0,34,16
1748429563869,SIO 132,A06,939482,Kacev; David & Hechinger; Ryan F.,25,0,34,9
1748429564907,SIO 136,A01,939562,Kacev; David & Shipp; Lauren Elizabeth,6,0,34,28
1748429564907,SIO 136,A02,939563,Kacev; David & Shipp; Lauren Elizabeth,24,0,34,10
1748429565934,SIO 147,A01,939566,Betancur Rodriguez; Ricard,0,0,30,30
1748429566961,SIO 166,A00,939567,Jimenez Cano; Nayeli Guada,13,0,30,17
1748429567988,SIO 167,A01,939569,Dunseth; Zachary Clark,9,0,10,1
1748429569015,SIO 170,A00,939571,Cook; Geoffrey W,39,0,45,6
1748429570047,SIO 171,A01,939573,Rudnick; Daniel Lars,44,0,50,6
1748429571078,SIO 177,A00,939574,Becker; Janet Maria,19,0,20,1
1748429572103,SIO 179,A01,939611,Martz; Todd R.,2,0,15,13
1748429573129,SIO 189,A00,939616,Staff,0,0,0,0
1748429574156,SIO 194,A00,954130,Hill; Seth J,9999,0,9999,0
1748429575183,SIOB 218,A01,960525,Staff,13,0,20,7
1748429576212,SIOB 262,A00,939617,Lukowski; April Lynn,15,0,20,5
1748429577244,SIOB 273,A00,939618,Leichter; James J.,9,0,15,6
1748429578274,SIOB 274,A01,939679,Leichter; James J.,15,0,20,5
1748429579301,SIOB 276,A01,939703,Sugihara; George,19,0,20,1
1748429580329,SIOB 279,A00,939717,Barton; Andrew David,19,0,25,6
1748429581356,SIOB 280,A00,939722,Allen; Andrew Ellis & Baumann-Pickering ; Simone,54,0,70,16
1748429582383,SIOB 296,A00,939790,Lyons; Deirdre Colleen,0,0,0,0
1748429583412,SIOB 297,A00,939795,Allen; Eric,57,0,65,8
1748429584440,SIOC 200A,A00,939821,Lin; Ying-Tsong,16,0,20,4
1748429585466,SIOC 203A,A00,939827,Becker; Janet Maria,18,0,20,2
1748429586496,SIOC 207A,A01,939909,Meyer; Florian,12,0,20,8
1748429587522,SIOC 208,A00,939913,Merrifield; Mark A,11,0,20,9
1748429588553,SIOC 210,A00,939917,Purkey; Sarah Michelle G.,25,0,35,10
1748429588553,SIOC 210,B00,939973,Purkey; Sarah Michelle G.,31,0,35,4
1748429589586,SIOC 217A,A00,940015,Evan; Amato Tomas,18,0,25,7
1748429590613,SIOC 221A,A00,940020,Alford; Matthew Hudson,16,0,20,4
1748429591640,SIOG 200C,A00,940290,Fan; Wenyuan,23,0,25,2
1748429592671,SIOG 223A,A00,940333,Constable; Catherine G,22,0,25,3
1748429593698,SIOG 225,A00,940334,Fialko; Yuri A.,19,0,20,1
1748429594726,SIOG 228,A00,940338,Diaz; Julia Michelle,15,0,40,25
1748429595755,SIOG 238,A00,940339,May; David Alexander,20,0,20,0
1748429596788,SIOG 239,A00,940340,Fan; Wenyuan,20,0,20,0
1748429596788,SIOG 239,B00,940342,Sandwell; David T,19,0,20,1
1748429597813,SIOG 240,A00,940409,Parnell-Turner; Ross Ernes,34,0,40,6
1748429598839,SIOG 249,A00,940442,Norris; Richard D.,25,0,25,0
1748429599869,SIOG 267,A01,940444,Martz; Todd R.,15,0,15,0
1748429600920,SIOG 288,A01,940446,Diaz; Julia Michelle,22,0,25,3
1748429601950,SOCE 194,A00,954128,Hill; Seth J,9999,0,9999,0
1748429602984,SOCG 200,A00,935260,Rona-Tas; Akos,2,0,12,10
1748429604017,SOCG 201,A00,935264,Shafir; Gershon,0,0,12,12
1748429605046,SOCG 203,A00,935265,Gong; Neil M,0,0,10,10
1748429606077,SOCG 207,A00,935267,Navon; Daniel,0,0,10,10
1748429607109,SOCG 208A,A00,935269,Blair-Loy; Mary,2,0,12,10
1748429608136,SOCG 226,A00,935302,Skrentny; John David,0,0,10,10
1748429609165,SOCG 227,A00,935303,Jules-Rosette; Bennetta W.,7,0,10,3
1748429610193,SOCG 244,A00,935305,Ribas Norris; Janet Vanesa,0,0,10,10
1748429611224,SOCG 252,A00,935307,Turner; Christena L.,2,0,10,8
1748429612257,SOCG 253,A00,935313,Evans; John Hyde,7,0,10,3
1748429613289,SOCG 255A,A00,934873,McKenzie; Kerry V.,10,0,10,0
1748429614319,SOCG 255C,A00,934874,McKenzie; Kerry V.,9,0,10,1
1748429615345,SOCG 271,A00,935434,Estefan; Michel,4,0,10,6
1748429616381,SOCI 1,A01,934878,Skrentny; John David,20,0,22,2
1748429616381,SOCI 1,A02,934879,Skrentny; John David,21,0,22,1
1748429616381,SOCI 1,A03,934880,Skrentny; John David,22,0,23,1
1748429616381,SOCI 1,A04,934881,Skrentny; John David,12,0,23,11
1748429616381,SOCI 1,A05,934883,Skrentny; John David,23,0,23,0
1748429616381,SOCI 1,A06,934884,Skrentny; John David,23,0,23,0
1748429616381,SOCI 1,A07,934885,Skrentny; John David,22,0,23,1
1748429616381,SOCI 1,A08,934886,Skrentny; John David,22,0,23,1
1748429616381,SOCI 1,A09,934887,Skrentny; John David,22,0,23,1
1748429617409,SOCI 30,A01,934889,Ruiz; Jonathan Joseph,18,0,20,2
1748429617409,SOCI 30,A02,934890,Ruiz; Jonathan Joseph,15,0,20,5
1748429618443,SOCI 60,A01,934892,Ribas Norris; Janet Vanesa,6,0,17,11
1748429618443,SOCI 60,A02,934896,Ribas Norris; Janet Vanesa,17,0,17,0
1748429618443,SOCI 60,A03,934965,Ribas Norris; Janet Vanesa,12,0,17,5
1748429618443,SOCI 60,A04,934974,Ribas Norris; Janet Vanesa,17,0,17,0
1748429619472,SOCI 70,A01,934984,Payne; Christine Anna,4,0,15,11
1748429619472,SOCI 70,A02,934988,Payne; Christine Anna,14,0,15,1
1748429619472,SOCI 70,A03,935006,Payne; Christine Anna,11,0,15,4
1748429619472,SOCI 70,A04,935047,Payne; Christine Anna,15,0,15,0
1748429620498,SOCI 88,A00,935058,Estefan; Michel,0,0,20,20
1748429621525,SOCI 100,A01,935065,Estefan; Michel,6,0,15,9
1748429621525,SOCI 100,A02,935068,Estefan; Michel,4,0,15,11
1748429621525,SOCI 100,A03,935069,Estefan; Michel,5,0,15,10
1748429621525,SOCI 100,A04,935071,Estefan; Michel,0,0,15,15
1748429622559,SOCI 103M,A00,935073,Kilpatrick; Kevin,22,0,30,8
1748429623586,SOCI 104,A00,935077,Arnal; Maud Marie Leonie,18,0,30,12
1748429624611,SOCI 104Q,A00,935079,Rogers; Julia,20,0,30,10
1748429625644,SOCI 105,A01,935083,Jules-Rosette; Bennetta W.,20,0,25,5
1748429626670,SOCI 109,A00,935084,Kilpatrick; Kevin,25,0,30,5
1748429627697,SOCI 112,A00,935085,Pitt; Richard Norris,61,0,65,4
1748429628727,SOCI 113,A00,935086,Rogers; Julia,68,0,75,7
1748429629765,SOCI 117,A01,935151,Jones; Makeba,0,0,13,13
1748429629765,SOCI 117,A02,935153,Jones; Makeba,4,0,13,9
1748429629765,SOCI 117,A03,935155,Jones; Makeba,11,0,12,1
1748429629765,SOCI 117,A04,935156,Jones; Makeba,10,0,12,2
1748429629765,SOCI 117,B01,935158,Jones; Gabrielle Anastasia,7,0,15,8
1748429629765,SOCI 117,B02,935159,Jones; Gabrielle Anastasia,15,0,15,0
1748429629765,SOCI 117,B03,935161,Jones; Gabrielle Anastasia,15,0,15,0
1748429629765,SOCI 117,B04,935162,Jones; Gabrielle Anastasia,15,0,15,0
1748429630791,SOCI 122,A00,935166,Lewis; Kevin Michael,101,0,120,19
1748429631818,SOCI 129,A00,935167,Pitt; Richard Norris,50,0,65,15
1748429632848,SOCI 135,A00,935170,Payne; Christine Anna,112,0,120,8
1748429633879,SOCI 136F,A00,935171,Gong; Neil M,52,0,56,4
1748429634904,SOCI 137,A00,935173,Crofts; Christine,53,0,100,47
1748429635929,SOCI 138,A00,935174,Navon; Daniel,111,0,135,24
1748429636960,SOCI 140,A00,935175,Ng; Kwai,47,0,65,18
1748429637986,SOCI 140K,A00,935176,Ng; Kwai,39,0,56,17
1748429639017,SOCI 142,A00,935177,Crofts; Christine,24,0,75,51
1748429640043,SOCI 143V,A00,935222,Lewis; Kevin Michael,99,0,140,41
1748429641069,SOCI 148,A00,935227,Shafir; Gershon,115,0,120,5
1748429642096,SOCI 148E,A00,935231,Calderon-Zaks; Michael Aar,44,0,56,12
1748429643126,SOCI 150,A00,935232,Victoria Torres; Pablo,14,0,50,36
1748429644151,SOCI 153,A00,935233,Ruiz; Jonathan Joseph,46,0,50,4
1748429645179,SOCI 166,A00,935243,Lampland; Martha,34,0,35,1
1748429646204,SOCI 170,A00,935247,Lampland; Martha,29,0,30,1
1748429647230,SOCI 172,A00,935249,Rona-Tas; Akos,40,0,45,5
1748429648255,SOCI 173,A00,935252,Arnal; Maud Marie Leonie,67,0,75,8
1748429649282,SOCI 180,A00,935253,Calderon-Zaks; Michael Aar,46,0,56,10
1748429650309,SOCI 184,A00,935254,Victoria Torres; Pablo,21,0,56,35
1748429651337,SOCI 196A,A00,935256,Turner; Christena L.,20,0,20,0
1748429652434,SPPS 200B,A00,959322,Luli; Alex J,99,0,99,0
1748429653472,SPPS 201,A00,959324,Mnatzaganian; Christina L,99,0,99,0
1748429654499,SPPS 202A,A00,959400,Tsunoda; Shirley M.,99,0,99,0
1748429655531,SPPS 204,A01,959405,Jones; John,99,0,99,0
1748429656558,SPPS 206,A00,959406,Bounthavong; Mark,80,0,80,0
1748429657589,SPPS 212A,A01,959408,Feist; Ashley,81,0,99,18
1748429658617,SPPS 213A,A00,959409,Namba; Jennifer Mariko,82,0,99,17
1748429659643,SPPS 219,A00,959410,Ma; Joseph David,81,0,99,18
1748429660670,SPPS 221,A01,959412,Siegel; Dionicio R.,80,0,80,0
1748429661698,SPPS 231,A00,959413,Penny; William F.,79,0,99,20
1748429662726,SPPS 232,A00,959415,Simonson; Tatum Sasha Summ,79,0,99,20
1748429663752,SPPS 233,A00,959417,Eckmann; Lars,79,0,99,20
1748429664784,SPPS 247,A00,959419,Brandl; Katharina,79,0,99,20
1748429665813,SPPS 251,A00,959420,Chen; Timothy,99,0,99,0
1748429666842,SPPS 264A,A00,959421,Tsunoda; Shirley M.,99,0,99,0
1748429668899,SPPS 267,A01,959426,Tsunoda; Shirley M.,25,0,25,0
1748429669931,SPPS 269,A00,959427,Atayee; Rabia Samady,29,0,30,1
1748429670959,SPPS 270A,A00,959430,Fricovsky; Eduardo Santiago,99,0,99,0
1748429671991,SPPS 271,A00,959432,Tsunoda; Shirley M.,99,0,99,0
1748429673017,SPPS 278,A00,959433,Fricovsky; Eduardo Santiago,98,0,99,1
1748429674049,SPPS 279,A00,959434,Painter; Nathan A.,99,0,99,0
1748429675085,SYN 2,001,946469,Girard; Gabrielle,3,0,20,17
1748429675085,SYN 2,002,946470,Girard; Gabrielle,0,0,20,20
1748429675085,SYN 2,003,946471,Rock; Martin,0,0,20,20
1748429675085,SYN 2,004,946472,Rock; Martin,0,0,20,20
1748429675085,SYN 2,005,946473,Iatarola; Briana Marie,0,0,20,20
1748429675085,SYN 2,006,946474,Tawater; Hanna Jean,0,0,20,20
1748429675085,SYN 2,007,946475,Browne; Emily,6,0,20,14
1748429675085,SYN 2,008,946476,Browne; Emily,0,0,20,20
1748429675085,SYN 2,009,946477,Staff,0,0,20,20
1748429675085,SYN 2,010,946478,Staff,8,0,20,12
1748429675085,SYN 2,012,946480,Deavenport; James Cary,0,0,20,20
1748429675085,SYN 2,013,946481,Deavenport; James Cary,0,0,20,20
1748429675085,SYN 2,014,946482,Staff,0,0,20,20
1748429675085,SYN 2,015,946483,Staff,0,0,20,20
1748429675085,SYN 2,016,946484,Staff,0,0,20,20
1748429675085,SYN 2,017,946485,Staff,5,0,20,15
1748429675085,SYN 2,019,946487,Atkinson; Arthur Laird,0,0,20,20
1748429675085,SYN 2,020,946488,Staff,0,0,20,20
1748429675085,SYN 2,021,946489,Staff,0,0,20,20
1748429675085,SYN 2,030,946498,Iatarola; Briana Marie,0,0,20,20
1748429675085,SYN 2,036,946587,Bishop; Graham,0,0,20,20
1748429676112,SYN 2R,001,946588,Bishop; Graham,0,0,20,20
1748429677156,SYN 100,A01,946594,Rock; Martin,0,0,15,15
1748429677156,SYN 100,A02,946595,Rock; Martin,0,0,15,15
1748429677156,SYN 100,B01,946598,Browne; Emily,0,0,15,15
1748429677156,SYN 100,B02,946600,Browne; Emily,0,0,15,15
1748429677156,SYN 100,C01,946606,Tawater; Hanna Jean,0,0,15,15
1748429677156,SYN 100,C02,946607,Tawater; Hanna Jean,0,0,15,15
1748429677156,SYN 100,D01,946610,Tawater; Hanna Jean,0,0,15,15
1748429677156,SYN 100,D02,946613,Tawater; Hanna Jean,0,0,15,15
1748429677156,SYN 100,E01,946617,Vega; Adrian,0,0,24,24
1748429677156,SYN 100,G01,946714,Iatarola; Briana Marie,0,0,15,15
1748429677156,SYN 100,G02,946721,Iatarola; Briana Marie,0,0,15,15
1748429677156,SYN 100,I01,946735,Gormally; Brenna,0,0,15,15
1748429677156,SYN 100,I02,946736,Gormally; Brenna,0,0,15,15
1748429677156,SYN 100,J01,946738,Hom; Kirstyn Courtney,0,0,15,15
1748429677156,SYN 100,J02,946739,Hom; Kirstyn Courtney,0,0,15,15
1748429677156,SYN 100,K01,946741,Hom; Kirstyn Courtney,0,0,15,15
1748429677156,SYN 100,K02,946742,Hom; Kirstyn Courtney,0,0,15,15
1748429677156,SYN 100,L01,946745,Difruscio; Mark,0,0,15,15
1748429677156,SYN 100,L02,946746,Difruscio; Mark,0,0,15,15
1748429677156,SYN 100,M01,946748,Difruscio; Mark,0,0,15,15
1748429677156,SYN 100,M02,946749,Difruscio; Mark,0,0,15,15
1748429677156,SYN 100,P01,946759,Atkinson; Arthur Laird,0,0,15,15
1748429677156,SYN 100,P02,946760,Atkinson; Arthur Laird,0,0,15,15
1748429677156,SYN 100,Q01,946763,Bishop; Graham,0,0,15,15
1748429677156,SYN 100,Q02,946764,Bishop; Graham,0,0,15,15
1748429677156,SYN 100,R01,946766,Deavenport; James Cary,0,0,15,15
1748429677156,SYN 100,R02,946767,Deavenport; James Cary,0,0,15,15
1748429678185,SYN 150,001,946771,Gladstein; Jill M,19,0,20,1
1748429678185,SYN 150,002,946772,Lagapa; Jason,17,0,20,3
1748429678185,SYN 150,003,946773,Fish; Gwendolyn Anne,19,0,20,1
1748429678185,SYN 150,004,946774,Fish; Gwendolyn Anne,20,0,20,0
1748429678185,SYN 150,006,946782,Lagapa; Jason,18,0,20,2
1748429678185,SYN 150,007,946783,Lagapa; Jason,19,0,20,1
1748429678185,SYN 150,008,946784,Fish; Gwendolyn Anne,19,0,20,1
1748429679212,SYN 150R,001,946786,Vega; Adrian,19,0,20,1
1748429680241,TDAC 1,A00,946788,Walsh; Kim C.,0,0,12,12
1748429680241,TDAC 1,B00,946789,Walsh; Kim C.,0,0,12,12
1748429680241,TDAC 1,C00,946790,Walsh; Kim C.,0,0,12,12
1748429680241,TDAC 1,D00,946791,Walsh; Kim C.,0,0,12,12
1748429680241,TDAC 1,E00,946792,Walsh; Kim C.,0,0,12,12
1748429680241,TDAC 1,F00,946793,Walsh; Kim C.,0,0,12,12
1748429681271,TDAC 101,A00,946887,Harting; Carla Kelso,3,0,12,9
1748429681271,TDAC 101,B00,946970,Salovey; Todd,9,0,12,3
1748429681271,TDAC 101,C00,946977,Walsh; Kim C.,10,0,12,2
1748429682299,TDAC 102,A00,946979,Celik; Aysan Karagasli,7,0,15,8
1748429683327,TDAC 104,A00,946994,Meyer; Ursula,14,0,15,1
1748429684354,TDAC 107,A00,946997,Stalling; Vanessa,0,0,0,0
1748429685384,TDAC 108,A00,947021,Basso; Beatrice,19,0,20,1
1748429685384,TDAC 108,B00,947025,Caban; Andrea Chudnow,12,0,20,8
1748429685384,TDAC 108,C00,968049,Buescher; Stephen W.,16,0,20,4
1748429686416,TDAC 115,A00,947050,Buescher; Stephen W.,14,0,20,6
1748429687448,TDAC 122,A00,947091,Stalling; Vanessa,30,0,30,0
1748429687448,TDAC 122,B00,947092,Perry; Lamar,30,0,30,0
1748429688479,TDAC 123,A00,947093,Castro; Robert Jess,30,0,30,0
1748429689507,TDDE 1,A01,946795,Guirguis; Mark C,10,0,11,1
1748429689507,TDDE 1,A02,946796,Guirguis; Mark C,10,0,11,1
1748429689507,TDDE 1,A03,946797,Guirguis; Mark C,7,0,11,4
1748429689507,TDDE 1,A04,946798,Guirguis; Mark C,8,0,11,3
1748429689507,TDDE 1,A05,946799,Guirguis; Mark C,11,0,11,0
1748429690535,TDDE 130,A00,947094,Guirguis; Mark C,20,0,20,0
1748429691564,TDDE 131,A00,947095,Guirguis; Mark C,17,0,20,3
1748429692590,TDDE 132,A00,947096,Guirguis; Mark C,20,0,20,0
1748429693617,TDDE 141,A00,947097,McElver; Robert Harrison,20,0,20,0
1748429694644,TDDM 1,A00,946800,Johnston; Holly,7,0,18,11
1748429695672,TDDM 100,A00,947098,Brown; Bernard Joseph,28,0,30,2
1748429696696,TDDR 101,A00,947099,Powell; Lora,4,0,20,16
1748429697722,TDDR 102,A00,947100,Powell; Lora,19,0,20,1
1748429698751,TDDR 111,A00,947101,Castro; Robert Jess,12,0,15,3
1748429699778,TDDR 190,A00,947102,Stalling; Vanessa,35,0,35,0
1748429700806,TDGE 1,A01,946802,Salovey; Todd,12,0,12,0
1748429700806,TDGE 1,A02,946803,Salovey; Todd,11,0,12,1
1748429700806,TDGE 1,A03,946804,Salovey; Todd,12,0,12,0
1748429700806,TDGE 1,A04,946806,Salovey; Todd,12,0,12,0
1748429700806,TDGE 1,A05,946807,Salovey; Todd,10,0,12,2
1748429700806,TDGE 1,A06,946808,Salovey; Todd,12,0,12,0
1748429701831,TDGE 10,A00,946810,Havis; Allan,208,0,225,17
1748429702859,TDGE 11,A00,946811,Fulton; Julia,205,0,245,40
1748429703892,TDGE 25,A00,946812,Harting; Carla Kelso,1,0,20,19
1748429703892,TDGE 25,B00,946813,Harting; Carla Kelso,5,0,20,15
1748429703892,TDGE 25,C00,946814,Harting; Carla Kelso,10,0,20,10
1748429703892,TDGE 25,D00,946815,Harting; Carla Kelso,12,0,20,8
1748429704921,TDGE 124,A00,947103,Fulton; Julia,190,0,245,55
1748429705954,TDGE 133,A00,947104,Brill; Robert L.,19,0,20,1
1748429706983,TDGR 201,A00,947268,Newcomb; James,8,0,8,0
1748429708009,TDGR 210A,A00,947269,Staff,8,0,8,0
1748429709040,TDGR 211A,A00,947270,Caban; Andrea Chudnow,8,0,8,0
1748429710067,TDGR 212,A00,947271,Meyer; Ursula,17,0,17,0
1748429710067,TDGR 212,B00,947272,Caban; Andrea Chudnow,17,0,17,0
1748429711095,TDGR 213A,A00,947273,Buescher; Stephen W.,8,0,8,0
1748429712126,TDGR 214A,A00,947274,Meyer; Ursula,8,0,8,0
1748429713156,TDGR 219,A00,947276,Stalling; Vanessa,3,0,5,2
1748429714183,TDGR 229,A00,947277,Meyer; Ursula,7,0,7,0
1748429715213,TDGR 231A,A00,947278,Meyer; Ursula,9,0,9,0
1748429716245,TDGR 233,A00,947279,Richard; Keiana Nikole,9,0,9,0
1748429717276,TDGR 235,A00,947280,Blair; Kyle Adam,9,0,9,0
1748429718305,TDGR 239,A00,947281,Staff,8,0,8,0
1748429718305,TDGR 239,B00,947282,Meyer; Ursula,9,0,9,0
1748429718305,TDGR 239,C00,947283,Staff,9,0,9,0
1748429719331,TDGR 240,A00,947284,Stalling; Vanessa,3,0,5,2
1748429720363,TDGR 244,A00,947285,Iizuka; Naomi Hisako,19,0,20,1
1748429721390,TDGR 245,A00,947287,Stalling; Vanessa,4,0,5,1
1748429722429,TDGR 250,A00,947289,Stein; Deborah Isobel,5,0,5,0
1748429723455,TDGR 251,A00,947296,Iizuka; Naomi Hisako,5,0,5,0
1748429723455,TDGR 251,B00,947355,Stein; Deborah Isobel,5,0,5,0
1748429724487,TDGR 274,A00,947358,Brill; Robert L.,19,0,20,1
1748429725512,TDGR 275,A00,947361,Staff,10,0,10,0
1748429726543,TDGR 276,A00,947362,Bokovikova; Alina V,10,0,10,0
1748429727575,TDGR 278,A00,947363,Petrovich; Victoria A.,12,0,12,0
1748429727575,TDGR 278,B00,947366,Staff,9,0,10,1
1748429728603,TDGR 279,A00,947367,Petrovich; Victoria A.,3,0,3,0
1748429728603,TDGR 279,B00,947368,Brill; Robert L.,2,0,3,1
1748429728603,TDGR 279,C00,947369,McElver; Robert Harrison,3,0,3,0
1748429728603,TDGR 279,D00,967973,Staff,0,0,0,0
1748429728603,TDGR 279,E00,967974,Bokovikova; Alina V,0,0,0,0
1748429729631,TDGR 282,A00,947370,McElver; Robert Harrison,10,0,10,0
1748429730658,TDGR 289,A00,947371,Power; Jade Yukana,10,0,10,0
1748429731688,TDGR 289C,A00,947373,Burelle; Julie Sara Veronique,10,0,10,0
1748429732718,TDGR 289D,A00,947374,Anderson; Mysia Anyse,5,0,5,0
1748429733746,TDGR 292,A00,947375,Yapp; Hentyle T,14,0,15,1
1748429734773,TDGR 295,A00,947376,Celik; Aysan Karagasli,8,0,8,0
1748429735802,TDGR 296,A00,947379,Powell; Lora,5,0,5,0
1748429736829,TDGR 297,001,947381,Meyer; Ursula,9,0,9,0
1748429737856,TDHT 10,A00,946817,Burelle; Julie Sara Veronique,23,0,25,2
1748429738882,TDHT 21,A02,946821,Power; Jade Yukana,11,0,15,4
1748429738882,TDHT 21,A03,946822,Power; Jade Yukana,8,0,15,7
1748429739910,TDHT 101,A00,947106,Perry; Lamar,19,0,25,6
1748429740940,TDHT 103,A00,947107,Yapp; Hentyle T,8,0,25,17
1748429741968,TDHT 115,A00,947108,Portes; Elizabeth Marie,16,0,25,9
1748429742996,TDMV 1,A00,946823,Arcidiacono; Kristin,18,0,30,12
1748429744024,TDMV 2,A00,946824,Wilson; Terry A.,24,0,30,6
1748429744024,TDMV 2,B00,946825,Brown; Bernard Joseph,23,0,30,7
1748429745049,TDMV 3,A00,946826,Mack; Kara Shanai',23,0,40,17
1748429746082,TDMV 11,A00,946827,Arcidiacono; Kristin,36,0,40,4
1748429746082,TDMV 11,B00,946828,Fyall; Daunte Edward,28,0,30,2
1748429747107,TDMV 20,A00,946830,Alvarez; Ana Maria,38,0,40,2
1748429747107,TDMV 20,B00,946831,Smith; Alison D,20,0,20,0
1748429748136,TDMV 110,A00,947109,Smith; Alison D,25,0,30,5
1748429749164,TDMV 120,A00,947110,Weinberg; Sadie,17,0,18,1
1748429749164,TDMV 120,B00,964374,Johnston; Holly,18,0,18,0
1748429750197,TDMV 123,A00,947111,Duran; Marcos Antonio,29,0,30,1
1748429751225,TDMV 138,A00,947113,Jun; Grace Shin Hae,4,0,40,36
1748429752261,TDMV 140,A00,947114,Corrales; Joseph Bernales,29,0,30,1
1748429752261,TDMV 140,B00,947138,Lima; Paulo Henrique,30,0,30,0
1748429752261,TDMV 140,C00,947139,Staff,25,0,30,5
1748429753290,TDMV 141,A00,947140,Caligagan; Tony,29,0,30,1
1748429754317,TDMV 142,A00,947225,Alvarez; Ana Maria,28,0,40,12
1748429754317,TDMV 142,B00,947226,Blanco; Juan Carlos,27,0,30,3
1748429755348,TDMV 143,A00,947227,Fyall; Daunte Edward,28,0,30,2
1748429756430,TDMV 144,A00,947261,Camaya; Michelle Ann,28,0,30,2
1748429756430,TDMV 144,B00,947262,Patnaik; Shibani,28,0,30,2
1748429757459,TDMV 146,A00,947263,Caligagan; Tony,30,0,30,0
1748429758488,TDPF 160,A00,947264,Mack; Kara Shanai',40,0,40,0
1748429759514,TDPR 6,A01,946869,Guirguis; Mark C,25,0,25,0
1748429759514,TDPR 6,A02,946870,Guirguis; Mark C,25,0,25,0
1748429760542,TDPR 102,A00,947265,Guirguis; Mark C,20,0,20,0
1748429761569,TDPR 104,A00,947266,Powell; Lora,15,0,15,0
1748429762602,TDPW 1,A00,946873,Stein; Deborah Isobel,6,0,10,4
1748429762602,TDPW 1,B00,946878,Stein; Deborah Isobel,10,0,10,0
1748429762602,TDPW 1,C00,946879,Stein; Deborah Isobel,10,0,10,0
1748429762602,TDPW 1,D00,946880,Stein; Deborah Isobel,7,0,10,3
1748429762602,TDPW 1,E00,946882,Stein; Deborah Isobel,7,0,10,3
1748429763629,TDPW 104,A00,947267,Loo; Eric James,13,0,20,7
1748429764657,TDTR 10,A00,946883,Wilson; Terry A.,14,0,20,6
1748429765687,TDTR 15,A00,946885,Smith; Alison D,30,0,30,0
1748429766713,TDTR 20,A00,946886,Duran; Marcos Antonio,25,0,30,5
1748429767748,USP 1,A01,943915,Garcia; Guadalupe,23,0,23,0
1748429767748,USP 1,A02,943916,Garcia; Guadalupe,19,0,23,4
1748429767748,USP 1,A03,943927,Garcia; Guadalupe,23,0,23,0
1748429767748,USP 1,A04,943933,Garcia; Guadalupe,22,0,23,1
1748429767748,USP 1,A05,943942,Garcia; Guadalupe,23,0,23,0
1748429767748,USP 1,A06,943951,Garcia; Guadalupe,22,0,23,1
1748429768780,USP 2,A01,943956,Pezzoli; Keith,15,0,23,8
1748429768780,USP 2,A02,943958,Pezzoli; Keith,20,0,22,2
1748429769812,USP 4,A00,943961,Schwaller; Nora Louise,2,0,18,16
1748429769812,USP 4,B00,943966,Schwaller; Nora Louise,12,0,18,6
1748429770838,USP 5,A01,943968,Boomhower; Matthew Charles,16,0,20,4
1748429770838,USP 5,A02,943969,Boomhower; Matthew Charles,16,0,20,4
1748429771866,USP 15,A01,943971,Anderson; William Raymond,18,0,20,2
1748429771866,USP 15,A02,944015,Anderson; William Raymond,19,0,20,1
1748429772898,USP 25,A00,944021,Shenkman; Michael Thomas,16,0,25,9
1748429773925,USP 50,A00,944025,Sun; Feiyang,3,0,30,27
1748429774954,USP 60,A01,944056,Wali; Behram,26,0,30,4
1748429775986,USP 105,A00,944057,Ruiz; Jonathan Joseph,9,0,15,6
1748429777013,USP 108,A00,944058,Pezzoli; Keith,10,0,21,11
1748429778041,USP 124,A00,944060,Devereux; Christina Schopp,16,0,35,19
1748429779072,USP 125,A00,944063,Lerner; Amy M,21,0,28,7
1748429780099,USP 136,A00,944064,Staff,27,0,35,8
1748429781126,USP 141A,A00,960658,Lewis; Leslie R,0,0,0,0
1748429782153,USP 143,A00,944065,Hinds; Juli Beth,200,0,250,50
1748429783180,USP 144,A00,944066,Chowdhury; Muhammed Zohir,94,0,100,6
1748429784207,USP 150,A00,944067,Devereux; Christina Schopp,68,0,75,7
1748429785238,USP 151,A00,944068,Clark; Christopher N,58,0,70,12
1748429786266,USP 152B,A00,944069,Moeder; Nathan L,14,0,25,11
1748429787297,USP 153,A00,944070,Shenkman; Michael Thomas,19,0,35,16
1748429788325,USP 161,A00,944071,Wartell; Julie Dara,27,0,35,8
1748429789352,USP 165C,A00,944072,Wali; Behram,25,0,30,5
1748429790381,USP 170,A00,944142,Entezam; Maryam,60,0,70,10
1748429791411,USP 171,A00,944153,Lerner; Amy M,24,0,65,41
1748429792439,USP 175,A00,944172,Peerson; Susan,0,0,25,25
1748429793467,USP 177A,A00,944173,Peerson; Susan,0,0,23,23
1748429795525,USP 185A,A01,944198,Boomhower; Matthew Charles,26,0,40,14
1748429795525,USP 185A,B01,944201,Sun; Feiyang,0,0,40,40
1748429796558,USP 186,A01,944255,Bussell; Mirle Rabinowitz,28,0,38,10
1748429796558,USP 186,A02,944262,Bussell; Mirle Rabinowitz,11,0,37,26
1748429797589,USP 189,A00,944269,Garcia; Guadalupe,35,0,35,0
1748429798620,USP 191A,A00,944270,McTague; Sarah,13,0,30,17
1748429799647,USP 193,A00,944271,Shilon; Mor,10,0,23,13
1748429800675,USP 194,A00,954112,Hill; Seth J,9999,0,9999,0
1748429801705,USP 265C,A00,944277,Wali; Behram,3,0,4,1
1748429802732,USP 271,A00,944280,Lerner; Amy M,5,0,5,0
1748429803763,VIS 1,A01,944283,Staff,4,0,12,8
1748429803763,VIS 1,A02,944284,Staff,0,0,12,12
1748429803763,VIS 1,A03,944286,Staff,0,0,12,12
1748429803763,VIS 1,A04,944288,Staff,0,0,12,12
1748429803763,VIS 1,A05,944290,Staff,0,0,12,12
1748429803763,VIS 1,A06,944292,Staff,1,0,12,11
1748429803763,VIS 1,A07,944293,Staff,9,0,12,3
1748429803763,VIS 1,A08,944300,Staff,0,0,12,12
1748429803763,VIS 1,A09,944302,Staff,12,0,12,0
1748429803763,VIS 1,A10,944303,Staff,0,0,12,12
1748429803763,VIS 1,A11,944307,Staff,0,0,12,12
1748429803763,VIS 1,A12,944309,Staff,0,0,12,12
1748429803763,VIS 1,A13,944310,Staff,0,0,12,12
1748429803763,VIS 1,A14,944312,Staff,0,0,12,12
1748429803763,VIS 1,A15,944316,Staff,6,0,12,6
1748429803763,VIS 1,A16,944319,Staff,0,0,12,12
1748429804799,VIS 20,A01,944323,Woods; Ann,14,0,16,2
1748429804799,VIS 20,A02,944325,Woods; Ann,15,0,16,1
1748429804799,VIS 20,A03,944326,Woods; Ann,14,0,16,2
1748429804799,VIS 20,A04,944328,Woods; Ann,14,0,16,2
1748429804799,VIS 20,A05,944330,Woods; Ann,16,0,16,0
1748429804799,VIS 20,A06,944334,Woods; Ann,16,0,16,0
1748429804799,VIS 20,A07,944336,Woods; Ann,14,0,16,2
1748429804799,VIS 20,A08,944337,Woods; Ann,16,0,16,0
1748429804799,VIS 20,A09,944338,Woods; Ann,15,0,16,1
1748429804799,VIS 20,A10,944339,Woods; Ann,16,0,16,0
1748429804799,VIS 20,A11,944340,Woods; Ann,15,0,16,1
1748429804799,VIS 20,A12,944342,Woods; Ann,15,0,16,1
1748429805829,VIS 23,A00,944343,Rose; Jordan M,0,0,5,5
1748429806862,VIS 30,A01,944346,Stone; Patricia,11,0,11,0
1748429806862,VIS 30,A02,944351,Stone; Patricia,0,0,11,11
1748429806862,VIS 30,A03,944353,Stone; Patricia,7,0,11,4
1748429806862,VIS 30,A04,944354,Stone; Patricia,9,0,11,2
1748429806862,VIS 30,A05,944356,Stone; Patricia,10,0,11,1
1748429806862,VIS 30,A06,944359,Stone; Patricia,6,0,11,5
1748429807891,VIS 41,A01,944391,D'Elena-Tweed; Jessica Erin,10,0,12,2
1748429807891,VIS 41,A02,944392,D'Elena-Tweed; Jessica Erin,11,0,12,1
1748429807891,VIS 41,A03,944393,D'Elena-Tweed; Jessica Erin,12,0,12,0
1748429807891,VIS 41,A04,944396,D'Elena-Tweed; Jessica Erin,9,0,12,3
1748429807891,VIS 41,A05,944397,D'Elena-Tweed; Jessica Erin,12,0,12,0
1748429807891,VIS 41,A06,944399,D'Elena-Tweed; Jessica Erin,8,0,12,4
1748429807891,VIS 41,A07,944405,D'Elena-Tweed; Jessica Erin,10,0,12,2
1748429807891,VIS 41,A08,944411,D'Elena-Tweed; Jessica Erin,10,0,12,2
1748429807891,VIS 41,A09,944412,D'Elena-Tweed; Jessica Erin,12,0,12,0
1748429807891,VIS 41,A10,944415,D'Elena-Tweed; Jessica Erin,10,0,12,2
1748429807891,VIS 41,A11,944428,D'Elena-Tweed; Jessica Erin,12,0,12,0
1748429807891,VIS 41,A12,944430,D'Elena-Tweed; Jessica Erin,11,0,12,1
1748429808919,VIS 42,A00,969576,Twomey; Robert Daniel,86,0,100,14
1748429809948,VIS 60,A01,944432,Sepuya; Paul Mpagi,10,0,12,2
1748429809948,VIS 60,A02,944434,Sepuya; Paul Mpagi,12,0,12,0
1748429809948,VIS 60,A03,944436,Sepuya; Paul Mpagi,12,0,12,0
1748429809948,VIS 60,A04,944438,Sepuya; Paul Mpagi,12,0,12,0
1748429810975,VIS 70N,A01,944456,Garnett; Mariah J,11,0,11,0
1748429810975,VIS 70N,A02,944461,Garnett; Mariah J,9,0,11,2
1748429810975,VIS 70N,A03,944462,Garnett; Mariah J,8,0,11,3
1748429810975,VIS 70N,A04,944500,Garnett; Mariah J,10,0,11,1
1748429810975,VIS 70N,A05,944501,Garnett; Mariah J,11,0,11,0
1748429810975,VIS 70N,A06,944502,Garnett; Mariah J,11,0,11,0
1748429810975,VIS 70N,A07,944503,Garnett; Mariah J,11,0,11,0
1748429810975,VIS 70N,A08,944507,Garnett; Mariah J,11,0,11,0
1748429812010,VIS 80,A01,944513,Adler; Amy,12,0,12,0
1748429812010,VIS 80,A02,944515,Adler; Amy,9,0,12,3
1748429812010,VIS 80,A03,944517,Adler; Amy,10,0,12,2
1748429812010,VIS 80,A04,944518,Adler; Amy,10,0,12,2
1748429812010,VIS 80,A05,944519,Adler; Amy,12,0,12,0
1748429812010,VIS 80,A06,944520,Adler; Amy,11,0,12,1
1748429812010,VIS 80,A07,944525,Adler; Amy,11,0,12,1
1748429812010,VIS 80,A08,944526,Adler; Amy,9,0,12,3
1748429813046,VIS 85A,A01,944694,Staff,18,0,18,0
1748429813046,VIS 85A,A02,944695,Staff,18,0,18,0
1748429813046,VIS 85A,A03,944696,Staff,17,0,18,1
1748429813046,VIS 85A,A04,944697,Staff,17,0,18,1
1748429813046,VIS 85A,A05,968082,Staff,17,0,18,1
1748429813046,VIS 85A,A06,968084,Staff,18,0,18,0
1748429813046,VIS 85A,A07,968085,Staff,17,0,18,1
1748429813046,VIS 85A,A08,968087,Staff,17,0,18,1
1748429814073,VIS 100,A00,944698,Cruz; Edwin Teddy,125,0,146,21
1748429815104,VIS 100A,A00,944699,D'Elena-Tweed; Jessica Erin,0,0,15,15
1748429816131,VIS 103D,A00,944767,Cartwright; Lisa,72,0,75,3
1748429817159,VIS 105A,A00,944769,Staff,8,0,30,22
1748429817159,VIS 105A,B00,944770,Staff,20,0,30,10
1748429818186,VIS 105B,A00,944773,Staff,16,0,30,14
1748429819217,VIS 105C,A00,944774,Ortiz-Torres; Ruben,1,0,15,14
1748429820248,VIS 106A,A00,944775,Staff,10,0,25,15
1748429821276,VIS 106B,A00,944776,Staff,0,0,25,25
1748429822303,VIS 107A,A00,944777,Staff,2,0,25,23
1748429823332,VIS 107C,A00,944780,Iglesias; Janelle Ann,11,0,15,4
1748429824361,VIS 108,A00,944781,Staff,0,0,15,15
1748429825386,VIS 110A,A00,944782,Staff,11,0,15,4
1748429826414,VIS 110G,A00,963093,Staff,14,0,15,1
1748429827441,VIS 113CN,A00,944783,Welchman; John C.,11,0,15,4
1748429828468,VIS 120A,A00,944784,Woods; Ann,118,0,146,28
1748429829501,VIS 121C,A00,944789,Tronzo; William,68,0,75,7
1748429830528,VIS 126F,A00,944793,Wardwell; Mariana Razo,74,0,75,1
1748429831554,VIS 128C,A00,944794,Staff,71,0,75,4
1748429832580,VIS 129A,A00,944799,Staff,7,0,15,8
1748429833606,VIS 132,A00,944800,Miller; Nicole L,6,0,15,9
1748429834636,VIS 133,A01,944806,Staff,32,0,34,2
1748429834636,VIS 133,A02,944809,Staff,34,0,34,0
1748429835666,VIS 133A,A00,944854,Staff,0,0,15,15
1748429836697,VIS 141A,A01,944856,Stalbaum; Brett,16,0,25,9
1748429836697,VIS 141A,A02,944858,Stalbaum; Brett,17,0,25,8
1748429836697,VIS 141A,A03,944859,Stalbaum; Brett,11,0,25,14
1748429836697,VIS 141A,A04,944861,Stalbaum; Brett,23,0,25,2
1748429837724,VIS 142,A01,944864,Stalbaum; Brett,11,0,15,4
1748429837724,VIS 142,A02,944865,Stalbaum; Brett,0,0,15,15
1748429837724,VIS 142,A03,944869,Stalbaum; Brett,11,0,15,4
1748429837724,VIS 142,A04,944873,Stalbaum; Brett,5,0,15,10
1748429837724,VIS 142,A05,944876,Stalbaum; Brett,15,0,15,0
1748429837724,VIS 142,A06,944878,Stalbaum; Brett,7,0,15,8
1748429838750,VIS 143,A00,969275,Akten; Mehmet,0,0,15,15
1748429839778,VIS 145B,A00,944879,Akten; Mehmet,0,0,15,15
1748429840805,VIS 146B,A00,944880,Twomey; Robert Daniel,15,0,15,0
1748429841837,VIS 147A,A01,944883,Staff,21,0,22,1
1748429841837,VIS 147A,A02,944923,Staff,12,0,22,10
1748429841837,VIS 147A,A03,944924,Staff,15,0,22,7
1748429841837,VIS 147A,A04,944925,Staff,17,0,22,5
1748429842868,VIS 147B,A00,944926,Staff,0,0,15,15
1748429842868,VIS 147B,B00,944927,Staff,1,0,15,14
1748429843900,VIS 149,A00,944928,Bratton; Benjamin H.,12,0,15,3
1748429843900,VIS 149,B00,944929,Crandall; Jordan,7,0,15,8
1748429844934,VIS 152D,A01,944931,Wardwell; Mariana Razo,19,0,24,5
1748429844934,VIS 152D,A02,945003,Wardwell; Mariana Razo,23,0,24,1
1748429844934,VIS 152D,A03,945007,Wardwell; Mariana Razo,24,0,24,0
1748429844934,VIS 152D,A04,945097,Wardwell; Mariana Razo,22,0,24,2
1748429845967,VIS 157,A01,945131,Cartwright; Lisa,23,0,24,1
1748429845967,VIS 157,A02,945167,Cartwright; Lisa,5,0,24,19
1748429847053,VIS 162,A00,945168,Bratton; Benjamin H.,6,0,15,9
1748429848083,VIS 163,A00,945169,Stone; Patricia,72,0,75,3
1748429849112,VIS 164,A00,945170,Sepuya; Paul Mpagi,19,0,22,3
1748429850146,VIS 165A,A00,945208,Staff,10,0,22,12
1748429851176,VIS 167,A00,945235,Staff,11,0,22,11
1748429852205,VIS 171,A00,945258,Staff,18,0,22,4
1748429853232,VIS 174,A00,945285,Cross; Brian R,0,0,22,22
1748429854260,VIS 175,A00,945286,Staff,18,0,22,4
1748429855289,VIS 179,A00,945287,Erdmann; Dean,20,0,22,2
1748429856320,VIS 180A,A00,945322,Cross; Brian R,9,0,22,13
1748429857350,VIS 180B,A00,945324,Gaines; Malik Julian,17,0,22,5
1748429858376,VIS 183B,A00,945329,Staff,4,0,22,18
1748429859406,VIS 203,A00,945331,Cruz; Edwin Teddy,4,0,15,11
1748429860488,VIS 204,A00,945333,Gaines; Malik Julian,11,0,15,4
1748429861519,VIS 205,A00,945334,Ortiz-Torres; Ruben,14,0,15,1
1748429862546,VIS 207,A00,971577,Staff,13,0,15,2
1748429863572,VIS 209,A00,945337,Welchman; John C.,10,0,15,5
1748429864598,VIS 243,A00,945340,Rose; Jordan M,8,0,15,7
1748429865627,VIS 255,A00,945342,Staff,9,0,15,6
1748429866654,VIS 295,001,971694,Miller; Nicole L,0,0,0,0
1748429866654,VIS 295,002,971695,Cruz; Edwin Teddy,0,0,0,0
1748429866654,VIS 295,003,971696,Segade; Alexandro Abraham,0,0,0,0
1748429866654,VIS 295,004,971697,Vangenderen; Monique Luise,0,0,0,0
1748429866654,VIS 295,005,971725,Sepuya; Paul Mpagi,0,0,0,0
1748429866654,VIS 295,006,971763,Sepuya; Paul Mpagi,0,0,0,0
1748429866654,VIS 295,007,971764,Mostajo; Lorena,0,0,0,0
1748429866654,VIS 295,008,971765,Akten; Mehmet,0,0,0,0
1748429867704,WCWP 10A,001,947782,Escobar; Jordan Christophe,20,0,20,0
1748429867704,WCWP 10A,002,947791,Escobar; Jordan Christophe,20,0,20,0
1748429867704,WCWP 10A,003,947792,Gagnon; Jeffrey C,0,0,0,0
1748429867704,WCWP 10A,004,947793,Escobar; Jordan Christophe,19,0,20,1
1748429867704,WCWP 10A,005,947794,Merryman; Walter,19,0,20,1
1748429867704,WCWP 10A,006,947840,Merryman; Walter,20,0,20,0
1748429867704,WCWP 10A,007,947841,Staff,0,0,0,0
1748429867704,WCWP 10A,008,947842,Staff,0,0,0,0
1748429867704,WCWP 10A,009,947843,Martiniuk; Jill,18,0,20,2
1748429867704,WCWP 10A,010,947844,Staff,0,0,0,0
1748429867704,WCWP 10A,011,947845,Martiniuk; Jill,19,0,20,1
1748429867704,WCWP 10A,012,947861,Martiniuk; Jill,20,0,20,0
1748429867704,WCWP 10A,013,947862,Staff,0,0,0,0
1748429867704,WCWP 10A,014,947863,Staff,0,0,0,0
1748429867704,WCWP 10A,015,947867,Staff,0,0,0,0
1748429867704,WCWP 10A,016,947868,Susi; Natalie,19,0,20,1
1748429867704,WCWP 10A,017,947869,Susi; Natalie,19,0,20,1
1748429867704,WCWP 10A,018,947870,Holloway Ii; Mathew,20,0,20,0
1748429867704,WCWP 10A,019,947912,Welji; Haleema Nazir,0,0,0,0
1748429867704,WCWP 10A,020,947941,Holloway Ii; Mathew,19,0,20,1
1748429867704,WCWP 10A,021,947954,Holloway Ii; Mathew,20,0,20,0
1748429867704,WCWP 10A,022,960902,Windham; Emily,19,0,20,1
1748429867704,WCWP 10A,023,960903,Windham; Emily,16,0,20,4
1748429867704,WCWP 10A,024,960904,Windham; Emily,18,0,20,2
1748429868743,WCWP 10B,001,948038,Dhir; Simrita,17,0,20,3
1748429868743,WCWP 10B,002,948042,Dhir; Simrita,13,0,20,7
1748429868743,WCWP 10B,003,948043,Uriarte; Emma,0,0,20,20
1748429868743,WCWP 10B,004,948044,Dhir; Simrita,12,0,20,8
1748429868743,WCWP 10B,005,948045,Uriarte; Emma,13,0,20,7
1748429868743,WCWP 10B,006,948046,Uriarte; Emma,13,0,20,7
1748429868743,WCWP 10B,007,948047,Staff,0,0,0,0
1748429868743,WCWP 10B,008,948075,Staff,0,0,0,0
1748429868743,WCWP 10B,009,948076,Ornelas; Tricia,15,0,20,5
1748429868743,WCWP 10B,010,948077,Staff,0,0,0,0
1748429868743,WCWP 10B,011,948096,Staff,0,0,0,0
1748429868743,WCWP 10B,012,948103,Staff,0,0,0,0
1748429868743,WCWP 10B,016,948169,Staff,0,0,0,0
1748429868743,WCWP 10B,017,948192,Ornelas; Tricia,12,0,20,8
1748429868743,WCWP 10B,018,948194,Ornelas; Tricia,14,0,20,6
1748429868743,WCWP 10B,019,948195,Staff,0,0,0,0
1748429869773,WCWP 100,A00,948196,McCleary; Keith Long,14,0,20,6
1748429869773,WCWP 100,B00,948198,McCleary; Keith Long,20,0,20,0
1748429869773,WCWP 100,C00,948199,McCleary; Keith Long,20,0,20,0
1748429869773,WCWP 100,D00,948200,Twohig; Niall Ivan,18,0,20,2
1748429869773,WCWP 100,E00,948201,Twohig; Niall Ivan,19,0,20,1
1748429869773,WCWP 100,F00,948202,Twohig; Niall Ivan,17,0,20,3
1748429869773,WCWP 100,G00,948203,Young; Mark T,18,0,20,2
1748429869773,WCWP 100,H00,948204,Young; Mark T,19,0,20,1
1748429869773,WCWP 100,I00,948205,Young; Mark T,19,0,20,1
1748429870800,WES 237C,A00,948206,Staff,15,0,15,0
1748429871831,WES 267,A00,948207,Staff,25,0,25,0
1748429872857,WES 268A,A01,948209,Staff,15,0,15,0
1748429875109,AAPI 87,A00,911745,Solomon; Amanda Lee Albaniel,20,0,20,0
1748429876136,AAS 10R,A01,912566,Butler; Elizabeth Annette,15,0,34,19
1748429876136,AAS 10R,A02,912567,Butler; Elizabeth Annette,20,0,34,14
1748429877161,AAS 170R,A00,912568,Butler; Elizabeth Annette,29,0,32,3
1748429878189,ANAR 104,A01,911408,Shtienberg; Gilad,11,0,20,9
1748429879217,ANAR 120,A00,911411,Staff,22,0,30,8
1748429880245,ANAR 166,A00,911412,Jimenez Cano; Nayeli Guada,21,0,30,9
1748429881272,ANAR 167,A01,911414,Dunseth; Zachary Clark,0,0,10,10
1748429882300,ANBI 100,A00,911416,Marchetto; Maria Carolina,36,0,40,4
1748429882300,ANBI 100,B00,961136,Staff,66,0,80,14
1748429883327,ANBI 112,A00,911417,Marchetto; Maria Carolina,0,0,20,20
1748429884362,ANBI 117,A01,961211,Fox; Patrick Keolu Ozer,33,0,40,7
1748429885388,ANBI 135,A01,911419,Non; Amy L,4,0,15,11
1748429886419,ANBI 141,A00,911420,Gagneux; Pascal,170,0,196,26
1748429887451,ANSC 108,A00,911460,Pedersen; David,38,0,40,2
1748429888481,ANSC 121,A00,911472,Sloane; Julia Kathryn,53,0,60,7
1748429889510,ANSC 124,A00,911473,Bialecki; Jon Anthony,32,0,40,8
1748429890543,ANSC 142,A00,911474,Stone; Annika Britt,31,0,40,9
1748429891572,ANSC 148,A00,911475,Walkover; Lillian B,46,0,46,0
1748429892602,ANSC 149,A00,911476,Varma; Saiba,56,0,60,4
1748429893632,ANSC 152,A00,961212,Staff,40,0,40,0
1748429894660,ANSC 190,A00,911479,Jassal; Aftab,41,0,50,9
1748429895686,ANTH 1,A00,910717,Jassal; Aftab,146,0,150,4
1748429896715,ANTH 2,A01,910719,Wilder; Linnea Lorene,31,0,36,5
1748429896715,ANTH 2,A02,910720,Wilder; Linnea Lorene,36,0,36,0
1748429896715,ANTH 2,A03,910722,Wilder; Linnea Lorene,32,0,36,4
1748429896715,ANTH 2,A04,910723,Wilder; Linnea Lorene,35,0,36,1
1748429896715,ANTH 2,A05,910724,Wilder; Linnea Lorene,35,0,36,1
1748429896715,ANTH 2,A06,910725,Wilder; Linnea Lorene,35,0,36,1
1748429896715,ANTH 2,A07,910726,Wilder; Linnea Lorene,33,0,34,1
1748429897742,ANTH 10,A00,910727,Stewart; Alexander B,148,0,175,27
1748429898771,ANTH 21,A01,910730,Stone; Annika Britt,35,0,36,1
1748429898771,ANTH 21,A02,910731,Stone; Annika Britt,34,0,36,2
1748429898771,ANTH 21,A03,910732,Stone; Annika Britt,34,0,36,2
1748429898771,ANTH 21,A04,910733,Stone; Annika Britt,30,0,36,6
1748429898771,ANTH 21,A05,910734,Stone; Annika Britt,35,0,36,1
1748429898771,ANTH 21,A06,910735,Stone; Annika Britt,30,0,36,6
1748429898771,ANTH 21,A07,910736,Stone; Annika Britt,24,0,34,10
1748429898771,ANTH 21,B01,910738,Kang; Byung Chu,36,0,36,0
1748429898771,ANTH 21,B02,910740,Kang; Byung Chu,36,0,36,0
1748429898771,ANTH 21,B03,910781,Kang; Byung Chu,34,0,36,2
1748429898771,ANTH 21,B04,910782,Kang; Byung Chu,34,0,36,2
1748429898771,ANTH 21,B05,910821,Kang; Byung Chu,36,0,36,0
1748429898771,ANTH 21,B06,910826,Kang; Byung Chu,34,0,36,2
1748429898771,ANTH 21,B07,910834,Kang; Byung Chu,34,0,34,0
1748429899808,ANTH 23,A01,910896,Stewart; Alexander B,25,0,25,0
1748429899808,ANTH 23,A02,910916,Stewart; Alexander B,25,0,25,0
1748429899808,ANTH 23,A03,910932,Stewart; Alexander B,25,0,25,0
1748429899808,ANTH 23,A04,910933,Stewart; Alexander B,24,0,25,1
1748429899808,ANTH 23,A05,910938,Stewart; Alexander B,25,0,25,0
1748429899808,ANTH 23,A06,911043,Stewart; Alexander B,25,0,25,0
1748429899808,ANTH 23,A07,911141,Stewart; Alexander B,24,0,25,1
1748429900837,ANTH 87,A00,911153,Jordan; David K.,20,0,20,0
1748429900837,ANTH 87,B00,911392,Jordan; David K.,20,0,20,0
1748429900837,ANTH 87,C00,911404,Varma; Saiba,20,0,20,0
1748429901864,ANTH 101,A01,911481,Staff,27,0,30,3
1748429901864,ANTH 101,A02,911482,Staff,15,0,30,15
1748429901864,ANTH 101,A03,911483,Staff,24,0,30,6
1748429901864,ANTH 101,A04,911484,Staff,17,0,30,13
1748429902890,ANTH 105,A00,911486,Staff,69,0,80,11
1748429903920,ANTH 108,A00,911487,Sloane; Julia Kathryn,31,0,35,4
1748429904946,ANTH 196A,A00,911488,Staff,14,0,15,1
1748429905973,ANTH 200,A00,911489,Non; Amy L,12,0,15,3
1748429907001,ANTH 203,A00,911490,Gagneux; Pascal,20,0,20,0
1748429908030,ANTH 208,A00,911491,Kang; Byung Chu,8,0,12,4
1748429909060,ANTH 268,A00,911492,McKenzie; Kerry V.,10,0,10,0
1748429910088,ANTH 273,A00,911493,McKenzie; Kerry V.,10,0,10,0
1748429911114,ANTH 281A,A00,911494,Pedersen; David,10,0,10,0
1748429912140,ANTH 285,A00,911495,Algaze; Guillermo,7,0,10,3
1748429913168,ASTR 1,A01,911506,Wright; Shelley Adams,282,0,300,18
1748429914195,ASTR 18,A01,911508,Arnold; Kam S,35,0,37,2
1748429915223,ASTR 20A,A01,911510,Theissen; Christopher Alexander,48,0,56,8
1748429916251,ASTR 65,A01,911512,Trumbo; Samantha Kathleen,49,0,50,1
1748429917284,ASTR 101,A01,911514,Burgasser; Adam Jonathan,25,0,32,7
1748429918313,ASTR 104,A01,911516,Lee; Eve Jihyun,29,0,32,3
1748429919343,ASTR 120,A01,911518,Tytler; David Robert,29,0,37,8
1748429920371,ASTR 124,A01,911520,Konopacky; Quinn Morgan,33,0,37,4
1748429921397,ASTR 150,A01,911522,Hosseinzadeh; Griffin Alex,34,0,40,6
1748429922430,ASTR 200,A00,911523,Sandstrom; Karin Marie,29,0,30,1
1748429923456,ASTR 201,A00,911524,Broekgaarden; Floor Suzan,30,0,30,0
1748429924483,ASTR 213,A00,911525,Keres; Dusan,28,0,30,2
1748429925510,ASTR 250,A00,911526,Theissen; Christopher Alexander & Hosseinzadeh; Griffin Alex,27,0,30,3
1748429926544,ASTR 251,A00,911527,Theissen; Christopher Alexander & Hosseinzadeh; Griffin Alex,27,0,30,3
1748429927593,AWP 3,001,910489,Staff,12,0,12,0
1748429927593,AWP 3,002,910490,Staff,12,0,12,0
1748429927593,AWP 3,003,910491,Staff,12,0,12,0
1748429927593,AWP 3,004,910492,Staff,12,0,12,0
1748429927593,AWP 3,005,910493,Staff,12,0,12,0
1748429927593,AWP 3,006,910495,Staff,12,0,12,0
1748429927593,AWP 3,007,910498,Staff,12,0,12,0
1748429927593,AWP 3,008,910509,Staff,12,0,12,0
1748429927593,AWP 3,009,910516,Staff,12,0,12,0
1748429927593,AWP 3,010,910525,Staff,12,0,12,0
1748429927593,AWP 3,011,910531,Staff,12,0,12,0
1748429927593,AWP 3,012,910532,Staff,12,0,12,0
1748429927593,AWP 3,013,910533,Staff,12,0,12,0
1748429927593,AWP 3,014,910534,Staff,12,0,12,0
1748429927593,AWP 3,015,910535,Staff,12,0,12,0
1748429927593,AWP 3,016,910536,Staff,12,0,12,0
1748429927593,AWP 3,017,910537,Staff,12,0,12,0
1748429927593,AWP 3,018,910538,Staff,12,0,12,0
1748429927593,AWP 3,019,910539,Staff,0,0,0,0
1748429927593,AWP 3,020,910540,Staff,0,0,0,0
1748429927593,AWP 3,021,910541,Staff,12,0,12,0
1748429927593,AWP 3,022,910542,Staff,0,0,0,0
1748429927593,AWP 3,023,910543,Staff,12,0,12,0
1748429927593,AWP 3,024,910545,Staff,12,0,12,0
1748429927593,AWP 3,025,910546,Staff,12,0,12,0
1748429927593,AWP 3,026,910547,Staff,12,0,12,0
1748429927593,AWP 3,027,910548,Staff,12,0,12,0
1748429927593,AWP 3,028,910549,Staff,12,0,12,0
1748429927593,AWP 3,029,910550,Staff,0,0,0,0
1748429927593,AWP 3,030,910551,Staff,0,0,0,0
1748429927593,AWP 3,031,910552,Staff,12,0,12,0
1748429927593,AWP 3,032,910553,Staff,12,0,12,0
1748429927593,AWP 3,033,910554,Staff,12,0,12,0
1748429927593,AWP 3,034,910555,Staff,12,0,12,0
1748429927593,AWP 3,035,910557,Staff,12,0,12,0
1748429927593,AWP 3,036,910558,Staff,12,0,12,0
1748429927593,AWP 3,037,910559,Staff,12,0,12,0
1748429927593,AWP 3,038,910560,Staff,12,0,12,0
1748429927593,AWP 3,039,910561,Staff,12,0,12,0
1748429927593,AWP 3,040,910562,Staff,12,0,12,0
1748429927593,AWP 3,041,910563,Staff,12,0,12,0
1748429927593,AWP 3,042,910564,Staff,12,0,12,0
1748429927593,AWP 3,043,910565,Staff,12,0,12,0
1748429927593,AWP 3,044,910566,Staff,12,0,12,0
1748429927593,AWP 3,045,910567,Staff,12,0,12,0
1748429927593,AWP 3,046,910568,Staff,12,0,12,0
1748429927593,AWP 3,047,910569,Staff,12,0,12,0
1748429927593,AWP 3,048,910570,Staff,12,0,12,0
1748429927593,AWP 3,049,910571,Staff,12,0,12,0
1748429927593,AWP 3,050,910576,Staff,12,0,12,0
1748429927593,AWP 3,051,910629,Staff,12,0,12,0
1748429927593,AWP 3,052,910630,Staff,12,0,12,0
1748429927593,AWP 3,053,910632,Staff,12,0,12,0
1748429927593,AWP 3,054,910633,Staff,12,0,12,0
1748429927593,AWP 3,055,910635,Staff,12,0,12,0
1748429927593,AWP 3,056,910636,Staff,12,0,12,0
1748429927593,AWP 3,057,910638,Staff,12,0,12,0
1748429927593,AWP 3,058,910640,Staff,0,0,0,0
1748429927593,AWP 3,059,910641,Staff,12,0,12,0
1748429927593,AWP 3,060,910645,Staff,12,0,12,0
1748429927593,AWP 3,061,910646,Staff,12,0,12,0
1748429927593,AWP 3,062,910648,Staff,12,0,12,0
1748429927593,AWP 3,063,910649,Staff,12,0,12,0
1748429927593,AWP 3,064,910653,Staff,12,0,12,0
1748429927593,AWP 3,065,910654,Staff,12,0,12,0
1748429927593,AWP 3,066,910656,Staff,12,0,12,0
1748429927593,AWP 3,067,910657,Staff,12,0,12,0
1748429927593,AWP 3,068,910659,Staff,15,0,15,0
1748429927593,AWP 3,069,910660,Staff,0,0,0,0
1748429927593,AWP 3,070,910662,Staff,12,0,12,0
1748429927593,AWP 3,071,910665,Staff,0,0,0,0
1748429927593,AWP 3,072,910667,Staff,12,0,12,0
1748429927593,AWP 3,073,970938,Staff,12,0,12,0
1748429927593,AWP 3,074,970939,Staff,12,0,12,0
1748429927593,AWP 3,075,970940,Staff,0,0,0,0
1748429927593,AWP 3,076,970941,Staff,12,0,12,0
1748429927593,AWP 3,077,970942,Staff,12,0,12,0
1748429927593,AWP 3,078,970943,Staff,0,0,0,0
1748429927593,AWP 3,079,970944,Staff,12,0,12,0
1748429927593,AWP 3,080,970945,Staff,0,0,0,0
1748429927593,AWP 3,081,971140,Staff,0,0,0,0
1748429927593,AWP 3,082,971141,Staff,0,0,0,0
1748429927593,AWP 3,083,971142,Staff,0,0,0,0
1748429927593,AWP 3,084,971152,Staff,0,0,0,0
1748429927593,AWP 3,085,971315,Staff,0,0,0,0
1748429928621,AWP 4B,B00,910682,Staff,0,0,0,0
1748429928621,AWP 4B,C00,910701,Staff,0,0,0,1
1748429929649,BENG 1,A01,911565,Khojah; Reem I,26,0,30,4
1748429929649,BENG 1,A02,911567,Khojah; Reem I,30,0,30,0
1748429929649,BENG 1,A03,911568,Khojah; Reem I,29,0,30,1
1748429930674,BENG 2,A00,911569,Khojah; Reem I,28,0,30,2
1748429931700,BENG 98,001,969809,Sah; Robert Lie-Yuan,9999,0,9999,0
1748429932731,BENG 99,001,969810,Sah; Robert Lie-Yuan,9999,0,9999,0
1748429933766,BENG 100,A01,911579,Taylor Amos; Alyssa C,35,0,50,15
1748429934800,BENG 110,A01,911582,Mc Culloch; Andrew Douglas,5,0,30,25
1748429934800,BENG 110,A02,911584,Mc Culloch; Andrew Douglas,17,0,30,13
1748429935827,BENG 122A,A01,958030,Cauwenberghs; Gert,54,0,70,16
1748429936854,BENG 133,A01,911589,Mali; Prashant Gulab Ram,33,0,40,7
1748429937880,BENG 135,A01,911653,Staff,32,0,40,8
1748429938909,BENG 141,A01,911674,Staff,29,0,40,11
1748429939937,BENG 161A,A01,911676,Fraley; Stephanie I.,16,0,35,19
1748429939937,BENG 161A,A02,957945,Fraley; Stephanie I.,29,0,35,6
1748429940966,BENG 162,A01,911682,Mali; Prashant Gulab Ram,0,0,30,30
1748429940966,BENG 162,A02,911683,Mali; Prashant Gulab Ram,25,0,30,5
1748429941996,BENG 166A,A02,911685,Sah; Robert Lie-Yuan,11,0,35,24
1748429943025,BENG 183,A01,911688,Zhong; Sheng,35,0,120,85
1748429944054,BENG 187B,A00,911689,Taylor Amos; Alyssa C,52,0,120,68
1748429945083,BENG 188A,A01,911691,Taylor Amos; Alyssa C,131,0,170,39
1748429946111,BENG 196,A00,911692,Cabrales; Pedro,5,0,5,0
1748429947138,BENG 197,A00,911693,Cabrales; Pedro,9999,0,9999,0
1748429948170,BENG 198,001,969812,Sah; Robert Lie-Yuan,9999,0,9999,0
1748429949198,BENG 211,A00,911720,Smarr; Benjamin,2,0,30,28
1748429950227,BENG 216,A01,911722,Cauwenberghs; Gert,1,0,40,39
1748429951255,BENG 219,A00,911723,Schoeneberg; Johannes,0,0,0,0
1748429952282,BENG 221,A00,911724,Valdez-Jasso; Daniela,27,0,70,43
1748429953309,BENG 226,A01,911727,Schmid-Schoenbein; Geert W,54,0,120,66
1748429954336,BENG 230A,A00,911728,Huang; Xiaohua,59,0,120,61
1748429955365,BENG 241A,A01,911730,Cyphert; Erika Leah,0,0,50,50
1748429956396,BENG 242,A00,911731,Cai; Shengqiang,16,0,40,24
1748429957424,BENG 247A,A00,911732,Shi; Lingyan,31,0,55,24
1748429958454,BENG 247B,A00,911733,Aran; Kiana,0,0,30,30
1748429959482,BENG 254,A01,911735,Hasty; Jeff M,0,0,20,20
1748429960510,BENG 260,A01,911737,Silva; Gabriel,15,0,45,30
1748429961541,BENG 280A,A00,911738,Liu; Thomas Tao-Ming & McVeigh; Elliot R.,34,0,70,36
1748429962570,BENG 281,A00,911739,Zhong; Sheng,5,0,90,85
1748429963600,BENG 282,A00,911740,Cabrales; Pedro,19,0,100,81
1748429964681,BENG 292,A01,911742,Ross; Camille,20,0,20,0
1748429965711,BENG 294A,A00,911743,King; Kevin R,25,0,50,25
1748429966738,BENG 295,A00,911744,Watson; John Thomas,9999,0,9999,0
1748429967769,BGGN 202,A00,943331,Kadonaga; James T,52,0,60,8
1748429968796,BGGN 204,A00,943332,Shurin; Jonathan,11,0,20,9
1748429969823,BGGN 206A,A00,943343,Bennett; Eric J,50,0,50,0
1748429970851,BGGN 208,A00,943344,Meyer; Justin Raymond & Bennett; Eric J,50,0,50,0
1748429971877,BGGN 213,A00,943349,Grant; Barry J,48,0,48,0
1748429972902,BGGN 214,A00,943351,Suel; Gurol Mehmet,23,0,50,27
1748429973930,BGGN 220,A00,943352,Dickinson; Alexandra Jazz & Pruneda-Paz; Jose L.,24,0,50,26
1748429974960,BGGN 227,A00,943372,Huffaker; Alisa,44,0,50,6
1748429976006,BGGN 249A,A01,969612,Bloodgood; Brenda Laurie,0,0,0,0
1748429976006,BGGN 249A,A02,969639,Bloodgood; Brenda Laurie,0,0,0,0
1748429977033,BGGN 260,A01,946423,Silva; Gabriel,15,0,15,0
1748429978170,BGGN 271,001,967097,Akbari; Omar Sultan,9999,0,9999,0
1748429978170,BGGN 271,002,967098,Allen; Nicola J,9999,0,9999,0
1748429978170,BGGN 271,003,967099,Alperin; Mariann,9999,0,9999,0
1748429978170,BGGN 271,004,967238,Antal; Corina Elena,9998,0,9999,1
1748429978170,BGGN 271,005,967365,Banghart; Matthew Ryan,9999,0,9999,0
1748429978170,BGGN 271,006,967368,Bier; Ethan,9999,0,9999,0
1748429978170,BGGN 271,007,967371,Boss; Gerard R.,9999,0,9999,0
1748429978170,BGGN 271,008,967375,Bouvet; Michael,9999,0,9999,0
1748429978170,BGGN 271,009,967376,Breen; Ellen C.,9999,0,9999,0
1748429978170,BGGN 271,010,967382,Bui; Jack D,9999,0,9999,0
1748429978170,BGGN 271,011,967391,Burnett; Lindsey,9998,0,9999,1
1748429978170,BGGN 271,012,967407,Caffrey; Conor,9999,0,9999,0
1748429978170,BGGN 271,013,967429,Castle; Michael James,9999,0,9999,0
1748429978170,BGGN 271,014,967431,Chang; John Tzu-yu,9999,0,9999,0
1748429978170,BGGN 271,015,967448,Chen; Xu,9999,0,9999,0
1748429978170,BGGN 271,016,967449,Cheng; Christine Shiang-Ling,9999,0,9999,0
1748429978170,BGGN 271,017,967464,Cheresh; David A.,9999,0,9999,0
1748429978170,BGGN 271,018,967496,Cherqui; Stephanie,9999,0,9999,0
1748429978170,BGGN 271,019,967500,Chu; Hiutung,9999,0,9999,0
1748429978170,BGGN 271,020,967559,Church; Kellie Breen,9999,0,9999,0
1748429978170,BGGN 271,021,967560,Cleland; Elsa Eleanor,9999,0,9999,0
1748429978170,BGGN 271,022,967561,Cohen; Shiran,9999,0,9999,0
1748429978170,BGGN 271,023,967562,Coufal; Nicole Gabriele,9999,0,9999,0
1748429978170,BGGN 271,024,967563,Croker; Ben Adam,9999,0,9999,0
1748429978170,BGGN 271,025,967564,Crotty Alexander; Laura E,9999,0,9999,0
1748429978170,BGGN 271,026,967565,Daugherty; Matthew Dorton,9998,0,9999,1
1748429978170,BGGN 271,027,967566,De Silva; Shermin,9999,0,9999,0
1748429978170,BGGN 271,028,967567,Dhar; Debanjan,9999,0,9999,0
1748429978170,BGGN 271,029,967568,Dixon; Jesse,9999,0,9999,0
1748429978170,BGGN 271,030,967569,Doherty; Taylor Alan,9998,0,9999,1
1748429978170,BGGN 271,031,967570,Dore; Kim Bohemie,9999,0,9999,0
1748429978170,BGGN 271,032,967571,Dorrestein; Pieter,9999,0,9999,0
1748429978170,BGGN 271,033,967572,Dulawa; Stephanie Carole,9999,0,9999,0
1748429978170,BGGN 271,034,967573,Fang; Xi,9999,0,9999,0
1748429978170,BGGN 271,035,967575,Farley; Emma Kristen,9998,0,9999,1
1748429978170,BGGN 271,036,967576,Ferguson; Cole John,9999,0,9999,0
1748429978170,BGGN 271,037,967578,Fisch; Kathleen Marie,9999,0,9999,0
1748429978170,BGGN 271,038,967579,George; Olivier,9999,0,9999,0
1748429978170,BGGN 271,039,967580,Ghosh; Pradipta,9998,0,9999,1
1748429978170,BGGN 271,040,967581,Glasgow; Stacey Marie,9999,0,9999,0
1748429978170,BGGN 271,041,967582,Golden; James W,9999,0,9999,0
1748429978170,BGGN 271,042,967583,Gonzalez Gamboa; Ivonne,9999,0,9999,0
1748429978170,BGGN 271,043,967584,Goren; Alon M,9999,0,9999,0
1748429978170,BGGN 271,044,967650,Guatelli; John C,9999,0,9999,0
1748429978170,BGGN 271,045,967651,Guma; Monica,9998,0,9999,1
1748429978170,BGGN 271,046,967652,Gustafsson; Asa Birgitta,9999,0,9999,0
1748429978170,BGGN 271,047,967655,Hamdoun; Amr,9999,0,9999,0
1748429978170,BGGN 271,048,967657,Hao; Nan,9999,0,9999,0
1748429978170,BGGN 271,049,967658,Hasty; Jeff M,9999,0,9999,0
1748429978170,BGGN 271,050,967660,Jiang; Qingfei,9998,0,9999,1
1748429978170,BGGN 271,051,967661,Jin; Chunyu,9999,0,9999,0
1748429978170,BGGN 271,052,967662,Jin; Yishi,9999,0,9999,0
1748429978170,BGGN 271,053,967663,Joshi; Shweta,9998,0,9999,1
1748429978170,BGGN 271,054,967664,Ju; Won-Kyu,9998,0,9999,1
1748429978170,BGGN 271,055,967665,Jun; Suckjoon,9999,0,9999,0
1748429978170,BGGN 271,056,967666,Kaech; Susan Michelle,9999,0,9999,0
1748429978170,BGGN 271,057,967668,Kauffman; Alexander,9998,0,9999,1
1748429978170,BGGN 271,058,967670,Kiger; Amy,9999,0,9999,0
1748429978170,BGGN 271,059,967720,Koloski; Miranda Jane,9998,0,9999,1
1748429978170,BGGN 271,060,967864,Komiyama; Takaki,9999,0,9999,0
1748429978170,BGGN 271,061,967865,Kronenberg; Mitchell E.,9998,0,9999,1
1748429978170,BGGN 271,062,967866,Kufareva; Irina,9999,0,9999,0
1748429978170,BGGN 271,063,967867,Lee; Yun Sok,9999,0,9999,0
1748429978170,BGGN 271,064,967869,Leutgeb; Stefan,9999,0,9999,0
1748429978170,BGGN 271,065,967870,Lewis; Warren G.,9999,0,9999,0
1748429978170,BGGN 271,066,967871,Li; Willis Xiaowei,9998,0,9999,1
1748429978170,BGGN 271,067,967872,Lim; Byungkook,9999,0,9999,0
1748429978170,BGGN 271,068,967873,Lo; Stanley M.,9998,0,9999,1
1748429978170,BGGN 271,069,967874,Lopez Ramirez; Miguel Alej,9999,0,9999,0
1748429978170,BGGN 271,070,967875,Lu; Li-Fan,9998,0,9999,1
1748429978170,BGGN 271,071,967877,Lu; Pengzhe,9999,0,9999,0
1748429978170,BGGN 271,072,967878,Lyons; Deirdre Colleen,9999,0,9999,0
1748429978170,BGGN 271,073,967879,Lyumkis; Dmitry Evgenievich,9999,0,9999,0
1748429978170,BGGN 271,074,967880,Mandyam; Chitra,9999,0,9999,0
1748429978170,BGGN 271,075,967881,McConville; Patrick James,9999,0,9999,0
1748429978170,BGGN 271,076,967882,Mertens; Jerome Stefan,9999,0,9999,0
1748429978170,BGGN 271,077,967884,Morris; Gerald P,9999,0,9999,0
1748429978170,BGGN 271,078,967885,Muroyama; Andrew David,9999,0,9999,0
1748429978170,BGGN 271,079,967886,Murre; Cornelis,9999,0,9999,0
1748429978170,BGGN 271,080,967887,Neal; Sonya E,9999,0,9999,0
1748429978170,BGGN 271,081,967889,Newton; Alexandra C.,9999,0,9999,0
1748429978170,BGGN 271,082,967890,Nieh; James Charles,9999,0,9999,0
1748429978170,BGGN 271,083,967893,Niwa; Maho,9999,0,9999,0
1748429978170,BGGN 271,084,967894,Pantham; Priyadarshini,9999,0,9999,0
1748429978170,BGGN 271,085,967895,Parast; Mana,9999,0,9999,0
1748429978170,BGGN 271,086,967899,Perry; Michael William,9999,0,9999,0
1748429978170,BGGN 271,087,967900,Pillus; Lorraine,9998,0,9999,1
1748429978170,BGGN 271,088,967902,Pogliano; Joseph,9999,0,9999,0
1748429978170,BGGN 271,089,967903,Pruneda-Paz; Jose L.,9999,0,9999,0
1748429978170,BGGN 271,090,967904,Raffatellu; Manuela,9999,0,9999,0
1748429978170,BGGN 271,091,967906,Rana; Tariq,9999,0,9999,0
1748429978170,BGGN 271,092,967907,Rao; Anjana,9998,0,9999,1
1748429978170,BGGN 271,093,967908,Raz; Eyal,9998,0,9999,1
1748429978170,BGGN 271,094,967909,Gaulton; Kyle J,9999,0,9999,0
1748429978170,BGGN 271,095,967910,Rifkin; Scott,9998,0,9999,1
1748429978170,BGGN 271,096,967912,Risbrough; Victoria Blythe,9999,0,9999,0
1748429978170,BGGN 271,097,967916,Rose; Noah Hartmann,9999,0,9999,0
1748429978170,BGGN 271,098,967917,Rouse; Gregory W.,9999,0,9999,0
1748429978170,BGGN 271,099,967918,Saier; Milton H.,9999,0,9999,0
1748429978170,BGGN 271,100,967919,Saltiel; Alan,9998,0,9999,1
1748429978170,BGGN 271,101,967920,Sanchez-Lopez; Elsa,9999,0,9999,0
1748429978170,BGGN 271,102,967921,Schenk; Simon,9999,0,9999,0
1748429978170,BGGN 271,103,967922,Schroeder; Julian I,9998,0,9999,1
1748429978170,BGGN 271,104,967923,Sebat; Lilia Mikhailovna,9999,0,9999,0
1748429978170,BGGN 271,105,967925,Sen; George L,9999,0,9999,0
1748429978170,BGGN 271,106,967926,Shaner; Nathan C.,9999,0,9999,0
1748429978170,BGGN 271,107,967927,Shao; Jianhua,9999,0,9999,0
1748429978170,BGGN 271,108,967928,Shurin; Jonathan,9998,0,9999,1
1748429978170,BGGN 271,109,967929,Sicklick; Jason Keith,9999,0,9999,0
1748429978170,BGGN 271,110,967931,Signer; Robert,9999,0,9999,0
1748429978170,BGGN 271,111,967932,Sigurdson; Christina,9999,0,9999,0
1748429978170,BGGN 271,112,967934,Simonson; Tatum Sasha Summ,9999,0,9999,0
1748429978170,BGGN 271,113,967935,Spitzer; Nicholas,9999,0,9999,0
1748429978170,BGGN 271,114,967936,Steinmetz; Nicole F,9999,0,9999,0
1748429978170,BGGN 271,115,967938,Su; Chih-Ying,9999,0,9999,0
1748429978170,BGGN 271,116,967939,Telese; Francesca,9999,0,9999,0
1748429978170,BGGN 271,117,967942,Towers; Christina Garlingt,9999,0,9999,0
1748429978170,BGGN 271,118,967943,Tye; Kay M,9999,0,9999,0
1748429978170,BGGN 271,119,967945,Wahlin; Karl Jonas,9997,0,9999,2
1748429978170,BGGN 271,120,967947,Wang; Shizhen,9999,0,9999,0
1748429978170,BGGN 271,121,967949,Wang; Jean Yin Jen,9999,0,9999,0
1748429978170,BGGN 271,122,967952,Webster; Nicholas J G,9999,0,9999,0
1748429978170,BGGN 271,123,967953,Weiskopf; Daniela,9998,0,9999,1
1748429978170,BGGN 271,124,967954,Welsbie; Derek,9999,0,9999,0
1748429978170,BGGN 271,125,967956,Wildonger; Jill Cathleen,9999,0,9999,0
1748429978170,BGGN 271,126,967957,Yelon; Deborah,9999,0,9999,0
1748429978170,BGGN 271,127,967958,Yeo; Eugene Wei-Ming,9998,0,9999,1
1748429978170,BGGN 271,128,967959,Ying; Wei,9998,0,9999,1
1748429978170,BGGN 271,129,967960,Young; Jared W.,9999,0,9999,0
1748429978170,BGGN 271,130,967961,Zage; Peter,9999,0,9999,0
1748429978170,BGGN 271,131,967962,Zengler; Karsten B,9999,0,9999,0
1748429978170,BGGN 271,132,967963,Zhang; Jin,9999,0,9999,0
1748429978170,BGGN 271,133,967964,Zhao; Yunde,9999,0,9999,0
1748429978170,BGGN 271,134,967965,Zheng; Ye,9998,0,9999,1
1748429978170,BGGN 271,135,967966,Zhou; Huilin,9998,0,9999,1
1748429978170,BGGN 271,136,967970,Zou; Yimin,9998,0,9999,1
1748429979200,BGGN 272,A00,943373,Lo; Stanley M.,14,0,15,1
1748429980226,BGGN 275,A00,943374,Pogliano; Joseph,0,0,0,0
1748429981255,BGGN 276,A00,943378,Pogliano; Joseph,0,0,0,0
1748429982291,BGJC 204,A00,943407,Lu; Li-Fan & Chang; John Tzu-yu,9998,0,9999,1
1748429983318,BGJC 215,A00,943417,Tour; Ella,9,0,10,1
1748429984427,BGRD 200,001,965406,Akbari; Omar Sultan,9999,0,9999,0
1748429984427,BGRD 200,002,965407,Allen; Eric,9999,0,9999,0
1748429984427,BGRD 200,003,965408,Allen; Nicola J,9998,0,9999,1
1748429984427,BGRD 200,004,965427,Alperin; Mariann,9999,0,9999,0
1748429984427,BGRD 200,005,965428,Amaro; Rommie E,9998,0,9999,1
1748429984427,BGRD 200,006,965429,Antal; Corina Elena,9998,0,9999,1
1748429984427,BGRD 200,007,965731,Asahina; Kenta,9999,0,9999,0
1748429984427,BGRD 200,008,965732,Augustine; Vineet,9999,0,9999,0
1748429984427,BGRD 200,009,965733,Ayres; Janelle Samantha,9998,0,9999,1
1748429984427,BGRD 200,010,965734,Banghart; Matthew Ryan,9999,0,9999,0
1748429984427,BGRD 200,011,965735,Barton; Andrew David,9999,0,9999,0
1748429984427,BGRD 200,012,965736,Bayless; Daniel Wilson,9999,0,9999,0
1748429984427,BGRD 200,013,965737,Benna; Marcus K,9999,0,9999,0
1748429984427,BGRD 200,014,965738,Bennett; Eric J,9999,0,9999,0
1748429984427,BGRD 200,015,965739,Bier; Ethan,9999,0,9999,0
1748429984427,BGRD 200,016,965740,Bloodgood; Brenda Laurie,9999,0,9999,0
1748429984427,BGRD 200,017,965741,Boss; Gerard R.,9999,0,9999,0
1748429984427,BGRD 200,018,966029,Bouvet; Michael,9999,0,9999,0
1748429984427,BGRD 200,019,966054,Breen; Ellen C.,9999,0,9999,0
1748429984427,BGRD 200,020,966072,Bui; Jack D,9999,0,9999,0
1748429984427,BGRD 200,021,966073,Burnett; Lindsey,9998,0,9999,1
1748429984427,BGRD 200,022,966080,Caffrey; Conor,9999,0,9999,0
1748429984427,BGRD 200,023,966082,Callaway; Edward M,9999,0,9999,0
1748429984427,BGRD 200,024,966087,Castle; Michael James,9999,0,9999,0
1748429984427,BGRD 200,025,966089,Chaim; Isaac,9999,0,9999,0
1748429984427,BGRD 200,026,966092,Chang; John Tzu-yu,9999,0,9999,0
1748429984427,BGRD 200,027,966094,Chen; Xu,9999,0,9999,0
1748429984427,BGRD 200,028,966095,Cheng; Christine Shiang-Ling,9999,0,9999,0
1748429984427,BGRD 200,029,966099,Cheresh; David A.,9999,0,9999,0
1748429984427,BGRD 200,030,966103,Cherqui; Stephanie,9999,0,9999,0
1748429984427,BGRD 200,031,966104,Chu; Hiutung,9999,0,9999,0
1748429984427,BGRD 200,032,966107,Church; Kellie Breen,9999,0,9999,0
1748429984427,BGRD 200,033,966108,Cleland; Elsa Eleanor,9997,0,9999,2
1748429984427,BGRD 200,034,966111,Cohen; Shiran,9999,0,9999,0
1748429984427,BGRD 200,035,966112,Cooper; Kimberly Lynn,9999,0,9999,0
1748429984427,BGRD 200,036,966114,Coufal; Nicole Gabriele,9999,0,9999,0
1748429984427,BGRD 200,037,966115,Croker; Ben Adam,9999,0,9999,0
1748429984427,BGRD 200,038,966116,Crotty Alexander; Laura E,9999,0,9999,0
1748429984427,BGRD 200,039,966117,Daugherty; Matthew Dorton,9997,0,9999,2
1748429984427,BGRD 200,040,966118,De Silva; Shermin,9998,0,9999,1
1748429984427,BGRD 200,041,966119,Desai; Arshad,9999,0,9999,0
1748429984427,BGRD 200,042,966120,Dhar; Debanjan,9999,0,9999,0
1748429984427,BGRD 200,043,966121,Dickinson; Alexandra Jazz,9999,0,9999,0
1748429984427,BGRD 200,044,966123,Dixon; Jesse,9999,0,9999,0
1748429984427,BGRD 200,045,966125,Doherty; Taylor Alan,9998,0,9999,1
1748429984427,BGRD 200,046,966128,Dore; Kim Bohemie,9999,0,9999,0
1748429984427,BGRD 200,047,966129,Dorrestein; Pieter,9999,0,9999,0
1748429984427,BGRD 200,048,966130,Dulawa; Stephanie Carole,9999,0,9999,0
1748429984427,BGRD 200,049,966131,Ecker; Joseph R,9999,0,9999,0
1748429984427,BGRD 200,050,966174,Engle; Dannielle D,9998,0,9999,1
1748429984427,BGRD 200,051,966179,Ernst; Andreas,9999,0,9999,0
1748429984427,BGRD 200,052,966182,Esko; Jeffrey D.,9999,0,9999,0
1748429984427,BGRD 200,053,966183,Fang; Xi,9999,0,9999,0
1748429984427,BGRD 200,054,966184,Farley; Emma Kristen,9998,0,9999,1
1748429984427,BGRD 200,055,966187,Ferguson; Cole John,9999,0,9999,0
1748429984427,BGRD 200,056,966190,Fisch; Kathleen Marie,9999,0,9999,0
1748429984427,BGRD 200,057,966193,Gage; Fred H,9999,0,9999,0
1748429984427,BGRD 200,058,966194,George; Monique Leana,9998,0,9999,1
1748429984427,BGRD 200,059,966196,George; Olivier,9999,0,9999,0
1748429984427,BGRD 200,060,966202,Ghosh; Pradipta,9998,0,9999,1
1748429984427,BGRD 200,061,966203,Glasgow; Stacey Marie,9999,0,9999,0
1748429984427,BGRD 200,062,966204,Glass; Christopher,9999,0,9999,0
1748429984427,BGRD 200,063,966226,Golden; James W,9999,0,9999,0
1748429984427,BGRD 200,064,966231,Goldrath; Ananda,9999,0,9999,0
1748429984427,BGRD 200,065,966232,Gonzalez Gamboa; Ivonne,9999,0,9999,0
1748429984427,BGRD 200,066,966233,Goren; Alon M,9999,0,9999,0
1748429984427,BGRD 200,067,966245,Guatelli; John C,9999,0,9999,0
1748429984427,BGRD 200,068,966247,Guma; Monica,9998,0,9999,1
1748429984427,BGRD 200,069,966253,Gustafsson; Asa Birgitta,9999,0,9999,0
1748429984427,BGRD 200,070,966255,Gutkind; Jorge Silvio,9998,0,9999,1
1748429984427,BGRD 200,071,966260,Hamdoun; Amr,9999,0,9999,0
1748429984427,BGRD 200,072,966262,Hampton; Randolph Y.,9998,0,9999,1
1748429984427,BGRD 200,073,966263,Hao; Nan,9999,0,9999,0
1748429984427,BGRD 200,074,966265,Hargreaves; Diana Clare,9997,0,9999,2
1748429984427,BGRD 200,075,966268,Hasty; Jeff M,9999,0,9999,0
1748429984427,BGRD 200,076,966270,Hollern; Daniel Patrick,9999,0,9999,0
1748429984427,BGRD 200,077,966271,Holway; David A.,9998,0,9999,1
1748429984427,BGRD 200,078,966272,Huffaker; Alisa,9999,0,9999,0
1748429984427,BGRD 200,079,966273,Hui; Enfu,9999,0,9999,0
1748429984427,BGRD 200,080,966275,Hwa; Terence T.,9999,0,9999,0
1748429984427,BGRD 200,081,966276,Jackrel; Sara,9998,0,9999,1
1748429984427,BGRD 200,082,966277,Jiang; Qingfei,9998,0,9999,1
1748429984427,BGRD 200,083,966281,Jin; Chunyu,9999,0,9999,0
1748429984427,BGRD 200,084,966283,Jin; Yishi,9999,0,9999,0
1748429984427,BGRD 200,085,966287,Joshi; Shweta,9999,0,9999,0
1748429984427,BGRD 200,086,966290,Ju; Won-Kyu,9998,0,9999,1
1748429984427,BGRD 200,087,966291,Jun; Suckjoon,9999,0,9999,0
1748429984427,BGRD 200,088,966292,Kadonaga; James T,9999,0,9999,0
1748429984427,BGRD 200,089,966293,Kaech; Susan Michelle,9999,0,9999,0
1748429984427,BGRD 200,090,966295,Kauffman; Alexander,9998,0,9999,1
1748429984427,BGRD 200,091,966301,Kendrick; Agnieszka Anasta,9999,0,9999,0
1748429984427,BGRD 200,092,966302,Kiger; Amy,9999,0,9999,0
1748429984427,BGRD 200,093,966314,Knight; Robin,9999,0,9999,0
1748429984427,BGRD 200,094,966315,Koloski; Miranda Jane,9998,0,9999,1
1748429984427,BGRD 200,095,966339,Komiyama; Takaki,9998,0,9999,1
1748429984427,BGRD 200,096,966351,Kosuri; Pallav,9999,0,9999,0
1748429984427,BGRD 200,097,966361,Kronenberg; Mitchell E.,9999,0,9999,0
1748429984427,BGRD 200,098,966374,Kryazhimskiy; Sergey A,9999,0,9999,0
1748429984427,BGRD 200,099,966377,Kufareva; Irina,9999,0,9999,0
1748429984427,BGRD 200,100,966380,Lee; Christopher Tingkuang,9999,0,9999,0
1748429984427,BGRD 200,101,966383,Lee; Kuo Fen,9999,0,9999,0
1748429984427,BGRD 200,102,966387,Lee; Yun Sok,9999,0,9999,0
1748429984427,BGRD 200,103,966397,Leutgeb; Jill K.,9999,0,9999,0
1748429984427,BGRD 200,104,966446,Leutgeb; Stefan,9998,0,9999,1
1748429984427,BGRD 200,105,966478,Lewis; Warren G.,9999,0,9999,0
1748429984427,BGRD 200,106,966490,Li; Willis Xiaowei,9998,0,9999,1
1748429984427,BGRD 200,107,966491,Lim; Byungkook,9998,0,9999,1
1748429984427,BGRD 200,108,966494,Lo; Stanley M.,9998,0,9999,1
1748429984427,BGRD 200,109,966499,Looger; Loren Lee,9998,0,9999,1
1748429984427,BGRD 200,110,966500,Lopez Ramirez; Miguel Alej,9999,0,9999,0
1748429984427,BGRD 200,111,966510,Lovett-Barron; Matthew Rod,9998,0,9999,1
1748429984427,BGRD 200,112,966513,Lu; Li-Fan,9998,0,9999,1
1748429984427,BGRD 200,113,966515,Lu; Pengzhe,9999,0,9999,0
1748429984427,BGRD 200,114,966522,Lykke-Andersen; Jens,9999,0,9999,0
1748429984427,BGRD 200,115,966526,Lyons; Deirdre Colleen,9999,0,9999,0
1748429984427,BGRD 200,116,966528,Lyumkis; Dmitry Evgenievich,9999,0,9999,0
1748429984427,BGRD 200,117,966531,Mandyam; Chitra,9999,0,9999,0
1748429984427,BGRD 200,118,966537,Manor; Uri,9999,0,9999,0
1748429984427,BGRD 200,119,966538,Mayfield; Stephen P.,9998,0,9999,1
1748429984427,BGRD 200,120,966539,McConville; Patrick James,9999,0,9999,0
1748429984427,BGRD 200,121,966546,Mertens; Jerome Stefan,9999,0,9999,0
1748429984427,BGRD 200,122,966586,Meyer; Justin Raymond,9999,0,9999,0
1748429984427,BGRD 200,123,966587,Morris; Gerald P,9999,0,9999,0
1748429984427,BGRD 200,124,966588,Mueller; Lena,9998,0,9999,1
1748429984427,BGRD 200,125,966590,Muroyama; Andrew David,9999,0,9999,0
1748429984427,BGRD 200,126,966591,Murre; Cornelis,9999,0,9999,0
1748429984427,BGRD 200,127,966593,Neal; Sonya E,9998,0,9999,1
1748429984427,BGRD 200,128,966594,Newton; Alexandra C.,9999,0,9999,0
1748429984427,BGRD 200,129,966596,Nieh; James Charles,9999,0,9999,0
1748429984427,BGRD 200,130,966597,Niwa; Maho,9999,0,9999,0
1748429984427,BGRD 200,131,966605,Nizet; Victor F.,9999,0,9999,0
1748429984427,BGRD 200,132,966606,Oegema; Karen,9999,0,9999,0
1748429984427,BGRD 200,133,966608,Panda; Satchidananda,9998,0,9999,1
1748429984427,BGRD 200,134,966610,Pantham; Priyadarshini,9999,0,9999,0
1748429984427,BGRD 200,135,966612,Parast; Mana,9999,0,9999,0
1748429984427,BGRD 200,136,966613,Pasquinelli; Amy,9999,0,9999,0
1748429984427,BGRD 200,137,966615,Pekkurnaz Banghart; Gulcin,9999,0,9999,0
1748429984427,BGRD 200,138,966639,Perry; Michael William,9998,0,9999,1
1748429984427,BGRD 200,139,966640,Pillus; Lorraine,9998,0,9999,1
1748429984427,BGRD 200,140,966654,Pogliano; Joseph,9999,0,9999,0
1748429984427,BGRD 200,141,966700,Pogliano; Kit J.,9999,0,9999,0
1748429984427,BGRD 200,142,966701,Pruneda-Paz; Jose L.,9999,0,9999,0
1748429984427,BGRD 200,143,966744,Raffatellu; Manuela,9999,0,9999,0
1748429984427,BGRD 200,144,966745,Ramanan; Deepshika,9998,0,9999,1
1748429984427,BGRD 200,145,966746,Rana; Tariq,9999,0,9999,0
1748429984427,BGRD 200,146,966747,Rao; Anjana,9999,0,9999,0
1748429984427,BGRD 200,147,966811,Raz; Eyal,9998,0,9999,1
1748429984427,BGRD 200,149,966817,Gaulton; Kyle J,9999,0,9999,0
1748429984427,BGRD 200,150,966824,Rennison; Diana,9999,0,9999,0
1748429984427,BGRD 200,151,966828,Reyes De Barboza; Nabora S,9999,0,9999,0
1748429984427,BGRD 200,152,966837,Rifkin; Scott,9998,0,9999,1
1748429984427,BGRD 200,153,966839,Risbrough; Victoria Blythe,9999,0,9999,0
1748429984427,BGRD 200,154,966846,Rivera; Fabian Chavez,9999,0,9999,0
1748429984427,BGRD 200,155,966851,Rohner; Patrick Thomas,9999,0,9999,0
1748429984427,BGRD 200,156,966859,Rose; Noah Hartmann,9999,0,9999,0
1748429984427,BGRD 200,157,966874,Rosenfeld; Michael G,9999,0,9999,0
1748429984427,BGRD 200,158,966882,Rouse; Gregory W.,9999,0,9999,0
1748429984427,BGRD 200,159,966885,Saier; Milton H.,9999,0,9999,0
1748429984427,BGRD 200,160,966923,Saltiel; Alan,9998,0,9999,1
1748429984427,BGRD 200,161,966926,Sanchez-Lopez; Elsa,9999,0,9999,0
1748429984427,BGRD 200,162,966927,Saphire; Erica Ollmann,9999,0,9999,0
1748429984427,BGRD 200,163,966931,Schenk; Simon,9999,0,9999,0
1748429984427,BGRD 200,164,966938,Schroeder; Julian I,9999,0,9999,0
1748429984427,BGRD 200,165,966966,Sebat; Lilia Mikhailovna,9999,0,9999,0
1748429984427,BGRD 200,166,966978,Sen; George L,9999,0,9999,0
1748429984427,BGRD 200,167,966981,Shah; Sameer B,9999,0,9999,0
1748429984427,BGRD 200,168,966982,Shaner; Nathan C.,9999,0,9999,0
1748429984427,BGRD 200,169,966983,Shao; Jianhua,9999,0,9999,0
1748429984427,BGRD 200,170,966984,Sharpee; Tatyana,9999,0,9999,0
1748429984427,BGRD 200,171,966985,Shaw; Reuben,9999,0,9999,0
1748429984427,BGRD 200,172,966986,Shurin; Jonathan,9997,0,9999,2
1748429984427,BGRD 200,173,966987,Sicklick; Jason Keith,9999,0,9999,0
1748429984427,BGRD 200,174,966988,Signer; Robert,9999,0,9999,0
1748429984427,BGRD 200,175,966989,Sigurdson; Christina,9999,0,9999,0
1748429984427,BGRD 200,176,966991,Simonson; Tatum Sasha Summ,9999,0,9999,0
1748429984427,BGRD 200,177,966992,Soncin; Francesca,9999,0,9999,0
1748429984427,BGRD 200,178,966993,Spitzer; Nicholas,9999,0,9999,0
1748429984427,BGRD 200,179,966994,Steinmetz; Nicole F,9999,0,9999,0
1748429984427,BGRD 200,180,966995,Su; Chih-Ying,9999,0,9999,0
1748429984427,BGRD 200,181,966996,Suel; Gurol Mehmet,9998,0,9999,1
1748429984427,BGRD 200,182,966997,Sun; Xin,9998,0,9999,1
1748429984427,BGRD 200,183,966998,Telese; Francesca,9998,0,9999,1
1748429984427,BGRD 200,184,966999,Towers; Christina Garlingt,9999,0,9999,0
1748429984427,BGRD 200,185,967000,Traver; David,9999,0,9999,0
1748429984427,BGRD 200,186,967001,Troemel; Emily Ruth,9998,0,9999,1
1748429984427,BGRD 200,187,967002,Tye; Kay M,9999,0,9999,0
1748429984427,BGRD 200,188,967003,Vijayanand; Pandurangan,9999,0,9999,0
1748429984427,BGRD 200,189,967004,Villa Rodriguez; Elizabeth,9999,0,9999,0
1748429984427,BGRD 200,190,967005,Wahlin; Karl Jonas,9997,0,9999,2
1748429984427,BGRD 200,191,967009,Wang; Shizhen,9999,0,9999,0
1748429984427,BGRD 200,192,967010,Wang; Jean Yin Jen,9999,0,9999,0
1748429984427,BGRD 200,193,967011,Webster; Nicholas J G,9999,0,9999,0
1748429984427,BGRD 200,194,967016,Weiskopf; Daniela,9998,0,9999,1
1748429984427,BGRD 200,195,967020,Welsbie; Derek,9999,0,9999,0
1748429984427,BGRD 200,196,967022,Wildonger; Jill Cathleen,9998,0,9999,1
1748429984427,BGRD 200,197,967027,Winzeler; Elizabeth A,9998,0,9999,1
1748429984427,BGRD 200,198,967029,Wodarz; Dominik Franz Xave,9999,0,9999,0
1748429984427,BGRD 200,199,967033,Yelon; Deborah,9998,0,9999,1
1748429984427,BGRD 200,200,967034,Yeo; Eugene Wei-Ming,9998,0,9999,1
1748429984427,BGRD 200,201,967040,Ying; Wei,9998,0,9999,1
1748429984427,BGRD 200,202,967052,Young; Jared W.,9999,0,9999,0
1748429984427,BGRD 200,203,967057,Zage; Peter,9999,0,9999,0
1748429984427,BGRD 200,204,967070,Zengler; Karsten B,9998,0,9999,1
1748429984427,BGRD 200,206,967081,Zhang; Jin,9999,0,9999,0
1748429984427,BGRD 200,207,967083,Zhao; Yunde,9999,0,9999,0
1748429984427,BGRD 200,208,967086,Zheng; Binhai,9999,0,9999,0
1748429984427,BGRD 200,209,967091,Zheng; Ye,9999,0,9999,0
1748429984427,BGRD 200,210,967093,Zhou; Huilin,9999,0,9999,0
1748429984427,BGRD 200,211,967095,Zou; Yimin,9998,0,9999,1
1748429984427,BGRD 200,212,967096,Zuniga; Elina I,9999,0,9999,0
1748429984427,BGRD 200,213,967978,Biering; Scott,9999,0,9999,0
1748429985454,BGSE 200,A00,943418,Tour; Ella & Petrie; Katherine Lynn,9999,0,9999,0
1748429986483,BGSE 205,A00,943419,Muroyama; Andrew David,46,0,50,4
1748429986483,BGSE 205,C00,943420,Russell; Alistair B,44,0,50,6
1748429986483,BGSE 205,D00,943421,Villa Rodriguez; Elizabeth,41,0,50,9
1748429986483,BGSE 205,E00,960271,Lim; Byungkook,45,0,50,5
1748429987514,BIBC 100,A01,959758,Flagg; Matthew Paul,0,0,38,38
1748429987514,BIBC 100,A02,959759,Flagg; Matthew Paul,0,0,38,38
1748429987514,BIBC 100,A03,959760,Flagg; Matthew Paul,0,0,38,38
1748429987514,BIBC 100,A04,959761,Flagg; Matthew Paul,0,0,36,36
1748429988547,BIBC 102,A01,959209,Pekkurnaz Banghart; Gulcin,0,0,34,34
1748429988547,BIBC 102,A02,959258,Pekkurnaz Banghart; Gulcin,0,0,34,34
1748429988547,BIBC 102,A03,959300,Pekkurnaz Banghart; Gulcin,0,0,35,35
1748429988547,BIBC 102,A04,959302,Pekkurnaz Banghart; Gulcin,0,0,34,34
1748429988547,BIBC 102,B01,959307,Pekkurnaz Banghart; Gulcin,0,0,34,34
1748429988547,BIBC 102,B02,959309,Pekkurnaz Banghart; Gulcin,0,0,34,34
1748429988547,BIBC 102,B03,959310,Pekkurnaz Banghart; Gulcin,0,0,33,33
1748429988547,BIBC 102,B04,959311,Pekkurnaz Banghart; Gulcin,0,0,34,34
1748429989578,BIBC 103,A01,942080,Grossman; Emily N,0,0,24,24
1748429989578,BIBC 103,A02,942081,Grossman; Emily N,0,0,24,24
1748429989578,BIBC 103,B01,942083,Grossman; Emily N,0,0,24,24
1748429989578,BIBC 103,B02,942129,Grossman; Emily N,0,0,24,24
1748429989578,BIBC 103,C01,942131,Burg; Michael,0,0,24,24
1748429989578,BIBC 103,C02,942152,Burg; Michael,0,0,24,24
1748429989578,BIBC 103,D01,942169,Burg; Michael,0,0,24,24
1748429989578,BIBC 103,D02,942170,Burg; Michael,0,0,24,24
1748429990616,BICD 100,A01,959831,Day; Christopher D,53,0,61,8
1748429990616,BICD 100,A02,959832,Day; Christopher D,49,0,61,12
1748429990616,BICD 100,A03,959833,Day; Christopher D,43,0,61,18
1748429990616,BICD 100,A04,959834,Day; Christopher D,57,0,61,4
1748429990616,BICD 100,B01,959749,McDonnell; Lisa Marie,0,0,61,61
1748429990616,BICD 100,B02,959750,McDonnell; Lisa Marie,0,0,61,61
1748429990616,BICD 100,B03,959751,McDonnell; Lisa Marie,0,0,61,61
1748429990616,BICD 100,B04,959752,McDonnell; Lisa Marie,37,0,61,24
1748429990616,BICD 100,C01,959835,Yelon; Deborah,0,0,61,61
1748429990616,BICD 100,C02,959836,Yelon; Deborah,54,0,61,7
1748429990616,BICD 100,C03,959837,Yelon; Deborah,61,0,61,0
1748429990616,BICD 100,C04,959838,Yelon; Deborah,57,0,61,4
1748429991642,BICD 110,A01,959312,Kiger; Amy,59,0,123,64
1748429991642,BICD 110,A02,959315,Kiger; Amy,94,0,122,28
1748429992669,BICD 130,A01,942207,Perry; Michael William,0,0,48,48
1748429992669,BICD 130,A02,942208,Perry; Michael William,37,0,48,11
1748429992669,BICD 130,A03,942209,Perry; Michael William,29,0,48,19
1748429992669,BICD 130,A04,942236,Perry; Michael William,19,0,48,29
1748429993697,BICD 140,A01,942372,Zuniga; Elina I,42,0,49,7
1748429993697,BICD 140,A02,942492,Zuniga; Elina I,45,0,49,4
1748429993697,BICD 140,A03,942493,Zuniga; Elina I,48,0,49,1
1748429993697,BICD 140,A04,942494,Zuniga; Elina I,46,0,49,3
1748429994724,BIEB 102,A01,942496,Butler; Shannon Rhey,182,0,248,66
1748429995755,BIEB 121,A00,942497,Holway; David A.,0,0,32,32
1748429995755,BIEB 121,B00,942498,Butler; Shannon Rhey,0,0,32,32
1748429996784,BIEB 141,A01,942500,Kryazhimskiy; Sergey A,23,0,40,17
1748429997812,BIEB 146,A01,942502,Petrie; Katherine Lynn,41,0,89,48
1748429997812,BIEB 146,A02,942503,Petrie; Katherine Lynn,0,0,88,88
1748429997812,BIEB 146,A03,942504,Petrie; Katherine Lynn,2,0,88,86
1748429997812,BIEB 146,A04,942505,Petrie; Katherine Lynn,21,0,89,68
1748429998845,BIEB 150,A01,942507,Rennison; Diana,28,0,41,13
1748429998845,BIEB 150,A02,942508,Rennison; Diana,32,0,41,9
1748429998845,BIEB 150,A03,942509,Rennison; Diana,36,0,41,5
1748429998845,BIEB 150,A04,942510,Rennison; Diana,6,0,40,34
1748429999879,BIEB 174,A01,942512,Cleland; Elsa Eleanor & Barton; Andrew David,9,0,41,32
1748429999879,BIEB 174,A02,942513,Cleland; Elsa Eleanor & Barton; Andrew David,37,0,41,4
1748429999879,BIEB 174,A03,942514,Cleland; Elsa Eleanor & Barton; Andrew David,35,0,41,6
1748429999879,BIEB 174,A04,942515,Cleland; Elsa Eleanor & Barton; Andrew David,30,0,40,10
1748430000912,BILD 1,A01,959729,Ochoa Mikrut; Stacy Daniel,50,0,60,10
1748430000912,BILD 1,A02,959730,Ochoa Mikrut; Stacy Daniel,46,0,59,13
1748430000912,BILD 1,A03,959731,Ochoa Mikrut; Stacy Daniel,48,0,59,11
1748430000912,BILD 1,A04,959732,Ochoa Mikrut; Stacy Daniel,50,0,59,9
1748430000912,BILD 1,B01,959733,Cooper; Andrew Michael,46,0,60,14
1748430000912,BILD 1,B02,959734,Cooper; Andrew Michael,58,0,59,1
1748430000912,BILD 1,B03,959735,Cooper; Andrew Michael,54,0,59,5
1748430000912,BILD 1,B04,959736,Cooper; Andrew Michael,50,0,59,9
1748430000912,BILD 1,C01,959737,Rusert; Jessica Marie,58,0,60,2
1748430000912,BILD 1,C02,959738,Rusert; Jessica Marie,59,0,59,0
1748430000912,BILD 1,C03,959739,Rusert; Jessica Marie,49,0,59,10
1748430000912,BILD 1,C04,959740,Rusert; Jessica Marie,55,0,59,4
1748430001943,BILD 2,A01,959013,Reyes Gonzalez; Catalina,28,0,57,29
1748430001943,BILD 2,A02,959016,Reyes Gonzalez; Catalina,51,0,57,6
1748430001943,BILD 2,A03,959017,Reyes Gonzalez; Catalina,46,0,56,10
1748430001943,BILD 2,A04,959018,Reyes Gonzalez; Catalina,51,0,55,4
1748430001943,BILD 2,B01,959078,Reyes Gonzalez; Catalina,42,0,57,15
1748430001943,BILD 2,B02,959095,Reyes Gonzalez; Catalina,50,0,57,7
1748430001943,BILD 2,B03,959165,Reyes Gonzalez; Catalina,55,0,56,1
1748430001943,BILD 2,B04,959169,Reyes Gonzalez; Catalina,54,0,55,1
1748430002984,BILD 3,A01,959741,Stockwell; Sarah R,56,0,60,4
1748430002984,BILD 3,A02,959742,Stockwell; Sarah R,57,0,59,2
1748430002984,BILD 3,A03,959743,Stockwell; Sarah R,59,0,59,0
1748430002984,BILD 3,A04,959744,Stockwell; Sarah R,55,0,59,4
1748430002984,BILD 3,B01,959745,Stockwell; Sarah R,55,0,60,5
1748430002984,BILD 3,B02,959746,Stockwell; Sarah R,59,0,59,0
1748430002984,BILD 3,B03,959747,Stockwell; Sarah R,56,0,59,3
1748430002984,BILD 3,B04,959748,Stockwell; Sarah R,58,0,59,1
1748430002984,BILD 3,C01,959823,Hammond; LaTisha Marie,47,0,60,13
1748430002984,BILD 3,C02,959824,Hammond; LaTisha Marie,47,0,59,12
1748430002984,BILD 3,C03,959825,Hammond; LaTisha Marie,56,0,59,3
1748430002984,BILD 3,C04,959826,Hammond; LaTisha Marie,58,0,59,1
1748430002984,BILD 3,D01,959827,Hammond; LaTisha Marie,43,0,60,17
1748430002984,BILD 3,D02,959828,Hammond; LaTisha Marie,49,0,59,10
1748430002984,BILD 3,D03,959829,Hammond; LaTisha Marie,52,0,59,7
1748430002984,BILD 3,D04,959830,Hammond; LaTisha Marie,56,0,59,3
1748430004024,BILD 4,A01,940749,Gonzalez Gamboa; Ivonne,0,0,0,0
1748430004024,BILD 4,A02,940750,Gonzalez Gamboa; Ivonne,0,0,0,0
1748430004024,BILD 4,A03,940909,Gonzalez Gamboa; Ivonne,0,0,0,0
1748430004024,BILD 4,A04,940922,Gonzalez Gamboa; Ivonne,0,0,0,0
1748430004024,BILD 4,A05,940925,Gonzalez Gamboa; Ivonne,0,0,0,0
1748430004024,BILD 4,A06,941008,Gonzalez Gamboa; Ivonne,0,0,0,0
1748430004024,BILD 4,A07,941009,Gonzalez Gamboa; Ivonne,0,0,0,0
1748430004024,BILD 4,A08,941114,Gonzalez Gamboa; Ivonne,0,0,0,0
1748430004024,BILD 4,B01,941116,Reuther; Keefe,0,0,0,0
1748430004024,BILD 4,B02,941119,Reuther; Keefe,0,0,0,0
1748430004024,BILD 4,B03,941120,Reuther; Keefe,0,0,0,0
1748430004024,BILD 4,B04,941143,Reuther; Keefe,0,0,0,0
1748430004024,BILD 4,B05,941182,Reuther; Keefe,0,0,0,0
1748430004024,BILD 4,B06,941183,Reuther; Keefe,0,0,0,0
1748430004024,BILD 4,B07,941184,Reuther; Keefe,0,0,0,0
1748430004024,BILD 4,B08,941202,Reuther; Keefe,0,0,0,0
1748430004024,BILD 4,C01,941209,Lo; Stanley M.,0,0,0,0
1748430004024,BILD 4,C02,941226,Lo; Stanley M.,0,0,0,0
1748430004024,BILD 4,C03,941228,Lo; Stanley M.,0,0,0,0
1748430004024,BILD 4,C04,941284,Lo; Stanley M.,0,0,0,0
1748430004024,BILD 4,C05,941394,Lo; Stanley M.,0,0,0,0
1748430004024,BILD 4,C06,941473,Lo; Stanley M.,0,0,0,0
1748430004024,BILD 4,C07,941905,Lo; Stanley M.,0,0,0,0
1748430004024,BILD 4,C08,941906,Lo; Stanley M.,0,0,0,0
1748430004024,BILD 4,D01,941908,Lo; Stanley M.,0,0,0,0
1748430004024,BILD 4,D02,941925,Lo; Stanley M.,0,0,0,0
1748430004024,BILD 4,D03,941926,Lo; Stanley M.,0,0,0,0
1748430004024,BILD 4,D04,941927,Lo; Stanley M.,0,0,0,0
1748430004024,BILD 4,D05,941928,Lo; Stanley M.,0,0,0,0
1748430004024,BILD 4,D06,941943,Lo; Stanley M.,0,0,0,0
1748430004024,BILD 4,D07,941944,Lo; Stanley M.,0,0,0,0
1748430004024,BILD 4,D08,941973,Lo; Stanley M.,0,0,0,0
1748430005053,BILD 5,A01,959177,Mueller; Liam O'Connor,0,0,0,0
1748430005053,BILD 5,A02,959178,Mueller; Liam O'Connor,0,0,0,0
1748430005053,BILD 5,A03,959179,Mueller; Liam O'Connor,0,0,0,0
1748430005053,BILD 5,A04,959181,Mueller; Liam O'Connor,0,0,0,0
1748430005053,BILD 5,B01,959183,Mueller; Liam O'Connor,0,0,0,0
1748430005053,BILD 5,B02,959184,Mueller; Liam O'Connor,0,0,0,0
1748430005053,BILD 5,B03,959188,Mueller; Liam O'Connor,0,0,0,0
1748430005053,BILD 5,B04,959189,Mueller; Liam O'Connor,0,0,0,0
1748430005053,BILD 5,C01,959190,Reuther; Keefe,0,0,0,0
1748430005053,BILD 5,C02,959191,Reuther; Keefe,0,0,0,0
1748430005053,BILD 5,C03,959196,Reuther; Keefe,0,0,0,0
1748430005053,BILD 5,C04,959199,Reuther; Keefe,0,0,0,0
1748430006078,BILD 10,A01,942020,Ochoa Mikrut; Stacy Daniel,40,0,40,0
1748430006078,BILD 10,A02,942033,Ochoa Mikrut; Stacy Daniel,35,0,39,4
1748430006078,BILD 10,A03,942045,Ochoa Mikrut; Stacy Daniel,32,0,39,7
1748430006078,BILD 10,A04,942046,Ochoa Mikrut; Stacy Daniel,30,0,39,9
1748430007108,BILD 87,A00,942047,Saier; Milton H.,20,0,20,0
1748430007108,BILD 87,B00,942060,Saier; Milton H.,20,0,20,0
1748430008139,BIMM 100,A01,959797,Lykke-Andersen; Jens,37,0,50,13
1748430008139,BIMM 100,A02,959798,Lykke-Andersen; Jens,5,0,50,45
1748430008139,BIMM 100,A03,959799,Lykke-Andersen; Jens,0,0,50,50
1748430008139,BIMM 100,A04,959800,Lykke-Andersen; Jens,3,0,50,47
1748430008139,BIMM 100,B01,959807,Pruneda-Paz; Jose L.,1,0,50,49
1748430008139,BIMM 100,B02,959808,Pruneda-Paz; Jose L.,0,0,50,50
1748430008139,BIMM 100,B03,959809,Pruneda-Paz; Jose L.,7,0,50,43
1748430008139,BIMM 100,B04,959810,Pruneda-Paz; Jose L.,37,0,50,13
1748430008139,BIMM 100,C01,959762,Pasquinelli; Amy,0,0,54,54
1748430008139,BIMM 100,C02,959763,Pasquinelli; Amy,20,0,54,34
1748430008139,BIMM 100,C03,959764,Pasquinelli; Amy,32,0,54,22
1748430008139,BIMM 100,C04,959765,Pasquinelli; Amy,47,0,54,7
1748430009167,BIMM 101,A01,942520,Meaders; Clara Leigh,0,0,24,24
1748430009167,BIMM 101,A02,942521,Meaders; Clara Leigh,0,0,24,24
1748430009167,BIMM 101,B01,942523,Meaders; Clara Leigh,0,0,24,24
1748430009167,BIMM 101,B02,942524,Meaders; Clara Leigh,0,0,24,24
1748430009167,BIMM 101,C01,942690,McDonnell; Lisa Marie,0,0,24,24
1748430009167,BIMM 101,C02,942755,McDonnell; Lisa Marie,0,0,24,24
1748430009167,BIMM 101,D01,942757,Day; Christopher D,0,0,24,24
1748430009167,BIMM 101,D02,942758,Day; Christopher D,11,0,24,13
1748430009167,BIMM 101,E01,942760,Cooper; Andrew Michael,0,0,24,24
1748430009167,BIMM 101,E02,942761,Cooper; Andrew Michael,0,0,24,24
1748430009167,BIMM 101,F01,942763,Rusert; Jessica Marie,14,0,24,10
1748430009167,BIMM 101,F02,942764,Rusert; Jessica Marie,19,0,24,5
1748430010197,BIMM 120,A01,942766,Saier; Milton H.,40,0,48,8
1748430010197,BIMM 120,A02,942767,Saier; Milton H.,40,0,48,8
1748430010197,BIMM 120,A03,942768,Saier; Milton H.,15,0,48,33
1748430010197,BIMM 120,A04,942769,Saier; Milton H.,0,0,48,48
1748430011230,BIMM 121,A01,942771,Gustafson-Brown; Cindy,0,0,24,24
1748430011230,BIMM 121,A02,942772,Gustafson-Brown; Cindy,0,0,24,24
1748430011230,BIMM 121,B01,942774,Gustafson-Brown; Cindy,0,0,24,24
1748430011230,BIMM 121,B02,942775,Gustafson-Brown; Cindy,5,0,24,19
1748430011230,BIMM 121,C01,942777,Pirino; Giorgia,0,0,24,24
1748430011230,BIMM 121,C02,942778,Pirino; Giorgia,0,0,24,24
1748430011230,BIMM 121,D01,942780,Pirino; Giorgia,0,0,24,24
1748430011230,BIMM 121,D02,942781,Pirino; Giorgia,0,0,24,24
1748430012262,BIMM 122,A01,942783,Russell; Alistair B,19,0,44,25
1748430012262,BIMM 122,A02,942784,Russell; Alistair B,29,0,44,15
1748430012262,BIMM 122,A03,942785,Russell; Alistair B,35,0,44,9
1748430012262,BIMM 122,A04,942786,Russell; Alistair B,30,0,44,14
1748430013294,BIMM 128,A01,942788,Hao; Nan,0,0,30,30
1748430013294,BIMM 128,A02,942789,Hao; Nan,0,0,31,31
1748430013294,BIMM 128,A03,942790,Hao; Nan,0,0,31,31
1748430013294,BIMM 128,A04,942791,Hao; Nan,0,0,31,31
1748430014326,BIMM 143,A01,942793,Grant; Barry J,13,0,40,27
1748430014326,BIMM 143,B01,942795,Bozinovic; Goran,21,0,40,19
1748430015355,BIMM 143R,A01,942797,Bozinovic; Goran,0,0,40,40
1748430016382,BIMM 194,A00,942798,Golden; Susan S.,4,0,32,28
1748430016382,BIMM 194,B00,942799,Golden; James W,21,0,32,11
1748430016382,BIMM 194,C00,942800,Karlseder; Jan & Saghatelian; Alan,0,0,32,32
1748430017411,BIOM 200A,A00,911746,Gordts; Philip,30,0,30,0
1748430018438,BIOM 200B,A00,911747,Gordts; Philip,35,0,35,0
1748430019468,BIOM 201,A00,911749,Daneman; Richard,35,0,35,0
1748430020496,BIOM 202,A01,911753,Corbett; Kevin Daniel,35,0,35,0
1748430021522,BIOM 203A,A00,911755,Corbett; Kevin Daniel,35,0,35,0
1748430022554,BIOM 218,A00,911756,Gagneux; Pascal,11,0,12,1
1748430023581,BIOM 219,A00,911757,Ross; Camille,20,0,20,0
1748430024630,BIOM 242,A00,911758,Hamilton; Bruce Alan,19,0,20,1
1748430025659,BIOM 293,A00,911759,Gustafsson; Asa Birgitta,35,0,35,0
1748430026688,BIOM 295,A00,911760,Joiner; William J.,0,0,0,0
1748430027716,BIOM 296,A00,911761,Yaksh; Tony L.,35,0,35,0
1748430028749,BIPN 100,A01,959801,Leutgeb; Stefan,0,0,36,36
1748430028749,BIPN 100,A02,959802,Leutgeb; Stefan,0,0,36,36
1748430028749,BIPN 100,A03,959803,Leutgeb; Stefan,3,0,36,33
1748430028749,BIPN 100,A04,959804,Leutgeb; Stefan,0,0,36,36
1748430028749,BIPN 100,B01,959766,Cooke; James Edward,33,0,41,8
1748430028749,BIPN 100,B02,959767,Cooke; James Edward,39,0,41,2
1748430028749,BIPN 100,B03,959768,Cooke; James Edward,37,0,40,3
1748430028749,BIPN 100,B04,959769,Cooke; James Edward,37,0,40,3
1748430028749,BIPN 100,C01,959770,Cooke; James Edward,35,0,41,6
1748430028749,BIPN 100,C02,959771,Cooke; James Edward,40,0,41,1
1748430028749,BIPN 100,C03,959772,Cooke; James Edward,37,0,40,3
1748430028749,BIPN 100,C04,959773,Cooke; James Edward,38,0,40,2
1748430028749,BIPN 100,D01,959811,Yang; Mingyu,0,0,41,41
1748430028749,BIPN 100,D02,959812,Yang; Mingyu,0,0,41,41
1748430028749,BIPN 100,D03,959813,Yang; Mingyu,0,0,40,40
1748430028749,BIPN 100,D04,959814,Yang; Mingyu,0,0,40,40
1748430029776,BIPN 103,A01,942981,Yang; Mingyu,0,0,48,48
1748430030803,BIPN 105,A01,942983,Armour; Jon Christopher,0,0,21,21
1748430030803,BIPN 105,A02,942984,Armour; Jon Christopher,0,0,21,21
1748430030803,BIPN 105,B01,942989,Armour; Jon Christopher,0,0,21,21
1748430030803,BIPN 105,B02,942990,Armour; Jon Christopher,0,0,21,21
1748430031830,BIPN 118,A01,960886,Banghart; Matthew Ryan,23,0,30,7
1748430031830,BIPN 118,A02,960889,Banghart; Matthew Ryan,24,0,30,6
1748430031830,BIPN 118,A03,960891,Banghart; Matthew Ryan,23,0,30,7
1748430031830,BIPN 118,A04,960892,Banghart; Matthew Ryan,27,0,30,3
1748430032857,BIPN 140,A01,942992,Owens; Melinda Tsao-Ying,8,0,32,24
1748430032857,BIPN 140,A02,942994,Owens; Melinda Tsao-Ying,0,0,32,32
1748430032857,BIPN 140,A03,942995,Owens; Melinda Tsao-Ying,1,0,32,31
1748430032857,BIPN 140,A04,942996,Owens; Melinda Tsao-Ying,9,0,30,21
1748430032857,BIPN 140,B01,942998,Owens; Melinda Tsao-Ying,4,0,32,28
1748430032857,BIPN 140,B02,942999,Owens; Melinda Tsao-Ying,3,0,32,29
1748430032857,BIPN 140,B03,943000,Owens; Melinda Tsao-Ying,18,0,32,14
1748430032857,BIPN 140,B04,943001,Owens; Melinda Tsao-Ying,23,0,30,7
1748430033885,BIPN 145,A01,943083,Maita; Isabella Vincenza,0,0,42,42
1748430033885,BIPN 145,B01,943085,Marino; Marc J,13,0,42,29
1748430033885,BIPN 145,C01,943108,Marino; Marc J,0,0,42,42
1748430034911,BIPN 148,A01,943119,Leutgeb; Jill K.,15,0,39,24
1748430034911,BIPN 148,A02,943120,Leutgeb; Jill K.,16,0,39,23
1748430034911,BIPN 148,A03,943121,Leutgeb; Jill K.,33,0,39,6
1748430034911,BIPN 148,A04,943201,Leutgeb; Jill K.,27,0,39,12
1748430035939,BIPN 189,A00,943247,Gentner; Tim,0,0,25,25
1748430036966,BISP 182,A00,943255,Pogliano; Joseph,9999,0,9999,0
1748430037995,BISP 194,A00,943261,Wertheim; Joel Okrent,0,0,32,32
1748430039022,BNFO 281,A00,961454,Gaasterland; Theresa,13,0,40,27
1748430040048,BNFO 283,A00,961457,Benner; Christopher William,69,0,100,31
1748430041077,BNFO 294,A01,961499,Ross; Camille,39,0,50,11
1748430042136,CAT 1,A01,915666,Bronstein; Phoebe Malan,13,0,16,3
1748430042136,CAT 1,A02,915673,Bronstein; Phoebe Malan,15,0,16,1
1748430042136,CAT 1,A03,915727,Bronstein; Phoebe Malan,16,0,16,0
1748430042136,CAT 1,A04,915728,Bronstein; Phoebe Malan,16,0,16,0
1748430042136,CAT 1,A05,915729,Bronstein; Phoebe Malan,16,0,16,0
1748430042136,CAT 1,A06,915730,Bronstein; Phoebe Malan,13,0,16,3
1748430042136,CAT 1,A07,915731,Bronstein; Phoebe Malan,16,0,16,0
1748430042136,CAT 1,A08,915732,Bronstein; Phoebe Malan,16,0,16,0
1748430042136,CAT 1,A09,915733,Bronstein; Phoebe Malan,14,0,16,2
1748430042136,CAT 1,A10,915734,Bronstein; Phoebe Malan,16,0,16,0
1748430042136,CAT 1,A11,915751,Bronstein; Phoebe Malan,16,0,16,0
1748430042136,CAT 1,A12,915752,Bronstein; Phoebe Malan,15,0,16,1
1748430042136,CAT 1,A13,915753,Bronstein; Phoebe Malan,15,0,16,1
1748430042136,CAT 1,A14,915754,Bronstein; Phoebe Malan,16,0,16,0
1748430042136,CAT 1,A15,915755,Bronstein; Phoebe Malan,16,0,16,0
1748430042136,CAT 1,A16,915756,Bronstein; Phoebe Malan,16,0,16,0
1748430042136,CAT 1,B01,915763,Bronstein; Phoebe Malan,15,0,16,1
1748430042136,CAT 1,B02,915764,Bronstein; Phoebe Malan,15,0,16,1
1748430042136,CAT 1,B03,915765,Bronstein; Phoebe Malan,14,0,16,2
1748430042136,CAT 1,B04,915766,Bronstein; Phoebe Malan,16,0,16,0
1748430042136,CAT 1,B05,915767,Bronstein; Phoebe Malan,12,0,16,4
1748430042136,CAT 1,B06,915768,Bronstein; Phoebe Malan,16,0,16,0
1748430042136,CAT 1,B07,915769,Bronstein; Phoebe Malan,16,0,16,0
1748430042136,CAT 1,B08,915770,Bronstein; Phoebe Malan,16,0,16,0
1748430042136,CAT 1,B09,915771,Bronstein; Phoebe Malan,16,0,16,0
1748430042136,CAT 1,B10,915772,Bronstein; Phoebe Malan,16,0,16,0
1748430042136,CAT 1,B11,915773,Bronstein; Phoebe Malan,16,0,16,0
1748430042136,CAT 1,B12,915774,Bronstein; Phoebe Malan,15,0,16,1
1748430042136,CAT 1,B13,915775,Bronstein; Phoebe Malan,16,0,16,0
1748430042136,CAT 1,B14,915776,Bronstein; Phoebe Malan,15,0,16,1
1748430042136,CAT 1,B15,915777,Bronstein; Phoebe Malan,14,0,16,2
1748430042136,CAT 1,B16,915778,Bronstein; Phoebe Malan,16,0,16,0
1748430042136,CAT 1,C01,915780,Algaze; Guillermo,11,0,16,5
1748430042136,CAT 1,C02,915781,Algaze; Guillermo,16,0,16,0
1748430042136,CAT 1,C03,915782,Algaze; Guillermo,15,0,16,1
1748430042136,CAT 1,C04,915783,Algaze; Guillermo,16,0,16,0
1748430042136,CAT 1,C05,915784,Algaze; Guillermo,16,0,16,0
1748430042136,CAT 1,C06,915785,Algaze; Guillermo,16,0,16,0
1748430042136,CAT 1,C07,915786,Algaze; Guillermo,16,0,16,0
1748430042136,CAT 1,C08,915787,Algaze; Guillermo,15,0,16,1
1748430042136,CAT 1,C09,915788,Algaze; Guillermo,16,0,16,0
1748430042136,CAT 1,C10,915790,Algaze; Guillermo,16,0,16,0
1748430042136,CAT 1,C11,915791,Algaze; Guillermo,16,0,16,0
1748430042136,CAT 1,C12,915792,Algaze; Guillermo,16,0,16,0
1748430042136,CAT 1,C13,915793,Algaze; Guillermo,16,0,16,0
1748430042136,CAT 1,C14,915794,Algaze; Guillermo,16,0,16,0
1748430042136,CAT 1,D01,915796,Marchisotto; Jennifer Anne,16,0,16,0
1748430042136,CAT 1,D02,915797,Marchisotto; Jennifer Anne,15,0,16,1
1748430042136,CAT 1,D03,915798,Marchisotto; Jennifer Anne,16,0,16,0
1748430042136,CAT 1,D04,915799,Marchisotto; Jennifer Anne,12,0,16,4
1748430042136,CAT 1,D05,915800,Marchisotto; Jennifer Anne,16,0,16,0
1748430042136,CAT 1,D06,915801,Marchisotto; Jennifer Anne,16,0,16,0
1748430042136,CAT 1,D07,915802,Marchisotto; Jennifer Anne,15,0,16,1
1748430042136,CAT 1,D08,915803,Marchisotto; Jennifer Anne,16,0,16,0
1748430042136,CAT 1,D09,915804,Marchisotto; Jennifer Anne,16,0,16,0
1748430042136,CAT 1,D10,915805,Marchisotto; Jennifer Anne,16,0,16,0
1748430042136,CAT 1,D11,915806,Marchisotto; Jennifer Anne,15,0,16,1
1748430042136,CAT 1,D12,915807,Marchisotto; Jennifer Anne,16,0,16,0
1748430042136,CAT 1,D13,915808,Marchisotto; Jennifer Anne,15,0,16,1
1748430042136,CAT 1,D14,915809,Marchisotto; Jennifer Anne,15,0,16,1
1748430043166,CAT 88,A00,969796,Popko; Elizabeth Ashley,0,0,0,0
1748430044192,CAT 90,A00,915812,Geibel; William,7,0,15,8
1748430045223,CAT 124,A01,915814,Rose; Becca Rae,0,0,20,20
1748430045223,CAT 124,B01,961453,Geibel; William,14,0,20,6
1748430046251,CAT 125,001,915815,Delaville; Romain,18,0,20,2
1748430046251,CAT 125,003,915817,Bigham; David Joseph,12,0,20,8
1748430046251,CAT 125,004,915818,Bigham; David Joseph,3,0,20,17
1748430046251,CAT 125,005,915819,Marchisotto; Jennifer Anne,11,0,20,9
1748430046251,CAT 125,006,915820,Marchisotto; Jennifer Anne,0,0,20,20
1748430046251,CAT 125,007,915821,Morales; Celeste Georgianna,12,0,20,8
1748430046251,CAT 125,008,915822,Morales; Celeste Georgianna,15,0,20,5
1748430046251,CAT 125,009,915823,Morales; Celeste Georgianna,18,0,20,2
1748430046251,CAT 125,010,915824,Irwin; Matthew Joseph,18,0,20,2
1748430046251,CAT 125,011,915825,Irwin; Matthew Joseph,15,0,20,5
1748430046251,CAT 125,012,915826,Irwin; Matthew Joseph,15,0,20,5
1748430046251,CAT 125,013,915827,Vanderschuit; Maya Alysia,16,0,20,4
1748430046251,CAT 125,014,915828,Vanderschuit; Maya Alysia,18,0,20,2
1748430046251,CAT 125,015,915829,Vanderschuit; Maya Alysia,15,0,20,5
1748430046251,CAT 125,016,915830,Rose; Becca Rae,5,0,20,15
1748430046251,CAT 125,017,915831,Rose; Becca Rae,4,0,20,16
1748430046251,CAT 125,018,915832,Hyland; Tina Mae,13,0,20,7
1748430046251,CAT 125,019,915833,Hyland; Tina Mae,17,0,20,3
1748430047277,CAT 125R,A00,915834,Hyland; Tina Mae,0,0,20,20
1748430047277,CAT 125R,B00,915835,Hyland; Tina Mae,0,0,20,20
1748430047277,CAT 125R,C00,915836,Hyland; Tina Mae,0,0,20,20
1748430047277,CAT 125R,D00,915837,Tosun; Adriana,0,0,20,20
1748430047277,CAT 125R,E00,915838,Smith; Lauryn Alissa,0,0,20,20
1748430047277,CAT 125R,F00,915839,Smith; Lauryn Alissa,0,0,20,20
1748430047277,CAT 125R,G00,915840,Smith; Lauryn Alissa,0,0,20,20
1748430048303,CAT 200,A00,915841,Popko; Elizabeth Ashley,17,0,20,3
1748430049335,CCE 1,A00,915063,Bigley; Michele Heather,30,0,40,10
1748430049335,CCE 1,B00,915064,Bigley; Michele Heather,36,0,40,4
1748430050367,CCE 2,001,915067,Santos; Vabianna Daria,0,0,20,20
1748430050367,CCE 2,002,915068,Santos; Vabianna Daria,0,0,20,20
1748430050367,CCE 2,003,915069,Santos; Vabianna Daria,18,0,20,2
1748430050367,CCE 2,004,915070,Staff,17,0,20,3
1748430050367,CCE 2,005,915071,Staff,15,0,20,5
1748430050367,CCE 2,006,915072,Staff,8,0,20,12
1748430050367,CCE 2,007,915073,Staff,10,0,20,10
1748430050367,CCE 2,008,915074,Staff,0,0,20,20
1748430050367,CCE 2,009,915090,Staff,5,0,20,15
1748430050367,CCE 2,010,915104,Merryman; Ashley,0,0,20,20
1748430050367,CCE 2,011,915114,Merryman; Ashley,0,0,20,20
1748430050367,CCE 2,012,915136,Merryman; Ashley,0,0,20,20
1748430050367,CCE 2,013,915176,Staff,13,0,20,7
1748430050367,CCE 2,014,915177,Staff,20,0,20,0
1748430050367,CCE 2,015,915178,Staff,17,0,20,3
1748430050367,CCE 2,016,915179,Staff,15,0,20,5
1748430051397,CCE 3,001,915194,Labat Ii; Michael Luis,13,0,20,7
1748430051397,CCE 3,002,915195,Labat Ii; Michael Luis,17,0,20,3
1748430051397,CCE 3,003,915196,Labat Ii; Michael Luis,17,0,20,3
1748430051397,CCE 3,004,915197,Lee; Kassandra,16,0,20,4
1748430051397,CCE 3,005,915198,Lee; Kassandra,6,0,20,14
1748430051397,CCE 3,006,915199,Lee; Kassandra,10,0,20,10
1748430051397,CCE 3,007,915200,Garcia; Kathryn Mary,0,0,20,20
1748430051397,CCE 3,008,915201,Garcia; Kathryn Mary,2,0,20,18
1748430052439,CCE 120,A01,915203,Quijada; David,26,0,30,4
1748430052439,CCE 120,B01,915205,Quijada; David,17,0,30,13
1748430052439,CCE 120,C01,915207,Williams; Danielle,21,0,30,9
1748430052439,CCE 120,D01,915275,Crawford; James,26,0,30,4
1748430052439,CCE 120,E01,915323,Kenley; Nicole,0,0,30,30
1748430052439,CCE 120,F01,915325,Kenley; Nicole,5,0,30,25
1748430053469,CENG 4,A01,913054,Li; Yanran,35,0,36,1
1748430053469,CENG 4,A02,913055,Li; Yanran,36,0,36,0
1748430053469,CENG 4,A03,913058,Li; Yanran,36,0,36,0
1748430053469,CENG 4,A04,913060,Li; Yanran,36,0,36,0
1748430054498,CENG 15,A01,913087,Lubarda; Vlado,69,0,70,1
1748430055524,CENG 100,A00,913088,Powell; Alyssa,108,0,120,12
1748430056552,CENG 101A,A00,913089,Opatkiewicz; Justin Paul,107,0,146,39
1748430057579,CENG 110,A01,913091,Powell; Alyssa,15,0,24,9
1748430058609,CENG 120,A00,913092,Opatkiewicz; Justin Paul,96,0,146,50
1748430059641,CENG 122,A00,913093,Li; Wan-Lu,120,0,140,20
1748430060672,CENG 170,A01,913196,Drews; Aaron,7,0,25,18
1748430060672,CENG 170,A02,913202,Drews; Aaron,4,0,25,21
1748430060672,CENG 170,A03,913204,Drews; Aaron,5,0,30,25
1748430061696,CENG 175,A00,913205,Steinmetz; Nicole F,14,0,35,21
1748430062723,CENG 205,A00,913207,Jahed Motlagh; Zeinab,54,0,70,16
1748430063751,CENG 210A,A00,913209,Shah; Nisarg,50,0,50,0
1748430064785,CENG 211,A00,913211,Sirbuly; Donald,23,0,25,2
1748430065813,CENG 213,A00,913213,Fenning; David,25,0,25,0
1748430066839,CENG 221A,A00,913214,Liu; Ping,38,0,50,12
1748430067872,CENG 252,A00,913215,Chen; Zheng,42,0,50,8
1748430068957,CGS 2A,A01,915347,Martin Sandino; Amanda Maria Yoland,11,0,15,4
1748430068957,CGS 2A,A02,915348,Martin Sandino; Amanda Maria Yoland,12,0,15,3
1748430068957,CGS 2A,A03,915375,Martin Sandino; Amanda Maria Yoland,11,0,15,4
1748430068957,CGS 2A,A04,915376,Martin Sandino; Amanda Maria Yoland,15,0,15,0
1748430069985,CGS 100A,A00,915379,Perez; Roy,16,0,31,15
1748430071014,CGS 109,A00,915458,Cuong; Marisol,36,0,40,4
1748430072042,CGS 110,A00,915463,Cuong; Marisol,27,0,30,3
1748430073070,CGS 113,A00,915465,Martin Sandino; Amanda Maria Yoland,8,0,16,8
1748430074100,CGS 134,A00,915498,Chatti; Deepti,17,0,32,15
1748430075127,CGS 150,A00,915508,Taylor-Garcia; Daphne,13,0,16,3
1748430076157,CGS 187,A00,915515,Martin Sandino; Amanda Maria Yoland,13,0,16,3
1748430077184,CGS 190,A00,915516,Taylor-Garcia; Daphne,7,0,7,0
1748430078212,CGS 208,A00,915517,Kang; Byung Chu,1,0,1,0
1748430079253,CHEM 4,A01,958051,Brydges; Stacey,39,0,40,1
1748430079253,CHEM 4,A02,958052,Brydges; Stacey,38,0,40,2
1748430079253,CHEM 4,A03,958053,Brydges; Stacey,37,0,40,3
1748430079253,CHEM 4,A04,958054,Brydges; Stacey,39,0,40,1
1748430079253,CHEM 4,A05,958055,Brydges; Stacey,40,0,40,0
1748430079253,CHEM 4,A06,958056,Brydges; Stacey,38,0,40,2
1748430079253,CHEM 4,A07,958057,Brydges; Stacey,40,0,40,0
1748430079253,CHEM 4,A08,958058,Brydges; Stacey,40,0,40,0
1748430079253,CHEM 4,B01,958059,Brydges; Stacey,40,0,40,0
1748430079253,CHEM 4,B02,958060,Brydges; Stacey,40,0,40,0
1748430079253,CHEM 4,B03,958061,Brydges; Stacey,40,0,40,0
1748430079253,CHEM 4,B04,958062,Brydges; Stacey,36,0,40,4
1748430079253,CHEM 4,B05,958063,Brydges; Stacey,38,0,40,2
1748430079253,CHEM 4,B06,958064,Brydges; Stacey,39,0,40,1
1748430079253,CHEM 4,B07,958065,Brydges; Stacey,40,0,40,0
1748430079253,CHEM 4,B08,958066,Brydges; Stacey,40,0,40,0
1748430080291,CHEM 6A,A01,958094,Stallings; Dontarie M,5,0,8,3
1748430080291,CHEM 6A,A02,958095,Stallings; Dontarie M,4,0,8,4
1748430080291,CHEM 6A,A03,958096,Stallings; Dontarie M,7,0,8,1
1748430080291,CHEM 6A,A04,958097,Stallings; Dontarie M,8,0,8,0
1748430080291,CHEM 6A,A05,958098,Stallings; Dontarie M,8,0,8,0
1748430080291,CHEM 6A,A06,958099,Stallings; Dontarie M,8,0,8,0
1748430080291,CHEM 6A,A07,958100,Stallings; Dontarie M,8,0,8,0
1748430080291,CHEM 6A,A08,958101,Stallings; Dontarie M,8,0,8,0
1748430080291,CHEM 6A,A09,958102,Stallings; Dontarie M,0,0,0,0
1748430080291,CHEM 6A,B01,958136,Stallings; Dontarie M,0,0,8,8
1748430080291,CHEM 6A,B02,958137,Stallings; Dontarie M,5,0,8,3
1748430080291,CHEM 6A,B03,958138,Stallings; Dontarie M,8,0,8,0
1748430080291,CHEM 6A,B04,958139,Stallings; Dontarie M,7,0,8,1
1748430080291,CHEM 6A,B05,958140,Stallings; Dontarie M,0,0,8,8
1748430080291,CHEM 6A,B06,958141,Stallings; Dontarie M,3,0,8,5
1748430080291,CHEM 6A,B07,958143,Stallings; Dontarie M,2,0,8,6
1748430080291,CHEM 6A,B08,958144,Stallings; Dontarie M,8,0,8,0
1748430080291,CHEM 6A,B09,958145,Stallings; Dontarie M,0,0,0,0
1748430080291,CHEM 6A,C01,958146,Schurmeier; Kimberly,6,0,8,2
1748430080291,CHEM 6A,C02,958147,Schurmeier; Kimberly,7,0,8,1
1748430080291,CHEM 6A,C03,958148,Schurmeier; Kimberly,8,0,8,0
1748430080291,CHEM 6A,C04,958149,Schurmeier; Kimberly,8,0,8,0
1748430080291,CHEM 6A,C05,958150,Schurmeier; Kimberly,8,0,8,0
1748430080291,CHEM 6A,C06,958151,Schurmeier; Kimberly,6,0,8,2
1748430080291,CHEM 6A,C07,958152,Schurmeier; Kimberly,8,0,8,0
1748430080291,CHEM 6A,C08,958153,Schurmeier; Kimberly,7,0,8,1
1748430080291,CHEM 6A,C09,958154,Schurmeier; Kimberly,0,0,0,0
1748430080291,CHEM 6A,D01,958155,Schurmeier; Kimberly,3,0,8,5
1748430080291,CHEM 6A,D02,958156,Schurmeier; Kimberly,3,0,8,5
1748430080291,CHEM 6A,D03,958157,Schurmeier; Kimberly,4,0,8,4
1748430080291,CHEM 6A,D04,958158,Schurmeier; Kimberly,6,0,8,2
1748430080291,CHEM 6A,D05,958159,Schurmeier; Kimberly,7,0,8,1
1748430080291,CHEM 6A,D06,958160,Schurmeier; Kimberly,7,0,8,1
1748430080291,CHEM 6A,D07,958161,Schurmeier; Kimberly,8,0,8,0
1748430080291,CHEM 6A,D08,958162,Schurmeier; Kimberly,8,0,8,0
1748430080291,CHEM 6A,D09,958195,Schurmeier; Kimberly,0,0,0,0
1748430080291,CHEM 6A,E01,958203,Zid; Brian M,0,0,8,8
1748430080291,CHEM 6A,E02,958206,Zid; Brian M,6,0,8,2
1748430080291,CHEM 6A,E03,958207,Zid; Brian M,7,0,8,1
1748430080291,CHEM 6A,E04,958350,Zid; Brian M,8,0,8,0
1748430080291,CHEM 6A,E05,958361,Zid; Brian M,7,0,8,1
1748430080291,CHEM 6A,E06,958373,Zid; Brian M,2,0,8,6
1748430080291,CHEM 6A,E07,958394,Zid; Brian M,7,0,8,1
1748430080291,CHEM 6A,E08,958395,Zid; Brian M,1,0,8,7
1748430080291,CHEM 6A,E09,958396,Zid; Brian M,0,0,0,0
1748430080291,CHEM 6A,F01,958397,Ortony; Julia Helen,8,0,8,0
1748430080291,CHEM 6A,F02,958407,Ortony; Julia Helen,0,0,8,8
1748430080291,CHEM 6A,F03,958409,Ortony; Julia Helen,2,0,8,6
1748430080291,CHEM 6A,F04,958417,Ortony; Julia Helen,6,0,8,2
1748430080291,CHEM 6A,F05,958422,Ortony; Julia Helen,8,0,8,0
1748430080291,CHEM 6A,F06,958425,Ortony; Julia Helen,8,0,8,0
1748430080291,CHEM 6A,F07,958428,Ortony; Julia Helen,7,0,8,1
1748430080291,CHEM 6A,F08,958442,Ortony; Julia Helen,8,0,8,0
1748430080291,CHEM 6A,F09,958488,Ortony; Julia Helen,0,0,0,0
1748430080291,CHEM 6A,G01,958489,Ortony; Julia Helen,7,0,8,1
1748430080291,CHEM 6A,G02,958490,Ortony; Julia Helen,8,0,8,0
1748430080291,CHEM 6A,G03,958491,Ortony; Julia Helen,3,0,8,5
1748430080291,CHEM 6A,G04,958499,Ortony; Julia Helen,2,0,8,6
1748430080291,CHEM 6A,G05,958500,Ortony; Julia Helen,4,0,8,4
1748430080291,CHEM 6A,G06,958501,Ortony; Julia Helen,8,0,8,0
1748430080291,CHEM 6A,G07,958502,Ortony; Julia Helen,8,0,8,0
1748430080291,CHEM 6A,G08,958636,Ortony; Julia Helen,8,0,8,0
1748430080291,CHEM 6A,G09,958637,Ortony; Julia Helen,0,0,0,0
1748430081325,CHEM 6B,A01,958638,Bussey; Thomas J,15,0,22,7
1748430081325,CHEM 6B,A02,958641,Bussey; Thomas J,0,0,22,22
1748430081325,CHEM 6B,A03,958646,Bussey; Thomas J,0,0,22,22
1748430081325,CHEM 6B,A04,958648,Bussey; Thomas J,11,0,22,11
1748430081325,CHEM 6B,A05,958650,Bussey; Thomas J,7,0,22,15
1748430081325,CHEM 6B,A06,958652,Bussey; Thomas J,18,0,22,4
1748430081325,CHEM 6B,A07,958653,Bussey; Thomas J,20,0,22,2
1748430081325,CHEM 6B,A08,958654,Bussey; Thomas J,19,0,22,3
1748430081325,CHEM 6B,A09,958710,Bussey; Thomas J,21,0,22,1
1748430081325,CHEM 6B,A10,958713,Bussey; Thomas J,21,0,22,1
1748430082361,CHEM 6C,A01,958743,Yuen Zhou; Joel,22,0,38,16
1748430082361,CHEM 6C,A02,958744,Yuen Zhou; Joel,20,0,38,18
1748430082361,CHEM 6C,A03,958745,Yuen Zhou; Joel,28,0,38,10
1748430082361,CHEM 6C,A04,958746,Yuen Zhou; Joel,30,0,38,8
1748430082361,CHEM 6C,A05,958747,Yuen Zhou; Joel,36,0,38,2
1748430082361,CHEM 6C,A06,958748,Yuen Zhou; Joel,23,0,38,15
1748430082361,CHEM 6C,A07,958749,Yuen Zhou; Joel,23,0,38,15
1748430082361,CHEM 6C,A08,958750,Yuen Zhou; Joel,12,0,38,26
1748430082361,CHEM 6C,A09,958751,Yuen Zhou; Joel,28,0,38,10
1748430083388,CHEM 7L,A01,912668,Leigh; Brian,0,0,24,24
1748430083388,CHEM 7L,A02,912669,Leigh; Brian,0,0,24,24
1748430083388,CHEM 7L,A03,912670,Leigh; Brian,0,0,24,24
1748430083388,CHEM 7L,A04,912671,Leigh; Brian,0,0,24,24
1748430083388,CHEM 7L,A05,912672,Leigh; Brian,0,0,24,24
1748430083388,CHEM 7L,A06,912673,Leigh; Brian,0,0,20,20
1748430083388,CHEM 7L,A07,912674,Leigh; Brian,0,0,24,24
1748430083388,CHEM 7L,A08,912675,Leigh; Brian,0,0,24,24
1748430083388,CHEM 7L,A09,912676,Leigh; Brian,0,0,24,24
1748430083388,CHEM 7L,A10,912677,Leigh; Brian,0,0,24,24
1748430083388,CHEM 7L,B01,912680,Leigh; Brian,0,0,24,24
1748430083388,CHEM 7L,B02,912681,Leigh; Brian,0,0,24,24
1748430083388,CHEM 7L,B03,912682,Leigh; Brian,0,0,24,24
1748430083388,CHEM 7L,B04,912683,Leigh; Brian,0,0,24,24
1748430083388,CHEM 7L,B05,912684,Leigh; Brian,0,0,24,24
1748430083388,CHEM 7L,B06,912685,Leigh; Brian,0,0,24,24
1748430083388,CHEM 7L,B07,912686,Leigh; Brian,0,0,24,24
1748430083388,CHEM 7L,B08,912687,Leigh; Brian,0,0,24,24
1748430083388,CHEM 7L,B09,912688,Leigh; Brian,0,0,24,24
1748430083388,CHEM 7L,B10,912689,Leigh; Brian,0,0,24,24
1748430084426,CHEM 40A,A01,958809,Bertrand; Guy,0,0,34,34
1748430084426,CHEM 40A,A02,958811,Bertrand; Guy,0,0,29,29
1748430084426,CHEM 40A,A03,958812,Bertrand; Guy,0,0,34,34
1748430084426,CHEM 40A,A04,958813,Bertrand; Guy,0,0,34,34
1748430084426,CHEM 40A,A05,958814,Bertrand; Guy,0,0,34,34
1748430084426,CHEM 40A,A06,958816,Bertrand; Guy,0,0,34,34
1748430084426,CHEM 40A,A07,958822,Bertrand; Guy,0,0,34,34
1748430084426,CHEM 40A,A08,958824,Bertrand; Guy,0,0,34,34
1748430084426,CHEM 40A,B01,958825,Bertrand; Guy,0,0,34,34
1748430084426,CHEM 40A,B02,958826,Bertrand; Guy,0,0,34,34
1748430084426,CHEM 40A,B03,958828,Bertrand; Guy,0,0,34,34
1748430084426,CHEM 40A,B04,958829,Bertrand; Guy,0,0,34,34
1748430084426,CHEM 40A,B05,958898,Bertrand; Guy,0,0,34,34
1748430084426,CHEM 40A,B06,958899,Bertrand; Guy,0,0,34,34
1748430084426,CHEM 40A,B07,958900,Bertrand; Guy,0,0,34,34
1748430084426,CHEM 40A,B08,958901,Bertrand; Guy,0,0,34,34
1748430084426,CHEM 40A,C01,958086,Yang; Jerry,29,0,34,5
1748430084426,CHEM 40A,C02,958087,Yang; Jerry,32,0,34,2
1748430084426,CHEM 40A,C03,958088,Yang; Jerry,31,0,34,3
1748430084426,CHEM 40A,C04,958089,Yang; Jerry,34,0,34,0
1748430084426,CHEM 40A,C05,958090,Yang; Jerry,34,0,34,0
1748430084426,CHEM 40A,C06,958091,Yang; Jerry,27,0,34,7
1748430084426,CHEM 40A,C07,958092,Yang; Jerry,29,0,34,5
1748430084426,CHEM 40A,C08,958093,Yang; Jerry,27,0,34,7
1748430084426,CHEM 40A,D01,958113,Albizati; Kim F.,0,0,34,34
1748430084426,CHEM 40A,D02,958114,Albizati; Kim F.,0,0,34,34
1748430084426,CHEM 40A,D03,958115,Albizati; Kim F.,0,0,34,34
1748430084426,CHEM 40A,D04,958116,Albizati; Kim F.,0,0,34,34
1748430084426,CHEM 40A,D05,958117,Albizati; Kim F.,0,0,34,34
1748430084426,CHEM 40A,D06,958118,Albizati; Kim F.,0,0,34,34
1748430084426,CHEM 40A,D07,958119,Albizati; Kim F.,0,0,34,34
1748430084426,CHEM 40A,D08,958120,Albizati; Kim F.,0,0,34,34
1748430085455,CHEM 40B,A01,958752,Molinski; Tadeusz,0,0,31,31
1748430085455,CHEM 40B,A02,958754,Molinski; Tadeusz,0,0,32,32
1748430085455,CHEM 40B,A03,958755,Molinski; Tadeusz,0,0,32,32
1748430085455,CHEM 40B,A04,958756,Molinski; Tadeusz,0,0,32,32
1748430085455,CHEM 40B,A05,958757,Molinski; Tadeusz,0,0,32,32
1748430085455,CHEM 40B,A06,958758,Molinski; Tadeusz,0,0,32,32
1748430085455,CHEM 40B,A07,958759,Molinski; Tadeusz,0,0,32,32
1748430085455,CHEM 40B,A08,958760,Molinski; Tadeusz,2,0,32,30
1748430085455,CHEM 40B,A09,958761,Molinski; Tadeusz,32,0,32,0
1748430086482,CHEM 41A,A01,958071,Klosterman; Jeremy K,0,0,22,22
1748430086482,CHEM 41A,A02,958072,Klosterman; Jeremy K,1,0,36,35
1748430086482,CHEM 41A,A03,958073,Klosterman; Jeremy K,16,0,36,20
1748430086482,CHEM 41A,A04,958074,Klosterman; Jeremy K,32,0,36,4
1748430086482,CHEM 41A,A05,958075,Klosterman; Jeremy K,0,0,0,0
1748430086482,CHEM 41A,A06,958076,Klosterman; Jeremy K,24,0,36,12
1748430086482,CHEM 41A,A07,958077,Klosterman; Jeremy K,3,0,36,33
1748430086482,CHEM 41A,A08,958078,Klosterman; Jeremy K,0,0,36,36
1748430086482,CHEM 41A,A09,958079,Klosterman; Jeremy K,36,0,36,0
1748430087516,CHEM 41C,A01,958105,Tor; Yitzhak,0,0,38,38
1748430087516,CHEM 41C,A02,958106,Tor; Yitzhak,0,0,40,40
1748430088548,CHEM 43A,A01,912711,Lam; Tin Yiu,0,0,24,24
1748430088548,CHEM 43A,A02,912712,Lam; Tin Yiu,0,0,24,24
1748430088548,CHEM 43A,A03,912713,Lam; Tin Yiu,0,0,24,24
1748430088548,CHEM 43A,A04,912714,Lam; Tin Yiu,0,0,24,24
1748430088548,CHEM 43A,A05,912715,Lam; Tin Yiu,0,0,24,24
1748430088548,CHEM 43A,A06,912716,Lam; Tin Yiu,0,0,24,24
1748430088548,CHEM 43A,A07,912717,Lam; Tin Yiu,0,0,24,24
1748430088548,CHEM 43A,A08,912718,Lam; Tin Yiu,0,0,24,24
1748430088548,CHEM 43A,A09,912719,Lam; Tin Yiu,0,0,24,24
1748430088548,CHEM 43A,A10,912720,Lam; Tin Yiu,0,0,24,24
1748430088548,CHEM 43A,B01,912722,Lam; Tin Yiu,0,0,24,24
1748430088548,CHEM 43A,B02,912723,Lam; Tin Yiu,0,0,24,24
1748430088548,CHEM 43A,B03,912724,Lam; Tin Yiu,0,0,19,19
1748430088548,CHEM 43A,B04,912725,Lam; Tin Yiu,0,0,24,24
1748430088548,CHEM 43A,B05,912726,Lam; Tin Yiu,0,0,24,24
1748430088548,CHEM 43A,B06,912727,Lam; Tin Yiu,0,0,24,24
1748430088548,CHEM 43A,B07,912728,Lam; Tin Yiu,0,0,24,24
1748430088548,CHEM 43A,B08,912729,Lam; Tin Yiu,0,0,24,24
1748430088548,CHEM 43A,B09,912730,Lam; Tin Yiu,0,0,24,24
1748430088548,CHEM 43A,B10,912731,Lam; Tin Yiu,0,0,24,24
1748430089581,CHEM 96,A00,960251,Bussey; Thomas J,15,0,20,5
1748430090609,CHEM 100A,A01,912734,Leigh; Brian,0,0,24,24
1748430090609,CHEM 100A,A02,912735,Leigh; Brian,0,0,24,24
1748430090609,CHEM 100A,A03,912736,Leigh; Brian,0,0,24,24
1748430090609,CHEM 100A,A04,912737,Leigh; Brian,0,0,24,24
1748430090609,CHEM 100A,A05,912738,Leigh; Brian,0,0,24,24
1748430090609,CHEM 100A,A06,912739,Leigh; Brian,0,0,24,24
1748430091640,CHEM 108,A01,912741,Ghosh; Gourisankar,0,0,24,24
1748430091640,CHEM 108,A02,912742,Ghosh; Gourisankar,0,0,24,24
1748430091640,CHEM 108,A03,912743,Ghosh; Gourisankar,13,0,24,11
1748430091640,CHEM 108,A04,912744,Ghosh; Gourisankar,23,0,24,1
1748430092668,CHEM 109,A01,912746,Muller; Ulrich K.,0,0,24,24
1748430092668,CHEM 109,A02,912747,Muller; Ulrich K.,0,0,24,24
1748430092668,CHEM 109,A03,912748,Muller; Ulrich K.,0,0,24,24
1748430092668,CHEM 109,A04,912749,Muller; Ulrich K.,15,0,24,9
1748430093695,CHEM 114A,A01,958067,Toor; Navtej,23,0,30,7
1748430093695,CHEM 114A,A02,958068,Toor; Navtej,18,0,30,12
1748430093695,CHEM 114A,A03,958069,Toor; Navtej,15,0,30,15
1748430093695,CHEM 114A,A04,958070,Toor; Navtej,0,0,30,30
1748430093695,CHEM 114A,B01,958080,Guseman; Alex,0,0,30,30
1748430093695,CHEM 114A,B02,958081,Guseman; Alex,0,0,30,30
1748430093695,CHEM 114A,B03,958082,Guseman; Alex,20,0,30,10
1748430093695,CHEM 114A,B04,958083,Guseman; Alex,24,0,30,6
1748430094721,CHEM 114D,A00,912752,Ghosh; Gourisankar,11,0,20,9
1748430095755,CHEM 116,A01,958121,Godula; Kamil,35,0,50,15
1748430095755,CHEM 116,A02,958122,Godula; Kamil,28,0,50,22
1748430096788,CHEM 117,A00,912754,Jones; Lisa Michelle,89,0,100,11
1748430097815,CHEM 126A,A01,958126,Schoeneberg; Johannes,14,0,35,21
1748430097815,CHEM 126A,A02,958127,Schoeneberg; Johannes,4,0,35,31
1748430097815,CHEM 126A,A03,958128,Schoeneberg; Johannes,0,0,35,35
1748430097815,CHEM 126A,A04,958129,Schoeneberg; Johannes,1,0,35,34
1748430097815,CHEM 126A,A05,958130,Schoeneberg; Johannes,34,0,35,1
1748430097815,CHEM 126A,A06,958131,Schoeneberg; Johannes,25,0,35,10
1748430098848,CHEM 130,A01,958084,Sinha; Amitabha,6,0,35,29
1748430098848,CHEM 130,A02,958085,Sinha; Amitabha,21,0,35,14
1748430099876,CHEM 142,A00,912758,Godula; Kamil,112,0,135,23
1748430100903,CHEM 143C,A01,912760,Klosterman; Jeremy K,8,0,24,16
1748430100903,CHEM 143C,A02,912761,Klosterman; Jeremy K,11,0,24,13
1748430101929,CHEM 152,A00,912762,Schmidt; Valerie A,18,0,30,12
1748430102956,CHEM 163,A00,912763,Jones; Lisa Michelle,1,0,10,9
1748430103983,CHEM 171,A01,958103,Slade; Jonathan,30,0,40,10
1748430103983,CHEM 171,A02,958104,Slade; Jonathan,36,0,40,4
1748430105011,CHEM 204,A00,912765,Ghosh; Partho,29,0,30,1
1748430106051,CHEM 209,A00,912766,Toor; Navtej,36,0,40,4
1748430107081,CHEM 213A,A00,912767,Guseman; Alex,46,0,50,4
1748430108110,CHEM 214,A00,912768,Ghosh; Gourisankar,18,0,20,2
1748430109141,CHEM 216,A00,912769,Godula; Kamil,28,0,30,2
1748430110168,CHEM 219A,A00,912770,Zid; Brian M,43,0,45,2
1748430111195,CHEM 222,A00,912771,Graeve; Olivia A,4,0,5,1
1748430112228,CHEM 224,A00,912772,Rinehart; Jeffrey Dennis,19,0,20,1
1748430113253,CHEM 227,A00,912773,Schimpf; Alina M,28,0,30,2
1748430115310,CHEM 231,A00,912775,Yong; Haiwang,20,0,20,0
1748430116339,CHEM 232A,A00,963071,Yuen Zhou; Joel,15,0,15,0
1748430117367,CHEM 234,A00,912776,Pun; Andrew Brian,39,0,40,1
1748430118393,CHEM 242,A00,912777,Godula; Kamil,22,0,25,3
1748430119417,CHEM 252,A00,912778,Schmidt; Valerie A,27,0,30,3
1748430120444,CHEM 263,A00,912779,Jones; Lisa Michelle,28,0,30,2
1748430121469,CHEM 291,A00,912780,Staff,20,0,20,0
1748430122498,CHEM 294,A00,912781,Staff,49,0,50,1
1748430123529,CHIN 10AD,A01,913381,Liu; Mingming,10,0,12,2
1748430123529,CHIN 10AD,A02,913382,Liu; Mingming,10,0,12,2
1748430124558,CHIN 10AM,A01,913384,Chen; Pei-Chia,9,0,12,3
1748430124558,CHIN 10AM,A02,913385,Chen; Pei-Chia,10,0,12,2
1748430125586,CHIN 10AN,A01,913387,Xu; Li,10,0,10,0
1748430125586,CHIN 10AN,A02,913388,Xu; Li,10,0,10,0
1748430125586,CHIN 10AN,B01,913390,Xu; Li,9,0,10,1
1748430125586,CHIN 10AN,B02,913391,Xu; Li,8,0,10,2
1748430125586,CHIN 10AN,C01,913393,Xu; Li,12,0,12,0
1748430125586,CHIN 10AN,C02,913394,Xu; Li,11,0,12,1
1748430126613,CHIN 20AD,A01,913396,Liu; Mingming,12,0,14,2
1748430126613,CHIN 20AD,A02,913397,Liu; Mingming,13,0,14,1
1748430127642,CHIN 20AM,A01,913399,Wang; Xiao,11,0,12,1
1748430127642,CHIN 20AM,A02,913400,Wang; Xiao,9,0,12,3
1748430127642,CHIN 20AM,B01,913402,Wang; Xiao,12,0,12,0
1748430127642,CHIN 20AM,B02,913403,Wang; Xiao,12,0,12,0
1748430128677,CHIN 20AN,A01,913405,Anderson; Qin-Hong,8,0,12,4
1748430128677,CHIN 20AN,A02,913406,Anderson; Qin-Hong,7,0,12,5
1748430128677,CHIN 20AN,B01,913408,Anderson; Qin-Hong,6,0,12,6
1748430128677,CHIN 20AN,B02,913409,Anderson; Qin-Hong,9,0,12,3
1748430128677,CHIN 20AN,C01,913411,Anderson; Qin-Hong,11,0,12,1
1748430129702,CHIN 100AM,A00,913412,Wang; Xiao,12,0,15,3
1748430130727,CHIN 100AN,A00,913413,Chen; Pei-Chia,8,0,15,7
1748430131755,CHIN 185A,A00,913414,Liu; Mingming,15,0,15,0
1748430132781,CLIN 294A,A00,914822,Weingarten; Amanda Gooding,10,0,10,0
1748430133810,CLIN 296,A00,914825,Moore; David Joseph,100,0,100,0
1748430133810,CLIN 296,B00,914826,Brookman; Lauren Irene,5,0,5,0
1748430134835,CLIN 297,A00,914827,Wall; Tamara Lynn,100,0,100,0
1748430135861,CLRE 254,A00,914830,Vaida; Florin,9997,0,9999,2
1748430136888,CLRE 255,A01,914832,Cuomo; Raphael Eduardo,9997,0,9999,2
1748430137912,CLRE 256,A01,914835,Morris; Sheldon,9996,0,9999,3
1748430138937,CLRE 257,A00,914836,Mehta; Ravindra L.,9997,0,9999,2
1748430139965,CLRE 258,A00,914839,Mehta; Ravindra L.,9997,0,9999,2
1748430140989,CLRE 260,A00,914840,Cuomo; Raphael Eduardo,9999,0,9999,0
1748430142017,CLRE 295A,A00,914845,Cuomo; Raphael Eduardo,9999,0,9999,0
1748430143045,CLRE 297,001,914847,Cuomo; Raphael Eduardo,9999,0,9999,0
1748430144071,CLX 87,A00,913379,Castro; Robert Jess,20,0,20,0
1748430145098,COGR 200A,A00,914800,Dewaard; Andrew Michael,5,0,5,0
1748430146123,COGR 200C,A00,914801,Irani; Lilly C,5,0,5,0
1748430147150,COGR 225A,A00,914803,McKenzie; Kerry V.,10,0,10,0
1748430148180,COGR 225C,A00,914804,McKenzie; Kerry V.,9,0,10,1
1748430149208,COGR 275,A00,914805,Jack; Caroline Sarah,9,0,10,1
1748430149208,COGR 275,B00,914807,Zilberg; Elana,9,0,10,1
1748430149208,COGR 275,C00,914809,Goldfarb; Brian,7,0,10,3
1748430150241,COGS 1,A01,913420,Beatty-Martinez; Anne,47,0,56,9
1748430150241,COGS 1,A02,913421,Beatty-Martinez; Anne,39,0,56,17
1748430150241,COGS 1,A03,913422,Beatty-Martinez; Anne,51,0,55,4
1748430150241,COGS 1,A04,913423,Beatty-Martinez; Anne,46,0,50,4
1748430150241,COGS 1,A05,913424,Beatty-Martinez; Anne,41,0,50,9
1748430150241,COGS 1,A06,913425,Beatty-Martinez; Anne,44,0,50,6
1748430150241,COGS 1,A07,913426,Beatty-Martinez; Anne,48,0,50,2
1748430150241,COGS 1,A08,913427,Beatty-Martinez; Anne,45,0,50,5
1748430151268,COGS 2,A01,913429,Boyle; Mary E. T.,49,0,50,1
1748430151268,COGS 2,A02,913430,Boyle; Mary E. T.,47,0,50,3
1748430151268,COGS 2,A03,913431,Boyle; Mary E. T.,46,0,50,4
1748430151268,COGS 2,A04,913432,Boyle; Mary E. T.,49,0,50,1
1748430151268,COGS 2,A05,913433,Boyle; Mary E. T.,47,0,50,3
1748430152299,COGS 3,A01,913435,Boyle; Mary E. T.,48,0,60,12
1748430152299,COGS 3,A02,913436,Boyle; Mary E. T.,52,0,60,8
1748430153330,COGS 9,A01,913439,Khosla; Meenakshi,48,0,50,2
1748430153330,COGS 9,A02,913440,Khosla; Meenakshi,49,0,50,1
1748430153330,COGS 9,A03,913441,Khosla; Meenakshi,48,0,50,2
1748430153330,COGS 9,A04,913442,Khosla; Meenakshi,46,0,50,4
1748430153330,COGS 9,A05,913443,Khosla; Meenakshi,44,0,50,6
1748430153330,COGS 9,A06,913444,Khosla; Meenakshi,46,0,50,4
1748430154360,COGS 10,A01,913446,Staff,41,0,50,9
1748430154360,COGS 10,A02,913447,Staff,46,0,50,4
1748430154360,COGS 10,A03,913448,Staff,47,0,50,3
1748430154360,COGS 10,A04,913449,Staff,47,0,50,3
1748430154360,COGS 10,A05,913450,Staff,50,0,50,0
1748430154360,COGS 10,A06,913451,Staff,45,0,50,5
1748430155385,COGS 11,A01,913453,Boroditsky; Lera,142,0,149,7
1748430156420,COGS 14A,A01,913455,Creel; Sarah,29,0,50,21
1748430156420,COGS 14A,A02,913456,Creel; Sarah,37,0,50,13
1748430156420,COGS 14A,A03,913457,Creel; Sarah,42,0,50,8
1748430156420,COGS 14A,A04,913458,Creel; Sarah,45,0,50,5
1748430156420,COGS 14A,A05,913459,Creel; Sarah,47,0,50,3
1748430156420,COGS 14A,A06,913460,Creel; Sarah,48,0,50,2
1748430156420,COGS 14A,A07,913461,Creel; Sarah,46,0,50,4
1748430157447,COGS 14B,A01,913463,Barrera; Steven James,32,0,50,18
1748430157447,COGS 14B,A02,913464,Barrera; Steven James,45,0,50,5
1748430157447,COGS 14B,A03,913465,Barrera; Steven James,40,0,50,10
1748430157447,COGS 14B,A04,913466,Barrera; Steven James,46,0,50,4
1748430157447,COGS 14B,A05,913467,Barrera; Steven James,40,0,50,10
1748430158473,COGS 15,A01,913469,Bergen; Benjamin,57,0,60,3
1748430158473,COGS 15,A02,913470,Bergen; Benjamin,57,0,60,3
1748430159503,COGS 17,A01,913472,Johnson; Christine M.,38,0,50,12
1748430159503,COGS 17,A02,913473,Johnson; Christine M.,47,0,50,3
1748430159503,COGS 17,A03,913474,Johnson; Christine M.,39,0,50,11
1748430159503,COGS 17,A04,913475,Johnson; Christine M.,42,0,50,8
1748430159503,COGS 17,A05,913476,Johnson; Christine M.,48,0,50,2
1748430159503,COGS 17,A06,913477,Johnson; Christine M.,48,0,50,2
1748430159503,COGS 17,A07,913478,Johnson; Christine M.,50,0,54,4
1748430159503,COGS 17,A08,913479,Johnson; Christine M.,43,0,56,13
1748430160542,COGS 18,A01,913481,Morgan; Eric,27,0,35,8
1748430160542,COGS 18,A02,913482,Morgan; Eric,30,0,35,5
1748430160542,COGS 18,A03,913483,Morgan; Eric,29,0,35,6
1748430160542,COGS 18,A04,913484,Morgan; Eric,32,0,35,3
1748430160542,COGS 18,A05,913485,Morgan; Eric,31,0,35,4
1748430160542,COGS 18,A06,913486,Morgan; Eric,31,0,35,4
1748430160542,COGS 18,A07,913487,Morgan; Eric,30,0,35,5
1748430160542,COGS 18,A08,913488,Morgan; Eric,31,0,35,4
1748430160542,COGS 18,A09,913520,Morgan; Eric,27,0,35,8
1748430160542,COGS 18,B01,968089,Morgan; Eric,34,0,35,1
1748430160542,COGS 18,B02,968090,Morgan; Eric,35,0,35,0
1748430160542,COGS 18,B03,968091,Morgan; Eric,35,0,35,0
1748430160542,COGS 18,B04,968092,Morgan; Eric,35,0,35,0
1748430160542,COGS 18,B05,968093,Morgan; Eric,35,0,35,0
1748430160542,COGS 18,B06,968094,Morgan; Eric,35,0,35,0
1748430160542,COGS 18,B07,968095,Morgan; Eric,35,0,35,0
1748430160542,COGS 18,B08,968096,Morgan; Eric,34,0,35,1
1748430160542,COGS 18,B09,968097,Morgan; Eric,34,0,35,1
1748430161571,COGS 100,A01,913580,Staff,58,0,60,2
1748430161571,COGS 100,A02,913581,Staff,55,0,60,5
1748430161571,COGS 100,A03,913621,Staff,55,0,60,5
1748430161571,COGS 100,A04,913622,Staff,55,0,60,5
1748430161571,COGS 100,A05,913663,Staff,54,0,60,6
1748430162599,COGS 101A,A01,913705,Barrera; Steven James,37,0,50,13
1748430162599,COGS 101A,A02,913709,Barrera; Steven James,35,0,50,15
1748430162599,COGS 101A,A03,913713,Barrera; Steven James,18,0,50,32
1748430162599,COGS 101A,A04,913715,Barrera; Steven James,25,0,50,25
1748430162599,COGS 101A,A05,913718,Barrera; Steven James,44,0,50,6
1748430162599,COGS 101A,A06,913721,Barrera; Steven James,36,0,50,14
1748430162599,COGS 101A,A07,913722,Barrera; Steven James,41,0,50,9
1748430163627,COGS 101B,A01,913725,Hoffman; Drew Ellen,26,0,50,24
1748430163627,COGS 101B,A02,913726,Hoffman; Drew Ellen,44,0,50,6
1748430163627,COGS 101B,A03,913727,Hoffman; Drew Ellen,47,0,50,3
1748430163627,COGS 101B,A04,913730,Hoffman; Drew Ellen,50,0,50,0
1748430164653,COGS 102A,A01,968009,Staff,41,0,48,7
1748430164653,COGS 102A,A02,968010,Staff,36,0,48,12
1748430164653,COGS 102A,A03,968011,Staff,47,0,50,3
1748430165680,COGS 107A,A01,913748,Rangel; Lara M,44,0,56,12
1748430165680,COGS 107A,A02,913750,Rangel; Lara M,43,0,54,11
1748430165680,COGS 107A,A03,913751,Rangel; Lara M,31,0,50,19
1748430165680,COGS 107A,A04,913754,Rangel; Lara M,20,0,50,30
1748430165680,COGS 107A,A05,913755,Rangel; Lara M,27,0,50,23
1748430165680,COGS 107A,A06,913756,Rangel; Lara M,0,0,50,50
1748430166708,COGS 107B,A01,968098,Staff,0,0,50,50
1748430166708,COGS 107B,A02,968099,Staff,6,0,50,44
1748430166708,COGS 107B,A03,968102,Staff,37,0,49,12
1748430167739,COGS 108,A01,913846,Fleischer; Jason G,0,0,56,56
1748430167739,COGS 108,A02,913847,Fleischer; Jason G,17,0,56,39
1748430167739,COGS 108,A03,913858,Fleischer; Jason G,20,0,50,30
1748430167739,COGS 108,A04,913899,Fleischer; Jason G,44,0,55,11
1748430167739,COGS 108,A05,913984,Fleischer; Jason G,29,0,50,21
1748430167739,COGS 108,A06,914035,Fleischer; Jason G,31,0,50,19
1748430167739,COGS 108,A07,914036,Fleischer; Jason G,36,0,50,14
1748430167739,COGS 108,A08,914037,Fleischer; Jason G,44,0,50,6
1748430167739,COGS 108,B01,914039,Fleischer; Jason G,38,0,50,12
1748430167739,COGS 108,B02,914040,Fleischer; Jason G,48,0,50,2
1748430167739,COGS 108,B03,914172,Fleischer; Jason G,32,0,50,18
1748430167739,COGS 108,B04,914182,Fleischer; Jason G,36,0,50,14
1748430167739,COGS 108,B05,914185,Fleischer; Jason G,28,0,50,22
1748430167739,COGS 108,B06,914188,Fleischer; Jason G,19,0,50,31
1748430167739,COGS 108,B07,914209,Fleischer; Jason G,39,0,54,15
1748430167739,COGS 108,B08,914210,Fleischer; Jason G,49,0,56,7
1748430168765,COGS 109,A01,968106,Mukamel; Eran A,30,0,48,18
1748430168765,COGS 109,A02,968107,Mukamel; Eran A,39,0,49,10
1748430168765,COGS 109,A03,968108,Mukamel; Eran A,47,0,49,2
1748430169797,COGS 111,A01,914261,Hoffman; Drew Ellen,34,0,50,16
1748430169797,COGS 111,A02,914262,Hoffman; Drew Ellen,49,0,50,1
1748430169797,COGS 111,A03,914263,Hoffman; Drew Ellen,46,0,50,4
1748430169797,COGS 111,A04,914264,Hoffman; Drew Ellen,28,0,50,22
1748430170825,COGS 115,A01,914266,Deak; Gedeon O.,35,0,70,35
1748430171857,COGS 116,A01,914268,Greene; Deanna Jacquelyn,49,0,70,21
1748430172936,COGS 118A,A01,914270,Tu; Zhuowen,30,0,50,20
1748430172936,COGS 118A,A02,914271,Tu; Zhuowen,31,0,50,19
1748430172936,COGS 118A,A03,914272,Tu; Zhuowen,7,0,50,43
1748430172936,COGS 118A,A04,914273,Tu; Zhuowen,6,0,50,44
1748430173969,COGS 118B,A01,969817,De Sa; Virginia,32,0,49,17
1748430173969,COGS 118B,A02,969818,De Sa; Virginia,34,0,49,15
1748430173969,COGS 118B,A03,969819,De Sa; Virginia,31,0,49,18
1748430173969,COGS 118B,A04,969822,De Sa; Virginia,43,0,49,6
1748430175001,COGS 125,A00,968043,Klemmer; Scott R,48,0,50,2
1748430176028,COGS 128,A01,914278,Staff,16,0,50,34
1748430176028,COGS 128,A02,914279,Staff,0,0,50,50
1748430177055,COGS 143,A01,914284,Johnson; Christine M.,16,0,40,24
1748430178081,COGS 150,A01,968112,Staff,36,0,50,14
1748430178081,COGS 150,A02,968113,Staff,44,0,49,5
1748430178081,COGS 150,A03,968114,Staff,43,0,48,5
1748430179124,COGS 151,A00,968044,Coulson; Seana M,48,0,50,2
1748430180157,COGS 160,A00,914286,Kirsh; David Joel,25,0,25,0
1748430181186,COGS 165,A01,914291,Kiyonaga; Anastasia,0,0,50,50
1748430182219,COGS 187A,A01,914293,Kirsh; David Joel,0,0,50,50
1748430182219,COGS 187A,A02,914294,Kirsh; David Joel,0,0,50,50
1748430182219,COGS 187A,A03,914295,Kirsh; David Joel,16,0,49,33
1748430183244,COGS 189,A00,914296,De Sa; Virginia,119,0,200,81
1748430184269,COGS 190A,A00,914297,Staff,9999,0,9999,0
1748430185296,COGS 194,A00,914298,Hill; Seth J,9999,0,9999,0
1748430186324,COGS 203,A00,914326,Zettersten; Martin,11,0,20,9
1748430187354,COGS 210A,001,914327,Kirsh; David Joel,9999,0,9999,0
1748430187354,COGS 210A,002,914328,Greene; Deanna Jacquelyn,9998,0,9999,1
1748430187354,COGS 210A,003,914329,Xia; Haijun,9998,0,9999,1
1748430187354,COGS 210A,004,914330,Nitz; Douglas A.,9999,0,9999,0
1748430187354,COGS 210A,005,914331,Hollan; James D.,9999,0,9999,0
1748430187354,COGS 210A,006,914332,De Sa; Virginia,9998,0,9999,1
1748430187354,COGS 210A,007,914333,Rossano; Federico,9999,0,9999,0
1748430187354,COGS 210A,008,914334,Kiyonaga; Anastasia,9999,0,9999,0
1748430187354,COGS 210A,009,914335,Coulson; Seana M,9998,0,9999,1
1748430188383,COGS 211A,A00,914336,Boroditsky; Lera,9995,0,9999,4
1748430189410,COGS 230,A00,914337,Munyaka; Imani N. S.,3,0,15,12
1748430190441,COGS 234,A00,970720,Xia; Haijun,4,0,20,16
1748430191471,COGS 260,A00,914340,Voytek; Bradley Thomas,9994,0,9999,5
1748430192517,COMM 10,A01,914366,Whitworth-Smith; Andrew C,6,0,10,4
1748430192517,COMM 10,A02,914367,Whitworth-Smith; Andrew C,7,0,10,3
1748430192517,COMM 10,A03,914368,Whitworth-Smith; Andrew C,9,0,10,1
1748430192517,COMM 10,A04,914369,Whitworth-Smith; Andrew C,6,0,10,4
1748430192517,COMM 10,A05,914370,Whitworth-Smith; Andrew C,10,0,10,0
1748430192517,COMM 10,A06,914371,Whitworth-Smith; Andrew C,9,0,10,1
1748430192517,COMM 10,A07,914372,Whitworth-Smith; Andrew C,9,0,10,1
1748430192517,COMM 10,A08,914373,Whitworth-Smith; Andrew C,7,0,10,3
1748430192517,COMM 10,A09,914374,Whitworth-Smith; Andrew C,9,0,10,1
1748430192517,COMM 10,A10,914375,Whitworth-Smith; Andrew C,10,0,10,0
1748430192517,COMM 10,A11,914376,Whitworth-Smith; Andrew C,6,0,10,4
1748430192517,COMM 10,A12,914377,Whitworth-Smith; Andrew C,10,0,10,0
1748430193547,COMM 20,A01,914385,Hill; Erin Truesdell,75,0,75,0
1748430194578,COMM 40,A00,914386,Jack; Caroline Sarah,61,0,75,14
1748430195604,COMM 50,A00,914387,Staff,21,0,25,4
1748430196633,COMM 80,A01,914389,Staff,77,0,80,3
1748430197662,COMM 100A,A01,914391,Harb; Anthony Joseph,1,0,10,9
1748430197662,COMM 100A,A02,914392,Harb; Anthony Joseph,0,0,10,10
1748430197662,COMM 100A,A03,914393,Harb; Anthony Joseph,0,0,10,10
1748430197662,COMM 100A,A04,914394,Harb; Anthony Joseph,0,0,10,10
1748430197662,COMM 100A,A05,914395,Harb; Anthony Joseph,0,0,10,10
1748430197662,COMM 100A,A06,914396,Harb; Anthony Joseph,0,0,10,10
1748430197662,COMM 100A,A07,914397,Harb; Anthony Joseph,1,0,10,9
1748430197662,COMM 100A,A08,914398,Harb; Anthony Joseph,6,0,10,4
1748430197662,COMM 100A,A09,914399,Harb; Anthony Joseph,7,0,10,3
1748430197662,COMM 100A,A10,914400,Harb; Anthony Joseph,7,0,10,3
1748430198690,COMM 101,A01,914404,Martinico; Daniel J,8,0,15,7
1748430198690,COMM 101,A02,914405,Martinico; Daniel J,2,0,15,13
1748430198690,COMM 101,A03,914406,Martinico; Daniel J,1,0,15,14
1748430198690,COMM 101,A04,914407,Martinico; Daniel J,13,0,15,2
1748430199715,COMM 101K,A00,914408,Staff,0,0,0,0
1748430200747,COMM 101M,A00,914409,Halm; Gavin Patrick,10,0,18,8
1748430201776,COMM 101N,A00,914410,Martinico; Daniel J,4,0,16,12
1748430202802,COMM 101T,A00,914411,Davis; Zeinabu I.,12,0,18,6
1748430203829,COMM 102C,A01,914417,Campion; Camille E,0,0,6,6
1748430203829,COMM 102C,A02,914423,Campion; Camille E,0,0,6,6
1748430203829,COMM 102C,A03,914432,Campion; Camille E,0,0,6,6
1748430204855,COMM 106,A00,914439,Kidman; Shawna F,54,0,70,16
1748430205883,COMM 106F,A00,914442,Hill; Erin Truesdell,23,0,42,19
1748430206909,COMM 106N,A00,914480,Hallin; Daniel C,46,0,70,24
1748430207936,COMM 108D,A00,914491,Goldfarb; Brian,45,0,46,1
1748430208962,COMM 113T,A00,914493,Dominguez Rubio; Fernando,43,0,46,3
1748430209989,COMM 114E,A00,914767,Pavon Aramburu; Maria Laur,41,0,44,3
1748430211015,COMM 114I,A00,914768,Rojo Solis; Juan Jose,39,0,44,5
1748430212046,COMM 115,A00,914769,Alac; Morana,35,0,46,11
1748430213073,COMM 119,A01,914771,Staff,50,0,50,0
1748430214099,COMM 120M,A00,914773,Abuelhiga; Soraya Jill,37,0,44,7
1748430215126,COMM 127,A00,914774,Abuelhiga; Soraya Jill,33,0,44,11
1748430216182,COMM 133,A00,914775,Dewey; Matthew D,35,0,44,9
1748430217209,COMM 134,A00,914777,Kidman; Shawna F,31,0,44,13
1748430218240,COMM 135,A00,914778,Davis; Zeinabu I.,43,0,46,3
1748430219265,COMM 142,A00,914779,McKenna; Denise,22,0,44,22
1748430220299,COMM 146,A00,914780,Halm; Gavin Patrick,34,0,44,10
1748430220299,COMM 146,B00,968068,Ybarra; Megan,41,0,44,3
1748430221329,COMM 148,A00,914785,Staff,0,0,0,0
1748430222358,COMM 164,A00,914786,Dominguez Rubio; Fernando,9,0,25,16
1748430223387,COMM 173,A00,914787,Alac; Morana,4,0,25,21
1748430224415,COMM 177,A00,914788,Rojo Solis; Juan Jose,2,0,25,23
1748430225444,COMM 185,A00,914792,Boateng; Boatema,21,0,25,4
1748430226477,COMM 190,B00,914793,Staff,0,0,23,23
1748430226477,COMM 190,C00,914794,Staff,10,0,23,13
1748430226477,COMM 190,D00,914795,Hassanpour; Anvar,4,0,23,19
1748430227506,COMM 194,A00,954115,Hill; Seth J,9999,0,9999,0
1748430228534,COMM 196A,A00,914796,Dewaard; Andrew Michael,0,0,0,1
1748430229570,CSE 3,A50,914849,Alvarado; Christine J.,49,0,50,1
1748430229570,CSE 3,A51,914850,Alvarado; Christine J.,49,0,50,1
1748430229570,CSE 3,A52,914852,Alvarado; Christine J.,46,0,46,0
1748430230598,CSE 6R,A01,914856,Soosai Raj; Adalbert Geral,238,0,250,12
1748430231630,CSE 8A,A50,914860,Soosai Raj; Adalbert Geral,2,0,3,1
1748430231630,CSE 8A,A51,914868,Soosai Raj; Adalbert Geral,0,0,3,3
1748430231630,CSE 8A,A52,914870,Soosai Raj; Adalbert Geral,0,0,3,3
1748430231630,CSE 8A,A53,914871,Soosai Raj; Adalbert Geral,1,0,3,2
1748430231630,CSE 8A,A54,914872,Soosai Raj; Adalbert Geral,2,0,3,1
1748430231630,CSE 8A,A55,914873,Soosai Raj; Adalbert Geral,2,0,3,1
1748430231630,CSE 8A,A56,914875,Soosai Raj; Adalbert Geral,3,0,3,0
1748430231630,CSE 8A,A57,914876,Soosai Raj; Adalbert Geral,1,0,3,2
1748430232665,CSE 11,A01,958990,Cao; Yingjun,0,0,50,50
1748430232665,CSE 11,B01,959775,Ochoa; Benjamin Lawrence,103,0,115,12
1748430233694,CSE 12,A01,958991,Cao; Yingjun,0,0,100,100
1748430234726,CSE 20,A01,959784,Jones; Miles E,0,0,25,25
1748430234726,CSE 20,A02,968053,Jones; Miles E,1,0,25,24
1748430235754,CSE 21,A01,959776,Jones; Miles E,0,0,30,30
1748430235754,CSE 21,A02,968059,Jones; Miles E,2,0,30,28
1748430236785,CSE 29,A50,914888,Politz; Joseph Gibbs,0,0,10,10
1748430236785,CSE 29,A51,914889,Politz; Joseph Gibbs,0,0,10,10
1748430236785,CSE 29,A52,914891,Politz; Joseph Gibbs,0,0,10,10
1748430236785,CSE 29,A53,914892,Politz; Joseph Gibbs,0,0,10,10
1748430236785,CSE 29,B50,914897,Shalev; Aaron D,0,0,10,10
1748430236785,CSE 29,B51,914898,Shalev; Aaron D,0,0,10,10
1748430236785,CSE 29,B52,914900,Shalev; Aaron D,0,0,10,10
1748430236785,CSE 29,B53,914901,Shalev; Aaron D,0,0,10,10
1748430237826,CSE 30,A01,959778,Eldon; John,0,0,15,15
1748430238858,CSE 87,A00,914904,Moshiri; Niema,20,0,20,0
1748430239886,CSE 89,A00,914906,Minnes Kemp; Mor Mia,100,0,100,0
1748430239886,CSE 89,B00,969276,Minnes Kemp; Mor Mia,100,0,100,0
1748430240911,CSE 95,A00,914907,Cao; Yingjun,100,0,100,0
1748430241942,CSE 100,A01,959787,Moshiri; Niema,0,0,75,75
1748430242975,CSE 100R,A01,914911,Moshiri; Niema,0,0,125,125
1748430244002,CSE 101,A01,958995,Impagliazzo; Russell,0,0,30,30
1748430244002,CSE 101,A02,958998,Impagliazzo; Russell,0,0,30,30
1748430244002,CSE 101,A03,959000,Impagliazzo; Russell,0,0,30,30
1748430244002,CSE 101,B01,959777,Liu; Qipeng,94,0,175,81
1748430245043,CSE 103,A01,959001,Freund; Yoav,69,0,96,27
1748430246071,CSE 105,A01,959785,Lovett; Shachar,0,0,45,45
1748430247098,CSE 107,A01,959002,Bellare; Mihir,81,0,96,15
1748430248125,CSE 110,A50,914923,Coblenz; Michael J,10,0,50,40
1748430248125,CSE 110,A51,914925,Coblenz; Michael J,18,0,50,32
1748430248125,CSE 110,A52,914926,Coblenz; Michael J,44,0,50,6
1748430248125,CSE 110,A53,914928,Coblenz; Michael J,33,0,50,17
1748430248125,CSE 110,A54,914930,Coblenz; Michael J,42,0,50,8
1748430248125,CSE 110,A55,914931,Coblenz; Michael J,36,0,45,9
1748430249156,CSE 118,A50,914934,Weibel; Nadir,16,0,25,9
1748430250189,CSE 120,A01,959780,Voelker; Geoffrey M.,130,0,295,165
1748430251222,CSE 127,A01,959795,Savage; Stefan,88,0,192,104
1748430252248,CSE 130,A01,959003,Polikarpova; Nadezhda,118,0,145,27
1748430253284,CSE 131,A01,914941,Politz; Joseph Gibbs,33,0,50,17
1748430254317,CSE 132A,A01,959790,Gupta; Amarnath,141,0,196,55
1748430255344,CSE 134B,A01,959005,Powell; Thomas Allan,115,0,146,31
1748430256374,CSE 140,A01,914947,Orailoglu; Alex,124,0,146,22
1748430257400,CSE 140L,A01,914949,Orailoglu; Alex,112,0,146,34
1748430258428,CSE 141,A01,959006,Pannuto; Patrick William,79,0,146,67
1748430259455,CSE 141L,A01,961134,Eldon; John,75,0,146,71
1748430260486,CSE 142,A01,959781,Swanson; Steven James,250,0,295,45
1748430261518,CSE 150A,A01,959774,Bonjour; Trevor,101,0,225,124
1748430262546,CSE 150B,A01,959791,Solares; Edwin A,187,0,196,9
1748430263578,CSE 151A,A01,959782,Dasgupta; Sanjoy,186,0,250,64
1748430263578,CSE 151A,B01,959783,Dasgupta; Sanjoy,226,0,250,24
1748430264603,CSE 152A,A01,959792,Su; Hao,0,0,0,0
1748430265633,CSE 158,A01,959793,McAuley; Julian John,99,0,196,97
1748430266661,CSE 158R,A01,914961,McAuley; Julian John,449,0,550,101
1748430266661,CSE 158R,B01,968064,McAuley; Julian John,100,0,100,0
1748430267692,CSE 167,A01,959796,Li; Tzumao,110,0,192,82
1748430268721,CSE 170,A01,914965,Vaccaro; Kristen Marie,13,0,20,7
1748430268721,CSE 170,A02,914967,Vaccaro; Kristen Marie,0,0,20,20
1748430268721,CSE 170,A03,914968,Vaccaro; Kristen Marie,17,0,20,3
1748430268721,CSE 170,A04,914969,Vaccaro; Kristen Marie,15,0,20,5
1748430268721,CSE 170,A05,914970,Vaccaro; Kristen Marie,17,0,20,3
1748430268721,CSE 170,A06,914971,Vaccaro; Kristen Marie,18,0,20,2
1748430268721,CSE 170,A07,914972,Vaccaro; Kristen Marie,16,0,19,3
1748430268721,CSE 170,A08,914973,Vaccaro; Kristen Marie,0,0,19,19
1748430268721,CSE 170,A09,914974,Vaccaro; Kristen Marie,8,0,19,11
1748430268721,CSE 170,A10,969577,Vaccaro; Kristen Marie,18,0,19,1
1748430269751,CSE 190,A00,914975,Vaccaro; Kristen Marie,146,0,146,0
1748430270777,CSE 191,A00,914976,Minnes Kemp; Mor Mia,9999,0,9999,0
1748430271805,CSE 193,A01,959007,Bonjour; Trevor,50,0,50,0
1748430272836,CSE 194,A01,959009,Munyaka; Imani N. S.,6,0,60,54
1748430273864,CSE 197,001,914980,Minnes Kemp; Mor Mia,9999,0,9999,0
1748430274895,CSE 202,A00,914981,Liu; Qipeng,0,0,0,0
1748430275925,CSE 206A,A00,914982,Micciancio; Daniele,0,0,0,0
1748430277010,CSE 207B,A00,914983,Heninger; Nadia A,0,0,0,0
1748430278040,CSE 209A,A00,914984,Impagliazzo; Russell,0,0,0,0
1748430279066,CSE 209B,A00,914985,Bellare; Mihir,0,0,0,0
1748430280096,CSE 210,A00,914986,Powell; Thomas Allan,0,0,0,0
1748430281125,CSE 216,A00,914987,Munyaka; Imani N. S.,0,0,0,0
1748430282151,CSE 221,A00,914988,Ousterhout; Amy,0,0,0,0
1748430283177,CSE 227,A00,914989,Fernandes; Earlence T,0,0,0,0
1748430284205,CSE 229A,A00,914990,Snoeren; Alex C.,0,0,0,0
1748430285230,CSE 229C,A00,914993,Fernandes; Earlence T,0,0,0,0
1748430286257,CSE 237C,A00,914994,Kastner; Ryan Charles,0,0,0,0
1748430287283,CSE 239B,A00,914996,D'Antoni; Loris,0,0,0,0
1748430288310,CSE 240A,A00,914997,Tullsen; Dean Michael,0,0,0,0
1748430289342,CSE 249E,A00,914998,Pannuto; Patrick William,0,0,0,0
1748430290370,CSE 250A,A00,914999,Bonjour; Trevor,0,0,0,0
1748430291396,CSE 252A,A00,915000,Ochoa; Benjamin Lawrence,0,0,0,0
1748430292436,CSE 258,A01,959794,McAuley; Julian John,0,0,0,0
1748430293465,CSE 258R,A01,915004,McAuley; Julian John,0,0,0,0
1748430294492,CSE 259,A00,915005,Prithviraj; Ammanabrolu,0,0,0,0
1748430295523,CSE 260,A01,959011,Chin; Bryan W.,0,0,0,0
1748430296550,CSE 270,A01,959012,Chern; Albert Ren-Haur,0,0,0,0
1748430297580,CSE 276A,A00,915009,Christensen; Henrik I,0,0,0,0
1748430298627,CSE 290,A00,915013,Bafna; Vineet,0,0,0,0
1748430298627,CSE 290,B00,915014,Nakashole; Ndapandula,0,0,0,0
1748430298627,CSE 290,C00,915015,Ramamoorthi; Ravi,0,0,0,0
1748430298627,CSE 290,D00,915017,Tullsen; Dean Michael,0,0,0,0
1748430298627,CSE 290,F00,915020,Vaccaro; Kristen Marie,0,0,0,0
1748430299659,CSE 291A,A00,915021,Yu; Qi,0,0,0,0
1748430299659,CSE 291A,B00,915022,Weibel; Nadir,0,0,0,0
1748430299659,CSE 291A,C00,915049,Munyaka; Imani N. S.,0,0,0,0
1748430299659,CSE 291A,D00,968730,Zhang; Yiying,0,0,0,0
1748430300689,CSE 291P,A00,915050,D'Antoni; Loris,0,0,0,0
1748430300689,CSE 291P,B00,915051,Ding; Yufei,0,0,0,0
1748430301723,CSE 291T,A00,915052,Grier; Daniel T,0,0,0,0
1748430301723,CSE 291T,B00,915053,Heninger; Nadia A,0,0,0,0
1748430302749,CSE 291Y,A00,915054,Fernandes; Earlence T,0,0,0,0
1748430303777,CSE 292,A00,968504,Ousterhout; Amy,0,0,0,0
1748430304829,CSE 293,001,968115,Bafna; Vineet,9999,0,9999,0
1748430304829,CSE 293,002,968116,Bellare; Mihir,9999,0,9999,0
1748430304829,CSE 293,003,968122,Berg-Kirkpatrick; Taylor D,9999,0,9999,0
1748430304829,CSE 293,004,968298,Chandraker; Manmohan Krishna,9999,0,9999,0
1748430304829,CSE 293,005,968317,Cheng; Chung Kuan,9999,0,9999,0
1748430304829,CSE 293,006,968334,Christensen; Henrik I,9999,0,9999,0
1748430304829,CSE 293,007,968339,Coblenz; Michael J,9999,0,9999,0
1748430304829,CSE 293,008,968345,Cottrell; Garrison W,9999,0,9999,0
1748430304829,CSE 293,009,968346,Deutsch; Alin Bernard,9999,0,9999,0
1748430304829,CSE 293,010,968357,Esmaeilzadeh; Hadi,9999,0,9999,0
1748430304829,CSE 293,011,968359,Freund; Yoav,9999,0,9999,0
1748430304829,CSE 293,012,968427,Griswold; William G.,9999,0,9999,0
1748430304829,CSE 293,013,968472,Gymrek; Melissa Ann,9999,0,9999,0
1748430304829,CSE 293,014,968473,Heninger; Nadia A,9999,0,9999,0
1748430304829,CSE 293,015,968480,Impagliazzo; Russell,9999,0,9999,0
1748430304829,CSE 293,016,968489,Jhala; Ranjit,9999,0,9999,0
1748430304829,CSE 293,017,968490,Kahng; Andrew Byun,9999,0,9999,0
1748430304829,CSE 293,018,968494,Kane; Daniel Mertz,9999,0,9999,0
1748430304829,CSE 293,019,968495,Kriegman; David J,9999,0,9999,0
1748430304829,CSE 293,020,968496,Kumar; Arun Kumar,9999,0,9999,0
1748430304829,CSE 293,021,968497,Lerner; Sorin,9999,0,9999,0
1748430304829,CSE 293,022,968498,Lovett; Shachar,9999,0,9999,0
1748430304829,CSE 293,023,968499,McAuley; Julian John,9999,0,9999,0
1748430304829,CSE 293,024,968501,Micciancio; Daniele,9999,0,9999,0
1748430304829,CSE 293,025,968502,Orailoglu; Alex,9999,0,9999,0
1748430304829,CSE 293,026,968503,Pannuto; Patrick William,9999,0,9999,0
1748430304829,CSE 293,027,968505,Paturi; Ramamohan,9999,0,9999,0
1748430304829,CSE 293,028,968506,Polikarpova; Nadezhda,9999,0,9999,0
1748430304829,CSE 293,029,968507,Politz; Joseph Gibbs,9999,0,9999,0
1748430304829,CSE 293,030,968508,Porter; George M,9999,0,9999,0
1748430304829,CSE 293,031,968509,Porter; Leonard Emerson,9999,0,9999,0
1748430304829,CSE 293,032,968510,Ramamoorthi; Ravi,9999,0,9999,0
1748430304829,CSE 293,033,968511,Riek; Laurel D,9999,0,9999,0
1748430304829,CSE 293,034,968512,Sahoo; Debashis,9999,0,9999,0
1748430304829,CSE 293,035,968513,Saul; Lawrence,9999,0,9999,0
1748430304829,CSE 293,036,968514,Savage; Stefan,9999,0,9999,0
1748430304829,CSE 293,037,968515,Schulze; Jurgen P.,9999,0,9999,0
1748430304829,CSE 293,038,968516,Snoeren; Alex C.,9999,0,9999,0
1748430304829,CSE 293,039,968517,Shang; Jingbo,9999,0,9999,0
1748430304829,CSE 293,040,968575,Stefan; Deian,9999,0,9999,0
1748430304829,CSE 293,041,968580,Su; Hao,9999,0,9999,0
1748430304829,CSE 293,042,968589,Swanson; Steven James,9999,0,9999,0
1748430304829,CSE 293,043,968639,Tullsen; Dean Michael,9999,0,9999,0
1748430304829,CSE 293,044,968674,Vaccaro; Kristen Marie,9999,0,9999,0
1748430304829,CSE 293,045,968681,Voelker; Geoffrey M.,9999,0,9999,0
1748430304829,CSE 293,046,968692,Zhao; Jishen,9999,0,9999,0
1748430304829,CSE 293,047,968694,Zhou; Yuan-Yuan,9999,0,9999,0
1748430304829,CSE 293,048,968702,Gao; Sicun,9999,0,9999,0
1748430304829,CSE 293,049,968703,Weibel; Nadir,9999,0,9999,0
1748430304829,CSE 293,050,968704,Gupta; Rajesh K.,9999,0,9999,0
1748430304829,CSE 293,051,968705,Soosai Raj; Adalbert Geral,9999,0,9999,0
1748430305859,CSE 294,A00,915055,Orailoglu; Alex,0,0,0,0
1748430306888,CSS 1,A01,958041,Staff,31,0,41,10
1748430306888,CSS 1,A02,958042,Staff,41,0,41,0
1748430306888,CSS 1,A03,958043,Staff,33,0,41,8
1748430306888,CSS 1,A04,958044,Staff,39,0,41,2
1748430307914,CSS 120,A01,915059,Staff,0,0,0,0
1748430308941,CSS 204,A01,915061,Long; Bria,0,0,0,0
1748430309968,CSS 209,A00,915062,Staff,14,0,40,26
1748430310994,DDPM 200,A00,919742,Ma; Joseph David,35,0,35,0
1748430312023,DDPM 201,A00,919743,Ma; Joseph David,35,0,35,0
1748430313055,DDPM 202,A00,919761,Reed; Chantal,35,0,35,0
1748430314081,DDPM 203,A00,963085,Momper; Jeremiah D,40,0,40,0
1748430315123,DOC 1,A01,916077,Staff,4,0,4,0
1748430315123,DOC 1,A02,916080,Staff,1,0,4,3
1748430315123,DOC 1,A03,916081,Staff,1,0,4,3
1748430315123,DOC 1,A04,916082,Staff,3,0,4,1
1748430315123,DOC 1,A05,916083,Staff,2,0,4,2
1748430315123,DOC 1,A06,916084,Staff,4,0,4,0
1748430315123,DOC 1,A07,916085,Staff,4,0,4,0
1748430315123,DOC 1,A08,916096,Staff,4,0,4,0
1748430315123,DOC 1,A09,916097,Staff,4,0,4,0
1748430315123,DOC 1,A10,916099,Staff,4,0,4,0
1748430315123,DOC 1,A11,916170,Staff,0,0,0,0
1748430315123,DOC 1,A12,916186,Staff,0,0,0,0
1748430315123,DOC 1,A13,916203,Staff,4,0,4,0
1748430315123,DOC 1,A14,916222,Staff,4,0,4,0
1748430315123,DOC 1,A15,916223,Staff,4,0,4,0
1748430315123,DOC 1,A16,916224,Staff,4,0,4,0
1748430315123,DOC 1,B01,916279,Staff,4,0,4,0
1748430315123,DOC 1,B02,916281,Staff,2,0,4,2
1748430315123,DOC 1,B03,916282,Staff,3,0,4,1
1748430315123,DOC 1,B04,916283,Staff,3,0,4,1
1748430315123,DOC 1,B05,916284,Staff,2,0,4,2
1748430315123,DOC 1,B06,916285,Staff,3,0,4,1
1748430315123,DOC 1,B07,916287,Staff,4,0,4,0
1748430315123,DOC 1,B08,916288,Staff,3,0,4,1
1748430315123,DOC 1,B09,916289,Staff,0,0,0,0
1748430315123,DOC 1,B10,916290,Staff,0,0,0,0
1748430315123,DOC 1,B11,916349,Staff,4,0,4,0
1748430315123,DOC 1,B12,916375,Staff,4,0,4,0
1748430315123,DOC 1,B13,916381,Staff,3,0,4,1
1748430315123,DOC 1,B14,916382,Staff,2,0,4,2
1748430315123,DOC 1,B15,916383,Staff,4,0,4,0
1748430315123,DOC 1,B16,916384,Staff,3,0,4,1
1748430315123,DOC 1,C01,916386,Staff,4,0,4,0
1748430315123,DOC 1,C02,916387,Staff,4,0,4,0
1748430315123,DOC 1,C03,916388,Staff,4,0,4,0
1748430315123,DOC 1,C04,916389,Staff,0,0,4,4
1748430315123,DOC 1,C05,916390,Staff,2,0,4,2
1748430315123,DOC 1,C06,916391,Staff,2,0,4,2
1748430315123,DOC 1,C07,916392,Staff,4,0,4,0
1748430315123,DOC 1,C08,916417,Staff,4,0,4,0
1748430315123,DOC 1,C09,916418,Staff,0,0,0,0
1748430315123,DOC 1,C10,916426,Staff,0,0,0,0
1748430315123,DOC 1,C11,916497,Staff,4,0,4,0
1748430315123,DOC 1,C12,916506,Staff,3,0,4,1
1748430315123,DOC 1,C13,916507,Staff,3,0,4,1
1748430315123,DOC 1,C14,916508,Staff,3,0,4,1
1748430315123,DOC 1,C15,916509,Staff,4,0,4,0
1748430315123,DOC 1,C16,916510,Staff,4,0,4,0
1748430315123,DOC 1,D01,916512,Staff,4,0,4,0
1748430315123,DOC 1,D02,916513,Staff,4,0,4,0
1748430315123,DOC 1,D03,916514,Staff,4,0,4,0
1748430315123,DOC 1,D04,916515,Staff,4,0,4,0
1748430315123,DOC 1,D05,916516,Staff,1,0,4,3
1748430315123,DOC 1,D06,916555,Staff,4,0,4,0
1748430315123,DOC 1,D07,916581,Staff,4,0,4,0
1748430315123,DOC 1,D08,916582,Staff,4,0,4,0
1748430315123,DOC 1,D09,916583,Staff,0,0,0,0
1748430315123,DOC 1,D10,916584,Staff,0,0,0,0
1748430315123,DOC 1,D11,916585,Staff,4,0,4,0
1748430315123,DOC 1,D12,916586,Staff,4,0,4,0
1748430315123,DOC 1,D13,916587,Staff,4,0,4,0
1748430315123,DOC 1,D14,916588,Staff,4,0,4,0
1748430315123,DOC 1,D15,916589,Staff,3,0,4,1
1748430315123,DOC 1,D16,916590,Staff,4,0,4,0
1748430316154,DOC 100D,A00,916591,Pass; Natalye,22,0,25,3
1748430316154,DOC 100D,B00,916838,Pass; Natalye,22,0,25,3
1748430317185,DSC 10,A01,915848,Tiefenbruck; Janine LoBue,0,0,0,0
1748430317185,DSC 10,B01,915851,Tiefenbruck; Janine LoBue,0,0,0,0
1748430317185,DSC 10,C01,915854,Tiefenbruck; Janine LoBue,0,0,0,0
1748430318212,DSC 20,A01,915857,Langlois; Marina,87,0,90,3
1748430319238,DSC 30,A01,915859,Liao; Soohyun Nam,175,0,180,5
1748430320265,DSC 40A,A01,915861,Mishne; Gal,167,0,180,13
1748430321292,DSC 40B,A01,915863,Langlois; Marina,126,0,149,23
1748430322319,DSC 80,A01,915865,Eldridge; Justin Matthew,117,0,145,28
1748430322319,DSC 80,B01,915867,Eldridge; Justin Matthew,140,0,145,5
1748430323346,DSC 95,A01,915869,Langlois; Marina,50,0,50,0
1748430324378,DSC 100,A01,915871,Shannon; Kyle Michael,97,0,150,53
1748430325405,DSC 102,A01,915890,Kolovos; Alexandros,128,0,150,22
1748430326437,DSC 106,A01,915892,Lau; Samuel Ethan,74,0,90,16
1748430326437,DSC 106,B01,915894,Lau; Samuel Ethan,53,0,90,37
1748430327464,DSC 140A,A01,915896,Ustun; Tevfik Berk,135,0,150,15
1748430328493,DSC 161,A00,968072,Roberts; Margaret Earling,24,0,25,1
1748430329526,DSC 180A,A01,915898,Bellur; Umesh,0,0,0,0
1748430329526,DSC 180A,A02,969828,Bellur; Umesh,0,0,0,0
1748430329526,DSC 180A,A03,969829,Bellur; Umesh,0,0,0,0
1748430329526,DSC 180A,A04,969830,Bellur; Umesh,0,0,0,0
1748430329526,DSC 180A,A05,969831,Bellur; Umesh,0,0,0,0
1748430329526,DSC 180A,A06,969833,Bellur; Umesh,0,0,0,0
1748430329526,DSC 180A,A07,969835,Bellur; Umesh,0,0,0,0
1748430329526,DSC 180A,A08,969836,Bellur; Umesh,0,0,0,0
1748430329526,DSC 180A,A09,969978,Bellur; Umesh,0,0,0,0
1748430329526,DSC 180A,A10,969985,Bellur; Umesh,0,0,0,0
1748430329526,DSC 180A,A11,969986,Bellur; Umesh,0,0,0,0
1748430329526,DSC 180A,A12,970002,Bellur; Umesh,0,0,0,0
1748430329526,DSC 180A,A13,970008,Bellur; Umesh,0,0,0,0
1748430329526,DSC 180A,A14,970011,Bellur; Umesh,0,0,0,0
1748430329526,DSC 180A,A15,970014,Bellur; Umesh,0,0,0,0
1748430329526,DSC 180A,A16,970019,Bellur; Umesh,0,0,0,0
1748430329526,DSC 180A,A17,970020,Bellur; Umesh,0,0,0,0
1748430329526,DSC 180A,B01,915901,Bellur; Umesh,0,0,0,0
1748430329526,DSC 180A,B02,915902,Bellur; Umesh,0,0,0,0
1748430329526,DSC 180A,B03,970021,Bellur; Umesh,0,0,0,0
1748430329526,DSC 180A,B04,970024,Bellur; Umesh,0,0,0,0
1748430329526,DSC 180A,B05,970025,Bellur; Umesh,0,0,0,0
1748430329526,DSC 180A,B06,970028,Bellur; Umesh,0,0,0,0
1748430329526,DSC 180A,B07,970030,Bellur; Umesh,0,0,0,0
1748430329526,DSC 180A,B08,970031,Bellur; Umesh,0,0,0,0
1748430329526,DSC 180A,B09,970034,Bellur; Umesh,0,0,0,0
1748430329526,DSC 180A,B10,970035,Bellur; Umesh,0,0,0,0
1748430329526,DSC 180A,B11,970042,Bellur; Umesh,0,0,0,0
1748430329526,DSC 180A,B12,970043,Bellur; Umesh,0,0,0,0
1748430329526,DSC 180A,B13,970047,Bellur; Umesh,0,0,0,0
1748430329526,DSC 180A,B14,970049,Bellur; Umesh,0,0,0,0
1748430329526,DSC 180A,B15,970050,Bellur; Umesh,0,0,0,0
1748430329526,DSC 180A,B16,970052,Bellur; Umesh,0,0,0,0
1748430329526,DSC 180A,B17,970057,Bellur; Umesh,0,0,0,0
1748430329526,DSC 180A,B18,970060,Bellur; Umesh,0,0,0,0
1748430329526,DSC 180A,B19,970063,Bellur; Umesh,0,0,0,0
1748430329526,DSC 180A,B20,970068,Bellur; Umesh,0,0,0,0
1748430329526,DSC 180A,B21,970070,Bellur; Umesh,0,0,0,0
1748430329526,DSC 180A,B22,970071,Bellur; Umesh,0,0,0,0
1748430329526,DSC 180A,B23,970075,Bellur; Umesh,0,0,0,0
1748430329526,DSC 180A,B24,970076,Bellur; Umesh,0,0,0,0
1748430329526,DSC 180A,B25,970083,Bellur; Umesh,0,0,0,0
1748430329526,DSC 180A,B26,970072,Bellur; Umesh,0,0,0,0
1748430330556,DSC 190,A01,915904,Schwartzman; Armin,176,0,200,24
1748430330556,DSC 190,C01,915908,Ma; Yian,48,0,60,12
1748430331583,DSC 197,001,971692,Eldridge; Justin Matthew,9999,0,9999,0
1748430332611,DSC 200,A00,915909,Watson-Parris; Duncan,0,0,100,100
1748430333637,DSC 204A,A00,915910,Zhang; Hao,65,0,90,25
1748430334664,DSC 207R,A01,915912,Soosai Raj; Adalbert Geral,99,0,100,1
1748430335692,DSC 209R,A01,915922,Lau; Samuel Ethan,34,0,75,41
1748430336719,DSC 210,A00,915979,Weng; Tsui-Wei (lily),0,0,100,100
1748430337747,DSC 212,A00,915984,Mazumdar; Arya,0,0,90,90
1748430338776,DSC 215R,A01,916032,Saab; Rayan,99,0,100,1
1748430340837,DSC 241,A00,916052,Aoi; Mikio C,81,0,90,9
1748430341867,DSC 256R,A01,916054,McAuley; Julian John,42,0,100,58
1748430342898,DSC 257R,A01,916057,Dasgupta; Sanjoy,50,0,75,25
1748430343927,DSC 261,A00,916058,Salimi; Babak,0,0,90,90
1748430344955,DSC 291,A00,916059,Rahman; Tauhidur,0,0,60,60
1748430344955,DSC 291,B00,916060,Wang; Yuxiang,0,0,60,60
1748430344955,DSC 291,C00,916061,Li; Aobo,0,0,40,40
1748430345986,DSC 293,A00,916062,Ustun; Tevfik Berk,9983,0,9999,16
1748430347024,DSC 294,001,970730,Danks; David J,9999,0,9999,0
1748430347024,DSC 294,002,970731,Hu; Zhiting,9999,0,9999,0
1748430347024,DSC 294,003,970732,Schwartzman; Armin,9999,0,9999,0
1748430347024,DSC 294,004,970739,Salimi; Babak,9999,0,9999,0
1748430347024,DSC 294,005,970742,Wang; Yuxiang,9999,0,9999,0
1748430347024,DSC 294,006,970749,Huang; Biwei,9999,0,9999,0
1748430347024,DSC 294,007,970751,Amariuta-Bartell; Tiffany,9999,0,9999,0
1748430347024,DSC 294,008,970754,Smarr; Benjamin,9999,0,9999,0
1748430347024,DSC 294,009,970755,Jin; Haojian,9999,0,9999,0
1748430347024,DSC 294,010,970758,Ma; Yian,9999,0,9999,0
1748430347024,DSC 294,011,970763,Warstadt; Alexander Scott,9999,0,9999,0
1748430347024,DSC 294,012,970764,Wang; Yusu,9999,0,9999,0
1748430347024,DSC 294,013,970766,Lau; Samuel Ethan,9999,0,9999,0
1748430347024,DSC 294,014,970771,Politis; Dimitris,9999,0,9999,0
1748430348052,DSE 200,A00,915842,Staff,30,0,30,0
1748430349079,DSE 203,A00,915844,Staff,20,0,20,0
1748430350109,DSE 220,A00,915845,Staff,20,0,20,0
1748430351138,DSE 290,A00,915846,Staff,30,0,30,0
1748430352175,DSGN 1,A01,913417,Meyer; Michael Wayne,0,0,50,50
1748430352175,DSGN 1,A02,913418,Meyer; Michael Wayne,14,0,50,36
1748430354241,DSGN 118,A01,914325,Xia; Haijun,0,0,50,50
1748430355272,DSGN 201,A00,970721,Eikey; Elizabeth Victoria,10,0,20,10
1748430356314,ECE 5,A01,917741,Morris; Karcher William,0,0,0,0
1748430356314,ECE 5,A02,917742,Morris; Karcher William,0,0,0,0
1748430356314,ECE 5,A03,917775,Morris; Karcher William,0,0,0,0
1748430356314,ECE 5,A04,917804,Morris; Karcher William,0,0,0,0
1748430356314,ECE 5,A05,917811,Morris; Karcher William,0,0,0,0
1748430356314,ECE 5,A06,917816,Morris; Karcher William,0,0,0,0
1748430357348,ECE 15,A01,917850,Schurgers; Curt,0,0,0,0
1748430357348,ECE 15,A02,917851,Schurgers; Curt,0,0,0,0
1748430358379,ECE 17,A01,917878,Sahay; Rajeev,61,0,65,4
1748430359409,ECE 18,A01,917886,Sahay; Rajeev,42,0,50,8
1748430360446,ECE 25,A50,917898,Liu; Zhaowei,0,0,0,0
1748430360446,ECE 25,A51,917900,Liu; Zhaowei,0,0,0,0
1748430360446,ECE 25,A52,917904,Liu; Zhaowei,0,0,0,0
1748430360446,ECE 25,A53,969573,Liu; Zhaowei,0,0,0,0
1748430361479,ECE 30,A50,917909,Mir Arabbaygi; Siavash,10,0,30,20
1748430361479,ECE 30,A51,917910,Mir Arabbaygi; Siavash,21,0,30,9
1748430361479,ECE 30,A52,917912,Mir Arabbaygi; Siavash,29,0,30,1
1748430362523,ECE 35,A50,917993,Schurgers; Curt,0,0,0,0
1748430362523,ECE 35,A51,917994,Schurgers; Curt,0,0,0,0
1748430362523,ECE 35,A52,918000,Schurgers; Curt,0,0,0,0
1748430362523,ECE 35,A53,918001,Schurgers; Curt,0,0,0,0
1748430362523,ECE 35,A54,918072,Schurgers; Curt,0,0,0,0
1748430362523,ECE 35,A55,918078,Schurgers; Curt,0,0,0,0
1748430362523,ECE 35,B50,918131,Schurgers; Curt,0,0,0,0
1748430362523,ECE 35,B51,918135,Schurgers; Curt,0,0,0,0
1748430362523,ECE 35,B52,918146,Schurgers; Curt,0,0,0,0
1748430362523,ECE 35,B53,918147,Schurgers; Curt,0,0,0,0
1748430362523,ECE 35,B54,918148,Schurgers; Curt,0,0,0,0
1748430362523,ECE 35,B55,918149,Schurgers; Curt,0,0,0,0
1748430363552,ECE 45,A01,918151,Zeger; Kenneth A.,94,0,120,26
1748430364586,ECE 65,A50,918356,Baghdadchi; Saharnaz,1,0,30,29
1748430364586,ECE 65,A51,918470,Baghdadchi; Saharnaz,17,0,30,13
1748430364586,ECE 65,A52,918477,Baghdadchi; Saharnaz,25,0,30,5
1748430365630,ECE 100,A01,918485,Baghdadchi; Saharnaz,0,0,30,30
1748430365630,ECE 100,A02,918486,Baghdadchi; Saharnaz,1,0,30,29
1748430365630,ECE 100,A03,918488,Baghdadchi; Saharnaz,0,0,30,30
1748430365630,ECE 100,A04,918490,Baghdadchi; Saharnaz,22,0,30,8
1748430366658,ECE 101,A01,918495,Zheng; Yang,21,0,75,54
1748430366658,ECE 101,A02,918497,Zheng; Yang,51,0,75,24
1748430367695,ECE 102,A00,918499,Hsueh; Tzu-Chien,52,0,100,48
1748430368722,ECE 103,A01,918621,Ng; Tse Nga,45,0,60,15
1748430369760,ECE 107,A01,918642,Fullerton; Eric E,31,0,70,39
1748430370791,ECE 108,A01,918661,Turakhia; Yatish Girish,6,0,70,64
1748430371823,ECE 109,A01,918758,Poveda Fonseca; Jorge,122,0,149,27
1748430372852,ECE 111,A01,918766,Koushanfar; Farinaz,46,0,75,29
1748430373881,ECE 121A,A50,918857,Esmaili; Gholamreza,11,0,24,13
1748430373881,ECE 121A,A51,918888,Esmaili; Gholamreza,15,0,24,9
1748430373881,ECE 121A,A52,918889,Esmaili; Gholamreza,2,0,24,22
1748430374906,ECE 128A,A00,918911,Esmaili; Gholamreza,53,0,75,22
1748430375932,ECE 135A,A01,918931,Kuzum; Duygu,24,0,40,16
1748430376964,ECE 143,A00,918936,Staff,0,0,0,3
1748430377998,ECE 148,A01,918940,Silberman; Jack,14,0,24,10
1748430379027,ECE 155,A01,919022,Gonzalez Prelcic; Nuria,20,0,25,5
1748430380058,ECE 158A,A01,919041,Javidi; Tara,58,0,70,12
1748430381143,ECE 161A,A01,919070,Meyer; Florian,65,0,80,15
1748430382178,ECE 164,A00,919098,Hall; Drew A.,100,0,146,46
1748430383213,ECE 166,A50,919250,Rebeiz; Gabriel,0,0,30,30
1748430383213,ECE 166,A51,919254,Rebeiz; Gabriel,23,0,30,7
1748430383213,ECE 166,A52,919262,Rebeiz; Gabriel,29,0,30,1
1748430383213,ECE 166,A53,919316,Rebeiz; Gabriel,28,0,30,2
1748430384240,ECE 171B,A01,919338,Shi; Yuanyuan,36,0,50,14
1748430385268,ECE 174,A01,919371,Wang; Jun-Kun,77,0,100,23
1748430386300,ECE 180,A00,968047,Fainman; Yeshaiahu,30,0,30,0
1748430387328,ECE 182,A01,962444,Fainman; Yeshaiahu,24,0,30,6
1748430388354,ECE 197,001,919379,Mercier; Patrick Philip,9999,0,9999,0
1748430389381,ECE 198,001,919418,Nguyen; Truong Quang,9999,0,9999,0
1748430390415,ECE 201,A00,919420,Lo; Yu-Hwa,0,0,0,0
1748430391442,ECE 203,A01,919506,Mercier; Patrick Philip,0,0,0,0
1748430392472,ECE 207A,A00,919507,Liu; Thomas Tao-Ming & McVeigh; Elliot R.,0,0,0,0
1748430393502,ECE 212AN,A00,919508,Nomura; Kenji,0,0,0,0
1748430394533,ECE 222A,A00,919524,Rebeiz; Gabriel,0,0,0,0
1748430395558,ECE 225A,A00,919525,Orlitsky; Alon,0,0,0,0
1748430396586,ECE 230A,A00,919526,Nomura; Kenji,0,0,0,0
1748430397613,ECE 238A,A00,919540,Luo; Jian,0,0,0,0
1748430398637,ECE 240A,A00,919541,Ndao; Abdoulaye,0,0,0,0
1748430399661,ECE 247A,A00,919553,Shi; Lingyan,0,0,0,0
1748430400690,ECE 247B,A00,919562,Aran; Kiana,0,0,0,0
1748430401716,ECE 250,A00,919563,Naghizadeh Ardabili; Parinaz,0,0,0,0
1748430402747,ECE 251C,A00,919583,Parhi; Rahul,0,0,0,0
1748430403779,ECE 253,A00,919597,Nguyen; Truong Quang,0,0,0,0
1748430404807,ECE 255A,A00,919638,Orlitsky; Alon,0,0,0,0
1748430405841,ECE 257A,A01,919640,Zhang; Xinyu,0,0,0,0
1748430406867,ECE 258A,A00,919653,Heath Jr.; Robert Wendell,0,0,0,0
1748430407898,ECE 260A,A01,919655,Eldon; John,0,0,0,0
1748430408929,ECE 264C,A00,919656,Galton; Ian A,0,0,0,0
1748430409954,ECE 265C,A00,919672,Staff,0,0,0,0
1748430410982,ECE 271A,A00,919673,Vasconcelos; Nuno,0,0,0,0
1748430412009,ECE 276C,A00,919674,Yip; Michael,0,0,0,0
1748430413035,ECE 283,A00,919675,Le; Hanh-Phuc,0,0,0,0
1748430413035,ECE 283,B00,919676,Hall; Drew A.,0,0,0,0
1748430414065,ECE 284,A00,919691,Kang; Mingu,0,0,0,0
1748430415092,ECE 285,A00,919718,Naghizadeh Ardabili; Parinaz,0,0,0,0
1748430416128,ECON 1,A01,917129,Famulari; Melissa,33,0,40,7
1748430416128,ECON 1,A02,917130,Famulari; Melissa,39,0,40,1
1748430416128,ECON 1,A03,917131,Famulari; Melissa,45,0,45,0
1748430416128,ECON 1,B01,917133,Famulari; Melissa,39,0,40,1
1748430416128,ECON 1,B02,917134,Famulari; Melissa,38,0,40,2
1748430416128,ECON 1,B03,917135,Famulari; Melissa,45,0,45,0
1748430416128,ECON 1,C01,917137,Levkoff; Steven B.,53,0,60,7
1748430416128,ECON 1,C02,917138,Levkoff; Steven B.,60,0,60,0
1748430416128,ECON 1,C03,917139,Levkoff; Steven B.,59,0,60,1
1748430416128,ECON 1,C04,917140,Levkoff; Steven B.,60,0,60,0
1748430416128,ECON 1,C05,917141,Levkoff; Steven B.,59,0,60,1
1748430416128,ECON 1,D01,917144,Levkoff; Steven B.,44,0,50,6
1748430416128,ECON 1,D02,917145,Levkoff; Steven B.,50,0,50,0
1748430416128,ECON 1,D03,917146,Levkoff; Steven B.,50,0,50,0
1748430416128,ECON 1,D04,917154,Levkoff; Steven B.,50,0,50,0
1748430417156,ECON 2,A01,917160,Crane; Meredith Helen,35,0,45,10
1748430417156,ECON 2,A02,917164,Crane; Meredith Helen,43,0,45,2
1748430418183,ECON 3,A01,917170,Ma; Alyson Chan,41,0,60,19
1748430419215,ECON 4,A01,917174,Brooks; Marcus Raymond,0,0,0,0
1748430420242,ECON 5,A01,917177,Staff,12,0,30,18
1748430420242,ECON 5,B01,917182,Staff,16,0,30,14
1748430420242,ECON 5,C01,917193,Dai; Yinlin,0,0,30,30
1748430421268,ECON 86,A00,917197,Muendler; Marc,95,0,100,5
1748430422299,ECON 100A,A01,917209,Newhouse; Herbert S,32,0,50,18
1748430422299,ECON 100A,A02,917212,Newhouse; Herbert S,34,0,50,16
1748430422299,ECON 100A,A03,917213,Newhouse; Herbert S,41,0,50,9
1748430422299,ECON 100A,B01,917216,Newhouse; Herbert S,0,0,50,50
1748430422299,ECON 100A,B02,917298,Newhouse; Herbert S,21,0,50,29
1748430422299,ECON 100A,B03,917301,Newhouse; Herbert S,44,0,50,6
1748430423327,ECON 100B,A01,917305,Crane; Meredith Helen,0,0,75,75
1748430423327,ECON 100B,B01,917309,Crane; Meredith Helen,0,0,75,75
1748430424353,ECON 100C,A01,917311,Staff,0,0,25,25
1748430425380,ECON 109,A01,917313,Shishkin; Denis,58,0,65,7
1748430425380,ECON 109,B01,917315,Shishkin; Denis,59,0,75,16
1748430426415,ECON 110A,A01,917336,Jaimovich; Nir,44,0,70,26
1748430426415,ECON 110A,B01,917339,Jaimovich; Nir,19,0,37,18
1748430426415,ECON 110A,B02,917341,Jaimovich; Nir,36,0,38,2
1748430427442,ECON 110B,A01,917388,Trottner; Fabian Gunter We,0,0,50,50
1748430427442,ECON 110B,A02,917389,Trottner; Fabian Gunter We,0,0,50,50
1748430427442,ECON 110B,A03,917390,Trottner; Fabian Gunter We,14,0,50,36
1748430427442,ECON 110B,B01,917396,Trottner; Fabian Gunter We,24,0,50,26
1748430428478,ECON 120A,A01,917401,Dai; Yinlin,21,0,50,29
1748430428478,ECON 120A,A02,917405,Dai; Yinlin,40,0,50,10
1748430428478,ECON 120A,B01,917408,Dai; Yinlin,0,0,40,40
1748430428478,ECON 120A,B02,917409,Dai; Yinlin,0,0,40,40
1748430428478,ECON 120A,B03,917410,Dai; Yinlin,30,0,40,10
1748430429515,ECON 120B,A01,917415,Candido; Maria Teresa,0,0,98,98
1748430429515,ECON 120B,A02,917418,Candido; Maria Teresa,78,0,98,20
1748430429515,ECON 120B,B01,917422,Candido; Maria Teresa,33,0,98,65
1748430429515,ECON 120B,B02,917423,Candido; Maria Teresa,75,0,98,23
1748430430541,ECON 120C,A01,917505,Candido; Maria Teresa,81,0,146,65
1748430431566,ECON 121,A00,917511,Vogl; Tom Saul,68,0,70,2
1748430431566,ECON 121,B00,917516,Vogl; Tom Saul,55,0,70,15
1748430432591,ECON 130,A00,917518,Staff,165,0,190,25
1748430433619,ECON 131,A00,917519,Jacobsen; Mark,56,0,120,64
1748430434648,ECON 139,A00,917520,Arnold; David Hall,21,0,50,29
1748430435675,ECON 152,A00,917523,Fadlon; Yizhak,87,0,90,3
1748430435675,ECON 152,B00,917524,Fadlon; Yizhak,88,0,90,2
1748430436720,ECON 181,A00,965256,Esfahani; Sara,88,0,100,12
1748430437760,ECON 186,A00,917525,Ross; Stephen Geoffrey,80,0,110,30
1748430438784,ECON 191B,A00,917527,Cullen; Julie,20,0,20,0
1748430439814,ECON 200A,A00,917529,Shishkin; Denis,20,0,20,0
1748430440840,ECON 204,A00,917531,Watson; Joel Christopher,25,0,25,0
1748430441864,ECON 205,A00,917532,Du; Songzi,20,0,20,0
1748430442891,ECON 210A,A00,917536,Alon; Titan Michael,20,0,20,0
1748430443916,ECON 220A,A00,917537,Elliott; Graham,20,0,20,0
1748430445063,ECON 220D,A00,917538,Hamilton; James D.,22,0,30,8
1748430446092,ECON 221,A00,960527,Zhu; Ying,20,0,20,0
1748430447121,ECON 232,A00,917539,Fadlon; Yizhak,18,0,20,2
1748430448150,ECON 242,A00,917540,Vogl; Tom Saul & Lee; Munseob,17,0,20,3
1748430449178,ECON 250A,A00,917544,Berman; Eli & Betts; Julian & Arnold; David Hall,21,0,25,4
1748430450205,ECON 262,A00,917546,Trevino; Isabel,20,0,20,0
1748430451233,ECON 268,A00,917547,Boomhower; Judson P,18,0,20,2
1748430452268,ECON 280,A00,917549,Arnold; David Hall,20,0,20,0
1748430453294,ECON 281,A00,917550,Jacobsen; Mark,20,0,20,0
1748430453294,ECON 281,B00,917553,Jaimovich; Nir,15,0,20,5
1748430454319,ECON 285,A00,917554,Bharadwaj; Prashant & Zhu; Ying,24,0,25,1
1748430455345,ECON 286,A00,917556,Ma; Xinwei,20,0,20,0
1748430455345,ECON 286,B00,917558,Eckert; Fabian Paul & Wu; Pak Yeung,20,0,20,0
1748430455345,ECON 286,C00,917559,Bharadwaj; Prashant,20,0,20,0
1748430455345,ECON 286,D00,969571,Cullen; Julie,20,0,20,0
1748430455345,ECON 286,E00,969572,Vespa; Emanuel Ignacio,19,0,20,1
1748430456372,ECON 296,A00,917565,Bharadwaj; Prashant & Zhu; Ying,24,0,25,1
1748430457397,EDS 31,A00,960270,Bussey; Thomas J,5,0,10,5
1748430458452,EDS 88,A00,960441,Bintliff; Amy S.V.,16,0,20,4
1748430459479,EDS 110R,A01,943452,Wishard Guerra; Alison G.,33,0,60,27
1748430459479,EDS 110R,B01,960792,Wishard Guerra; Alison G.,20,0,20,0
1748430460507,EDS 111,A00,969314,Cohen; Shana R,31,0,60,29
1748430461532,EDS 112,A00,969313,Chapman; Thandeka K,32,0,50,18
1748430462558,EDS 114,A01,943493,Eguchi; Emi,19,0,20,1
1748430462558,EDS 114,A02,943494,Eguchi; Emi,18,0,20,2
1748430463582,EDS 115,A00,943495,Jones; Gabrielle Anastasia,46,0,60,14
1748430464627,EDS 117,A01,943675,Jones; Makeba,17,0,37,20
1748430464627,EDS 117,A02,943682,Jones; Makeba,36,0,37,1
1748430464627,EDS 117,A03,943683,Jones; Makeba,33,0,38,5
1748430464627,EDS 117,A04,943691,Jones; Makeba,35,0,38,3
1748430464627,EDS 117,B01,943693,Jones; Gabrielle Anastasia,21,0,30,9
1748430464627,EDS 117,B02,943694,Jones; Gabrielle Anastasia,27,0,30,3
1748430464627,EDS 117,B03,943695,Jones; Gabrielle Anastasia,28,0,30,2
1748430464627,EDS 117,B04,943696,Jones; Gabrielle Anastasia,30,0,30,0
1748430465653,EDS 124AR,A00,943698,Simon; Elizabeth A,129,0,150,21
1748430465653,EDS 124AR,B00,943699,Simon; Elizabeth A,149,0,150,1
1748430465653,EDS 124AR,C00,961307,Simon; Elizabeth A,40,0,40,0
1748430466678,EDS 124BR,A00,943700,Eguchi; Emi,122,0,150,28
1748430466678,EDS 124BR,B00,961276,Eguchi; Emi,20,0,20,0
1748430467708,EDS 125,A00,943701,Jones; Gabrielle Anastasia,49,0,60,11
1748430468742,EDS 129A,A01,943703,Heinzman; Erica M.,48,0,50,2
1748430469772,EDS 130,A01,943705,Staff,6,0,20,14
1748430469772,EDS 130,A02,943706,Staff,18,0,20,2
1748430469772,EDS 130,A03,943707,Staff,20,0,20,0
1748430470802,EDS 131,A01,943709,Staff,8,0,20,12
1748430470802,EDS 131,A02,943710,Staff,17,0,20,3
1748430471827,EDS 133,A01,960443,Bintliff; Amy S.V.,20,0,25,5
1748430471827,EDS 133,A02,960447,Bintliff; Amy S.V.,15,0,15,0
1748430472854,EDS 139,A00,943725,Heinzman; Erica M.,40,0,50,10
1748430472854,EDS 139,B00,943726,Staff,29,0,50,21
1748430472854,EDS 139,C00,943788,Staff,34,0,50,16
1748430472854,EDS 139,E00,943802,Bintliff; Amy S.V.,42,0,50,8
1748430472854,EDS 139,F00,960448,Bintliff; Amy S.V.,40,0,40,0
1748430473881,EDS 149,A00,943814,Black; Alison Michelle,20,0,20,0
1748430474906,EDS 201,A00,943816,Fine; Sarah,44,0,45,1
1748430475934,EDS 203,A01,943818,Eguchi; Emi,44,0,45,1
1748430476978,EDS 205A,A00,943819,Staff,44,0,45,1
1748430478004,EDS 246,A01,943855,Cohen; Shana R,10,0,10,0
1748430479029,EDS 250,A00,943856,Chapman; Thandeka K,49,0,50,1
1748430480054,EDS 251,A00,943862,Wishard Guerra; Alison G.,10,0,10,0
1748430481081,EDS 257,A00,943863,Datnow; Amanda Lee,7,0,10,3
1748430482109,EDS 283,A00,943871,Daly; Alan J.,15,0,15,0
1748430483133,EDS 285,A00,943872,Daly; Alan J.,15,0,15,0
1748430484157,EDS 286,A00,943873,Daly; Alan J.,15,0,15,0
1748430485235,EDS 289D,A00,943874,Hofstetter; Carolyn,15,0,15,0
1748430486259,EDS 292,A00,943876,Hofstetter; Carolyn,15,0,15,0
1748430487303,EDS 296,001,970523,Aragon; Maria Jose,9999,0,9999,0
1748430487303,EDS 296,002,970539,Bintliff; Amy S.V.,9997,0,9999,2
1748430487303,EDS 296,003,970543,Chapman; Thandeka K,9999,0,9999,0
1748430487303,EDS 296,004,970544,Clarke; Sherice Nicole,9999,0,9999,0
1748430487303,EDS 296,005,970587,Cohen; Shana R,9998,0,9999,1
1748430487303,EDS 296,006,970606,Daly; Alan J.,9998,0,9999,1
1748430487303,EDS 296,007,970607,Datnow; Amanda Lee,9997,0,9999,2
1748430487303,EDS 296,008,970608,Eguchi; Emi,9999,0,9999,0
1748430487303,EDS 296,009,970609,Fine; Sarah,9999,0,9999,0
1748430487303,EDS 296,010,970614,Hofstetter; Carolyn,9998,0,9999,1
1748430487303,EDS 296,011,970615,Hopkins; Megan Beth,9998,0,9999,1
1748430487303,EDS 296,012,970616,Jones; Makeba,9999,0,9999,0
1748430487303,EDS 296,013,970631,Jones; Gabrielle Anastasia,9999,0,9999,0
1748430487303,EDS 296,014,970636,Mamas; Christoforos,9998,0,9999,1
1748430487303,EDS 296,015,970649,Phuong; Andrew,9999,0,9999,0
1748430487303,EDS 296,016,970670,Pollock; Mica,9999,0,9999,0
1748430487303,EDS 296,017,970671,Wishard Guerra; Alison G.,9998,0,9999,1
1748430488343,EDS 297,001,972987,Staff,1,0,1,0
1748430489368,ENG 5,A00,916064,Rodriguez; Ruben,70,0,70,0
1748430490396,ENG 10,A00,916066,Evdokimenko; Ekaterina,58,0,60,2
1748430491423,ENG 15,A00,916067,Evdokimenko; Ekaterina,24,0,30,6
1748430492455,ENG 100D,A00,916069,Ngo; Anh-Thu T.,23,0,50,27
1748430493486,ENG 100L,A00,916070,Kleissl; Jan,8,0,8,0
1748430493486,ENG 100L,B00,916071,Bratton; Maryann,8,0,8,0
1748430493486,ENG 100L,C00,916072,Goldberg; Charles G.,8,0,8,0
1748430493486,ENG 100L,D00,916073,de Oliveira; Mauricio,8,0,8,0
1748430493486,ENG 100L,E00,916074,Bratton; Maryann,8,0,8,0
1748430493486,ENG 100L,F00,916075,Boyle; Mary E. T.,8,0,8,0
1748430494522,ENVR 30,A01,959899,Amoa-Bosompem; Michael,17,0,30,13
1748430494522,ENVR 30,A02,959900,Amoa-Bosompem; Michael,27,0,30,3
1748430494522,ENVR 30,A03,959901,Amoa-Bosompem; Michael,26,0,30,4
1748430494522,ENVR 30,A04,959902,Amoa-Bosompem; Michael,28,0,30,2
1748430494522,ENVR 30,A05,959903,Amoa-Bosompem; Michael,29,0,30,1
1748430494522,ENVR 30,A06,959904,Amoa-Bosompem; Michael,30,0,30,0
1748430495577,ENVR 102,A00,960031,Laughing; Cheron,23,0,25,2
1748430496602,ERC 20,A00,921227,Evans; Ivan T,30,0,30,0
1748430496602,ERC 20,B00,921229,Evans; Ivan T,30,0,30,0
1748430497632,ERC 88,A00,961214,Peterson; Johanna L,19,0,20,1
1748430498660,ESYS 101,A01,921233,Taylor; Jennifer Rebecca,21,0,32,11
1748430498660,ESYS 101,A02,921234,Taylor; Jennifer Rebecca,14,0,32,18
1748430498660,ESYS 101,A03,921235,Taylor; Jennifer Rebecca,20,0,32,12
1748430498660,ESYS 101,A04,921241,Taylor; Jennifer Rebecca,26,0,32,6
1748430499771,ESYS 187A,A01,921248,Hetherington; Elizabeth Dorsey,30,0,40,10
1748430499771,ESYS 187A,B01,921250,Shipp; Lauren Elizabeth,27,0,40,13
1748430500806,ETHN 1,A01,919800,Wilson; Brenda K,13,0,15,2
1748430500806,ETHN 1,A02,919843,Wilson; Brenda K,14,0,15,1
1748430500806,ETHN 1,A03,920214,Wilson; Brenda K,15,0,15,0
1748430500806,ETHN 1,A04,920215,Wilson; Brenda K,14,0,15,1
1748430500806,ETHN 1,A05,920223,Wilson; Brenda K,15,0,15,0
1748430500806,ETHN 1,A06,920224,Wilson; Brenda K,15,0,15,0
1748430500806,ETHN 1,A07,920225,Wilson; Brenda K,15,0,15,0
1748430500806,ETHN 1,A08,920226,Wilson; Brenda K,12,0,15,3
1748430500806,ETHN 1,A09,920237,Wilson; Brenda K,15,0,15,0
1748430500806,ETHN 1,A10,920368,Wilson; Brenda K,15,0,15,0
1748430500806,ETHN 1,A11,920402,Wilson; Brenda K,15,0,15,0
1748430500806,ETHN 1,A12,920406,Wilson; Brenda K,15,0,15,0
1748430500806,ETHN 1,A13,920410,Wilson; Brenda K,14,0,15,1
1748430500806,ETHN 1,A14,920441,Wilson; Brenda K,14,0,15,1
1748430501831,ETHN 20R,A01,920461,Sasaki; Christen T,0,0,15,15
1748430501831,ETHN 20R,A02,920467,Sasaki; Christen T,0,0,15,15
1748430501831,ETHN 20R,A03,920468,Sasaki; Christen T,0,0,15,15
1748430501831,ETHN 20R,A04,920470,Sasaki; Christen T,0,0,15,15
1748430502861,ETHN 100A,A00,920489,Patel; Shaista,18,0,35,17
1748430503886,ETHN 101TV,A01,920518,Gallagher-Geurtsen; Tricia Meghan,21,0,25,4
1748430503886,ETHN 101TV,A02,920519,Gallagher-Geurtsen; Tricia Meghan,20,0,25,5
1748430503886,ETHN 101TV,A03,920522,Gallagher-Geurtsen; Tricia Meghan,24,0,25,1
1748430503886,ETHN 101TV,A04,920523,Gallagher-Geurtsen; Tricia Meghan,22,0,25,3
1748430504919,ETHN 110,A00,920528,Klann; Mary Cameron,27,0,35,8
1748430505986,ETHN 116,A00,920529,Cuong; Marisol,29,0,35,6
1748430507016,ETHN 120,A00,920542,Tran; Ly Thi Hai,31,0,35,4
1748430508054,ETHN 122A,A00,920559,Museus; Samuel David,30,0,35,5
1748430509079,ETHN 125R,A00,920694,Sasaki; Christen T,0,0,35,35
1748430510105,ETHN 130,A00,920703,Frank; Ross H.,28,0,30,2
1748430511129,ETHN 139,A00,920704,Ruiz; Ariana,18,0,20,2
1748430512162,ETHN 150,A00,920717,Taylor-Garcia; Daphne,16,0,16,0
1748430513189,ETHN 161,A00,920826,Browne; Errol Tsekani,33,0,35,2
1748430514213,ETHN 174,A00,963091,Staff,15,0,15,0
1748430515238,ETHN 186,A00,959881,Perez; Roy,25,0,30,5
1748430516267,ETHN 187,A00,920860,Martin Sandino; Amanda Maria Yoland,16,0,16,0
1748430517295,ETHN 189,A00,920861,Museus; Samuel David,18,0,20,2
1748430518320,ETHN 200A,A00,920862,Espiritu; Yen,7,0,10,3
1748430519349,ETHN 230,A00,920864,Perreira; Christopher Michael,8,0,10,2
1748430520373,ETIM 289,A00,921224,Patel; Shaista,10,0,10,0
1748430521446,EXPR 100,A00,964355,Staff,9999,0,9999,0
1748430522471,EXPR 105,A00,964356,Staff,9999,0,9999,0
1748430523498,EXPR 201,A00,964357,Staff,9999,0,9999,0
1748430524523,EXPR 205,A00,964358,Staff,9999,0,9999,0
1748430525549,FILM 71,A01,960804,Park; Joanne Moeun,0,0,11,11
1748430525549,FILM 71,B01,960877,Park; Joanne Moeun,3,0,11,8
1748430526575,FILM 72,A01,964349,Kroopf; Jackson Stanford,9,0,11,2
1748430526575,FILM 72,B01,964351,Kroopf; Jackson Stanford,9,0,11,2
1748430527601,FILM 73,A01,964345,Staff,0,0,0,0
1748430527601,FILM 73,B01,964347,Kroopf; Jackson Stanford,7,0,11,4
1748430528625,FMPH 291,A00,969582,Tsuyuki; Kiyomi,10,0,10,0
1748430529652,FPM 291,A00,922036,Rabin; Adrienn Borsika & Stadnick; Nicole & Aarons; Gregory A,12,0,12,0
1748430530683,GLBH 20,A00,921344,Elwardani; Nile Regina,137,0,146,9
1748430531709,GLBH 100,A00,921503,Jenkins; Janis A.,5,0,12,7
1748430531709,GLBH 100,B00,921504,Schonberg; Jeffrey,18,0,20,2
1748430532743,GLBH 111,A01,921733,Burgos; Jose L.,17,0,17,0
1748430532743,GLBH 111,B01,921862,Burgos; Jose L.,17,0,17,0
1748430533770,GLBH 114,A00,921864,Olivas Hernandez; Olga Lid,42,0,50,8
1748430534800,GLBH 116,A00,921865,Villarino; Margarita,41,0,45,4
1748430535825,GLBH 117,A00,921873,Villarino; Margarita,40,0,40,0
1748430536853,GLBH 118,A00,921884,Wilson; Brenda K,25,0,32,7
1748430537881,GLBH 119,A00,921956,Elwardani; Nile Regina,40,0,40,0
1748430538908,GLBH 148,A00,921961,Walkover; Lillian B,75,0,100,25
1748430539933,GLBH 181,A00,921962,Burgos; Jose L.,188,0,216,28
1748430540958,GLBH 200,A00,921963,Schonberg; Jeffrey,15,0,18,3
1748430541983,GLBH 201,A00,921982,Staff,16,0,18,2
1748430543011,GLBH 248,A00,921999,Kaiser; Bronwyn Nicole,16,0,18,2
1748430544038,GPEC 243,A00,946441,McCord; Gordon Carlos,96,0,100,4
1748430545071,GSS 20,A00,923030,Siapno; Jacqueline A,38,0,40,2
1748430545071,GSS 20,B00,923031,Siapno; Jacqueline A,36,0,40,4
1748430546098,HDS 1,A01,923033,Reese; Clarissa Jane,25,0,25,0
1748430546098,HDS 1,A02,923034,Reese; Clarissa Jane,20,0,25,5
1748430546098,HDS 1,A03,923035,Reese; Clarissa Jane,19,0,25,6
1748430546098,HDS 1,A04,923036,Reese; Clarissa Jane,22,0,25,3
1748430546098,HDS 1,A05,923037,Reese; Clarissa Jane,22,0,25,3
1748430546098,HDS 1,A06,923038,Reese; Clarissa Jane,23,0,25,2
1748430546098,HDS 1,A07,923039,Reese; Clarissa Jane,24,0,25,1
1748430547123,HDS 60,A01,923041,Staff,25,0,30,5
1748430547123,HDS 60,A02,923042,Staff,21,0,30,9
1748430548148,HDS 111,A00,923043,Staff,13,0,40,27
1748430549177,HDS 124,A00,923044,Staff,29,0,40,11
1748430550204,HDS 150,A00,923045,Staff,20,0,20,0
1748430551231,HDS 175,A00,923046,Staff,14,0,25,11
1748430552258,HDS 181,A01,923048,Staff,30,0,30,0
1748430553285,HDS 191,A01,923050,Reese; Clarissa Jane,25,0,25,0
1748430554314,HIEA 112,A00,922103,Matsumura; Wendy Y,92,0,115,23
1748430555339,HIEA 153,A00,922106,Henry; Todd A.,43,0,51,8
1748430556364,HIEU 108,A00,922108,Balberg; Mira,29,0,70,41
1748430557391,HIEU 114,A00,959889,Staff,59,0,70,11
1748430558422,HIEU 139,A00,922110,Strasser; Ulrike,40,0,51,11
1748430559448,HIEU 140,A00,922111,Radcliff; Pamela B.,58,0,65,7
1748430560473,HIEU 154,A00,922113,Hansen; Jan Eric,55,0,65,10
1748430561499,HIEU 158,A00,922116,Hertz; Deborah,61,0,70,9
1748430562528,HIEU 171,A00,922117,Hertz; Deborah,15,0,15,0
1748430563555,HIEU 271,A00,922189,Hertz; Deborah,0,0,0,0
1748430564581,HIGR 200,A00,922191,Matsumura; Wendy Y,10,0,10,0
1748430565607,HIGR 210,A00,922221,Muscolino; Micah S,8,0,10,2
1748430566639,HIGR 222,A00,963094,Biess; Frank Peter,10,0,10,0
1748430567669,HIGR 238,A00,922242,McKenzie; Kerry V.,9,0,10,1
1748430568694,HIGR 240,A00,922253,McKenzie; Kerry V.,10,0,10,0
1748430569720,HIGR 267A,A00,922256,Widener; Daniel,8,0,10,2
1748430571774,HILA 114,A00,922118,Cowan; Benjamin A,42,0,65,23
1748430572803,HILA 131,A00,922125,Vitz; Matthew,91,0,99,8
1748430573834,HILA 161,A00,922126,Cowan; Benjamin A,12,0,15,3
1748430574862,HILD 2A,A01,922043,Staff,31,0,32,1
1748430574862,HILD 2A,A02,922044,Staff,31,0,32,1
1748430574862,HILD 2A,A03,922046,Staff,28,0,32,4
1748430574862,HILD 2A,A04,922047,Staff,32,0,32,0
1748430574862,HILD 2A,A05,922051,Staff,30,0,32,2
1748430575890,HILD 7A,A01,922063,Widener; Daniel,31,0,32,1
1748430575890,HILD 7A,A02,922066,Widener; Daniel,31,0,32,1
1748430575890,HILD 7A,A03,922067,Widener; Daniel,32,0,32,0
1748430575890,HILD 7A,A04,922070,Widener; Daniel,28,0,32,4
1748430575890,HILD 7A,A05,922072,Widener; Daniel,32,0,32,0
1748430575890,HILD 7A,A06,922074,Widener; Daniel,32,0,32,0
1748430575890,HILD 7A,A07,922078,Widener; Daniel,29,0,32,3
1748430575890,HILD 7A,A08,922080,Widener; Daniel,32,0,32,0
1748430575890,HILD 7A,A09,922081,Widener; Daniel,32,0,32,0
1748430575890,HILD 7A,A10,922082,Widener; Daniel,32,0,32,0
1748430575890,HILD 7A,A11,922083,Widener; Daniel,32,0,32,0
1748430575890,HILD 7A,A12,922084,Widener; Daniel,32,0,32,0
1748430576915,HILD 10,A01,922089,Muscolino; Micah S,30,0,32,2
1748430576915,HILD 10,A02,922090,Muscolino; Micah S,28,0,32,4
1748430576915,HILD 10,A03,922092,Muscolino; Micah S,31,0,32,1
1748430576915,HILD 10,A04,922095,Muscolino; Micah S,30,0,32,2
1748430577946,HILD 14,A01,959886,Murillo; Dana V.,26,0,32,6
1748430577946,HILD 14,A02,959887,Murillo; Dana V.,32,0,32,0
1748430578970,HINE 144,A00,922132,Provence; Michael,40,0,45,5
1748430579998,HINE 186,A00,922133,Provence; Michael,15,0,15,0
1748430581029,HISA 110,A00,922136,De; Aniket,38,0,45,7
1748430582053,HISA 122,A00,959884,De; Aniket,12,0,15,3
1748430583080,HISC 107,A00,922137,Golan; Tal,41,0,45,4
1748430584105,HISC 131,A00,922148,Golan; Tal,45,0,51,6
1748430585136,HITO 87,A00,922097,Patterson; Patrick H.,0,0,0,0
1748430585136,HITO 87,B00,922098,Patterson; Patrick H.,0,0,0,0
1748430586164,HITO 100,A00,922150,Martinez-Matsuda; Veronica,0,0,17,17
1748430587194,HITO 193,A00,954127,Hill; Seth J,9999,0,9999,0
1748430588229,HITO 194,001,970059,Hertz; Deborah,1,0,1,0
1748430588229,HITO 194,002,970084,Daly; Heather Marie,1,0,1,0
1748430588229,HITO 194,003,970086,Plant; Rebecca Jo,1,0,1,0
1748430588229,HITO 194,004,970093,Henry; Todd A.,1,0,1,0
1748430588229,HITO 194,005,970094,Biess; Frank Peter,1,0,1,0
1748430588229,HITO 194,006,970095,Shafir; Nir,1,0,1,0
1748430588229,HITO 194,007,970099,Martinez-Matsuda; Veronica,1,0,1,0
1748430588229,HITO 194,008,970101,De; Aniket,1,0,1,0
1748430588229,HITO 194,009,970126,Kwak; Nancy,1,0,1,0
1748430588229,HITO 194,010,970128,Muscolino; Micah S,1,0,1,0
1748430588229,HITO 194,011,970129,Hendrickson; Gerald M.,1,0,1,0
1748430588229,HITO 194,012,970132,Balberg; Mira,1,0,1,0
1748430589311,HITO 196,A00,922151,Man; Simeon S,14,0,22,8
1748430590342,HIUS 105,A00,922152,Bermudez; Rosie Cano,22,0,35,13
1748430591366,HIUS 106,A00,922154,Bermudez; Rosie Cano,52,0,65,13
1748430592394,HIUS 144,A00,922156,Daly; Heather Marie,31,0,35,4
1748430593418,HIUS 158,A00,922163,Frank; Ross H.,12,0,20,8
1748430594444,HIUS 181,A00,922187,Daly; Heather Marie,8,0,15,7
1748430595470,HIUS 281,A00,922264,Daly; Heather Marie,0,0,0,0
1748430596499,HUM 1,A01,946360,Markman; Kristina,14,0,15,1
1748430596499,HUM 1,A02,946361,Markman; Kristina,12,0,15,3
1748430596499,HUM 1,A03,946362,Markman; Kristina,14,0,15,1
1748430596499,HUM 1,A04,946363,Markman; Kristina,11,0,15,4
1748430596499,HUM 1,A05,946364,Markman; Kristina,14,0,15,1
1748430596499,HUM 1,A06,946365,Markman; Kristina,14,0,15,1
1748430596499,HUM 1,A07,946366,Markman; Kristina,14,0,15,1
1748430596499,HUM 1,A08,946367,Markman; Kristina,12,0,15,3
1748430596499,HUM 1,A09,946368,Markman; Kristina,13,0,15,2
1748430596499,HUM 1,A10,946369,Markman; Kristina,11,0,15,4
1748430596499,HUM 1,A11,946370,Markman; Kristina,6,0,15,9
1748430596499,HUM 1,A12,946371,Markman; Kristina,15,0,15,0
1748430597531,HUM 3,A01,946373,West; Geoffrey Scott,20,0,28,8
1748430597531,HUM 3,A02,946374,West; Geoffrey Scott,14,0,28,14
1748430597531,HUM 3,A03,946375,West; Geoffrey Scott,13,0,28,15
1748430597531,HUM 3,A04,946376,West; Geoffrey Scott,9,0,28,19
1748430597531,HUM 3,A05,946377,West; Geoffrey Scott,8,0,28,20
1748430597531,HUM 3,A06,946378,West; Geoffrey Scott,22,0,28,6
1748430597531,HUM 3,A07,946379,West; Geoffrey Scott,23,0,28,5
1748430597531,HUM 3,A08,946380,West; Geoffrey Scott,15,0,28,13
1748430597531,HUM 3,A09,946381,West; Geoffrey Scott,0,0,0,0
1748430597531,HUM 3,A10,946382,West; Geoffrey Scott,0,0,0,0
1748430597531,HUM 3,C01,946393,Crum; Matthew Stephen,0,0,0,0
1748430597531,HUM 3,C02,946394,Crum; Matthew Stephen,0,0,0,0
1748430597531,HUM 3,C03,946395,Crum; Matthew Stephen,17,0,28,11
1748430597531,HUM 3,C04,946396,Crum; Matthew Stephen,25,0,28,3
1748430597531,HUM 3,C05,946397,Crum; Matthew Stephen,16,0,28,12
1748430597531,HUM 3,C06,946398,Crum; Matthew Stephen,20,0,28,8
1748430597531,HUM 3,C07,946399,Crum; Matthew Stephen,24,0,28,4
1748430597531,HUM 3,C08,946400,Crum; Matthew Stephen,26,0,28,2
1748430597531,HUM 3,C09,946401,Crum; Matthew Stephen,18,0,28,10
1748430597531,HUM 3,C10,946402,Crum; Matthew Stephen,22,0,28,6
1748430597531,HUM 3,D01,946404,Rodriguez; Bretton Sigfred,4,0,28,24
1748430597531,HUM 3,D02,946405,Rodriguez; Bretton Sigfred,16,0,28,12
1748430597531,HUM 3,D03,946406,Rodriguez; Bretton Sigfred,25,0,28,3
1748430597531,HUM 3,D04,946407,Rodriguez; Bretton Sigfred,12,0,28,16
1748430597531,HUM 3,D05,946408,Rodriguez; Bretton Sigfred,12,0,28,16
1748430597531,HUM 3,D06,946409,Rodriguez; Bretton Sigfred,19,0,28,9
1748430597531,HUM 3,D07,946410,Rodriguez; Bretton Sigfred,0,0,0,0
1748430597531,HUM 3,D08,946411,Rodriguez; Bretton Sigfred,0,0,0,0
1748430597531,HUM 3,D09,946412,Rodriguez; Bretton Sigfred,7,0,28,21
1748430597531,HUM 3,D10,946413,Rodriguez; Bretton Sigfred,20,0,28,8
1748430598560,HUM 88,A00,969578,Markman; Kristina,0,0,0,0
1748430599586,HUM 100,A00,946414,West; Geoffrey Scott,14,0,16,2
1748430599586,HUM 100,B00,946415,West; Geoffrey Scott,15,0,16,1
1748430599586,HUM 100,C00,946416,Zavodny; Tatiana Sophia,13,0,16,3
1748430599586,HUM 100,D00,946417,Zavodny; Tatiana Sophia,15,0,16,1
1748430599586,HUM 100,E00,946419,Zavodny; Tatiana Sophia,15,0,16,1
1748430599586,HUM 100,F00,946420,Crum; Matthew Stephen,0,0,0,0
1748430599586,HUM 100,G00,946421,Crum; Matthew Stephen,0,0,0,0
1748430599586,HUM 100,H00,946422,Crum; Matthew Stephen,16,0,16,0
1748430599586,HUM 100,I00,946424,Staff,0,0,0,0
1748430599586,HUM 100,J00,946425,Crum; Matthew Stephen,16,0,16,0
1748430599586,HUM 100,K00,946426,Staff,0,0,0,0
1748430600620,INTL 100,A01,960908,Feuer; Anna Stagg,9,0,20,11
1748430600620,INTL 100,A02,960964,Feuer; Anna Stagg,16,0,20,4
1748430600620,INTL 100,A03,961088,Feuer; Anna Stagg,15,0,20,5
1748430600620,INTL 100,A04,961091,Feuer; Anna Stagg,17,0,20,3
1748430600620,INTL 100,A05,961100,Feuer; Anna Stagg,16,0,20,4
1748430600620,INTL 100,A06,961130,Feuer; Anna Stagg,19,0,20,1
1748430601647,INTL 101,A01,923053,McIntosh; Justin,1,0,30,29
1748430601647,INTL 101,A02,923055,McIntosh; Justin,8,0,30,22
1748430601647,INTL 101,A03,923127,McIntosh; Justin,5,0,30,25
1748430601647,INTL 101,A04,923140,McIntosh; Justin,0,0,30,30
1748430601647,INTL 101,A05,923148,McIntosh; Justin,9,0,30,21
1748430601647,INTL 101,A06,923186,McIntosh; Justin,10,0,30,20
1748430602681,INTL 102,A01,923194,Prather; Lauren R,3,0,30,27
1748430602681,INTL 102,A02,923195,Prather; Lauren R,4,0,30,26
1748430602681,INTL 102,A03,923199,Prather; Lauren R,13,0,30,17
1748430602681,INTL 102,A04,923202,Prather; Lauren R,7,0,30,23
1748430603710,INTL 190,A00,923203,Segui; Alan S,0,0,0,5
1748430603710,INTL 190,B00,923205,Segui; Alan S,0,0,0,9
1748430603710,INTL 190,C00,923219,Lee; Munseob,0,0,0,5
1748430604738,INTL 190H,A00,923247,Feuer; Anna Stagg,0,0,0,1
1748430605769,JAPN 10A,A01,923258,Kamioka; Sachiko,22,0,23,1
1748430605769,JAPN 10A,B01,923261,Ross; Kayoko F,23,0,23,0
1748430605769,JAPN 10A,C01,923265,Sato; Kyoko,20,0,23,3
1748430605769,JAPN 10A,D01,923268,Inada; Minori,22,0,23,1
1748430605769,JAPN 10A,E01,923270,Tipton; Yuko,9,0,12,3
1748430605769,JAPN 10A,E02,923273,Tipton; Yuko,12,0,12,0
1748430605769,JAPN 10A,F01,923352,Ross; Kayoko F,11,0,12,1
1748430605769,JAPN 10A,F02,923355,Ross; Kayoko F,12,0,12,0
1748430605769,JAPN 10A,G01,923358,McKee; Mayumi Mochizuki,7,0,10,3
1748430605769,JAPN 10A,G02,923360,McKee; Mayumi Mochizuki,6,0,10,4
1748430605769,JAPN 10A,H01,923365,Sato; Kyoko,8,0,12,4
1748430605769,JAPN 10A,H02,923370,Sato; Kyoko,12,0,12,0
1748430605769,JAPN 10A,I01,923373,Inada; Minori,8,0,12,4
1748430605769,JAPN 10A,I02,923374,Inada; Minori,8,0,12,4
1748430605769,JAPN 10A,J01,923376,McKee; Mayumi Mochizuki,11,0,12,1
1748430605769,JAPN 10A,J02,923428,McKee; Mayumi Mochizuki,11,0,12,1
1748430605769,JAPN 10A,K01,923433,Tipton; Yuko,5,0,10,5
1748430605769,JAPN 10A,K02,923437,Tipton; Yuko,9,0,10,1
1748430605769,JAPN 10A,L01,923439,Sato; Kyoko,12,0,12,0
1748430605769,JAPN 10A,L02,923449,Sato; Kyoko,11,0,12,1
1748430605769,JAPN 10A,M01,923455,Kamioka; Sachiko,22,0,23,1
1748430605769,JAPN 10A,N01,923459,McKee; Mayumi Mochizuki,22,0,23,1
1748430606800,JAPN 10AR,A01,923462,Tipton; Yuko,17,0,20,3
1748430607830,JAPN 20A,A01,923470,Takeda; Izumi,21,0,23,2
1748430607830,JAPN 20A,B01,923473,Iwamoto; Naoki,9,0,12,3
1748430607830,JAPN 20A,B02,923475,Iwamoto; Naoki,6,0,12,6
1748430607830,JAPN 20A,C01,923519,Takeda; Izumi,0,0,12,12
1748430607830,JAPN 20A,C02,923520,Takeda; Izumi,4,0,12,8
1748430607830,JAPN 20A,D01,923623,Iwamoto; Naoki,11,0,12,1
1748430607830,JAPN 20A,D02,923625,Iwamoto; Naoki,11,0,12,1
1748430607830,JAPN 20A,E01,923627,Simpson; Junko Tokuda,12,0,20,8
1748430608856,JAPN 130A,A01,923630,Kamioka; Sachiko,14,0,15,1
1748430608856,JAPN 130A,B01,923634,Ross; Kayoko F,11,0,15,4
1748430609884,JAPN 135A,A00,923636,Iwamoto; Naoki,10,0,20,10
1748430610910,JAPN 137A,A00,923638,Simpson; Junko Tokuda,19,0,20,1
1748430611939,JAPN 140A,A00,923640,Takeda; Izumi,18,0,20,2
1748430612967,JWSP 1,A01,921258,Shuster; Alana,19,0,20,1
1748430613997,JWSP 104,A01,921340,Shuster; Alana,15,0,15,0
1748430615026,LATI 10,A01,923694,Kennemore; Amy Michelle,22,0,28,6
1748430615026,LATI 10,A02,923695,Kennemore; Amy Michelle,25,0,28,3
1748430615026,LATI 10,A03,923707,Kennemore; Amy Michelle,25,0,28,3
1748430615026,LATI 10,A04,923713,Kennemore; Amy Michelle,27,0,28,1
1748430615026,LATI 10,A05,923720,Kennemore; Amy Michelle,28,0,28,0
1748430615026,LATI 10,A06,923723,Kennemore; Amy Michelle,30,0,30,0
1748430615026,LATI 10,A07,923745,Kennemore; Amy Michelle,26,0,30,4
1748430616058,LATI 50,A01,923778,Kokinis; Troy Andreas,27,0,30,3
1748430616058,LATI 50,A02,923779,Kokinis; Troy Andreas,28,0,30,2
1748430616058,LATI 50,A03,923780,Kokinis; Troy Andreas,29,0,30,1
1748430616058,LATI 50,A04,923783,Kokinis; Troy Andreas,28,0,30,2
1748430616058,LATI 50,A05,923784,Kokinis; Troy Andreas,30,0,30,0
1748430617085,LATI 166,A00,923785,Kokinis; Troy Andreas,117,0,120,3
1748430618110,LATI 170,A00,923787,Kennemore; Amy Michelle,45,0,60,15
1748430619138,LATI 180,A00,923788,Kennemore; Amy Michelle,52,0,60,8
1748430620166,LATI 184,A00,923790,Jimenez Cano; Nayeli Guada,29,0,30,1
1748430621195,LATI 200,A00,923791,Martin-Cabrera; Luis,7,0,10,3
1748430622222,LIAB 1A,A00,923983,Saab; Dima,12,0,14,2
1748430622222,LIAB 1A,B00,923984,Saab; Dima,8,0,14,6
1748430623247,LIAB 1AX,A00,923992,El Cheddadi; Youniss,25,0,28,3
1748430624275,LIAB 1D,A00,923996,Saab; Dima,7,0,14,7
1748430625302,LIAB 1DX,A00,923998,El Cheddadi; Youniss,10,0,14,4
1748430626337,LIFR 1A,A00,923999,Van Moer; Vinciane G,14,0,14,0
1748430626337,LIFR 1A,B00,924001,Van Moer; Vinciane G,14,0,14,0
1748430626337,LIFR 1A,C00,924003,Van Moer; Vinciane G,13,0,14,1
1748430626337,LIFR 1A,D00,924039,Van Moer; Vinciane G,12,0,14,2
1748430626337,LIFR 1A,E00,924044,Van Moer; Vinciane G,12,0,14,2
1748430626337,LIFR 1A,F00,924100,Van Moer; Vinciane G,10,0,14,4
1748430627368,LIFR 1AX,A00,924134,Van Moer; Vinciane G,26,0,28,2
1748430627368,LIFR 1AX,B00,924138,Van Moer; Vinciane G,24,0,28,4
1748430627368,LIFR 1AX,C00,924196,Van Moer; Vinciane G,26,0,28,2
1748430628394,LIFR 1B,A00,924197,Van Moer; Vinciane G,11,0,14,3
1748430628394,LIFR 1B,B00,924199,Van Moer; Vinciane G,11,0,14,3
1748430629419,LIFR 1BX,A00,924215,Van Moer; Vinciane G,23,0,28,5
1748430630447,LIFR 1D,A00,924216,Van Moer; Vinciane G,11,0,14,3
1748430630447,LIFR 1D,B00,924217,Van Moer; Vinciane G,12,0,14,2
1748430630447,LIFR 1D,C00,924218,Van Moer; Vinciane G,3,0,14,11
1748430631476,LIFR 1DX,A00,924219,Van Moer; Vinciane G,14,0,21,7
1748430631476,LIFR 1DX,B00,924220,Van Moer; Vinciane G,13,0,21,8
1748430632502,LIFR 11,A00,924221,Goodall; Grant Todd,10,0,10,0
1748430633529,LIGM 1A,A00,924222,Fischer-Grunski; Eva K,11,0,14,3
1748430633529,LIGM 1A,B00,924223,Fischer-Grunski; Eva K,13,0,14,1
1748430633529,LIGM 1A,C00,924224,Fischer-Grunski; Eva K,11,0,14,3
1748430633529,LIGM 1A,D00,924227,Fischer-Grunski; Eva K,11,0,14,3
1748430634556,LIGM 1AX,A00,924228,Fischer-Grunski; Eva K,28,0,28,0
1748430634556,LIGM 1AX,B00,924229,Fischer-Grunski; Eva K,19,0,28,9
1748430635584,LIGM 1D,A00,924230,Fischer-Grunski; Eva K,0,0,0,0
1748430635584,LIGM 1D,B00,924231,Fischer-Grunski; Eva K,12,0,14,2
1748430637071,LIGM 1DX,A00,924232,Fischer-Grunski; Eva K,0,0,0,0
1748430638095,LIGM 11,A00,924233,Goodall; Grant Todd,10,0,10,0
1748430639128,LIGN 5,A00,923794,Goodall; Grant Todd,112,0,120,8
1748430640154,LIGN 7,A00,923796,Mayberry; Rachel,115,0,120,5
1748430641180,LIGN 8,A00,923797,McIntosh; Justin,231,0,245,14
1748430642207,LIGN 17,A00,923798,Staff,232,0,245,13
1748430643234,LIGN 101,A01,923929,Bakovic; Eric John,26,0,30,4
1748430643234,LIGN 101,A02,923930,Bakovic; Eric John,26,0,30,4
1748430643234,LIGN 101,A04,923935,Bakovic; Eric John,19,0,30,11
1748430643234,LIGN 101,A05,923940,Bakovic; Eric John,23,0,30,7
1748430644260,LIGN 108,A00,923942,Rose; Sharon,29,0,35,6
1748430645290,LIGN 110,A01,923944,Garellek; Marc,15,0,27,12
1748430645290,LIGN 110,A02,923947,Garellek; Marc,14,0,27,13
1748430645290,LIGN 110,A03,923948,Garellek; Marc,20,0,27,7
1748430645290,LIGN 110,A04,923949,Garellek; Marc,4,0,27,23
1748430646318,LIGN 152,A00,967971,Caballero; Gabriela Hernandez,17,0,30,13
1748430647343,LIGN 160,A00,963083,Dudley; Rachel,39,0,50,11
1748430648371,LIGN 167,A00,923951,Warstadt; Alexander Scott,0,0,90,90
1748430649402,LIGN 179,A00,923955,Kluender; Robert,0,0,35,35
1748430650433,LIGN 188R,A00,923956,Clem; Emily,40,0,40,0
1748430651463,LIGN 200,A00,973075,Staff,0,0,0,0
1748430652490,LIGN 210,A00,923962,Garellek; Marc,10,0,10,0
1748430653516,LIGN 221,A00,923964,Clem; Emily,9,0,10,1
1748430654543,LIGN 236,A00,923965,Clem; Emily,8,0,10,2
1748430655569,LIGN 293,A00,923971,Caballero; Gabriela Hernandez,0,0,0,0
1748430656599,LIGN 296,001,950061,Ackerman; Farrell,10,0,10,0
1748430656599,LIGN 296,002,950062,Bakovic; Eric John,10,0,10,0
1748430656599,LIGN 296,003,950063,Bergen; Leon,10,0,10,0
1748430656599,LIGN 296,004,950064,Caballero; Gabriela Hernandez,10,0,10,0
1748430656599,LIGN 296,005,950065,Caponigro; Ivano,10,0,10,0
1748430656599,LIGN 296,006,950066,Clem; Emily,10,0,10,0
1748430656599,LIGN 296,007,950067,Dudley; Rachel,10,0,10,0
1748430656599,LIGN 296,008,950068,Garellek; Marc,10,0,10,0
1748430656599,LIGN 296,009,950070,Goodall; Grant Todd,9,0,10,1
1748430656599,LIGN 296,010,950071,Kehler; Andrew Scott,10,0,10,0
1748430656599,LIGN 296,011,950072,Kluender; Robert,10,0,10,0
1748430656599,LIGN 296,012,950073,Rose; Sharon,10,0,10,0
1748430656599,LIGN 296,013,950074,Styler; William Francis,10,0,10,0
1748430656599,LIGN 296,014,950075,Caponigro; Ivano,10,0,10,0
1748430657625,LIHL 112F,A00,923972,Pagkalinawan; Leticia Cant,15,0,28,13
1748430658655,LIHL 114F,A00,923973,Nguyen; Hoan Thi,8,0,28,20
1748430659683,LIHL 117F,A00,923974,Sadegholvad; Elham,19,0,20,1
1748430660710,LIHL 118,A00,923975,Chen; Areana Yen,23,0,28,5
1748430661737,LIHL 124F,A00,923976,Nguyen; Hoan Thi,17,0,20,3
1748430662768,LIHL 132F,A00,923978,Pagkalinawan; Leticia Cant,18,0,20,2
1748430663798,LIHL 134F,A00,923980,Nguyen; Hoan Thi,19,0,20,1
1748430664825,LIHL 138,A00,923982,Chen; Areana Yen,28,0,28,0
1748430665856,LIIT 1A,A00,924234,Carnelos; Chiara,11,0,14,3
1748430665856,LIIT 1A,B00,924235,Carnelos; Chiara,11,0,14,3
1748430665856,LIIT 1A,C00,924236,Carnelos; Chiara,13,0,14,1
1748430665856,LIIT 1A,D00,924237,Carnelos; Chiara,12,0,14,2
1748430666883,LIIT 1AX,A00,924238,Carnelos; Chiara,28,0,28,0
1748430666883,LIIT 1AX,B00,924239,Carnelos; Chiara,24,0,28,4
1748430667910,LIPO 1A,A00,924241,Paladini; Denise,13,0,14,1
1748430667910,LIPO 1A,B00,924242,Paladini; Denise,14,0,14,0
1748430668942,LIPO 1AX,A00,924243,De Abreu; Cassia,13,0,14,1
1748430668942,LIPO 1AX,B00,924244,De Abreu; Cassia,14,0,14,0
1748430669969,LIPO 1D,A00,924245,Paladini; Denise,11,0,14,3
1748430670996,LIPO 1DX,A00,924248,De Abreu; Cassia,14,0,14,0
1748430672024,LISL 1A,A00,924249,Lott; Margaret S.,9,0,14,5
1748430672024,LISL 1A,B00,924250,Lott; Margaret S.,11,0,14,3
1748430672024,LISL 1A,C00,924252,Lott; Margaret S.,7,0,14,7
1748430672024,LISL 1A,D00,924253,Lott; Margaret S.,12,0,14,2
1748430672024,LISL 1A,E00,924254,Lott; Margaret S.,4,0,14,10
1748430672024,LISL 1A,F00,924255,Lott; Margaret S.,13,0,14,1
1748430673052,LISL 1AR,A00,924257,Lott; Margaret S.,11,0,15,4
1748430673052,LISL 1AR,B00,924258,Lott; Margaret S.,10,0,15,5
1748430673052,LISL 1AR,C00,924260,Lott; Margaret S.,9,0,15,6
1748430673052,LISL 1AR,D00,968060,Lott; Margaret S.,3,0,3,0
1748430673052,LISL 1AR,E00,968061,Lott; Margaret S.,3,0,3,0
1748430673052,LISL 1AR,F00,968062,Lott; Margaret S.,3,0,3,0
1748430674079,LISL 1AX,A00,924261,Lott; Margaret S.,28,0,28,0
1748430674079,LISL 1AX,B00,924262,Lott; Margaret S.,18,0,28,10
1748430674079,LISL 1AX,C00,924263,Lott; Margaret S.,21,0,28,7
1748430675206,LISL 1B,A00,924264,Lott; Margaret S.,13,0,14,1
1748430675206,LISL 1B,B00,924265,Lott; Margaret S.,6,0,14,8
1748430675206,LISL 1B,C00,924302,Lott; Margaret S.,9,0,14,5
1748430675206,LISL 1B,D00,924304,Lott; Margaret S.,7,0,14,7
1748430675206,LISL 1B,E00,924305,Lott; Margaret S.,10,0,14,4
1748430675206,LISL 1B,F00,964375,Lott; Margaret S.,12,0,14,2
1748430676234,LISL 1BX,A00,924307,Lott; Margaret S.,12,0,28,16
1748430676234,LISL 1BX,B00,924308,Lott; Margaret S.,20,0,28,8
1748430676234,LISL 1BX,C00,924314,Lott; Margaret S.,28,0,28,0
1748430677265,LISL 1D,A00,924316,Lott; Margaret S.,0,0,14,14
1748430677265,LISL 1D,B00,924317,Lott; Margaret S.,0,0,14,14
1748430677265,LISL 1D,C00,924319,Lott; Margaret S.,0,0,14,14
1748430677265,LISL 1D,D00,924321,Lott; Margaret S.,0,0,14,14
1748430678295,LISL 1DX,A00,924323,Lott; Margaret S.,0,0,28,28
1748430678295,LISL 1DX,B00,924365,Lott; Margaret S.,0,0,28,28
1748430679330,LISP 1A,A00,924370,Munoz Sanchez; Alicia,12,0,14,2
1748430679330,LISP 1A,B00,924372,Munoz Sanchez; Alicia,8,0,14,6
1748430679330,LISP 1A,C00,924401,Munoz Sanchez; Alicia,0,0,14,14
1748430679330,LISP 1A,D00,924406,Munoz Sanchez; Alicia,3,0,14,11
1748430679330,LISP 1A,E00,924471,Munoz Sanchez; Alicia,0,0,14,14
1748430679330,LISP 1A,F00,924472,Munoz Sanchez; Alicia,4,0,14,10
1748430679330,LISP 1A,G00,924473,Munoz Sanchez; Alicia,11,0,14,3
1748430679330,LISP 1A,H00,924474,Munoz Sanchez; Alicia,9,0,14,5
1748430680362,LISP 1AX,A00,924478,Munoz Sanchez; Alicia,16,0,28,12
1748430680362,LISP 1AX,B00,924479,Munoz Sanchez; Alicia,26,0,28,2
1748430680362,LISP 1AX,C00,924484,Munoz Sanchez; Alicia,12,0,28,16
1748430680362,LISP 1AX,D00,924491,Munoz Sanchez; Alicia,18,0,28,10
1748430681393,LISP 1B,A00,924492,Munoz Sanchez; Alicia,12,0,14,2
1748430681393,LISP 1B,B00,924493,Munoz Sanchez; Alicia,6,0,14,8
1748430681393,LISP 1B,C00,924498,Munoz Sanchez; Alicia,13,0,14,1
1748430681393,LISP 1B,D00,924501,Munoz Sanchez; Alicia,13,0,14,1
1748430681393,LISP 1B,E00,924505,Munoz Sanchez; Alicia,11,0,14,3
1748430681393,LISP 1B,F00,924506,Munoz Sanchez; Alicia,9,0,14,5
1748430681393,LISP 1B,G00,924507,Munoz Sanchez; Alicia,10,0,14,4
1748430681393,LISP 1B,H00,924549,Munoz Sanchez; Alicia,12,0,14,2
1748430681393,LISP 1B,I00,924566,Munoz Sanchez; Alicia,13,0,14,1
1748430681393,LISP 1B,J00,924572,Munoz Sanchez; Alicia,13,0,14,1
1748430681393,LISP 1B,K00,924576,Munoz Sanchez; Alicia,12,0,14,2
1748430681393,LISP 1B,L00,924577,Munoz Sanchez; Alicia,13,0,14,1
1748430682442,LISP 1BX,A00,924578,Munoz Sanchez; Alicia,26,0,28,2
1748430682442,LISP 1BX,B00,924618,Munoz Sanchez; Alicia,24,0,28,4
1748430682442,LISP 1BX,C00,924619,Munoz Sanchez; Alicia,20,0,28,8
1748430682442,LISP 1BX,D00,924629,Munoz Sanchez; Alicia,24,0,28,4
1748430682442,LISP 1BX,E00,924635,Munoz Sanchez; Alicia,24,0,28,4
1748430682442,LISP 1BX,F00,924640,Munoz Sanchez; Alicia,27,0,28,1
1748430683481,LISP 1D,A00,924641,Munoz Sanchez; Alicia,10,0,14,4
1748430683481,LISP 1D,B00,924649,Munoz Sanchez; Alicia,10,0,14,4
1748430683481,LISP 1D,C00,924654,Munoz Sanchez; Alicia,11,0,14,3
1748430683481,LISP 1D,D00,924660,Munoz Sanchez; Alicia,7,0,14,7
1748430683481,LISP 1D,E00,924671,Munoz Sanchez; Alicia,5,0,14,9
1748430683481,LISP 1D,F00,924722,Munoz Sanchez; Alicia,6,0,14,8
1748430683481,LISP 1D,G00,924724,Munoz Sanchez; Alicia,8,0,14,6
1748430683481,LISP 1D,H00,924726,Munoz Sanchez; Alicia,9,0,14,5
1748430683481,LISP 1D,I00,924728,Munoz Sanchez; Alicia,13,0,14,1
1748430683481,LISP 1D,J00,924732,Munoz Sanchez; Alicia,14,0,14,0
1748430683481,LISP 1D,K00,924739,Munoz Sanchez; Alicia,13,0,14,1
1748430683481,LISP 1D,L00,924745,Munoz Sanchez; Alicia,12,0,14,2
1748430684510,LISP 1DX,A00,924747,Munoz Sanchez; Alicia,23,0,28,5
1748430684510,LISP 1DX,B00,924818,Munoz Sanchez; Alicia,27,0,28,1
1748430684510,LISP 1DX,C00,924819,Munoz Sanchez; Alicia,16,0,28,12
1748430684510,LISP 1DX,D00,924820,Munoz Sanchez; Alicia,23,0,28,5
1748430684510,LISP 1DX,E00,924821,Munoz Sanchez; Alicia,16,0,28,12
1748430684510,LISP 1DX,F00,924822,Munoz Sanchez; Alicia,22,0,28,6
1748430685536,LISP 15,A00,924823,Munoz Sanchez; Alicia,17,0,20,3
1748430686565,LISP 18,A00,924824,Munoz Sanchez; Alicia,14,0,20,6
1748430687596,LTAF 120,A00,925431,Zhiri; Oumelbanine,37,0,40,3
1748430688627,LTAM 100,A00,925432,Villafuerte Vazquez; Nadia,33,0,40,7
1748430689661,LTCH 101,A00,964372,Liao; Ping H,35,0,40,5
